//灵梦口上:
PRINTFORMDW あの迷宮が霊夢の前に姿を現すとすれば、それは……前と同じく一人で無防備に探し回っている場合のみ。	PRINTFORMDW 如果那个迷宫出现在灵梦面前、那只能是……和以前一样，只有一个人毫无防备地四处寻找的时候。
PRINTFORMW 「もう完全にくっついちゃった上に、この様子だと私を見るだけで興奮しちゃうんでしょ？　おっきなお腹の私を」	PRINTFORMW 「已经完全粘在一起了，再加上这个样子，光是看到我就会兴奋吧？　看到这大肚子的我」
PRINTFORMDW 断末魔を漏らしながら奇怪に歪んでいく様を見れば、もう止めは要らないことは、分かる。それでも……	PRINTFORMDW 看着它一边说着临终遗言，一边奇怪地扭曲着的样子，就知道已经不需要阻止了。尽管如此……
PRINTFORMDW そうして晒された魔理沙の股間には、本来女性にはありえない、しかし迷宮では散々見かけたモノがついていた。	PRINTFORMDW 在魔理沙的大腿间，有一件本来不可能是女性所有的，但在迷宫里却随处可见的东西。
PRINTFORMDW 生き物のように揺れ、崩れ始めた天井や壁は、この通路で脱出できる機会が今しかないことを示していた。	PRINTFORMDW 天花板和墙壁像生物一样摇晃着、开始崩塌、这表明通过这条通道逃生的机会只有现在。
PRINTFORMDW だから、できない。{DAY}日も彷徨った挙句、逃げ出すのがやっとだった前回を繰り返すわけにはいかない。	PRINTFORMDW 所以，没办法。我不能再重复上次彷徨了{DAY}天，好不容易逃走的情形。
PRINTFORMDW この中にいれば紫も手を出せず、今度こそ元凶を倒せば娘の扱いに文句をつけられる云われはない。	PRINTFORMDW 只要在这里面，紫也不会出手，这次一定要打倒元凶，这样就不会有人对女儿指手画脚了。
PRINTFORMDW ここから更に止めを刺す必要はなかった。断末魔を漏らしながら奇怪に歪んでいく様を見れば、分かる。	PRINTFORMDW 没必要再继续攻击了。看到她一边说着临终遗言，一边离奇地扭曲的样子，就明白了。
PRINTFORMDW 小さく漏らす霊夢。これで終わりだ。元凶が断たれた以上、後は残りをじっくり安全に片付ければいい。	PRINTFORMDW 灵梦小声说着。这样就结束了。既然元凶已经断掉了，剩下的就慢慢地安全处理好了。
PRINTFORMDW 弄びながら自らも服を脱ぎ捨てた霊夢は、明らかに膨らんだ胸と腹を抱えながら魔理沙の股間に跨った。	PRINTFORMDW 灵梦一边玩弄一边将衣服脱了下来、抱住明显膨胀的胸和腹部、跨上了魔理沙的股间。
PRINTFORMDW 迷宮から脱出はできたものの……二人の体と心が元に戻ることはなく、ただ毎日のように犯し犯されるだけ。	PRINTFORMDW 虽然逃出了迷宫……两个人的身心并没有恢复到原来的状态，只是每天都在交合。
PRINTFORMDW 「紫様がいない状況で更に、博麗の巫女まで行方不明にする気か？　片方だけならまだしも……」	PRINTFORMDW 「在紫样不在的情况下，还想让博丽的巫女失踪吗？　如果只有一边的话还说得过去……」
PRINTFORMDW あれから、半月。霊夢は自分の産んだ娘を引き取って、いつも通りの生活に戻った。いつも通りの……	PRINTFORMDW 那之后，半个月了。灵梦收养了自己生下的女儿，恢复了往常的生活。和往常一样……
PRINTFORMDW だが、無事に戻ってきた魔理沙はなぜか外出を控えるようになり……そんな彼女の元に霊夢は足しげく通っていた。	PRINTFORMDW 但是，平安归来的魔理沙不知为何控制了外出，而灵梦经常来到她身边。
PRINTFORMDW 何かを探すように霊夢が首を回すと同時に、霊夢にそっくりな小さい影が紫の背後から現れる。	PRINTFORMDW 灵梦像是在寻找什么似的转头、与此同时，紫的背后出现了一个和灵梦一模一样的小影子。
PRINTFORMDW 周囲には鬱蒼とした森。隠れるのには最適だろう。紫には関係ないんだろうけど、とも思ったが。	PRINTFORMDW 周围是郁郁葱葱的森林。用来躲藏最合适不过了。但也许和紫没什么关系吧、这么想着。
PRINTFORMDW 断末魔を漏らしながら奇怪に歪んでいく様を見る限り、止めを刺すまでもなく死んでいくだろう。	PRINTFORMDW 看到他一边说着临终遗言，一边离奇地扭曲着的样子，看样子就不需要补刀它也会死吧。
PRINTFORMDW 子持ち母親の説得力に魔理沙が押される中、ぽん、と胸の中にいる娘が魔理沙の頭を叩いた。	PRINTFORMDW 被有孩子的母亲的说服力所压倒的魔理沙，砰”的一声，被怀中灵梦的女儿敲了魔理沙的头。
PRINTFORMDW それならそれでいい、と霊夢は思った。また一人で探し回れば、向こうから捕まえに来るだろうから。	PRINTFORMDW 那就这样吧、灵梦这样想着。如果再一个人去找的话、对方一定会想来抓捕的吧。
PRINTFORMW 「そりゃ、私だってそうしたいけどね……紫どころか式神までやられてるのに一人で殴り込めっての？」	PRINTFORMW 「当然，我也想这么做……别说是紫了，连式神都被打倒了，你一个人还敢去吗？」
PRINTFORMDW 今日もまた子供を産む霊夢の体は、出産で受ける感覚がすべて快感になるよう作り変えられていた。	PRINTFORMDW 今天也还在生孩子的灵梦的身体，被改造成生产时感受到的所有感觉都变成了快感。
PRINTFORMW 『もう一度言うわ、霊夢。その子を渡しなさい。この異変を解決するには、その娘は利用できる』	PRINTFORMW 『我再说一遍，灵梦。把那个孩子交给我。为了解决这个异变，那个孩子是可以利用的』
PRINTFORMDW ふん、と吐き捨てる。脱出してきた迷宮が消えて場所がわからなくなった、と言ったのもまずかった。	PRINTFORMDW 噗，一声吐了出来。逃出来后的迷宫就消失了，搞不清地点了、这样说也不好。
PRINTFORMDW 母親が完全に屈服したことを確認した娘は、愛おしげに霊夢を抱え上げると迷宮の一室に連れ込んだ。	PRINTFORMDW 确认母亲完全屈服的女儿，满怀爱意地抱起灵梦，把她带到迷宫的一间屋子里。
PRINTFORMDW 霊夢が絶頂すると共に、娘の竿は霊夢の一番奥で射精した。膣から、白いものが溢れてくる。	PRINTFORMDW 在灵梦达到高潮的同时，女儿的竿子在灵梦的最深处射精。白色的东西从阴道里溢出来。
PRINTFORMDW あまりにも瓜二つな子供に、眼をまばたかせる香霖。そんな彼の耳に、予想だにしない言葉が届いた。	PRINTFORMDW 这个和简直她一模一样的孩子、眨了眨眼。霖之助听到了一句意料之外的话。
PRINTFORMDW それなのに、こうして迷っている。失敗、喪失、未知――今まで縁遠かったもので逡巡して。	PRINTFORMDW 尽管如此，却如此迷茫。失敗、喪失、未知――因为至今为止的无处可寻而犹豫不决。
PRINTFORMDW 言葉を漏らす。背負った子供が重い。捨ててしまえれば、霊夢ではなく娘を狙うに違いない。	PRINTFORMDW 话音刚落。就感觉到背着的孩子很重。如果抛弃她，紫一定会瞄准女儿，而不是灵梦。
PRINTFORMDW 「も、もうやめようよ……お前、何回も何回も私犯して……妊娠、しちゃってるのに……やあぁっ！？」	PRINTFORMDW 「快、快停手吧……你、一次次地侵犯我……明明已经怀孕了……呀！？」
PRINTFORMDW 結局、魔理沙は抗えずに嬌声を上げることしかできない。霊夢に犯される快楽に酔いしれてしまう。	PRINTFORMDW 结果，魔理沙无法抵抗，只能娇滴滴地叫出声来。沉醉在被灵梦侵犯的快乐中。
PRINTFORMW 「んあああああああああっ！　やめて、やめてやめてやめてぇ！　イく、すぐイっちゃうぅぅっ！」	PRINTFORMW 「嗯啊啊啊啊啊啊啊！　住手、住手住手住手啊！　去了、马上就去了啊啊啊啊！」
PRINTFORMDW 「いや、僕には自分の店の管理が……だいたい、神隠しは無事に終わったんじゃないのかい？」	PRINTFORMDW 「不行、我要管理自己的店……再说、迷宫不是因为突然消失而平安结束了吗？」
PRINTFORMW 「あそこから抜けだしても、射精するのやめられないんでしょ？　私も同じ、精液が欲しくてたまらないの。	PRINTFORMW 「就算从那里抽出来，也无法停止射精吧？　我也一样，非常渴望精液。
PRINTFORMDW 今の彼女たちに妖怪退治ができるはずもなく、できる事はただ苗床として互いの子を作り続ける事のみだった……	PRINTFORMDW 现在的她们不可能退治妖怪，能做的只有作为苗床继续生育……
PRINTFORMDW 娘の腰の動きが加速する。その気持ちよさに、言葉と裏腹に霊夢の腰も自然と揺れてしまう。	PRINTFORMDW 女儿的腰部动作加快了。在这种心情的刺激下，灵梦的腰部也不由自主地摇晃起来。
PRINTFORMDW 女王の死で総崩れとなった怪物たちはあっさり殲滅され、閉じこまれていた人妖も救出できた。	PRINTFORMDW 由于女王的死而全线崩溃的怪物们被简单地歼灭，被封闭的人和妖也被救出了。
PRINTFORMDW いつも、何か期待するように熱い吐息を漏らしながら――今日も霧雨魔法店に足を踏み入れる。	PRINTFORMDW 总是像是期待着什么似的，一边吐着炽热的气息——今天也走进了雾雨魔法店。
PRINTFORMW 　ほら、おちんちんは素直よ魔理沙？　おっきくなって、なかに、出そうとっ、してるぅ……♪	PRINTFORMW 　你看、魔理沙、小鸡鸡很老实哦？　变得这么大、在里面、快要射、的样子……♪
PRINTFORMDW 応援を呼んで外からなんとかすればいいと思っていた霊夢の考えまで、見事に整地されてしまった。	PRINTFORMDW 灵梦还想着出到外面来再想办法救援就行了、没想到现在只有一片平地。
PRINTFORMDW こうして休んでいるのは異変が終わったと思っているからではなく、どうしようもないからだった。	PRINTFORMDW 之所以这样休息，并不是因为认为异变已经结束了，而是因为无可奈何。
PRINTFORMDW それを抜きにしても幻想郷の管理を任せ、いつものごとく一人で突っ走って再突入できたはずだ。	PRINTFORMDW 就算不会这样，也可以把幻想乡的管理交给他，像往常一样一个人冲进去。
PRINTFORMDW この異変を起こした異種の血を引く娘の存在と、それを霊夢が庇う事実が彼女には気に入らない。	PRINTFORMDW 她不喜欢拥有引起异变的异种血统的女儿的存在，以及灵梦包庇她的事实。
PRINTFORMDW 多種多様な式神を使って連日行われる、持久戦狙いの襲撃。食料や住居を狙った兵糧攻め。	PRINTFORMDW 连续几天使用多种多样的式神进行持续的袭击。以食物和住所为目标的粮草攻势。
PRINTFORMDW 僅かな引っ掛かりと苛立ちを覚えながら、ぼうっとする……それが、戻ってきてからの日常だった。	PRINTFORMDW 一边感到些微的不安和焦躁，一边发呆……这就是我回来后的日常生活。
PRINTFORMDW 自分とそっくりな相手と口付けをすることも、それが自分の娘だということも、余計興奮してしまう。	PRINTFORMDW 和自己长得一模一样的人接吻，或者说是自己的女儿，让人更加兴奋。
PRINTFORMW 「ねぇ……今でも、私を孕ませられるの？　あの感覚が、忘れられないから……だから、ね？」	PRINTFORMW 「呐……现在还、能让我怀孕吗？　因为我无法忘记那种感觉……所以呢、呐？」
PRINTFORMDW それでもいつか、魔理沙が治ると信じる。そう信じて、動かない彼女の世話をすると決めた。	PRINTFORMDW 尽管如此，我相信总有一天魔理沙会痊愈的。一直相信着，决定照顾不动的她。
PRINTFORMDW 霊夢は暇つぶしに娘とサッカーをしていた。拾ったガラクタを適当に蹴り合っているだけだが。	PRINTFORMDW 灵梦为了打发时间和女儿一起踢足球。虽然只是随便踢一下捡来的破烂而已。
PRINTFORMDW なんとか助けられたものの全身を犯された魔理沙の心からは、財宝への欲は完全に消えていた。	PRINTFORMDW 魔理沙虽然好不容易获救，但全身都被侵犯了，他对财宝的欲望完全消失了。
PRINTFORMDW そのまま、膣内へとじっくりと竿を押し込んでいく。慣れ親しんだ快感に、霊夢は腰を浮かした。	PRINTFORMDW 就这样，把竿子慢慢地塞进阴道里。一种熟悉的快感让灵梦的腰挺了起来。
PRINTFORMW （油断させて倒すため、だもの……気持ちよくなるためじゃないなら、こういう事しても……）	PRINTFORMW （是为了让它麻痹大意、把它打倒……如果不是为了变得舒服、这种事也……）
PRINTFORMDW しばらく藍の話を聞いていた霊夢だったが、数分もすると耐え切れなくなったように腕を上げた。	PRINTFORMDW 听蓝说了一会儿的灵梦，过了几分钟后，好像无法忍受似的抬起了手臂。
PRINTFORMDW なぜか、気分が重い。茶を飲んでいても落ち着かない。周りのことがすべて色褪せて見える。	PRINTFORMDW 不知为什么，心情很沉重。喝着茶也静不下来。周围的一切看起来都褪色了。
PRINTFORMDW 女王の死で総崩れとなった怪物たちはあっさり殲滅され、閉じこめられていた人妖も救出できた。	PRINTFORMDW 因女王之死而溃不成军的怪物们被轻易歼灭，被囚禁的人和妖也获救了。
PRINTFORM 　お互い損はしないんだし、いいじゃない？　魔理沙の子供なら、ちゃんと産んであげるわ……	PRINTFORM 　彼此都不会吃亏，不是挺好的吗？　而且是魔理沙的孩子，我会好好生下来的……
PRINTFORMDW 半年経っても彼女はここがトラウマだったが、対照的に霊夢の表情はにこやかな笑顔だ。	PRINTFORMDW 半年过去了，她在这里受到了心理创伤，但与此相反，灵梦的表情却是笑容满面。
PRINTFORMDW 数週間後、香霖堂には様々な物品を抱えた霊夢とげっそり痩せた魔理沙の姿があったという……	PRINTFORMDW 几周后，香霖堂出现了抱着各种物品的灵梦和瘦骨嶙峋的魔理沙的身影……
PRINTFORMDW それは迷宮があったはずの場所も例外ではなく……出入口どころか迷宮そのものが無くなっていた。	PRINTFORMDW 那个应该有迷宫的地方也不例外……别说出入口，连迷宫都没有了。
PRINTFORMDW 広がっているのは彼女の内心を、そしてこの先を展望を表すかのような曇り空だけだった……	PRINTFORMDW 广阔的只有乌云密布的天空，仿佛在表达她的内心，以及对未来的展望……
PRINTFORMDW 迷宮から脱出して一週間。疲労困憊のまま、霊夢は歩いていた。眠っている自分の娘を背負って。	PRINTFORMDW 从迷宫中逃出来一周间。灵梦疲惫不堪地走着。背着自己熟睡的女儿。
PRINTFORMDW 体こそ治せたものの、精神は壊れたまま――空っぽで、喋ることも、動くことも、ない。	PRINTFORMDW 身体虽然治好了，但精神还是崩溃了——双眼无神，既不能说话，也不能动弹。
PRINTFORMDW 興味を覚えたのか、微妙に表情を変えた魔理沙に対し霊夢はぐ！と親指を立てて宣言した。	PRINTFORMDW 可能是兴致来了、微妙地改变了表情，灵梦刷的一下对魔理沙竖起了大拇指。
PRINTFORMDW 娘は朗らかに笑うと自分の股間から竿を生やし、霊夢の割れ目にぴったりと先端を当てる。	PRINTFORMDW 女儿爽朗地笑了笑，从自己的大腿间生出一根竿子，尖端紧贴着灵梦的裂缝。
PRINTFORMW 「何かしらこれ……ま、確認するのは後でいいわね。見つけられたんだし、少し休も……」	PRINTFORMW 「这是什么……嘛、之后再确认就好了。既然找到了，就稍微休息一下吧……」
PRINTFORMDW あの日、一時的に外へ出る選択をした霊夢を待っていたのは、何もないまっ平らな平地だった。	PRINTFORMDW 那天，暂时选择外出的灵梦，等待着他的，是一片什么都没有的平地。
PRINTFORMDW 藍の言葉に、霊夢は怒鳴り返す。こういうじっくりとした動き方は、彼女の主義ではなかった。	PRINTFORMDW 听到蓝的话，灵梦怒吼道。这种慢条斯理的行动方式，不是她的风格。
PRINTFORMDW しばらく橙の話を聞いていた霊夢だったが、数分もすると耐え切れなくなったように腕を上げた。	PRINTFORMDW 听了橙的话的灵梦，过了几分钟后，好像无法忍受似的抬起了胳膊。
PRINTFORMDW 異変で情勢不安定になった幻想郷では助けを求めることもできず、逃げ回るしかできなかった。	PRINTFORMDW 在因异变而局势变得不稳定的幻想乡，无法寻求帮助，只能四处逃亡。
PRINTFORMDW 脱走者を捉える好機と見て誘い込みにかかったのだろうが、霊夢にとっても狙い通りだ。	PRINTFORMDW 大概是认为这是捕捉逃脱者的好机会而进行引诱吧，对灵梦来说也正合其意。
PRINTFORMDW どうやら、娘がずっと呼んでいたらしい。慌てて振り向くと、自分の子供が裸で立っていた。	PRINTFORMDW 看来是女儿一直在叫她。慌忙回头一看，自己的孩子光着身子站在那里。
PRINTFORMDW 相変わらず首を傾げている自分の娘に歩み寄ると、そのままキスをする。それも、舌を入れて。	PRINTFORMDW 她走到依然歪着头的女儿身边，吻了她一下。然后，把舌头伸了进去。
PRINTFORMDW 「嫌なんだよー！　そりゃ化け物はほとんどいなくなったけど、罠はまだ残ってるじゃんか！」	PRINTFORMDW 「当然很难受啊！　虽然怪物几乎没有了，但是陷阱还留着不是吗！」
PRINTFORMDW ぐったりとしてした霊夢を触手で縛り上げると、娘はさっそく胸に吸い付き母乳を吸い上げていく……	PRINTFORMDW 用触手把筋疲力尽的灵梦绑起来，女儿立刻开始吸吮着母乳……
PRINTFORMW 「んんっ……勘違いしないでよ、身内の恥を外に出したくないってだけなんだから、んむぅっ……」	PRINTFORMW 「嗯嗯……你别误会，我只是不想让自己的家人出丑而已、嗯姆……」
PRINTFORMW 「でも、あれだけ体験してもいつも通りなあたり……逆に大丈夫という考え方もあるわね。	PRINTFORMW 「但是，即使经历了那么多，已经习惯了……反过来想也还是可以理解的。
PRINTFORMDW クイーンの死により迷宮は機能保全を起こし、行方不明になっていた魔理沙も助け出せたが……	PRINTFORMDW 由于女王的死，迷宫的机能得以保全，也救出了失踪的魔理沙……
PRINTFORMDW 余韻に浸っていた霊夢の奥を、また竿が押し広げる。急な快楽で、霊夢の息が詰まる。	PRINTFORMDW 沉浸在余韵中的灵梦的深处，又被竹竿撑开了。突然的快乐，让灵梦窒息。
PRINTFORMDW はぁ、と露骨なため息を返されたが、霊夢はいつも通りの表情で気にする様子はない。	PRINTFORMDW “唉”她露骨地叹了口气，但灵梦还是一如既往地表情平静，毫不在意。
PRINTFORMDW さっそく財宝探しに入ろうと、魔理沙が適当なでこぼこへと無防備に近づいた瞬間――	PRINTFORMDW 为了立刻开始寻找财宝，魔理沙向适当的坑坑洼洼无防备接近，瞬间――
PRINTFORMW 「や、ふやぁっ！？　その吸い方いやぁ、赤ちゃんにイかされるのいや、あ、ああぁっ♪」	PRINTFORMW 「不、布要啊！？　不要那样子吸、不想被孩子弄去啊、啊、啊啊啊♪」
PRINTFORMW 「あ、ふあ、あっ、きもちいいっ、こういうのやめるって決めたのに、きもちいぃよぉっ♪」	PRINTFORMW 「啊、呼啊、啊、好舒服啊、明明决定不再做这种事了、好舒服啊♪」
PRINTFORMDW 霊夢は仲間が逃げ出す気配を即座に感じ取ったらしく、敵の体内から悲鳴が漏れ始める。	PRINTFORMDW 灵梦似乎立刻察觉到了同伴逃跑的迹象，敌人的体内开始发出悲鸣。
PRINTFORMDW ガーディアンの撃破と共に出口が開く。紛れも無い、外への通路だった。だが……	PRINTFORMDW 随着卫士被击破，出口被打开了。毫无疑问，是通往外面的通道。但是……
PRINTFORMDW それに驚くことなく、むしろ嬉しそうな顔でその少女を――自分の娘を撫でる霊夢。	PRINTFORMDW 她并没有感到惊讶、反而一脸高兴地抚摸着那个少女――灵梦自己女儿。
PRINTFORMW 「わかってるわよ、そんなの！　だからあんたと組んで、地味な調査に専念してるんじゃないの！」	PRINTFORMW 「这我知道！　所以才和你搭档、专心做些朴素的调查吧！」
PRINTFORMDW 声を聞くやいなや、さっそく娘は魔理沙に抱きついていった。しっかりと受け止める魔理沙。	PRINTFORMDW 一听到声音，女儿马上就抱住了魔理沙。魔理沙也好好接住了。
PRINTFORMDW 聞くやいなや、180°回れ後ろをする魔理沙。だが、あっさり霊夢に服を掴まれた。	PRINTFORMDW 听到这话，魔理沙就向后转了过去。但是，被灵梦轻易地抓住了衣服。
PRINTFORMW 「ふぅ、ふうぅっ……あはっ、私、またこどもに……きもちよく、されちゃったぁ……♪」	PRINTFORMW 「嗯、哼嗯……啊哈、我、又被自己的孩子……弄得、很舒服……♪」
PRINTFORMDW 紫が帰ったのを確認するやいなや空を飛び、その辺の妖精を蹴散らしながら突き進む。	PRINTFORMDW 确认紫回来后，便立刻飞向天空，一边冲散附近的妖精，一边向前冲。
PRINTFORMDW 多少消耗しながらも直感で辿り着いたのは、今まで見たこともないおかしな地下洞窟。	PRINTFORMDW 虽然多少有些消耗，但凭着直觉到达了一个前所未见的奇怪地下洞穴。
PRINTFORMDW 縋りつくような霊夢の泣き声をその場に残して、%CALLNAME:1%は逃げ出した……	PRINTFORMDW %CALLNAME:1%留下了痛哭流涕的灵梦逃走了……
PRINTFORMW 「そもそも、あんたと同じか分からない以上……こんな話しても意味ないけど、ね……」	PRINTFORMW 「说到底、还不知道跟你是不是同类……这样说也没什么意义啊……」
PRINTFORMDW ガーディアンを倒し、あの迷宮を脱出してから一ヶ月後。霊夢は、神社で客を迎えていた。	PRINTFORMDW 在打败了卫士，逃出那个迷宫的一个月后。灵梦在神社里迎客。
PRINTFORMDW そもそも、捨てさせるために紫はこんな事をしてるんだろうな、と思考が浮かぶ。	PRINTFORMDW 原本紫就是为了让我丢弃孩子才这么做的吧、这样的想法浮现在脑海里。
PRINTFORMDW それでも、霊夢は自分の娘を背負って歩き続け……とうとう、目的地に辿り着いた。	PRINTFORMDW 即便如此，灵梦还是背着自己的女儿继续前行……终于到达了目的地。
PRINTFORMW 「ふふーん……？　くだらない妄想する前に、まずその白馬の王子様とやらを見つけることね」	PRINTFORMW 「呵呵……？　在胡思乱想之前，首先要找到那个白马王子呢」
PRINTFORMDW 「変なとこには蹴り飛ばさないが、サッカーがパワーなのは確かだぜ、そら！」	PRINTFORMDW 「不会踢到奇怪的地方啦、不过踢球确实是需要力量da☆ze、看招！」
PRINTFORMW 「あ、あぁ、うぅっ……で、でて、くるの！　なかから、なにか出てくるぅぅっ！」	PRINTFORMW 「啊、啊啊、嗯……要、生出、来了！　里面、好像有什么东西出来了！」
PRINTFORMW 「いつもなら結界くらい軽く張れるのに、なんで手こずってんのよ私は……！」	PRINTFORMW 「如果是平时的话，我轻轻松松就能张开结界，、为什么现在这么难了……！」
PRINTFORMDW 中を細かく抉っていく動きに、散々秘所を犯され開発されてきた霊夢は耐え切れない。	PRINTFORMDW 在里面仔细挖掘的动作，让一直被侵犯和开发秘部的灵梦无法忍受。
PRINTFORMDW そんな霊夢の顔を見て、娘はにっこりと笑った。膣内から、自分のペニスを抜かないまま。	PRINTFORMDW 看到灵梦的脸，女儿微微一笑。没有从阴道里拔出自己的阴茎。
PRINTFORML 　そう……待つだけ、待つだけよ、他に手がないから仕方なくやってるんだから。	PRINTFORML 　是吗……只有等待，只能等待了、因为没有其他办法，所以只好这么做。
PRINTFORMW 「終わってないわよ。出口が消えるのは予想してたけど、迷宮自体まで消えてたんだから」	PRINTFORMW 「还没结束呢。我本来以为出口会消失，没想到连迷宫都消失了」
PRINTFORMDW 温泉なら上がってきたばかりらしく、頭を布巾で拭きながら困ったように首を傾げている。	PRINTFORMDW 她好像刚洗完温泉，一边用毛巾擦着头，一边困惑地歪着头。
PRINTFORMW 「まったく、結界の展開にお風呂に世話までっ……世話を焼かせないでよ、ねっ！」	PRINTFORMW 「真是的，为了结界的展开连洗澡都要照顾……别让我照顾你啊，呐！」
PRINTFORMW 「だ、だめだめだめだめぇ！　きもちいぃことはしてあげるから、こどもはぁっ！」	PRINTFORMW 「不、不行不行不行不行啊！　我会跟你做舒服的事情、孩子的话就！」
PRINTFORMDW それから毎日、霊夢は娘たちに犯され続け……何度も出産してはすぐ孕まされた。	PRINTFORMDW 从那以后，灵梦每天都被女儿们侵犯……生了好几次，很快就怀上了。
PRINTFORMW 「当然でしょ。二人で行っても警戒されて見つけられないかもしれないし、留守番は必要だし」	PRINTFORMW 「当然了。两个人去不可能不被发现、而且还需要看门的」
PRINTFORMW 「んうっ……降りてっ……くるのぉ、なか、こすりながら、おりてくるぅ……♪」	PRINTFORMW 「嗯唔……要生……出来了、里面、一边摩擦着、一边生出来了……♪」
PRINTFORMW 「真っ向からぶつかってどかーんと弾幕やって終わるのが、いつものやり方なんだけどねぇ」	PRINTFORMW 「一般来说平时都是迎面冲上去，然后“轰”的一声解决掉」
PRINTFORMDW 嬉しそうな娘に霊夢はもはや抵抗する様子もなく、蕩け切った笑みを浮かべるだけ。	PRINTFORMDW 灵梦对高兴的女儿已经没有抵抗的样子，只是露出了淫乱的笑容。
PRINTFORMW 「ほ、ほら……さっさと動きなさいよ……他のやつ、襲わせるわけにはいかないんだから……	PRINTFORMW 「快、快点……快点动起来吧……我不能让其他人袭击你……
PRINTFORM 　んふっ、そんな顔しても、だーめ、逃がさないの、精液出させるのっ、うあぁんっ	PRINTFORM 　哼哼、就算做出那样的表情，也不行、别想逃走、把精液射给你、呜啊啊
PRINTFORMW 「これって確か……えーっと、あの凄いやつだっけ。私に使いこなせるかしら？」	PRINTFORMW 「这个我记得是……嗯、是那个挺厉害的东西吧。我能运用自如吗？」
PRINTFORMW 　私は普通に飛べるし、それを抜きにしてもこんな所じゃまともに飛べないし」	PRINTFORMW 　虽然我可以正常飞行，但如果没有它，在这种地方我就不能正常飞行」
PRINTFORMW 「この調子でいっぱい集めて帰れば、異変の時以外は寝て暮らせるわね！」	PRINTFORMW 「照这个样子收集了很多回去的话、除了特殊情况以外就可以安稳睡觉了！」
PRINTFORM 「どぉ、おちんちんから搾り取られる感覚……？　しゃせーで動けなくして倒しちゃうんだからね	PRINTFORM 「大鸡鸡被榨精的感觉怎么样……？　让你射到站不起来哦
PRINTFORMDW 二人の目指す場所は、言うまでもなくあの迷宮。目的は、今度こそ根源を断つため。	PRINTFORMDW 两个人的目标，不用说就是那个迷宫。这次一定要切断其根源。
PRINTFORMDW 寝床や食料を調達しようとして、先回りされ妨害を受けた事が何度あったか。	PRINTFORMDW 我有多少次在准备铺盖和食物的时候，被人抢先了一步，受到了妨碍。
PRINTFORMDW それからずっと、霊夢は毎日のように娘と交わり合っている。例外は食事と、睡眠と、	PRINTFORMDW 从那以后，灵梦几乎每天都在和女儿交合。除了饮食和睡眠、
PRINTFORMDW 外見こそ人間でも明らかに人ではないそれに、霊夢は息を切らしながらも笑いかけた。	PRINTFORMDW 虽然外表上是人，但显然不是人，灵梦气喘吁吁地笑了起来。
PRINTFORMDW 魔理沙は、動かない。何も見ること無く、ぼんやりとした瞳でどこかを見つめ続けている。	PRINTFORMDW 魔理沙一动不动。双眼无神，只是呆呆地盯着什么地方。
PRINTFORMDW 放たれた弾は目標を貫通し、クイーンの体は真っ二つにへし折れて萎びていった――	PRINTFORMDW 射出的弹幕穿透了目标，女王的身体被打成两半，开始枯萎――
PRINTFORMW 「間違いなく。あんな状況でも見つけられるくらいよ、今なら余裕で宝を漁れるわね」	PRINTFORMW 「没错。在那种情况下也能找到，现在的话还可以从容地寻宝了」
PRINTFORMW 「いじらないでぇっ……いま、乳首、そんなにすわれたら、あ、あぁっ……！」	PRINTFORMW 「不要欺负胸部啊……现在、乳首、被这么吸着的话、啊、啊啊……！」
PRINTFORMW 「スペルカードルールなんて知らない化物ばっかりだけど、私はいつも通りやるだけ。	PRINTFORMW 「虽然都是些不知道符卡规则的怪物、但我还是要跟往常一样做。
PRINTFORMW 「んっ、ここから、私が産まれたんだよね……やっと一人で、じっくり弄れるね♪」	PRINTFORMW 「嗯、我就是从这里出生的吧……终于可以一个人好好地玩弄了♪」
PRINTFORMDW 快楽で痙攣する霊夢にできるのは、蕩けた表情で甘い声を漏らすことだけ。	PRINTFORMDW 因为快乐而痉挛的灵梦，能做的就是带着淫荡的表情，发出甜美的声音。
PRINTFORMW 　孕むとか気にしなくていいの、もうお腹の中にいるんだから、好きなだけ中出ししてぇっ！」	PRINTFORMW 　不用担心怀孕，因为肚子里已经有了、尽情内射吧！」
PRINTFORMW 「何をいちばん避けなきゃいけないか、ちゃんと分かるよ……私もできるんだから！」	PRINTFORMW 「到底该躲避什么、我已经充分了解了……就算是我也能做到！」
PRINTFORMDW 「前みたいに、一人で探せばいいじゃん。前はそうやって見つけたんでしょ？」	PRINTFORMDW 「像以前一样，一个人去找不就行了吗。以前是这样找到的吧？」
PRINTFORMDW 彼女は手持ち無沙汰なまま、茶を飲んでいた。その表情には明らかな苛立ちが見える。	PRINTFORMDW 她无所事事地喝着茶。从他的表情中可以看出明显的焦躁。
PRINTFORMDW 文字通りに手が足りないのか、触手を生やしてバスタオルを止めているのが、見えた。	PRINTFORMDW 不知道手是不是真的不够用，我看到它用触手来抵住浴巾。
PRINTFORMW 「や、やめてぇ……そんなに、つよく、すったら……あっ、あぁっ、んあぁっ！」	PRINTFORMW 「不、不要啊……那么、激烈地、吸的话……啊、啊啊、嗯啊啊！」
PRINTFORMW 　……いいわよ、別に。こんな状況だし、犯されるよりは、ずっと……ずっと」	PRINTFORMW 　……没关系，没什么。这种情况下，比起被侵犯、要好得多了……」
PRINTFORMW 「だ、だめよ……そんな、の……わたし、たち、おや、こ……ひあぁっんっ！？」	PRINTFORMW 「不、不行啊……那种、事……我、们、母、女……咿啊啊啊！？」
PRINTFORMW 「はっ、ああぁぁぁぁっ……ふふ、見て、魔理沙、あんたのが入ってるのよ……？	PRINTFORMW 「哈、啊啊啊啊啊啊……唔唔、你看、魔理沙、你的进来了哦……？
PRINTFORMW 　受精してもいいっ、欲しいの、子供も産みたいの、だから好きなだけ中出ししてぇっ！」	PRINTFORMW 　受精也没关系，我想要，我也想生孩子，尽情内射吧！」
PRINTFORMDW だが、その悲鳴は物理的にも精神的にも仲間に届くことはなかった……	PRINTFORMDW 但是，无论在物理上还是精神上，她的尖叫声都没有传到同伴的耳中……
PRINTFORMDW 誰か捨てるものかと即座に思ったものの、逃亡生活は本当に辛いのも確かだった。	PRINTFORMDW 虽然马上就就想，又有谁会抛弃呢、但逃亡生活确实很痛苦。
PRINTFORMDL 「いやぁ、行方不明になってたお前が子持ちになって出てきた時は驚いたけど……	PRINTFORMDL 「哎呀、失踪的你带着孩子出来的时候，真是我吓了一跳……
PRINTFORMDW クイーンを血を引く最後の生き残りである娘も、少しずつ博麗神社に馴染んでいく。	PRINTFORMDW 拥有女王血统的最后幸存的女儿，也渐渐熟悉了博丽神社。
PRINTFORMW 「調子が悪いわ……これくらいで化物退治をサボるわけにもいかないけどさ……」	PRINTFORMW 「身体有点不舒服……不过也不能因为这个而停止消灭怪物……」
PRINTFORMDW 迷宮が霊夢に瓜二つの少女たちで溢れかえる日は、そう遠くはないだろう……	PRINTFORMDW 迷宮离到处都是和灵梦一模一样的少女的那天，已经不远了吧……
PRINTFORMDL 確証もないし何より面倒なので意に介さなかった霊夢だったが、	PRINTFORMDL 因为没有确切的证据，而且最重要的是，感觉很麻烦，所以灵梦没有特别在意、
PRINTFORMW 「あら、いじる度に震えちゃうのね。ついでに息でも吹きかけようかしら……？」	PRINTFORMW 「啊啦、每次摆弄的时候都会颤抖呢。顺便吹口气怎么样……？」
PRINTFORMW 「退治するのが私の役目とはいえ……いくらなんでも限度があるわよ、まったく」	PRINTFORMW 「虽说退治是我的职责……不管怎么说都是有限度的，真是的」
PRINTFORMW 　私が言うのもなんだけど、ここでそんなことしてる余裕なんてないでしょうに……」	PRINTFORMW 　虽然我也这么说、但在这里根本没有时间做那种事……」
PRINTFORMW 「そうよ、霖之助さん。異変はまだ片付いてないんだし。神社の管理とかよろしくね」	PRINTFORMW 「是啊，霖之助。异变还没解决呢。神社的打理就拜托了」
PRINTFORMDW 呟いて、俯く。今までだったら、失敗を繰り返さないだなんて考えもしなかった。	PRINTFORMDW 低声说着，低下了头。到现在为止，想过可能会重复失败。
PRINTFORMDW それならそれでいい、と霊夢は思った。こちらから探しまわって、見つけ出すだけだ。	PRINTFORMDW 那就这样吧，灵梦想。自己四处寻找，找出来就是了。
PRINTFORMDW 最後の攻撃が突き刺さる。クイーンが不気味に呻き、その体が折れ曲がっていく。	PRINTFORMDW 最后的攻击打了过去。女王发出可怕的呻吟，身体弯曲着。
PRINTFORMDW 長く深いキスを終えて離れた娘は、嬉しいような戸惑ったような顔をしていた。	PRINTFORMDW 既长又深的吻结束后离开的女儿，露出既高兴又困惑的表情。
PRINTFORMDW 勃起した擬似陰茎の弱点を愛撫され、魔理沙の抵抗は更に弱まっていく一方だ。	PRINTFORMDW 那勃起的疑似阴茎的弱点被爱抚、魔理沙的抵抗力越来越弱。
PRINTFORMW 「く、くるの、きもちいいのっ、我慢できな――あ、ああああああぁんっ♪」	PRINTFORMW 「要、要来了、好舒服啊、无法忍耐――啊、啊啊啊啊啊啊啊啊♪」
PRINTFORMW 「だ、だめぇ……もう、がまん、できなっ、い……う、うまれちゃうぅ……！」	PRINTFORMW 「不、不行……已经、忍不、住、了……要、要生出来了……！」
PRINTFORMW 「い、いや……気持ちよくなるのいや、産みながらイっちゃうのはもういやぁ！」	PRINTFORMW 「不、不要……不想变舒服了、已经不想一边出产一边去了！」
PRINTFORM 「んああああっ、入ってるぅ♪　なか、あついの、いっぱい来ちゃったぁんっ……	PRINTFORM 「嗯啊啊啊啊、进来了♪　里面、热热的、满满的进来了、啊嗯……
PRINTFORMW 「か、勘違いしないでよね、何か貰えるからやってるんだから……ふやんっ！？」	PRINTFORMW 「别、别误会了哦、只是因为能得到什么才帮你的……呀！？」
PRINTFORMW 　……………………だから、前からずっと言ってたのに。私の真似なんてするなって。	PRINTFORMW 　……………………所以，我之前就一直在说。不要学我。
PRINTFORMW （紫の力を受け継いでいるなら、私のお腹の中にいるのが何かわかるのかしら……）	PRINTFORMW （如果接受了紫的力量、能知道我肚子里的是什么吗……）
PRINTFORMDW それならそれでいい、と霊夢は思った。こちらから探しまわって見つけ出すだけだ。	PRINTFORMDW 那就这样吧、灵梦这么想着。只能从这里开始去找了。
PRINTFORMW 「このままじゃまた消える奴が出るかもしれないし。さっさと戻って片付けなきゃ」	PRINTFORMW 「再这样下去，说不定又会有人消失。赶紧回去解决掉吧」
PRINTFORMW 「いくら私だって、あの連中の血を引いている奴を信用できるほど暢気じゃないわ。	PRINTFORMW 「就算是我，也不会随随便便就相信那些有它们血统的人。
PRINTFORMDW 今回の相手がスペルカードルールを無視するのは、散々味わわされたことなのだから。	PRINTFORMDW 这次的对手无视符卡规则，是被狠狠教训了一顿的。
PRINTFORMDW そう言うと、今度は魔理沙が服を脱ぎやすいようにバンザイをさせる霊夢。	PRINTFORMDW 这么说着，为了让魔理沙方便脱衣服，让她做出了万岁的姿势。
PRINTFORMD 「ふあ、うあぁっ、やら、またいつもみたいになるの、やだ、もうやらぁあっ	PRINTFORMD 「呼啊、呜啊、不要、又要和之前一样了、不要、已经不想要了啊
PRINTFORMDW 動こうとするモノはほぼ無くなった触手宮……そこに、霊夢は再び足を踏み入れた。	PRINTFORMDW 在触手宮几乎没有活物之后……灵梦再次踏上了旅程。
PRINTFORMDW 耳にした異変の内容がその悔しさを打ち消すくらい魔理沙には嫌なものだった以上……	PRINTFORMDW 魔理沙讨厌听到的异变的内容足以抵消他的懊悔……
PRINTFORMW 「何回消しても、根本を断たない限りはやっぱり元に戻るのかなぁ……」	PRINTFORMW 「无论消灭多少次，只要不切断根本，还是会回到原来的状态吧……」
PRINTFORMW 「えへへ、また妹ができたね、ママ。そろそろ、娘で孫な子も作れるよ♪」	PRINTFORMW 「诶嘿嘿、妈妈，你又有妹妹了。差不多该造女儿孙女的孩子了♪」
PRINTFORMDW だが、怯えることもなく霊夢は先ほどの言葉をつぶやき、足を踏み出していく。	PRINTFORMDW 但是，灵梦毫不畏惧地自言自语着刚才的话，迈开了脚步。
PRINTFORM 　抜かないでっ！　なかだしして魔理沙、赤ちゃんにせーえき飲ませてあげてぇっ	PRINTFORM 　不要拔出来！　魔理沙、在里面射出来吧，让小宝宝喝上精液吧
PRINTFORMW 「うんうん、こんな風に股間に張り付いた妖怪は退治しないと！　それじゃ……」	PRINTFORMW 「嗯嗯、像这样粘在秘部上的妖怪必须消灭！　那么就……」
PRINTFORMW 「……ちゃんと修行してたら、紫みたいにパシリに使えたかもしれないけど。	PRINTFORMW 「……如果好好修行的话，说不定也能像紫那样去欺凌别人了。
PRINTFORMW 「ねぇ化け猫。今まで神隠しされた奴がいた場所とか状況とか分かった？」	PRINTFORMW 「喂，怪猫。你清楚到目前为止失踪的人所在的地方和情况吗？」
PRINTFORMDW 迷宮から脱出したあの日、紫はいたく喜び、その後すぐさま眼をつり上げた。	PRINTFORMDW 从迷宫中逃脱的那天，紫非常高兴，但之后马上白了一眼。
PRINTFORMDW それで、霊夢は気付いた。なんだかんだで、この子も我慢していたんだ――	PRINTFORMDW 之后、灵梦注意到了。被这样那样后、这孩子还是忍住了――
PRINTFORMDW 霊夢の中から這い出てくる赤子に、孕ませた張本人は無邪気な笑みを浮かべている。	PRINTFORMDW 灵梦对着从体内爬出来的孩子、露出了天真的笑容。
PRINTFORMW 「お腹が膨れてきてる……でも妊娠したなら体調が悪くなってるはずだし……」	PRINTFORMW 「肚子鼓起来了……但如果是怀孕的话身体应该会变差……」
PRINTFORMW 「…………？　なによ、急に青ざめて。変な病気なら教えてよ」	PRINTFORMW 「…………？　怎么了、突然脸色这么青。如果有什么奇怪的病记得告诉我」
PRINTFORMW 「あ……あぁ……イっちゃった、わたし……こどもに、イかされちゃったよぉ……」	PRINTFORMW 「啊……啊啊……去了、我……被孩子、弄去了啊……」
PRINTFORMW 「きりがないし何か得られるわけでもないし……ここの壁ってほんと嫌だわ」	PRINTFORMW 「没完没了的还得不到什么东西……这里的墙壁太令人讨厌了」
PRINTFORMW 「飛べれば楽なんだけど……天井からなんか蠢いてる気がする……」	PRINTFORMW 「要是飞起来就轻松多了……不过天花板上好像有什么东西在蠢动……」
PRINTFORMDW 霊夢は破瓜の血が零れ落ちるのを、思考が浮かばないぼんやりとした瞳で見つめている……	PRINTFORMDW 灵梦茫然地望着破瓜的血滴落，无法思考……
PRINTFORMW 「あ、か、噛まれっ、はんっうっ！？　ち、乳首、したで、転がされてぇ！？」	PRINTFORMW 「啊、在、在咬着、哈嗯呜！？　乳、乳首、被玩弄着！？」
PRINTFORMW 　でも、みんなとしちゃいけないから……んうっ、一人でしなきゃ……♪」	PRINTFORMW 　但是、因为不能和大家一起做……嗯呜、只能一个人做……♪」
PRINTFORMW 「あ、あぁっ……できちゃう、だめなのにぃ、また子供できちゃうぅ……♪」	PRINTFORMW 「啊、啊啊……出来了、明明不可以、孩子还没出生……♪」
PRINTFORMW 　どう考えてもこれだけの人数を養える余裕、うちの神社にはないわよねぇ……」	PRINTFORMW 　不管怎么想，我们神社都没有钱养活这么多人吧……」
PRINTFORMDW 目的は言うまでもない。もう一度あの迷宮に挑み、根本を断つためである。	PRINTFORMDW 目的是不言而喻的。为了再次挑战那个迷宫，斩断其根源。
PRINTFORMDW そう返すと、霊夢はふわりと体を浮かせた。いつも通りに片付けるために。	PRINTFORMDW 这么回答后，灵梦身体漂浮了起来。为了将一切恢复正常。
PRINTFORMW 「あいつにとって、博麗の巫女なんてすぐ代わりが用意できるのかしら……」	PRINTFORMW 「对那家伙来说，博丽的巫女马上就能准备好替代品吗……」
PRINTFORMDW 目の前にある、あの迷宮。子供を産んで、こんな状況になった元凶。	PRINTFORMDW 眼前出现的、是那个迷宫。被迫生下孩子、变成这种状况的元凶。
PRINTFORMW 「ふふ、もうっ……！　ママじゃなくて……『おまえ』でしょ……？」	PRINTFORMW 「呵呵、真是的……！　已经不是妈妈……而是『你』了吧……？」
PRINTFORMDW どこ吹く風とばかりに取り合わない霊夢に、微妙に顔をひきつらせている魔理沙。	PRINTFORMDW 一阵不合时宜的风吹向灵梦、魔理沙微妙地绷着脸。
PRINTFORMDW 胡散臭そうな目で見つめる魔理沙に、霊夢はぐ！と親指を立てた。	PRINTFORMDW 对于用怀疑的眼神看着自己的魔理沙，灵梦刷的一下竖起了大拇指。
PRINTFORMDW そんな魔理沙の気持ちをいざ知らず、霊夢の表情はにこやかな笑顔で言葉を返す。	PRINTFORMDW 不管魔理沙的心情如何，灵梦的表情是微笑着回答。
PRINTFORMW 「私の体が、退治するべき化物を育てているとしたら……最悪だわ……」	PRINTFORMW 「如果我的身体孕育着应该被消灭的怪物的话……太糟糕了……」
PRINTFORMW 「はぁ……結界の展開よりもお風呂の準備のほうが辛いわ。こんな場所だし」	PRINTFORMW 「哈……比起结界的展开，洗澡的准备更辛苦。这地方真烂」
PRINTFORMDW ふん、と鼻を鳴らしながら踏み込めば、入ってきたはずの入り口は消えてしまった。	PRINTFORMDW 哼了一声，走了进去，刚才进来的入口却消失了。
PRINTFORMW 「普通ならこれくらいがちょうどいいのかな？　私たちは普通じゃないみたいだけど」	PRINTFORMW 「一般来说这样正合适吗？　虽然我们本就不一般」
PRINTFORMW 「うあぁっ、こーびしたい……みんなと交尾したくて、たまらないよぉ……」	PRINTFORMW 「呜啊啊、好想交尾啊……想和大家交尾、想得不得了……」
PRINTFORMW 「た、戦わなきゃ……んんっ♪　わらひが、たたかわなきゃ、みんなぁ……」	PRINTFORMW 「必、必须要战斗……嗯♪　窝、必须要战斗、大家……」
PRINTFORMW 　ね、ねぇ、勝算はあるのよね、すぐ助けに来てくれるのよね……！？」	PRINTFORMW 　呐、呐、还是有胜算的吧、马上就会来救我的对吧……！？」
PRINTFORMW 「みんなはどうしてるかな……私が帰ってこない事には気づいてると思うけど」	PRINTFORMW 「大家都在做什么的呢……我想应该没注意到我没回来」
PRINTFORMW （どうやっても抜け出せない……なら、身を任せてチャンスを待つしか……	PRINTFORMW （怎么也摆脱不了……既然如此，就只能委身等待机会了……
PRINTFORMDW 博麗神社へ入っていく娘を見送る霊夢に、にやつきながら紫は声をかける。	PRINTFORMDW 目送女儿进入博丽神社的灵梦，紫一边做着一边对她说。
PRINTFORMW 　だいたい、博麗の巫女の継がせ方とかあんた知ってるの？　私は知らないわ」	PRINTFORMW 　再说、你知道博丽的巫女继承方法吗？　我是不知道」
PRINTFORMW 「それならせめて、私と真っ向勝負してくればいいのに……あの性悪め」	PRINTFORMW 「如果是那样的话，至少和我一决胜负就好了……真是坏脾气」
PRINTFORMDW 紫は霊夢が洗脳されているのだと思ったらしい。実際、消えてしまったのだが。	PRINTFORMDW 紫似乎以为灵梦被洗脑了。实际上，它已经消失了。
PRINTFORMDW 耳元で息を吹きかけながら、霊夢は容赦なく相手の衣服を剥がしていく。	PRINTFORMDW 在耳边吹气的同时，灵梦毫不留情地剥下了魔理沙的衣服。
PRINTFORMW 「……私……また、こども産んで……また、こどもに、犯されちゃった……」	PRINTFORMW 「……我……又、生了孩子……又被、孩子、侵犯了……」
PRINTFORMW 「あくまで障害物を焼き払うだけなんだし、気遣いも体裁もいらないわね」	PRINTFORMW 「只是把障碍物彻底烧干净而已、不需要顾虑是以什么形式」
PRINTFORMDW 抽送を止めることなく、娘は霊夢の顔に自分の顔をすり寄せ、囁いた。	PRINTFORMDW 女儿没有停止抽送，把自己的脸贴在灵梦的脸上，小声说道。
PRINTFORMW 「だめぇ、も、もうっ、イく、なかだしでイっちゃううぅぅぅっ！！？」	PRINTFORMW 「不行、已、已经、去了、射在里面、去了啊啊啊啊啊！！？」
PRINTFORMDW 娘と交わっているという背徳感も、快楽を加速させる要素にしかならない。	PRINTFORMDW 和女儿交合的这种背德感，也只能成为加速快乐的要素。
PRINTFORMW 　こうなってほしくないから、大人しく寝てろっていつも言ってたのに……」	PRINTFORMW 　因为不希望事情变成这样，所以总是叫你乖乖睡觉……」
PRINTFORM 　抜かないでっ！　なかだしして魔理沙、私に貴方の赤ちゃん孕ませてぇっ	PRINTFORM 　不要拔出来！　魔理沙、在里面射出来吧、让我怀上你的孩子吧
PRINTFORMW 「い、いいよ、きもちいいのっ、そのまま――あ、ああああああぁんっ♪」	PRINTFORMW 「好、好舒服、好舒服啊、就这样――啊、啊啊啊啊啊啊♪」
PRINTFORML 「じ、じろじろ見ないでよ……しょうがないでしょ、襲われたんだから」	PRINTFORML 「别、别一直盯着看啊……这是没办法的事、毕竟被袭击了」
PRINTFORMW 「ここの化物共を式神の素体にするのは……やめたほうがいいわね、絶対」	PRINTFORMW 「这里的怪物们的式神素体是用……还是别去想了比较好」
PRINTFORMW 「こんなところにも春はあるのかしら。あっても集めたくないけど……」	PRINTFORMW 「这样的地方也有春度吗。就算有我也不想收集就是了……」
PRINTFORMW 「これに御利益があるのは確かなんだし、商品にすれば売れるかしら？」	PRINTFORMW 「这个要是能灵验的话确实不错、当商品的话能卖出去吗？」
PRINTFORMDW 本当なら、すぐにでも飛び出してあの迷宮を探し、異変を片付けたい。	PRINTFORMDW 如果可以的话，我想立刻跑出去找到那个迷宫，消除异变。
PRINTFORMDW そう言うと……霊夢は愛液で溢れ始めた秘部を、娘の前で露わにした。	PRINTFORMDW 这么说着……灵梦在女儿面前露出了开始溢出爱液的秘部。
PRINTFORMDW 嬉しそうに笑う娘と、その背後で互いに交わっている妹にして孫たち。	PRINTFORMDW 高兴地笑着的女儿和在她背后相互交缠的妹妹以及子孙们。
PRINTFORMDW すべての料理を食べ終えさせると、霊夢は魔理沙の姿勢を整えていく。	PRINTFORMDW 让魔理沙吃完所有的料理后，灵梦调整好了魔理沙的姿势。
PRINTFORMDW 「……あんな奴らの血を引いてる子供なんて、よく仲良くできるよな、お前」	PRINTFORMDW 「……有那种家伙血统的孩子，亏你还能好好相处」
PRINTFORMW 「そういうのを防ぐために二人で来たんでしょ。ほら、行くわよ」	PRINTFORMW 「是为了防止这样的事情再次发生，两个人一起走吧。好啦、走吧」
PRINTFORMDW 悲鳴を上げる魔理沙を引きずりながら、霊夢は触手宮の奥へと消えていった。	PRINTFORMDW 灵梦拖着发出悲鸣的魔理沙、消失在触手宫的深处。
PRINTFORMW 「………………。まさか、子供がいるなんてこと、ないわよね……？」	PRINTFORMW 「………………。难道说、是有孩子了吗、应该不会吧……？」
PRINTFORMW 「い、いたいっ、おなか、いたいのっ！　こんな痛み、知らないっ……！」	PRINTFORMW 「好、好疼、肚子、好疼啊！　没想到、会这么疼……！」
PRINTFORMW 「っ、あ、あぁっ、あばれてるっ……なにか、うごいて、るっ……！」	PRINTFORMW 「呃、啊、啊啊、被搅来搅去的……有什么、在动、着……！」
PRINTFORMW 「吸ってっ、おっぱい吸ってっ……お母さんを、そのおくちでイかせてぇっ！」	PRINTFORMW 「在吸着、在吸着欧派……用那张嘴、让妈妈去吧！」
PRINTFORMW 「う……くっ、このっ、ちょっと走るくらい、なんともっ、ないんだからっ」	PRINTFORMW 「嗯……唔、你慢点、我连、跑一会的力气、都没有啊」
PRINTFORMW 「ママ、もう子供がいるんだね……？　わたし、妹にあいさつしたい♪」	PRINTFORMW 「妈妈，你已经有孩子了呢……？　我想和妹妹打个招呼♪」
PRINTFORMW 「別に、いい……けど。間違っても一人で解決しようとしないでよ。	PRINTFORMW 「没什么，没关系……不过。即使犯错了也不要一个人去解决哦。
PRINTFORMW 「い、いたた……落石なんかに当たっちゃうだなんて、勘が鈍ってるのかな」	PRINTFORMW 「疼、疼疼……居然会被落石砸中，是不是有点迟钝了」
PRINTFORMW 　できちゃってもいい、せーえき欲しいの、だから好きなだけ中出ししてぇっ！」	PRINTFORMW 　有了也没关系、我想要精液、所以尽情内射吧！」
PRINTFORMW 「あはっ……♪　これでやめちゃやだよ……ずっとイかせ続けてね……♪」	PRINTFORMW 「啊哈……♪　不能就这样停下……让我一直去吧……♪」
PRINTFORMW （……あからさまにお腹から視線を逸らされると、逆に辛いんだけど）	PRINTFORMW （……如果这露骨的视线从肚子上移开的话，反而会很难受）
PRINTFORMW （こいつだって化物なんだし、手元に置かないと何するか分からない……）	PRINTFORMW （这家伙也是怪物，不放在身边不知道会做出什么……）
PRINTFORMW 「あんたは、また一人でそうやって、私の真似をしようと、よく考えないで……！」	PRINTFORMW 「你怎么又自己在那模仿我、别想太多……！」
PRINTFORMW 「……急ごしらえで作った奴じゃない。ちゃんと書き込んである御札だわ。	PRINTFORMW 「……看起来不是随便做的东西。是写得很清楚的御札。
PRINTFORMW 「ここだと空飛ぶ靴より、足が速くなる靴のほうが扱いやすそうなんだけど」	PRINTFORMW 「在这个地方比起飞天鞋，跑得更快的鞋似乎更好用」
PRINTFORMW 「よろしい。何かあったら、ちゃんと紫に教えてもらったとおりにするのよ？」	PRINTFORMW 「那好吧。如果有什么事，就照紫教你的去做哦？」
PRINTFORMW 「ええ、いい子は素直に褒めてあげるべきだもの。霊夢もそうしたら？」	PRINTFORMW 「嗯、好孩子就应该坦率地表扬。灵梦也这样做怎么样？」
PRINTFORMDW いや、客というには語弊がある。ここ最近、毎日のように来ているのだから。	PRINTFORMDW 不，以客人来说很容易误解。因为最近每天都来。
PRINTFORMW 「考えてわかるんなら、先にあんたが法則性を見つけ出してるでしょう？」	PRINTFORMW 「如果想一想就明白的话、那你应该就找出规律了吧？」
PRINTFORMW 「私の子供が信用できる奴なら博麗の巫女をやらせればいいだけの話だけど。	PRINTFORMW 「如果我的孩子可信的话，让她做博丽的巫女就好了。
PRINTFORMW 「いや……さすがに一人でここを掘り返すのは危ないし。二人でしなきゃ」	PRINTFORMW 「不……毕竟一个人挖这个地方很危险。必须得两个人」
PRINTFORMW 「あぁっ、動いてる……私の中でしっかり生きてるってわかっちゃうぅ……」	PRINTFORMW 「啊啊、在动着……有好好地在我肚子里活着呢……」
PRINTFORMW 「はぁ、なんかだるいなぁ……こんな状況じゃ疲れてもしょうがないけど」	PRINTFORMW 「哈、感觉好累啊……不过在这种情况下累了也很正常」
PRINTFORMW 「いいっ、きもちいぃっ♪　やっぱり、私、みんなと……ふぁあんっ！」	PRINTFORMW 「好舒服、好舒服啊♪　果然、我、和大家……呼啊啊！」
PRINTFORML 娘との会話や孕ませ系、ステータス変化による分岐に注力した口上。	PRINTFORML 和妹子对话的妊娠系，是注重因状态变化而产生分歧的口上。
PRINTFORMW 「だしてっ、もっとだしてっ、せーえき出して赤ちゃん溺れるくらいぃ♪」	PRINTFORMW 「射出来、再射多一些、把精液射出来淹没孩子吧♪」
PRINTFORMW 「……仕切り直すだけよ。ここでゲームオーバーになんて、絶対しない」	PRINTFORMW 「……只是重新开始而已。绝对不会在这里就游戏结束」
PRINTFORMW 　本当ならあんたも退治しないといけないんだし、馴れ馴れしくしないでよね！」	PRINTFORMW 　看来不把你退治不行了、你可别太亲昵了！」
PRINTFORMW 「うわ、すごい便利！　持って帰ったら家事が凄い楽になりそう！」	PRINTFORMW 「哇，太方便了！　带回家的话感觉做家务会变得很轻松！」
PRINTFORMW 　あの連中の血を引いている奴を信用できるほど……私は暢気じゃないわ」	PRINTFORMW 　现在居然要相信那些家伙的血脉……真叫人不自在」
PRINTFORMDW それも、自分ではなく娘のほうを狙ってくるのだから始末に負えない。	PRINTFORMDW 而且，她的目标不是自己，而是女儿，真是难以收拾。
PRINTFORMDW ……もっとも、そういう手段を取ることそのものには不平を言うことはできない。	PRINTFORMDW ……不过，采取这种手段本身也不能抱怨。
PRINTFORMDW 最初こそ娘も驚いたものの、すぐに馴染んで舌を絡ませてきた。	PRINTFORMDW 刚开始女儿也吓了一跳，但很快就习惯了，用舌头缠住了她。
PRINTFORMDW 霊夢がぶつけられた視線に、渋々と言った様子で魔理沙も立ち上がった。	PRINTFORMDW 面对被灵梦撞到的视线，魔理沙不情愿地站了起来。
PRINTFORML 「この結界に何か入ってくれば音が鳴るから、聞き逃さないでよ。	PRINTFORML 「只要有什么东西进入这个结界就会发出声音、可别听漏了哦。
PRINTFORMW 「しかたないの……んふっ、他の誰かを犯させるわけにはいかない、しっ……♪	PRINTFORMW 「没办法啊……嗯呼、不能让别人侵犯、啊……♪
PRINTFORM 「お尻ならいいから……はっ、んぅ……ふふ、ほら、いっぱい出しなさい	PRINTFORM 「用屁股就行了……哈、嗯……唔唔、快点、满满的射出来吧
PRINTFORM 　そのまま動いてっ、いっぱいせーえき出させておちんちん退治するんだからぁ	PRINTFORM 　就这样动起来吧、满满的射出精液，然后消灭小鸡鸡
PRINTFORMDW 耐え切れないように、霊夢は熱っぽい表情で自分の指を咥えている……	PRINTFORMDW 因为无法忍耐、灵梦一脸热切地含住自己的手指……
PRINTFORMW 「別に、無理して解決しようとしなくてもいいから。どこかに隠れてなさいよ」	PRINTFORMW 「也不用勉强自己去解决。找个地方躲起来吧」
PRINTFORMW 「さすがにこの状態で一人は辛いけど……まぁ、なんとかするわよ」	PRINTFORMW 「在这种状态下，一个人确实很辛苦……嘛、总有办法的」
PRINTFORMDW 応援を呼んで大勢で押しかけるようなことはさせない、ということだろう。	PRINTFORMDW 也就是说、是不想让很多不速之客进去救援吧。
PRINTFORMDW しばらく体を休めていた霊夢は、装備を整えると香霖堂に押しかけた。	PRINTFORMDW 休息了一段时间的灵梦、整理好装备后来到香霖堂。
PRINTFORMW 「聞く限り、相手がいつも通りではない事を貴方は体験したようなのだけど」	PRINTFORMW 「据我所知、你经历了一些他们不常经历的事情」
PRINTFORMDW しなだれかかる霊夢を振り払おうとする、魔理沙の態度は弱々しい。	PRINTFORMDW 魔理沙想要摆脱依偎在身上的灵梦，但是态度很软弱。
PRINTFORMW 「はぁんっ……♪　やめないでぇ……このままイかせ続けてぇ……♪」	PRINTFORMW 「哈啊……♪　不要停……就这样继续让我去吧……♪」
PRINTFORMW （……なに、この感覚？　まるで、体の中から見張られてるような）	PRINTFORMW （……什么、这种感觉？　就像被人从身体里监视着一样）
PRINTFORMW 「警戒しようにも、どこもかしこも怪しいし。走ったほうがいいわね」	PRINTFORMW 「虽然很警惕、但感觉到处都怪怪的。还是走快一点吧」
PRINTFORMW 「ゆっくり動くのも、これはこれで辛いわね……走るのよりは楽だけどさ」	PRINTFORMW 「慢悠悠地移动，这也太辛苦了……虽然比跑轻松」
PRINTFORMW 「普段なら、適当に勘で動くだけで上手くすり抜けられられるのに」	PRINTFORMW 「平时的话，只要适当地凭直觉行动就能很好地摆脱过去」
PRINTFORMDW 満足げに娘が胸から離れる頃には、霊夢は何度も絶頂を繰り返していた。	PRINTFORMDW 当女儿心满意足地离开她时，灵梦已经多次高潮。
PRINTFORMW 「ママがきもちよさそうで、よかった……♪　それじゃ、続きだね！」	PRINTFORMW 「妈妈看起来好舒服、太好了……♪　那么、继续吧！」
PRINTFORMW （吸えば……自分でしたくなる……してもしょうがなくなる……！）	PRINTFORMW （被吸的话……就会变得想要了……没办法停止了……！）
PRINTFORMDW そう呟きながら、霊夢はまるで肉塊のような洞窟の壁を見渡していた。	PRINTFORMDW 灵梦一边嘟囔着，一边环视着宛如肉块的洞窟墙壁。
PRINTFORMDW 紫が「動いてはいけない」と静止しに来たのをきっかけに直感した。	PRINTFORMDW 因为紫说「它不能动」，所以以此为契机来感受一下。
PRINTFORMW 「しゅきなの、ごしゅごしゅされながら出されるのしゅごくいぃの……♪」	PRINTFORMW 「好稀饭、一边搅来搅去一边内射好舒胡……♪」
PRINTFORMW 「い、いや、中出しはいや、また子供作るのはいやぁぁぁぁぁっ！」	PRINTFORMW 「不、不行、不能中出、还不想生孩子啊啊啊啊啊啊！」
PRINTFORMW （だけどもし、どうやっても私を助け出せないと思って逃げたんなら。	PRINTFORMW （但是，如果是觉得无论如何也救不了我，就逃跑了。
PRINTFORMW 「いつもの異変とは違うんだもの、同じように振舞ってちゃ駄目よ？」	PRINTFORMW 「一直以来的异变不一样、不能做跟同类的事情哦？」
PRINTFORMW 「スパイみたいなことできないのかしら？　あいつらの眷属なんだし」	PRINTFORMW 「不能做像间谍那样的事吗？　毕竟我是他们的眷属」
PRINTFORMW 　敵よけの結界を張ってあげたんだし、あと少しだけ寝かせて……」	PRINTFORMW 　我给你设置了一个防御敌人的结界、你再睡会吧……」
PRINTFORMW 「ほんとは狙っちゃいけないんでしょうけど、言ってる場合じゃないか」	PRINTFORMW 「虽说没法瞄得太准了、但现在不是说这个的时候」
PRINTFORMDW しばらく体を休めていた霊夢は、神社にやってきた紫にそう返した。	PRINTFORMDW 休息了一段时间的灵梦，对来到神社的紫这样回答。
PRINTFORMW 「……そっちこそ、目に入れても痛くない様子で修行つけてた癖に」	PRINTFORMW 「……你才是那种，即使看到了也不会心痛的修行习惯」
PRINTFORMDW ため息をつきながら、魔理沙は蹴られた物を受け止めた。しっかりと。	PRINTFORMDW 魔理沙一边叹气，一边好好地接住了被踢的东西。
PRINTFORMW 「ふふ……魔理沙ったら、まだ受け入れられていないのね？」	PRINTFORMW 「ふふ……魔理沙ったら、まだ受け入れられていないのね？」
PRINTFORMW 「ふっ……んんっ……だれも、見てない、今の……うちにぃ……♪」	PRINTFORMW 「呼……嗯嗯……谁也没、看见、现在的……我……♪」
PRINTFORMW 「ひ、ひろがってるぅ……なか、むりやりっ、広げられてっ……！？」	PRINTFORMW 「在、在扩张着……里面、被强行、张开了……！？」
PRINTFORMW ただしこの神隠しは、人であろうと妖であろうと、帰ってこれない――	PRINTFORMW 只是这个突然失踪，不管是人还是妖，都回不来了――
PRINTFORMDW 熱い吐息を吐きながら、もじもじと霊夢は股間を擦りあわせた……	PRINTFORMDW 灵梦一边吐着热气，一边扭扭捏捏地搓着大腿间……
PRINTFORMDW 魔物からの視線に気づき、霊夢は顔を赤らめながら胸を隠した……	PRINTFORMDW 注意到来自魔物的视线，灵梦红着脸遮住了胸口……
PRINTFORMW 　ああん、もうっ！　せめて弾幕勝負になってくれればいいんだけど！」	PRINTFORMW 　啊啊、算了！　至少能变成弹幕胜负就好了！」
PRINTFORMW 「何か、拾ったの？　後で見せて……今は、余裕ないから……」	PRINTFORMW 「捡到什么了吗？　回头给我看看……现在没有时间……」
PRINTFORMW 「相手が何だろうと、異変の原因は片っ端から退治するのみ！」	PRINTFORMW 「不管对方是什么，只要把异变的原因消灭掉就可以了！」
PRINTFORMW 「普通ならこれくらいがちょうどいいんだけど……相手が普通ならね」	PRINTFORMW 「一般来说这个程度刚刚好……对手是普通人的话」
PRINTFORM 「ふふっ……立てなくなるくらい射精させて、退治しちゃうんだからぁ	PRINTFORM 「呼呼……让它射精到站不起来的程度，然后把它消灭掉
PRINTFORMDW 一日でも早く用意を整えて、行方不明になったままの魔理沙を助けに行きたい。	PRINTFORMDW 想尽快做好准备，去救失踪的魔理沙。
PRINTFORMW 「ふーんだ。どっちかというと、あんたのほうが子育てできないんじゃないの？	PRINTFORMW 「哼哒。说起来，你不是不能抚养孩子吗？
PRINTFORMW 「私の見張る番？　時間がどれだけ進んでるのかわかりにくいわね……」	PRINTFORMW 「该我站岗了？　很难知道时间过了多久呢……」
PRINTFORMW 「一度見張りに起きると寝付けないわね。寝床がこんなのだし」	PRINTFORMW 「起来站岗之后就再也睡不着了。毕竟床都已经这个样了」
PRINTFORMW 「あっ、あぁぁんっ……！　こ、こえ、だしたら……でもぉ♪」	PRINTFORMW 「啊、啊啊啊嗯……！　这、介个、去了的话……我也♪」
PRINTFORMW 「いやぁっ……！　産んだ時みたいになるの、もういやぁ……」	PRINTFORMW 「不要……！　感觉跟生下孩子的时候一样、不要啊……」
PRINTFORM 「うあぁあんっ♪　お、おっぱい、すわれるのでも、感じちゃっうぅ……	PRINTFORM 「呜啊啊啊♪　欧、欧派、在被吸着、好有感觉啊……
PRINTFORMW 「せめて、今のうちに敵を減らさなきゃ……動けなくなる前に……」	PRINTFORMW 「至少、要趁现在减少敌人……在无法动弹之前……」
PRINTFORMDW 霊夢は愚痴りながら、そのまま風呂で仲間たちの体を洗っている……	PRINTFORMDW 灵梦一边抱怨，一边在浴室里给伙伴们洗身体……
PRINTFORMW 「だ、だめよ……そんな、の……こども、が……ひあぁっんっ！？」	PRINTFORMW 「不、不行啊……那种、事……孩子……咿啊啊！？」
PRINTFORMW 　迷惑な話よ。いろんな仕事をしないといけなくなったのが目に見えてるし。	PRINTFORMW 　这下麻烦了。看来很多事我要自己去做了。
PRINTFORMW 「あはっ……♪　これでやめちゃ、やだよ……もっとぉ……♪」	PRINTFORMW 「啊哈……♪　就这样停下、不行啊……再来更多……♪」
PRINTFORMW 「あ、あぁっ……いるのに、お腹に赤ちゃんいるのにぃ……♪」	PRINTFORMW 「啊、啊啊……明明、明明肚子里还有小宝宝啊……♪」
PRINTFORMW 　私が助かる望みはある。きっと体勢を立て直して助けに来てくれる。	PRINTFORMW 　我有得救的希望。一定会重整旗鼓回来救我的。
PRINTFORMW 「なんで、ここにあるのかはわからないけど。これさえあれば……」	PRINTFORMW 「虽然不知道为什么会在这里。但只要有这个……」
PRINTFORMW 「塵も積もれば山となるっていうけど、塵が山になったらゴミの山よねぇ」	PRINTFORMW 「都说尘埃积少成多、积成山就是垃圾堆了」
PRINTFORMW 「私の様子が変だったら起こしてよ。こんな体、だもの……」	PRINTFORMW 「如果我的样子很奇怪的话就叫醒我。因为这副身体……」
PRINTFORMW その先には、神社の庭で妖精をつついている彼女自身の娘が、いた。	PRINTFORMW 在那之前，她的女儿就在神社的庭院里和妖精打闹。
PRINTFORMW 「相手がいつも通りではないこと……よくわかったと思うのだけどねぇ」	PRINTFORMW 「对方和往常不一样……我想你应该明白了吧」
PRINTFORMW 「……やっぱぜーんぜんダメだわ。だって、法則性なんて少しもないもの」	PRINTFORMW 「……果然是不行。因为没有一点规律可言」
PRINTFORMDW 迷宮で知った快感が忘れられず、霊夢はいよいよ深みに嵌っていく。	PRINTFORMDW 无法忘记在迷宫中获得的快感，灵梦越陷越深。
PRINTFORMDW 「私は育児放棄しない白馬の王子様を見つけて結婚するからいいんだよ。	PRINTFORMDW 「我会找到不放弃育儿的白马王子结婚的。
PRINTFORMW 「あぐっ……はぁ、はぁっ、せ、せめて、もう少しだけ、遅らせて……」	PRINTFORMW 「啊哈……哈、哈、至、至少、再等一等……」
PRINTFORMW 「なんとか持ち帰って博麗神社のお土産に……って消えるなー！」	PRINTFORMW 「得想办法带回去博丽神社当礼物……别消失啊ー！」
PRINTFORMW 「誰かやられちゃったみたいね。それなら、これは貰っていいでしょ。	PRINTFORMW 「好像有谁被打败了。那样的话，这个就收下吧。
PRINTFORMW 「あん、ふあぁんっ、いい、そこいいっ、とろけちゃうぅ……」	PRINTFORMW 「啊嗯、哼嗯、好舒服、那里好舒服、要溶化了……」
PRINTFORMW 　それまで待ってる。こいつを倒すために、待ってるんだから……	PRINTFORMW 　在那之前我等你。为了打倒这家伙、我等着你……
PRINTFORMW 「弾幕を撃つ気はないみたいだし……いったい何なのよ、もう？」	PRINTFORMW 「好像没打算发射弹幕……这到底是怎么回事啊？」
PRINTFORMDW 話すだけで足がふらつく霊夢の状態は、明らかにまだ辛そうだ……	PRINTFORMDW 光是说说话就站不稳的灵梦、看起来很辛苦……
PRINTFORMW 「……あんたと会ったのはちょうどいいのか、最悪なタイミングなのか」	PRINTFORMW 「……和你见面是正好，还是最坏的时机？」
PRINTFORMW 「相変わらずの収集癖ねぇ。でも、今はそれがありがたいかな」	PRINTFORMW 「还是老样子的收集癖啊。不过，现在这样也挺好的」
PRINTFORMW 「……ここに落ちてると、なんか変なのが染み付いたりしてそう」	PRINTFORMW 「……掉在这里的话、感觉会染上什么东西的样子」
PRINTFORMW 「……とにかく逃げ出して、やり残しは後で片付けるしかないみたいね」	PRINTFORMW 「……总之先逃出去，剩下的事情以后再说」
PRINTFORMDW 脱出してからずっと、霊夢は藍と共に今後を相談し続けている。	PRINTFORMDW 逃出之后，灵梦一直和蓝一起商量着今后的事情。
PRINTFORMDW 脱出してからずっと、霊夢は橙と共に今後を相談し続けている。	PRINTFORMDW 逃出之后，灵梦一直和橙一起商量着今后的事情。
PRINTFORMDW そう……霊夢が逃げ回っているのは、他の誰でもない紫が相手だった。	PRINTFORMDW 是的……灵梦之所以四处游荡、是为了紫。
PRINTFORMW 　こしゅ、こしゅってるっ、うぅんっ♪　んっ、んうぅっ……！」	PRINTFORMW 　一抽、一抽地在动着、唔嗯♪　嗯、嗯嗯……！」
PRINTFORMDW 悲鳴を上げる魔理沙を引きずりながら、また迷宮に潜っていく霊夢。	PRINTFORMDW 拖着发出悲鸣的魔理沙，灵梦又深入了迷宫。
PRINTFORMW 「……疲れがとれない……前にもこんなこと、あったっけ」	PRINTFORMW 「……无法消除疲劳……好像以前、也发生过这样的事吧」
PRINTFORMW 　……そう、よね。そうそう何度も、あるわけないもの、うん！」	PRINTFORMW 　……是、啊。对对，不可能、有好几次的、嗯！」
PRINTFORMW 「育ってる……前みたいに、数日もしないうちに生まれるの？」	PRINTFORMW 「在成长着……就像以前一样，没几天就出生了吗？」
PRINTFORMW 「ちょ、ちょっと待って。なんか、めまいがして……病気かな？」	PRINTFORMW 「等、稍微等一下。总觉得头晕……是生病了吗？」
PRINTFORMW 「んっ……だすよ、ママ、ちゃんと妹に届かせてねっ……！」	PRINTFORMW 「嗯……出来啦、妈妈、一定要让传达给妹妹哦……！」
PRINTFORMW 「お尻なら……しても大丈夫でしょ、早く満足しなさいよ……」	PRINTFORMW 「如果是屁股的话……做也没关系、快点满足吧……」
PRINTFORML 「あ……凄い、どんどんおっきくなってきてる……出したいのね？	PRINTFORML 「啊……好厉害、变得越来越大了……想射出来吗？
PRINTFORMW 「普通に叩きつけるくらいじゃ、みんなは負けを認めないよね？」	PRINTFORMW 「如果只是普通的打一下、大家是不会认输的吧？」
PRINTFORML 「はぁっ……んはっ♪　気持ちよくしなくちゃ、動けない、しぃ♪	PRINTFORML 「哈啊……哈♪　不够舒服的话、就动不了、了♪
PRINTFORMW 　無茶な戦いをして余計な犠牲が増えるより、よっぽどいい……）	PRINTFORMW 　这比胡乱战斗增加不必要的牺牲要好得多……）
PRINTFORMW 　だから、早く助けに来なさいよ。じゃないと私、死んじゃうんだから」	PRINTFORMW 　所以，快来救我吧。不然我就要死掉了」
PRINTFORMW 「な、何よ、その顔。……いや、私そっくりな顔だけど。	PRINTFORMW 「什、什么啊、那张脸。……不是、跟我的脸一模一样啊。
PRINTFORMW 「生まれるのがあんたみたいなやつなら、まぁ、マシかな……	PRINTFORMW 「如果生的是你这样的家伙的话、嘛、总比没有好……
PRINTFORMW 　……勘違いしないでよ？　別にあんたのこと認めたわけじゃないから」	PRINTFORMW 　……可不要误会哦？　我才没有承认你」
PRINTFORMW 「誰かが落としたか、どっかから流れ着いたか。それとも……」	PRINTFORMW 「是谁掉的，还是从什么地方漂来的。还是说……」
PRINTFORMW 「こんな所に玉露がごろごろ落ちてるなんて、なんかムカつくわ……」	PRINTFORMW 「玉露怎么掉在这种地方、真让人不爽……」
PRINTFORMDW 話を切るように飛び立つ霊夢に、紫はやれやれと肩を竦めた。	PRINTFORMDW 面对话音刚落就飞到了空中的灵梦、紫耸了耸肩。
PRINTFORMDW そう判断するくらいには――自分の娘を、信じているのだから。	PRINTFORMDW 做出了这样的判断――因为她相信自己的女儿。
PRINTFORMDW 霊夢の言葉に合わせて、影から一人の女の子が姿を現した。	PRINTFORMDW 随着灵梦的话、从影子下出现了一个女孩子的身影。
PRINTFORMDW もっとも、そういうやり方のほうが霊夢の性に合うのは確かだったが。	PRINTFORMDW 不过，这种做法确实更符合灵梦的本性。
PRINTFORMDW 長い戦いが終わったのに、なぜか心は弾まなかった。	PRINTFORMDW 漫长的战争结束了，但不知为何，我的心却没有任何波澜。
PRINTFORMDW 「そりゃ、見た目は上から下までお前とそっくりだけどさ……」	PRINTFORMDW 「看起来、外表从上到下都和你一模一样……」
PRINTFORMDW 　足りないところがあっても、二人で協力して育てていくんだ」	PRINTFORMDW 　即使有不足之处，也要两个人一起努力培养」
PRINTFORMDW その背後から、本気で嫌がっている魔理沙が恐る恐る尋ねる。	PRINTFORMDW 在他背后，一脸不乐意的魔理沙战战兢兢地问道。
PRINTFORMDW 宝という言葉にあっさり釣られて消える、魔理沙の警戒心。	PRINTFORMDW 被“宝”这个词轻易吸引的魔理沙的警戒心消失了。
PRINTFORMW 「だ、だめっ……これ以上はだめ、だめぇぇぇぇぇっ♪」	PRINTFORMW 「不、不行……再这样下去不行、不行啊~~~~~~♪」
PRINTFORMW 　……そうよね……そうそう何度も、あるわけないもの……うん」	PRINTFORMW 　……是啊……对对，不可能有好几次的……嗯」
PRINTFORMW 「……あれ？　私、太った？　最近、あんまり食べてないのに」	PRINTFORMW 「……啊咧？　私、胖了？　明明最近都没怎么吃」
PRINTFORM 　ダメよ、抜かせないっ、私の中にいっぱいなかだししてぇっ	PRINTFORM 　不行哦、不会让你拔出来的、在我的里面满满的射出来吧
PRINTFORMW 「ほ、ほら……手伝ってあげるから、早くなんとかしなさいよそれ」	PRINTFORMW 「你、你看……我会帮你的、赶快做点什么吧」
PRINTFORMW 「んんっ……いぃよぉ、みんなと交尾するの、やめられないよぉ♪」	PRINTFORMW 「嗯……好舒服、和大家交配，停不下来啊♪」
PRINTFORMW 「次から次へと……ま、何であろうと退治するだけだけどね」	PRINTFORMW 「一个接一个地……嘛，不管怎么说只是退治而已」
PRINTFORMW 　それまで待ってる。こいつを倒すために、待ってるから……	PRINTFORMW 　在那之前我等你。为了打倒这家伙，我等着你……
PRINTFORMW 　だから、早く助けに来なさいよ。じゃないと私、死んじゃうんだから」	PRINTFORMW 　所以，快来救我吧。不然我就死掉了」
PRINTFORMW 「じょ、冗談……よね？　私、目がおかしくなったのかな……	PRINTFORMW 「开、开玩笑……的吧？　我的眼睛不正常了吗……
PRINTFORMW 「それくらいじゃないと困るわ。私の……子供、なんだし？」	PRINTFORMW 「不这样的话就麻烦了。毕竟是我的……孩子嘛？」
PRINTFORMW 「霊力が篭ってる……この様子だと、宣言中に襲われたのね。	PRINTFORMW 「充满了灵力……这个情况、是宣言中被袭击了吧。
PRINTFORMW 「私の子供なら問題ないでしょ。強さは私が保証するわ」	PRINTFORMW 「如果是我的孩子的话没问题吧。我可以保证它的强度」
PRINTFORMDW はぁと、ため息をつく霊夢。この異変は、まだ終わっていない。	PRINTFORMDW 灵梦叹了口气。这个异变、还远远没有结束。
PRINTFORMDW 彼女がいれば、こんな細かいことは全部やってくれただろう。	PRINTFORMDW 如果有她在，这些琐碎的事情都会帮我做的吧。
PRINTFORMW 「いっそ、お腹でもぶん殴ったほうがいいのかな……はは……」	PRINTFORMW 「干脆、狠狠地锤一下肚子怎么样……哈哈……」
PRINTFORMW 「急ごしらえのお札を使った結界じゃ、もって四半日かな？」	PRINTFORMW 「匆忙准备的札构筑的结界，总共需要四半天吧？」
PRINTFORMDW 霊夢は自分に言い聞かせるように、独り言を繰り返している……	PRINTFORMDW 灵梦像是在说给自己听，不停地自言自语……
PRINTFORMW 「とけるっ、あつくて、胸がとけちゃうぅぅぅぅぅっ！」	PRINTFORMW 「要融化了、好烫啊、胸要融化了————————！」
PRINTFORMW 「いぁ、い、いいのっ、きもちいぃんっ、も、もうとめてぇ！」	PRINTFORMW 「好、好、好舒服、好舒服啊、还、还要更多！」
PRINTFORMW 「私ね、妹がほしい……ママにいっぱい子供を産んで欲しい♪」	PRINTFORMW 「我啊，想要个妹妹……希望妈妈能多生孩子♪」
PRINTFORMW 「んっ……だすよ、ママ、ちゃんとじゅせーしてねっ……！」	PRINTFORMW 「嗯……出来啦、妈妈、要好好收下精子哦……！」
PRINTFORMW 「だいじょうぶだよ……私達は、そうそう簡単に死なないから♪」	PRINTFORMW 「没关系的哦……因为我们不会轻易死去的♪」
PRINTFORMW 「あんた達と一緒にいたら、いつまで経っても脱出できないわ」	PRINTFORMW 「和你们在一起的话，无论过多久都逃不出去啊」
PRINTFORMW 「い、いたた……やっぱり動きが鈍ってる、なんとかしないと」	PRINTFORMW 「疼、疼……果然动作变慢了，必须得想个办法」
PRINTFORMW 「事前に水滴落としちゃうような間抜けに、私が引っかかるわけない」	PRINTFORMW 「事先露出马脚的蠢货，我怎么会上钩呢」
PRINTFORMW 「あはっ……も、もっとぉ、もっといっぱいちょうだぁい……♪」	PRINTFORMW 「啊哈……更、更多、让我尽情地去吧……♪」
PRINTFORMW 「ひっ、あひっ！？　き……きてるぅ、なんかきてぇ♪」	PRINTFORMW 「哼、嗯哈！？　要……要来了、有什么要来了~♪」
PRINTFORMW 「だしてっ、もっとだしてっ、赤ちゃんじゅせーしたいからぁ♪」	PRINTFORMW 「射出来、再射多一些、孩子想被射更多♪」
PRINTFORMW 「んうっ！？　せーえき、きてる、おく、とどいてるよぉ！」	PRINTFORMW 「嗯唔！？　精子、来啦、里面、已经收到了！」
PRINTFORMW 「んうっ、びゅくびゅくあったかいの、とどいてるぅ……♪」	PRINTFORMW 「嗯唔、去了去了！热乎乎的，送进来了……♪」
PRINTFORMW 　だめ、もう……だめぇっ、がまんできないぃ……うはぁ♪」	PRINTFORMW 　不行、已经……不行了、受不了了……哈啊♪」
PRINTFORMW 「親譲りの収集癖ねぇ。でも、今はそれがありがたいかな」	PRINTFORMW 「母亲遗传的收集癖。不过，至少这是值得庆幸的」
PRINTFORMW 　戦力不足でひどい前に遭う前に、私に泣きついたら？」	PRINTFORMW 　在因为战斗力不足而遭殃之前、可别哭着求我哦？」
PRINTFORMW 「……ねぇ魔理沙、いくらなんでも落とし過ぎじゃないの？」	PRINTFORMW 「……呐魔理沙、就算是个圈套也太过分了吧？」
PRINTFORMW 「また宣言中に襲われた奴が……真面目なのはいい事だけど」	PRINTFORMW 「又是宣言中被袭击的家伙……虽然认真是好事」
PRINTFORMW 「竜宮の使いが持ってたやつだっけ。もしかして誰でも使えるの？	PRINTFORMW 「是龙宫的使者拿着的吧。难道谁都能用吗？
PRINTFORMW 「叩きつけるくらいじゃ、あんたらは負けを認めないようだし」	PRINTFORMW 「如果只是轻轻打一下，你们又不会轻易认输」
PRINTFORMDW こんな状況と相手でも――彼女の意志は、揺るがない。	PRINTFORMDW 即使是这种情况下的对手――她的意志也不会动摇。
PRINTFORMW 「らんー。その顔だと、また神隠しされる奴が出たのー？」	PRINTFORMW 「蓝。看你这个表情、是不是又有人突然失踪了？」
PRINTFORMDW 「ああ。一応、今まで消えた人妖の資料を揃えたが」	PRINTFORMDW 「嗯。姑且把至今为止消失的人和妖的资料都备齐了」
PRINTFORMW 「うあっ！？　あ、あぁっ、うま、うまれっ、うまれりゅっ！	PRINTFORMW 「嗯啊！？　啊、啊啊、生、生出来、生出来了！
PRINTFORMDW 　こうしてちゃんと母親をやれてる事よりは大したことじゃないな」	PRINTFORMDW 　比起这样好好做母亲，这不算什么」
PRINTFORMW 「サッカーはパワーとか言って変なとこに蹴り飛ばすんじゃないわよ」	PRINTFORMW 「用力踢球可不是要踢到奇怪的地方哦」
PRINTFORMDW 背後から、微妙に嫌がっている魔理沙が恐る恐る尋ねる。	PRINTFORMDW 从背后，微妙地厌恶着的魔理沙战战兢兢地问道。
PRINTFORMDL 異変解決に乗り遅れたのは彼女にとって悔しいことだったが、	PRINTFORMDL 没能及时解决异变对她来说是一件遗憾的事、
PRINTFORMW 「……ちゃんと修行してれば、こういうのも追い払えたのかしら」	PRINTFORMW 「……只要好好修行、这种事也能驱赶走吗」
PRINTFORMW 「うぅっ、あぅ……限界が、来る前に、準備を……」	PRINTFORMW 「唔、啊……到极限了吗、在敌人来之前、做好准备……」
PRINTFORMW 「やぁっ、だめぇっ……！　わたしのこどもじゃ、ないのぃ……」	PRINTFORMW 「不要、不行……！　不是、我的孩子……」
PRINTFORMW 「い、いやぁっ……はなれ、て……あ、あぁぁっ……♪」	PRINTFORMW 「不、不要啊……快松开、啊……啊、啊啊啊……♪」
PRINTFORMW 「……苛々するけど、今の状況じゃ満足に戦えないし」	PRINTFORMW 「……虽然很烦躁、但以现在的状况是无法尽情战斗的」
PRINTFORMW 「……あーあ、こうも動きがないとあくびが止まんないわ」	PRINTFORMW 「……哈ー啊、这样静止不动的话就会开始犯困了」
PRINTFORMW 「……軽い結界を作ってるだけなのに、こんなに疲れるなんて」	PRINTFORMW 「……只是做了个简单的结界，竟然会这么累」
PRINTFORMW 「そりゃ……頼りにならないと思われても仕方ないけど、さ」	PRINTFORMW 「那是……就算被认为不可靠也没办法、不过嘛」
PRINTFORMW 「いやぁ、吸っちゃだめぇ……また、またみるく出るからぁ！？」	PRINTFORMW 「不要、不能吸啊……母乳、又出来了！？」
PRINTFORMW 「うーん、やっぱりみんな弾幕の美しさなんて気にしないよね～」	PRINTFORMW 「呜ー嗯、果然大家都不在乎弹幕的美啊～」
PRINTFORMW 「あ……すごく、べとべとして……気持ちよさそぉ……♪」	PRINTFORMW 「啊……变得、黏糊糊的……感觉好舒服啊……♪」
PRINTFORMW 「や、やめてよ、やめっ――や、やああぁぁぁぁっ！」	PRINTFORMW 「住、住手啊、住手――不、恩啊啊啊啊啊啊啊啊啊！」
PRINTFORMW 「またこんな奴？　普通の妖精とかはかかって来ないの？」	PRINTFORMW 「又是这样的家伙？　就没有普通的妖精来吗？」
PRINTFORMW 　私が助かる望みはある。体勢を立て直して助けに来てくれる。	PRINTFORMW 　我还有得救的希望。得重整旗鼓等待救援。
PRINTFORMW 「最近の天気はどう？　……うん、私も空なんて見えない」	PRINTFORMW 「最近天气怎么样？　……嗯、我也看不见天空」
PRINTFORMW 　霖之助さんに売りつけたら、いくら貰えるかしら……！？」	PRINTFORMW 　卖给霖之助的话，能得到多少钱呢……！？」
PRINTFORMW 「寝心地は最悪だろうけど、贅沢言ってる場合じゃないわね」	PRINTFORMW 「虽然睡得不舒服，但现在也不是讲究的时候」
PRINTFORMDW 「いや……博麗の巫女がまた長い間いなくなるのは」	PRINTFORMDW 「不行……要是博丽的巫女又消失了很长时间的话」
PRINTFORMW 「前みたいに、私が囮になって探すしかないのかしら……」	PRINTFORMW 「难道只能像以前那样，我去当诱饵来找吗……」
PRINTFORMDW 霊夢は運良く生きていた魔理沙と、一緒に暮らすことに決めた。	PRINTFORMDW 灵梦决定和侥幸生还的魔理沙一起生活。
PRINTFORMW 「だから誰も来てなくて、宝がいっぱい埋まってるんじゃない」	PRINTFORMW 「所以谁都没来、这里不是埋了很多宝藏吗」
PRINTFORMDW 本気で泣いている魔理沙を見て、霊夢は困ったように頭をかく。	PRINTFORMDW 看着痛哭的魔理沙，灵梦困惑地挠挠头。
PRINTFORMW 「な、なにこれ、胸から何か、滲んで……あぐっ！」	PRINTFORMW 「这、这是怎么了、胸部有什么、漏出来了……啊哈！」
PRINTFORMW 「そ、そんなっ、あっ、だめ、そこはぁぁぁぁぁぁっ♪」	PRINTFORMW 「怎、怎么这样、啊、不行、那里、咿咿咿咿咿♪」
PRINTFORMDW 表情は快感に染まり、言葉は嬌声ばかりになっていく……	PRINTFORMDW 表情被快感所感染，话语里尽是娇喘的声音……
PRINTFORMW 「ママがぜったい、１００％妊娠できるくらいまでやろうよ♪」	PRINTFORMW 「一定要做到妈妈能１００％妊娠为止哦♪」
PRINTFORMW 「んぐっ、んむぅ……は、はひゃく、はひてっては……」	PRINTFORMW 「嗯唔、嗯姆……快、快hi点、快点社出来……」
PRINTFORMW 「これ、いぃの、なかになにかだされるのきもちいぃよぉ！」	PRINTFORMW 「这个、好舒服、里面被什么弄的好舒服！」
PRINTFORMDW 裸の状態で体を締め付けられ、霊夢は必死にもがいている……	PRINTFORMDW 赤裸的身体被束缚、灵梦在拼命挣扎……
PRINTFORML 「た……たたかわなきゃ、たたかわなきゃ……あ、あぁっ！	PRINTFORML 「必……必须要战斗、必须要战斗……啊、啊！
PRINTFORMW 「……もしかして私、おばあちゃんになったわけ？　うげぇ。	PRINTFORMW 「……难道说我已经、变成奶奶了？　诶~。
PRINTFORMW 　でも娘とか姪っ子より若い妹って、そっちとしてはどうなの？」	PRINTFORMW 　可是比女儿和侄女还年轻的妹妹呢？」
PRINTFORMW 　そっちから見た時の立場ってどういう表現になるのかしら？」	PRINTFORMW 　从那边看时的立场会是怎样的表现呢？」
PRINTFORMW （紫には、私のお腹の中にいるのが何かわかるのかしら……）	PRINTFORMW （紫的话、能知道我肚子里的是什么吗……）
PRINTFORMW （なんか、ものすごく情けないことしてるような気がするわ……）	PRINTFORMW （总觉得自己做了一件很丢脸的事……）
PRINTFORMW 　私の力じゃ弾幕の補助に使うのが限界ね。失敗したなぁ」	PRINTFORMW 　以我的力量来辅助弹幕是极限了。失策了呢」
PRINTFORMW 「……気遣って、無理に長く寝かせようとしなくてもいいわよ」	PRINTFORMW 「……不放心的话、别让我睡太久就行了」
PRINTFORM 「んむぅ……せーえき、全部吸い尽くして、やっつけるのぉ……	PRINTFORM 「嗯姆……精液、全部吸干净、看我干掉你……
PRINTFORMDW 誰かのためを意識して戦いに挑むことを――霊夢は初めて選択した。	PRINTFORMDW 灵梦第一次选择了为了谁而战斗。
PRINTFORMDW 彼女はまだ半年前の出来事から立ち直りきれていないようだ。	PRINTFORMDW 她好像还没从半年前的事情中恢复过来。
PRINTFORMW 「……ちょっと失敗しちゃったから、しばらく、援護お願い」	PRINTFORMW 「……稍微有点失策了、麻烦暂时掩护一下」
PRINTFORM 　私もきてる、きもちいいの来るっ、そのまま、なかにだしてぇっ	PRINTFORM 　我也去了、舒服的来了、就这样、射在里面
PRINTFORM 　なら出して、びゅくびゅくって体が真っ白になるくらい……	PRINTFORM 　那就射出来、biubiu地把身体染白吧……
PRINTFORMW 「落ち着かなきゃ……教えてもらった通りにやるんだ……」	PRINTFORMW 「我必须冷静下来……按照教给我的去做……」
PRINTFORMW 「はぁっ、いいっ……じぶん交尾きもちよかったぁ……♪」	PRINTFORMW 「哈啊、好舒服……肉棒交尾好舒服啊……♪」
PRINTFORMW 「……悪いけど、庇いながら戦える余裕はないのよ」	PRINTFORMW 「……不好意思，我没有一边保护一边战斗的余地」
PRINTFORMW 「そう？　別にいいけど、やられても知らないわよ」	PRINTFORMW 「是吗？　那倒无所谓、要是被打倒了我也不管了」
PRINTFORMW 「こういうの置いても、だーれも買わないのよね……」	PRINTFORMW 「就算放了这样的东西、谁~也不会买的吧……」
PRINTFORMW 　気持ちよくなるのは、あくまで戦略なのよ……だから。	PRINTFORMW 　变得舒服什么的、是恶魔的战略啊……所以。
PRINTFORMDW 舌打ちしながら、霊夢は気分を変えようと外を見る。	PRINTFORMDW 灵梦一边咂着嘴，一边看向外面，想换个心情。
PRINTFORMW 　ん……こういうこと、しちゃいけないんじゃなかったの？」	PRINTFORMW 　嗯……这样的事，不是不可以做的吗？」
PRINTFORMW 「あはっ♪　あれから、これで５人目だねママ！」	PRINTFORMW 「啊哈♪　从那以后，这已经是第五个了吧，妈妈！」
PRINTFORMDW 彼女が新しいクイーンとなる日も、そう遠くはないだろう――	PRINTFORMDW 她成为新的女王的日子也不远了吧――
PRINTFORMW 「ふあぁ～あ……敵よけの結界はあいかわらず異常なしっと」	PRINTFORMW 「呼啊～啊……防敌的结界依旧没有异常」
PRINTFORMW 「……私の様子がおかしかったら、すぐ起こしてよ」	PRINTFORMW 「……如果感觉我的情况不对劲，就马上把我叫醒」
PRINTFORMW 「や、やめなさい、やめっ――あ、うああぁぁぁぁっ！」	PRINTFORMW 「住、住手啊、不要――啊、嗯啊啊啊啊啊！」
PRINTFORMW 「結界は張ってあげたんだから、そっちがお風呂沸かしてよね」	PRINTFORMW 「帮你设置了结界、你就去烧个热水吧」
PRINTFORM 「いやぁ、吸っちゃだめぇ、赤ちゃんのために出るのにぃ……	PRINTFORM 「不要、不能吸啊、明明这是给小宝宝喝的……
PRINTFORMW 「安全そうだし、この場所は覚えておいたほうがいいわね」	PRINTFORMW 「看起来很安全，这个地方还是记住比较好」
PRINTFORMW 「……あんたとは、それなりに長い付き合いだったみたいだけど。	PRINTFORMW 「……虽然和你已经认识了很长时间。
PRINTFORMW 「この服は……紫の……。そう。そういうことなのね。	PRINTFORMW 「这件衣服……是紫的……。是。原来是这样啊。
PRINTFORMW 「外の戦いは、なにかルールを守らないといけないんだって」	PRINTFORMW 「外面的战斗，好像必须要遵守什么规则」
PRINTFORML 「あはぁっ♪　やっぱりすきぃ、こういうことだいすきぃ♪	PRINTFORML 「啊哈啊♪　我果然喜欢、这种事情好喜欢♪
PRINTFORMW 「だ、だめぇ……がまん、できなくなっちゃうよぉ……！」	PRINTFORMW 「不、不行……啊、完全忍不住了啊……！」
PRINTFORMW 「い、いたいっ！　……これって、処女ってやつなのかな？	PRINTFORMW 「好、好疼！　……这个是、处女的那个吗？
PRINTFORMW 「あ、あぁっ……出てるの、いっぱい、すてきぃ……♪」	PRINTFORMW 「啊、啊啊……出来了、好多、好棒……♪」
PRINTFORMW 「ひっ……な、なんなのこれ、何してるの……！？」	PRINTFORMW 「哼嗯……这、这什么鬼啊、在干什么……！？」
PRINTFORMW 「ここで取れる茸で、なんかおいしいやつとかない？」	PRINTFORMW 「这里能采到的蘑菇，就没有什么好吃的吗？」
PRINTFORMW 「ん……成果が出たんだし、そろそろ寝よっかな……」	PRINTFORMW 「嗯……既然有成果了、差不多该睡了吧……」
PRINTFORMW 「魔理沙ったら、いくらなんでも落とし過ぎじゃないの？」	PRINTFORMW 「魔理沙、就算是个圈套也太过分了吧？」
PRINTFORMW 「また、完璧なのが落ちてる……誰かが書いているのかな？」	PRINTFORMW 「还有、正好落在这……是谁写的吗？」
PRINTFORMW 「また落ちてる。結構な数の竜宮の使いが捕まってるの？」	PRINTFORMW 「又掉了。有很多龙宫的使者被抓了吗？」
PRINTFORMW 「霖之助さんがつけてるアレかしら？　なんか違うけど」	PRINTFORMW 「是霖之助戴的“那个”吗？　好像不是啊」
PRINTFORMDW 「……はぁ！？　霊夢、君、なんて言ったんだ！？」	PRINTFORMDW 「……哈啊！？　霊夢、你、在说什么！？」
PRINTFORMDW 「じゃあ、あの娘に博麗の巫女をやらせるとかどうかな」	PRINTFORMDW 「那就让那个孩子做博丽的巫女怎么样」
PRINTFORMDW そんな神社の階段を登ってくる白と黒の人影が、ひとつ。	PRINTFORMDW 有一个黑白相间的人影爬上神社的台阶。
PRINTFORMDW 頬ずりする娘に、よしよしと魔理沙は額を撫でた。	PRINTFORMDW 魔理沙摸了摸她的额头，说:“哟西哟西。”。
PRINTFORMW 「ほんとよかったわね魔理沙。なんとか処女は守れて……」	PRINTFORMW 「真是万幸魔理沙。总算保住了处女……」
PRINTFORMW 「今から無理やり追いだそうとしても……手遅れなのよね」	PRINTFORMW 「即使现在硬把他赶出去……也太晚了吧」
PRINTFORMW 「うぅっ、あぅ、だい、じょうぶ……まだ……動ける、から」	PRINTFORMW 「呜呜、啊、我、没事……还……能动」
PRINTFORMW 「お、おなかっ、押されてるっ、私の、おなかがぁっ！？」	PRINTFORMW 「肚、肚子、在被挤压、我的、肚子！？」
PRINTFORMW （駄目。どう見ても、普段より結界が弱まってる……）	PRINTFORMW （不行。不管怎么看，结界都比平时弱了……）
PRINTFORMW 「気付くのが遅れてたら……危なかったかも」	PRINTFORMW 「如果我没有及时发现... ... 可能会很危险」
PRINTFORMW 「壁も敵なんだから、ほんと気が休まらないわね……」	PRINTFORMW 「墙壁也是敌人，真是让人喘不过气来啊……」
PRINTFORMW 「あ、いき、止めなきゃ、す、吸っちゃっ……！？」	PRINTFORMW 「啊、走开、给我停下来、别、别吸啊……！？」
PRINTFORMW 「まだ、いる……あぐっ、なかから、擦られてるぅ……」	PRINTFORMW 「又、有什么……啊、在里面、摩擦着……」
PRINTFORMW 「あー、もう！　もっと厚着をしてくればよかったわ」	PRINTFORMW 「啊、真是的！　要是穿得再厚一点就好了」
PRINTFORMD 魔物から視線を向けられている事に気付いた霊夢は、不快そうに	PRINTFORMD 注意到魔物视线的灵梦，感到了不快
PRINTFORMW 「……とっとと行きなさい。仕切り直して準備を整えるんでしょ。	PRINTFORMW 「……快走吧。重新准备一下吧。
PRINTFORMW 「いい？　弾幕は相手を犯すために使うわけじゃないの」	PRINTFORMW 「听好了吗？　弹幕不是用来侵犯对方的」
PRINTFORMW 「……何やってんのかしら、私。こんなのを助けて……」	PRINTFORMW 「……我在干什么啊。帮助这些东西……」
PRINTFORMW 「ん……成果が出たんだし、そろそろ寝ない……？」	PRINTFORMW 「嗯……既然有成果了、要不就睡了吧……？」
PRINTFORMW 「……私にも分かる。この剣……普通の剣じゃないわ。	PRINTFORMW 「……我也明白。这把剑……不是普通的剑。
PRINTFORMW 「あいつらの体液とかが混じってたりしないわよね……」	PRINTFORMW 「不会和那群家伙的体液混在一起吧……」
PRINTFORMW 「寝て覚めたらお腹が戻ってたり……しないでしょうね」	PRINTFORMW 「睡了一觉肚子又恢复了……不会有事吧」
PRINTFORMW 「だいじょーぶだよ、ママ！　お留守番は私に任せてね！」	PRINTFORMW 「没事啦，妈妈！　看家就交给我吧！」
PRINTFORMDW あの子ならきっとうまくやるわね、と小さく呟いて。	PRINTFORMDW 那孩子一定会做得很好、灵梦小声嘀咕着。
PRINTFORMW 「わかんない時は人に聞く、って言ったらしいわねあんた」	PRINTFORMW 「你好像说过，不知道的时候就问别人」
PRINTFORMDW 一日でも早く用意を整えて、魔理沙の仇を討ちに行きたい。	PRINTFORMDW 想尽快做好准备，去给魔理沙报仇。
PRINTFORMDW 崩れ落ちる異体。それを、霊夢は無言で見つめていた……	PRINTFORMDW 灵梦默默地凝视着那个崩落的异体……
PRINTFORMDW それでも敢えて霊夢は一歩前に出て、腕を向けた。	PRINTFORMDW 尽管如此，灵梦还是向前走了一步，伸出手。
PRINTFORMDW 縁側では、魔理沙が微妙な表情でそれを見つめている。	PRINTFORMDW 檐廊上，魔理沙用微妙的表情注视着它。
PRINTFORMDW 「だぜじゃなくて、魔理沙だぜ……っとと」	PRINTFORMDW 「不是da☆ze、是魔理沙da☆ze……的说」
PRINTFORMDW 「ち、違う、そんなんじゃない……ひゃんっ！？」	PRINTFORMDW 「不、不是这样的、没有那回事……呀！？」
PRINTFORMW 「準備する必要はなさそうだし、挿れちゃうわね……♪」	PRINTFORMW 「好像也没必要准备、插进去了哦……♪」
PRINTFORMDW 「……で、なんでわざわざこんな所に呼んだんだ？」	PRINTFORMDW 「……那么，你为什么特意叫我来这里？」
PRINTFORMW 「財宝を見つけるまで帰らないわ。ほら、行くわよ」	PRINTFORMW 「在找到财宝之前我不会回去的。好啦、走吧」
PRINTFORMW 「はぁ、なんかだるいなぁ……嫌な予感がする……」	PRINTFORMW 「哈啊、感觉好累啊……有种不好的预感……」
PRINTFORMW 「……なんでこんなもったいない事してんのかしら、私」	PRINTFORMW 「……我为什么要做这种浪费时间的事呢」
PRINTFORMW 「結界は、張れたし……もう、さっさと休みたい……」	PRINTFORMW 「结界、已经展开了……真想早点休息……」
PRINTFORMDW それこそ吸い尽くされる勢いで乳首を吸われること数分……	PRINTFORMDW 乳头被以吸尽的气势吸了几分钟……
PRINTFORMW 「落とした奴のことを気にできる状態じゃないわね……」	PRINTFORMW 「现在不是在意掉下去的是谁的时候……」
PRINTFORM 「魔理沙ったら、擦られる度に震えちゃってる。かわいい	PRINTFORM 「魔理沙、每次被摩擦的时候都会发抖。好可爱
PRINTFORMW 「ごめんね？　そういう戦い方はしちゃいけないんだって」	PRINTFORMW 「对不起哦？　不可以用那种战斗方式」
PRINTFORM 「や、やだっ……これ以上はやだ、やだぁぁぁぁぁぁっ	PRINTFORM 「不、不要……这样下去不行、不行啊啊啊啊啊啊
PRINTFORMW 「どうせ着てても、すぐ破きにかかるんでしょうけど」	PRINTFORMW 「就算穿着衣服，也马上就会被撕破的吧」
PRINTFORMW 「早く、あの化け物を退治する対策を考えないと……」	PRINTFORMW 「必须尽快想出对付那个怪物的对策……」
PRINTFORMW 「そうね……今日は、幻想郷についてのお話でもする？」	PRINTFORMW 「对了……今天，我们谈一谈幻想乡？」
PRINTFORML 「……ふんだ。別れた後、どうなっても知らないわよ。	PRINTFORML 「……哼。分开之后会怎么样我可不管了。
PRINTFORMW 「んむっ……！？　んん、ふみゅ、んにゅっ……♪」	PRINTFORMW 「嗯姆……！？　嗯嗯、呼姆、嗯姆……♪」
PRINTFORMDW 今日もこうして、手作り料理を彼女の口へと運ぶ。	PRINTFORMDW 今天也是这样，把亲手做的菜送到她嘴里。
PRINTFORMW 「あとはお願い……こっちはもう限界なのよ……」	PRINTFORMW 「剩下的就拜托你了……我已经到极限了……」
PRINTFORMW 「膨らんでるっ……なにか、すわれてるぅ……！」	PRINTFORMW 「膨胀起来了……有什么东西、在吸着……！」
PRINTFORMW 　ちゃんと解決するから、宴会の計画はよろしくね」	PRINTFORMW 　我会好好解决的，宴会的计划就拜托你了」
PRINTFORMW 「こういう時、化けるには最良の人間よね……」	PRINTFORMW 「こういう時、化けるには最良の人間よね……」
PRINTFORMW 「しまった、こんなのにやられるなんて……！」	PRINTFORMW 「糟了、明明都这样了怎么还会被攻击啊……！」
PRINTFORMDW ……前触れもなく、幻想郷に流れ始めたうわさ話。	PRINTFORMDW ……毫无预兆地，幻想乡开始流传的传闻。
PRINTFORMDW いつものように、異変を片付けて宴会をするために。	PRINTFORMDW 像往常一样，为了收拾异变，举行宴会。
PRINTFORML 「はぁっ……んっ♪　こども作りたいし、うみたぁい♪	PRINTFORML 「哈啊……嗯♪　我想生个孩子、好想生♪
PRINTFORM 「きたぁっ♪　イっちゃう、みんなとこーびしてイっちゃうよぉ	PRINTFORM 「来了♪　去了、和大家交尾着去了啊
PRINTFORM 「イっちゃうぅ……♪　みんなとこーびしてイっちゃうよぉ……	PRINTFORM 「去啦……♪　和大家交尾着去了……
PRINTFORM 　みてるだけじゃやなの、なかに白いのほしいよぉっ	PRINTFORM 　不要只是看着嘛，里面好想要白色的东西啊~
PRINTFORMW 「うっ……意味分かんないけど悪寒が……」	PRINTFORMW 「唔……虽然不知道是什么意思，但有股恶寒……」
PRINTFORMW 「今度こそ勝つ……って言いたいところだけれど……」	PRINTFORMW 「这次一定要赢……虽然想这么说……」
PRINTFORMW 「……いいわよ、ある意味いつも通りよねっ！」	PRINTFORMW 「……好吧、至少在某种意义上和往常一样！」
PRINTFORMW 「……やられちゃったのか。いや、犯られちゃった？	PRINTFORMW 「……是被打败了吗。不对、是被侵犯了？
PRINTFORMW 「ごめん。せめて、軽い結界を張っていくから……」	PRINTFORMW 「对不起。至少要张开一个小型结界……」
PRINTFORMW 「庇いきれなくなるし、あんまり前に出ないでよ？」	PRINTFORMW 「因为没法保护你，所以不要走太远哦？」
PRINTFORMW 「また拾えた！　これで貧乏神社からおさらばねー！」	PRINTFORMW 「又捡到了！　从此神社告别贫困吧！」
PRINTFORMW 「絶対に私が飲むから！　誰にも渡さないから！」	PRINTFORMW 「我一定会喝的！　因为我不会给任何人！」
PRINTFORMW 「体力がなくても、これくらいの弾幕は……！」	PRINTFORMW 「就算没有体力，这种程度的弹幕也能……！」
PRINTFORMW 「ルールを守らないつもりなら、それでいいわ」	PRINTFORMW 「如果你不打算遵守规则的话、那就等着瞧吧」
PRINTFORMW 「一回休みも白旗も知らないって言うなら……」	PRINTFORMW 「如果说一次连休息和投降都不知道的话……」
PRINTFORMDW 店内の騒ぎをよそに、霊夢は外へ出て飛んでいく。	PRINTFORMDW 灵梦不理会店里的骚动、飞到外面去了。
PRINTFORMDW 「見つけた宝は二人で山分けだぜ。オッケー？」	PRINTFORMDW 「找到的宝藏是两个人平分的。OK吗？」
PRINTFORMW 　私のおっぱい、化物の子供に、吸われてるぅ……♪」	PRINTFORMW 　我的欧派，被怪物的孩子吸了……♪」
PRINTFORMW 「うっ……なんか、視界が歪んで……病気かな？」	PRINTFORMW 「唔……感觉视线模糊了……是生病了吗？」
PRINTFORMW 　子供って、生まれるまで何ヶ月もかかるはずじゃ……」	PRINTFORMW 　生孩子、应该要几个月才对吧……」
PRINTFORMW 「のんびりしてたら、追ってくるかもしれない……！」	PRINTFORMW 「放松大意的话，也许会被追上……！」
PRINTFORMW 「ちゃ、ちゃんと対価をよこしなさいよ……ひゃんっ！？」	PRINTFORMW 「一、一定给我报酬哦……呀！？」
PRINTFORMW 「あんたを退治して持ち物を奪ったほうが早いと思うんだけど」	PRINTFORMW 「我觉得消灭你抢东西比较快」
PRINTFORMW 「……もっと……きもちいいの、ほしいよぉ……♪」	PRINTFORMW 「……更多……舒服的、好像要啊……♪」
PRINTFORMW 　私は一人でへーきだから。私の心配はしなくていいよ！」	PRINTFORMW 　我一个人没事的。不用担心我！」
PRINTFORMW （だ、だめ……私、期待しちゃってる……！）	PRINTFORMW （不、不行……我、好像在期待着什么……！）
PRINTFORMW 「だ、だめ、射精はもうだめ、だめだってばぁ！」	PRINTFORMW 「不、不行、不要再射了、已经不行了！」
PRINTFORMW 「きゃっ！？　こ、この、ほんといやらしいわね！」	PRINTFORMW 「呀！？　你、你这个、真是下流啊！」
PRINTFORMW 　は、はやく、どこか、隠れて……あ、あふぁっ♪」	PRINTFORMW 　快，找个地方躲起来……啊，哎呀♪」
PRINTFORMW 「こんな連中の相手なんて、まともにしてられないわ」	PRINTFORMW 「跟这样的家伙打交道，可不能当真」
PRINTFORMW 　ま、待って、今、見捨てられたら、私……！	PRINTFORMW 　等、等一下、现在、抛弃我的话、我会……！
PRINTFORMW 「……ただでさえ余裕ないのに、冗談じゃないわ」	PRINTFORMW 「……明明本来就不宽裕了，开什么玩笑」
PRINTFORMW 「帰った後の神社掃除を考えると憂鬱だわ……」	PRINTFORMW 「一想到回去后要打扫神社，就很烦呐……」
PRINTFORMW 「できるだけ早く元凶を倒すから。それで勘弁して」	PRINTFORMW 「我会尽快打倒元凶的。所以饶了我吧」
PRINTFORMW 「博麗の巫女の戦い方、ちゃーんと見ときなさい」	PRINTFORMW 「博丽巫女的战斗方式、好好见识一下吧」
PRINTFORMW 「この程度なら、普通に撃ったほうが強いわね」	PRINTFORMW 「这种程度的话，还是普通射击比较厉害吧」
PRINTFORMW 　あいつら自身が強いんじゃなくて、服が強いのね」	PRINTFORMW 　不是他们自己厉害、而是衣服厉害啊」
PRINTFORMW 「弾幕の形なんて整えても、意味はなさそうね」	PRINTFORMW 「就算调整弹幕的形状，好像也没什么意义」
PRINTFORMDW ガーディアンを倒し、あの迷宮を脱出してから数日後。	PRINTFORMDW 在打败卫士，逃出迷宫的几天后。
PRINTFORMW 「そっちこそ。ちゃんと手がかり見つけたんでしょうね？」	PRINTFORMW 「你才是。一定是有头绪了吧？」
PRINTFORMW 「代理ならもう見つけたわよ？　ほら、この子」	PRINTFORMW 「代理的话已经找到了哦？　你看，这孩子」
PRINTFORMW 『……私の娘よ。どう扱おうと私の勝手だわ』	PRINTFORMW 『……这是我的女儿。怎么处理都是我的自由』
PRINTFORMW 「おはよう、魔理沙。ほら、あーんして。あーん」	PRINTFORMW 「早上好，魔理沙。喂、已经早上了。喂」
PRINTFORMDW 確かに魔理沙は生き残った。だが、それだけだ。	PRINTFORMDW 魔理沙确实活了下来。但是，仅此而已。
PRINTFORMW 　どうせ、霖之助さんに全部投げ出すに決まってるわ」	PRINTFORMW 　反正一定会把一切都抛给霖之助的」
PRINTFORMDW 入ってくる側に馴染む気があれば、きっと――	PRINTFORMDW 如果进来的一方想适应的话，一定可以――
PRINTFORMDW 「なぁ霊夢、なんで今更ここに来るんだよ……」	PRINTFORMDW 「呐灵梦、为什么现在才来这里呢……」
PRINTFORMW 「んぅっ……♪　私のおっぱい、おいしぃの……？」	PRINTFORMW 「嗯……♪　我的欧派、美味吗……？」
PRINTFORMW 「ふわぁぁぁ……ちょっと休んだほうがいいかしら」	PRINTFORMW 「哇啊啊啊……能让我稍微休息一下吗」
PRINTFORMDW 霊夢は眠気を振り払うように体を伸ばしている……	PRINTFORMDW 灵梦舒展着身体，仿佛要驱散睡意……
PRINTFORMW 「？　体がいつもみたいにちゃんと浮く感じ……」	PRINTFORMW 「？　好像没有往常一样飘浮的感觉……」
PRINTFORMW 「今の体調でも、これくらいは避けられるわよ」	PRINTFORMW 「即使是现在的身体状况，也能避开这些哦」
PRINTFORMW 「は、はやく、叩き落とっ……やぁぁぁぁぁっ！」	PRINTFORMW 「快、快点、弄掉它……呀啊啊啊啊啊！」
PRINTFORMW 　とりあえずしなきゃいけなくなったのは――仇討ちだけど」	PRINTFORMW 　总之首先要做的是――报仇」
PRINTFORM 「はむっ……飲ませてね、魔理沙のせーえき……れろぉ	PRINTFORM 「哈姆……让我喝吧、魔理沙的精液……舔
PRINTFORMW 「胸をくすぐられても、気持ちよくなっちゃうもん」	PRINTFORMW 「胸部被玩弄的话、会变得舒服起来啊」
PRINTFORMW 「服なんてどうでもいいからぁ、はやくぅ……♪」	PRINTFORMW 「衣服什么的都无所谓了、快点……♪」
PRINTFORMW 　自分で言っててなんだけど、趣味悪いわね……」	PRINTFORMW 　虽然是自己说的、但太恶趣味了……」
PRINTFORMW 　でも、この子は生まれる前からおばさんか……」	PRINTFORMW 　但是、奶奶在这孩子出生之前就……」
PRINTFORMW 「……お腹を見ないで、魔理沙。お願いよ……」	PRINTFORMW 「……不要看肚子，魔理沙。求你了……」
PRINTFORMW 「……そんなところまで魔理沙に似なくていいのに」	PRINTFORMW 「……不用和魔理沙那么像也可以吧」
PRINTFORMW 「何かの機械かしら。まぁ、頼ることはあるかもね」	PRINTFORMW 「是什么机器吗。嘛、也许挺给力的」
PRINTFORMW 「うわ、ださっ。でも、魔力は篭ってるみたいね」	PRINTFORMW 「哇、好恶。但是、魔力好像是困住了」
PRINTFORMW 「武器を用意するのもそれなりに手間がかかるし……」	PRINTFORMW 「准备武器也需要相应的时间……」
PRINTFORMW 「今の状態じゃ抜け出せない、待つしか……」	PRINTFORMW 「以现在的状态无法脱身、只能等待了……」
PRINTFORMW 　がまんしないで、気持ちよく、なっても……）	PRINTFORMW 　即使变得很舒服，也不需要忍耐了……）
PRINTFORMW （囮になるだけ……なるだけ、なんだから……）	PRINTFORMW （只会变成诱饵而已……而已、的说……）
PRINTFORMDW 「ちょ、ちょっと待て、これはどういう……！？」	PRINTFORMDW 「等、等一下，这到底是……！？」
PRINTFORMDW だが、できない。そもそも場所がわからないから。	PRINTFORMDW 但是，做不到。根本就不知道在哪。
PRINTFORMDW さっそくとばかりに、娘は魔理沙に足を向ける。	PRINTFORMDW 就在这时，女儿马上跑到魔理沙跟前。
PRINTFORMDW 商談開始とばかりに霊夢に習って親指を立てる。	PRINTFORMDW 商谈开始，跟灵梦学着竖起了大拇指。
PRINTFORMW 「……ご飯、いらない。食欲がないからあげるわ」	PRINTFORMW 「……不想吃饭。我没食欲，就给你吧」
PRINTFORMW 「この程度……失敗なんか、しないわよ……！」	PRINTFORMW 「这种程度……可不会让我失败啊……！」
PRINTFORMW 「はぁ、はぁっ、急ごうにもこの体じゃ……」	PRINTFORMW 「哈啊、哈啊、再怎么急我也跟不上啊……」
PRINTFORMW 「ぐ、最悪だわ……こいつら、出てこない……」	PRINTFORMW 「唔、糟透了……这些家伙、不出来……」
PRINTFORMW 　それも、もうおしまいね。さよなら……アリス」	PRINTFORMW 　但那也已经结束了。再见……爱丽丝」
PRINTFORMW 「体力がなくても、これくらい撃てるもん……！」	PRINTFORMW 「就算没有体力，也能打这么多……！」
PRINTFORMW 「みんな、物理的に足を止めないと駄目だもん」	PRINTFORMW 「大家、不在物理上停下脚步是不行的哦」
PRINTFORMW 「ほんとは狙っちゃいけないんだって、なんでかな？」	PRINTFORMW 「真的一定要瞄准吗、为什么呢？」
PRINTFORMW 「服なんてどうでもいいよぉ、はやくぅ……♪」	PRINTFORMW 「衣服什么的都无所谓啦，快点吧……♪」
PRINTFORML （今の状態なら私を助け出せないと思って逃げたんなら、	PRINTFORML （以现在的状态是救不了我的、
PRINTFORMW 「いつかあんたにも、外の世界を見せないとね」	PRINTFORMW 「总有一天，也要让你看看外面的世界」
PRINTFORMW 「……危険ならいいわ。無茶はしなくていいの！」	PRINTFORMW 「……危险就算了。千万不要乱来！」
PRINTFORMW 　私は一人で大丈夫。自分の心配だけしてなさい」	PRINTFORMW 　我一个人没问题。只管担心自己吧」
PRINTFORMW 「急に見かけるようになったわね、これ……」	PRINTFORMW 「怎么好像突然能看到的样子、这个……」
PRINTFORMW 「アリスの人形かな。盾くらいにはなるかしら」	PRINTFORMW 「是爱丽丝的人偶吗。能当当我的盾吗」
PRINTFORMW 「落ち着いて……いつも通りにやるだけ……」	PRINTFORMW 「冷静点……只是像往常一样做而已……」
PRINTFORMW 「口頭で説明してよ。多分そっちのほうが早いから」	PRINTFORMW 「口头说明一下。应该会比较快吧」
PRINTFORMDW 茶を飲み終えると同時に、八つ当たりぎみに呟く。	PRINTFORMDW 茶喝完的同时，他生气地嘟囔着。
PRINTFORMW 　私は外から仕掛ける方法を探るから、頑張りなさい」	PRINTFORMW 　我会在外面想办法的，请加油」
PRINTFORMW 「ねぇ、着替えがないよ。どこにあるっけ？」	PRINTFORMW 「呐、没有换洗的衣服哦。在哪儿来着？」
PRINTFORMW 「早く……早く進んで、隠れなきゃ……！」	PRINTFORMW 「快点……必须快点前进，躲藏起来……！」
PRINTFORMDW この先に、何が待っているかも知らないまま――	PRINTFORMDW 她不知道前面还有什么在等着她――
PRINTFORMW 「いい加減飽きてきたし、もう負けていいよ？」	PRINTFORMW 「我已经厌倦了、已经可以认输了哦？」
PRINTFORMW 　だから、ね……別にいいよ。しようよ……？」	PRINTFORMW 　所以、呐……没关系的。做吧……？」
PRINTFORMW （やっぱり……私の居場所は、こっちだったんだ……	PRINTFORMW （果然……我的归宿、就是这里……
PRINTFORML なお、この口上を使用すると娘も喋ります。	PRINTFORML 另外，使用这个口上的话，妹子也会说话。
PRINTFORMW 「んあぁ……も、もっと！　もっとしてぇ！」	PRINTFORMW 「嗯啊……更、更多！　再做多一些！」
PRINTFORMW 「何、こいつ？　やる気みたいだけど……」	PRINTFORMW 「什么鬼，这家伙？　好像很有干劲……」
PRINTFORMW 「はぁ、はぁっ、はぁっ……て、手間を……」	PRINTFORMW 「哈、哈啊、哈……这、这种时候……」
PRINTFORMW 「はぁ……。いったい、何匹倒せばいいんだか」	PRINTFORMW 「啊……。到底要打倒多少只才行啊」
PRINTFORMW 「馬鹿ね。その程度で私に勝てるはずがない」	PRINTFORMW 「笨蛋。就这点程度，不可能战胜我的」
PRINTFORMW （せめて、こういう子が生まれればいいな……）	PRINTFORMW （至少能生个这样的孩子就好了……）
PRINTFORMW 「弾幕の美しさなんて気にする相手じゃないかしら」	PRINTFORMW 「这个对手感受不到弹幕的美吗」
PRINTFORMW 「物理的に足を止めないといけないみたいね」	PRINTFORMW 「看来得用物理方法来停下它的脚步了」
PRINTFORMDW 周囲から響きだした音に、霊夢は首を回す。	PRINTFORMDW 听到周围传来的声音，灵梦转过头来。
PRINTFORMW 「その上……あの子の見張りも必要と来てるしね」	PRINTFORMW 「而且……我也需要监视那个孩子」
PRINTFORMW 「弾幕ごっこのこととか教えてあげてね。じゃ」	PRINTFORMW 「稍微教了点小儿科的弹幕。那再见」
PRINTFORMDW はじめて、心の底から、弱音を吐いた気がした……	PRINTFORMDW 这是第一次发自内心地叫苦……
PRINTFORMDW 「ん、そうだな……よし、私にボールくれよ」	PRINTFORMDW 「嗯、是啊……好吧、把球给我吧」
PRINTFORMW 「何よ、普段だったらこういうのノリノリな癖に」	PRINTFORMW 「怎么啦、平时的那种气势去哪了」
PRINTFORMDW 「きゃあああああ！？　壁から触手がー！」	PRINTFORMDW 「呀啊啊啊啊！？　墙壁上有触手！」
PRINTFORMW 「こ……のっ、吸い付く……なぁっ……！」	PRINTFORMW 「你……这个、不要吸……上来啊……！」
PRINTFORMW 「……さんざん中に出されたけど……まさか」	PRINTFORMW 「……虽然被狠狠地中出了……不会吧」
PRINTFORMW 「食欲が出ない……食べなきゃいけないのに……」	PRINTFORMW 「没有食欲……明明必须要吃……」
PRINTFORMW 「うっ、気分が……。また、なのかなぁ……」	PRINTFORMW 「唔、气氛有点……。又、来了吗……」
PRINTFORMW 「おなか、重い……どうして、こんな事に」	PRINTFORMW 「肚子，好重……为什么、会发生这种事」
PRINTFORMW 「そうなんだ、よかった♪　それでね……ママ」	PRINTFORMW 「是吗，太好了♪　然后呢……妈妈」
PRINTFORM 「もう、困った子ね。私がしてあげるから……	PRINTFORM 「真是个让人头疼的孩子。我来帮你做吧……
PRINTFORMW 「弾幕は、形に気を遣わなきゃいけないんだっけ？」	PRINTFORMW 「弹幕是必须要注意形状的吧？」
PRINTFORMW 「武器を用意するのもそれなりに手間がかかる、だっけ？」	PRINTFORMW 「准备武器也很费事吧？」
PRINTFORMW 「む～、もっと厚着をすればよかったのかな……」	PRINTFORMW 「嗯～、我应该再穿厚一点吗……」
PRINTFORMW 「…………なんとかしないと……でも……」	PRINTFORMW 「…………不做点什么的话……但……」
PRINTFORMW 「た……体勢……立て直さなきゃ……」	PRINTFORMW 「身……身体……必须要重新振作起来……」
PRINTFORMW 「中を優先的に守らないとまずいのかしら？」	PRINTFORMW 「没法优先守住里面不是很糟糕吗？」
PRINTFORMW （あ、あれ……私、なにしてるんだろう……）	PRINTFORMW （啊、啊咧……我、我在做什么……）
PRINTFORMDW これが恐怖なんだと、霊夢は自覚する。	PRINTFORMDW これが恐怖なんだと、霊夢は自覚する。
PRINTFORMDW 霊夢は、自分自身が唾を飲んでいる事に気付いた。	PRINTFORMDW 灵梦意识到自己正在吞口水。
PRINTFORMW 「ん……治った？　風邪にでも罹ってたのかしら」	PRINTFORMW 「嗯……治好了？　只是感冒吗」
PRINTFORMW 「い、痛っ！　……もしかして、これって……	PRINTFORMW 「好、痛！　……难不成，这个是……
PRINTFORMW 「……はぁ、はぁっ、んぅっ、あはぁ……♪」	PRINTFORMW 「……哈啊、哈啊、嗯、啊哈……♪」
PRINTFORMW 「……お茶がいいとか贅沢は言わないわ」	PRINTFORMW 「……我不会去在意茶贵不贵或者好不好」
PRINTFORMW 「は、はむぅ……ど、どう、魔理沙……」	PRINTFORMW 「哈、哈姆……怎、怎么样、魔理沙……」
PRINTFORMW 「こういう時は、まずけんせーだっけ……」	PRINTFORMW 「这种时候、好像是先攻要害来着……」
PRINTFORMW 　でもぉ、だめだからぁ……自分でするのっ♪」	PRINTFORMW 　但是、不行啊……只能自己做♪」
PRINTFORMW 「んぅんっ、しゅごい、しゅごいよぉ……♪」	PRINTFORMW 「嗯唔、好腻害、好腻害啊……♪」
PRINTFORMW （変なことやられるの、もう無理よぉ……）	PRINTFORMW （被做了奇怪的事、已经不行了……）
PRINTFORMW 「……とっとと行きなさい。仕切り直すんでしょ。	PRINTFORMW 「……快走吧。去重整旗鼓吧。
PRINTFORMW 「ありがと。化け物退治にちゃんと役立てるから」	PRINTFORMW 「谢谢。对消灭怪物很有帮助」
PRINTFORMW 「ちょ、ちょっと、ねぇっ！　……もう！」	PRINTFORMW 「等、等一下、呐！　……真是的！」
PRINTFORMW 「魔理沙、あんたどこかでこれ落としてたの？」	PRINTFORMW 「魔理沙、你在哪里掉了这个？」
PRINTFORMW 　こんな切り札、落とした覚えはないんだけど」	PRINTFORMW 　我不记得我留过这么一手王牌」
PRINTFORMW 「寝てる最中に産まれたりするのかしら……」	PRINTFORMW 「是在睡觉的时候生出来的吗……」
PRINTFORMW 「もうっ、これで倒れなさいよ……！」	PRINTFORMW 「到此为止了、就这样给我倒下吧……！」
PRINTFORMW 「いい加減飽きてきたし、さっさと退治されてよね」	PRINTFORMW 「我已经腻了、迅速解决吧」
PRINTFORMW 「……やはり、一人で行くつもりなのかしら？」	PRINTFORMW 「……果然是打算一个人去吗？」
PRINTFORMDW それを見て、紫は微妙な笑みを浮かべた。	PRINTFORMDW 看到这一幕，紫露出了微妙的笑容。
PRINTFORMDW それが、いつもの霊夢のやり方だとしても……	PRINTFORMDW 即使那是通常的灵梦的做法……
PRINTFORMDW まるで、何か……物足りないような、感覚。	PRINTFORMDW 好像是什么……美中不足的感觉。
PRINTFORMDW その舞台となった場所にも長居したくなかった。	PRINTFORMDW 我也不想在那个舞台上久留。
PRINTFORMW 「こんな体調でも、これくらい……！」	PRINTFORMW 「就算是这样的状态、这种程度也……！」
PRINTFORMW 「走るのも、眠気覚ましにはなるかしら……」	PRINTFORMW 「跑一会、是不是就能提神了……」
PRINTFORMW 「……こっちも余裕はないんだけどね、っと！」	PRINTFORMW 「……我也没有时间跟你耗了！」
PRINTFORMW 「ほら、起きなさい。もう大丈夫なはずよ？」	PRINTFORMW 「快起来吧。应该已经没事了哦？」
PRINTFORMW 「……入るべきだったかもしれないわ。そんな気がする」	PRINTFORMW 「……感觉我应该进去」
PRINTFORMW 「は、張り付かないでっ、そこだめぇっ！？」	PRINTFORMW 「不、不要贴上来、那里不行！？」
PRINTFORMW 「どうせなら、温泉だったらよかったのに」	PRINTFORMW 「如果是温泉就好了，但总比没有好」
PRINTFORMW 　だから……私の中に、出してって……」	PRINTFORMW 　所以……在我的里面、射出来吧……」
PRINTFORMW 「ママは節約に気を遣わなきゃいけない人なんだって」	PRINTFORMW 「妈妈说她是个节俭的人」
PRINTFORMW 「もともと、私は……みんなの、仲間だもん。	PRINTFORMW 「本来，我就是……大家的伙伴嘛。
PRINTFORMW 「わ、私……こういうの、やめなきゃっ……」	PRINTFORMW 「我……必须停止、做这种事……」
PRINTFORML キャラは全般的にクール。微妙にツンデレ。	PRINTFORML 角色会比较冷静。还有微妙的傲娇。
PRINTFORMW 「うぅ、気持ち悪い……離れなさいよっ……」	PRINTFORMW 「噫、好恶心……离我远点……」
PRINTFORMW 「服でも狙ってたの？　なめきったもんね」	PRINTFORMW 「专门瞄准衣服吗？　别小看我了」
PRINTFORMW 　勝つためには、しょうが、ないのぉ……♪」	PRINTFORMW 　为了胜利、没办、法啊……♪」
PRINTFORMW 「どいつもこいつも、馬鹿じゃないの……！」	PRINTFORMW 「一个个的、都是笨蛋吗……！」
PRINTFORMW 「無茶するところまで親に似なくていいからね」	PRINTFORMW 「不要像母亲那样乱来好了吗」
PRINTFORMW 「私が知ってるのはこんな感じ。そっちは？」	PRINTFORMW 「我知道的就这些。你那边呢？」
PRINTFORMW 「わざわざここで修行なんてしたくないわ……」	PRINTFORMW 「我不想特意在这里修行……」
PRINTFORMW 「おじさんが霖之助さん？　よろしくね！」	PRINTFORMW 「欧吉桑是霖之助？　拜托你了！」
PRINTFORMDW 「むっ、私だって頑張って調べてきたのに！」	PRINTFORMDW 「唉，我也努力调查过了！」
PRINTFORMW 「や、やぁっ、おっぱい、すわないでぇっ！」	PRINTFORMW 「不、不要、不要吸、欧派啊！」
PRINTFORMW 「動かない相手なら、まぁ問題ないわ」	PRINTFORMW 「如果是不动的对手的话、应该没问题」
PRINTFORMW 「無理……こんなんじゃ戦えない……！」	PRINTFORMW 「不行……这样的话无法战斗……！」
PRINTFORMW 「う……このままだとやばいかな……」	PRINTFORMW 「嗯……这样下去的话会很危险吧……」
PRINTFORMW 「い、痛っ！　あんた、何して……！？」	PRINTFORMW 「好、痛！　你、干了什么……！？」
PRINTFORMW 「これで、お茶っ葉があったら言うことないんだけど」	PRINTFORMW 「如果有茶叶就更好了」
PRINTFORMW 「拾った以上は、有効活用させてもらいましょ」	PRINTFORMW 「既然捡到了，就好好利用吧」
PRINTFORMW 「なっ、ばか、どこに入り込んでぇっ！？」	PRINTFORMW 「什、笨蛋、你躲到哪里去了！？」
PRINTFORMW 「……これ……は……魔理……沙、の。	PRINTFORMW 「……这个……是……魔理……沙、的。
PRINTFORMW 「今の状況で当たるのはいけないのかな……」	PRINTFORMW 「现在这种情况下打不中吗……」
PRINTFORMW 「い、いたいっ！　なに、これ……！？」	PRINTFORMW 「好、好疼！　什么、这个……！？」
PRINTFORMW 　よくわかんないし、どうでもいいけど……」	PRINTFORMW 　反正不是很懂、没所谓了……」
PRINTFORMW 　ずっと、一緒にいようね……みんな……♪）	PRINTFORMW 　一直在一起吧……大家……♪）
PRINTFORMW 「そんなに妖怪の味方がしたいってわけ？」	PRINTFORMW 「你就那么想当妖怪的伙伴吗？」
PRINTFORMW 「えっ、なっ……ちょ、ちょっと、待って！	PRINTFORMW 「诶、什……等、等等、等一下！
PRINTFORMW 「なるほど。あんたを退治すればいいわけね」	PRINTFORMW 「原来如此。把你干掉就行了」
PRINTFORMW 「それはともかく、無事だったみたいね」	PRINTFORMW 「不管怎么说、看起来没事就行了」
PRINTFORMW 「ありがと……これで、なんとか……」	PRINTFORMW 「谢谢……这样，总算有办法了……」
PRINTFORMW 「……あいつも退治しないといけないのかしら」	PRINTFORMW 「……那家伙也得消灭掉吗」
PRINTFORMW 「今の状況で食らうのはまずいわね……」	PRINTFORMW 「现在这种情况有点吃不消了……」
PRINTFORMW 「ちゃんと弾幕で勝負しなさいよ、あんた達」	PRINTFORMW 「就好好用弹幕来一决胜负吧」
PRINTFORMW 「これからよろしくね、霖之助おじさん！」	PRINTFORMW 「今后请多指教、霖之助叔叔！」
PRINTFORMDW 博麗の巫女の戦いはまだ、終わらない……	PRINTFORMDW 博丽的巫女之战还没有结束……
PRINTFORMW 「かわいいからいいのよ。かわいいは正義」	PRINTFORMW 「可爱就就行了。可爱即是正义」
PRINTFORMW 「や、やぁっ、おっぱい、なんでぇっ！？」	PRINTFORMW 「不、不要、欧派、为什么！？」
PRINTFORMW 「ま、待ってよ、もう少しゆっくり走って！」	PRINTFORMW 「等、等一下、再走慢一点！」
PRINTFORMW 「結界は張ったわ。後は待つだけよ」	PRINTFORMW 「结界已经设好了。剩下的只有等待了」
PRINTFORMW 「ほら、しっかりして！　目を開けるの！」	PRINTFORMW 「喂、振作起来！　睁开眼睛！」
PRINTFORMW 「あっ……ぅ、んあっ、あ、あーっ！？」	PRINTFORMW 「啊……呜、嗯啊、啊、啊ー！？」
PRINTFORMW 「水風呂でも、落ち着けられるだけマシね」	PRINTFORMW 「就算是冷水澡、也总比没有强」
PRINTFORMW 「な、中に……うぁ、うあああぁっ！？」	PRINTFORMW 「里、里面……唔、呜啊啊啊！？」
PRINTFORMW 「は、張り付かないでっ、そこだめぇっ！」	PRINTFORMW 「不、不要贴上来、那里不行！」
PRINTFORMW 「ま、こんなのを避けるくらいはね……」	PRINTFORMW 「嘛、至少这种还是躲得开的……」
PRINTFORMW 「ぷちぷちする感触は気持ちいいけど……」	PRINTFORMW 「软软的感触感觉很舒服啊……」
PRINTFORMW 「なかを優先的に守らないといけないのかな？」	PRINTFORMW 「不优先保护里面不行吗？」
PRINTFORMW 「……目を覚まさせる必要があるみたいね」	PRINTFORMW 「……好像有必要让她醒过来」
PRINTFORMW （…………！　気配が、遠く……？）	PRINTFORMW （…………！　气息、变远了……？）
PRINTFORMW 「なんかもう、慣れてきた自分が怖いわ。	PRINTFORMW 「感觉我害怕已经习惯了的自己。
PRINTFORMW 「先制攻撃をするって選択肢が欲しいわね」	PRINTFORMW 「我想要选择先发制人的攻击」
PRINTFORMW 「あんたの家、そろそろ大変なことになってそうね」	PRINTFORMW 「你家快要出大事了」
PRINTFORMW 「これで終わってくれるとありがたいんだけど」	PRINTFORMW 「如果能就此结束就好了」
PRINTFORMW 「胸をくすぐられると気色悪いのよね……」	PRINTFORMW 「胸被玩弄感觉好恶心啊……」
PRINTFORMDW 何かあった時の心配をする必要はない。	PRINTFORMDW 不管发生什么事都不需要担心。
PRINTFORMW 「こっちはそう言ってないみたいだけど？」	PRINTFORMW 「这边好像不是那么说的哦？」
PRINTFORMDW 「いやー！　いや～～～～～～！」	PRINTFORMDW 「不要！　我不要～～～～～～！」
PRINTFORMW 「ひんっ♪　あっ……ううぅんっ……！」	PRINTFORMW 「哈啊♪　啊……嗯嗯嗯……！」
PRINTFORMW 「慌てる必要なかったわね……服ないし」	PRINTFORMW 「不需要惊慌……反正没穿衣服」
PRINTFORMW 「……なんか、もったいないことをした気がする」	PRINTFORMW 「……总觉得太可惜了」
PRINTFORM あっ、う、ぁあっ、きてる、のぼってきてる、	PRINTFORM 啊、呜、啊啊、来了、要出来了、
PRINTFORMW 「どーせ、まいったなんて言わないよね？」	PRINTFORMW 「反正、之前也没说什么吧？」
PRINTFORMW 「……この状態で来たくはなかったけど」	PRINTFORMW 「……没想到在这种时候来了」
PRINTFORMW 「あんた達なんかに、絶対負けない……！」	PRINTFORMW 「绝对不会输给你们……！」
PRINTFORMW 「大物……！？　やばいかも……」	PRINTFORMW 「这么大……！？　有点难搞了……」
PRINTFORMW 　これ、帰ったらどうすればいいのかな」	PRINTFORMW 　这个回去后该怎么办才好啊」
PRINTFORMW 「何かあったら、すぐ私を探すのよ？」	PRINTFORMW 「有什么事的话，马上找我哦？」
PRINTFORMW 「いつもの服に拘ってる場合じゃないわね」	PRINTFORMW 「现在不是在意穿着的时候」
PRINTFORMW 「湿気ってたりしないといいんだけど……」	PRINTFORMW 「要是没有湿气就好了……」
PRINTFORMW 「好き勝手やれるのはここまでよ！」	PRINTFORMW 「随心所欲的胡闹就到此为止了！」
PRINTFORMW 「醜い壁の一つにでも戻ってくれる？」	PRINTFORMW 「能滚回到那丑陋墙壁里去吗？」
PRINTFORMW 「もったいない、ちゃんと節約しなくちゃ」	PRINTFORMW 「太浪费了、稍微节约一下」
PRINTFORMW 「まとめて吹き飛んでくれれば……！」	PRINTFORMW 「如果能把它们一起打飞……！」
PRINTFORMW 「あーもうっ、さっさと離しなさいよ！」	PRINTFORMW 「啊——够了、快放开我啊！」
PRINTFORMW 「う、うっさいわね……さっさと行くわよ」	PRINTFORMW 「无、无路赛……赶紧走吧」
PRINTFORMDW そう。この異変はまだ終わっていない。	PRINTFORMDW 没错。这个异变还没有结束。
PRINTFORMDW 霊夢は、容赦なく更に止めを放った。	PRINTFORMDW 灵梦毫不留情地进一步攻击了。
PRINTFORMDW その時には既に、何もかもが手遅れだった。	PRINTFORMDW 但那时一切都为时已晚。
PRINTFORMDW 「や、やめろよ……こんなこと……」	PRINTFORMDW 「住、住手吧……这种事……」
PRINTFORMW 「な、なに飲んで……はなれてよっ……！」	PRINTFORMW 「不、不要……喝啊……！」
PRINTFORMW 「なにか、体に引っかかるような……」	PRINTFORMW 「好像、有什么东西在体内……」
PRINTFORMW 「うぅっ……こいつ、うごくなっ……」	PRINTFORMW 「嗯……你这家伙、别动啊……」
PRINTFORML 「……なんで？　ほんとに妊娠したの？	PRINTFORML 「……为什么？　真的怀孕了吗？
PRINTFORMW 「もういや、気が滅入りそう……！」	PRINTFORMW 「快不行了、感觉提不起劲……！」
PRINTFORMW 「ん……ママのみるく、おいしいよ♪」	PRINTFORMW 「嗯……妈妈的奶、好美味啊♪」
PRINTFORMW 「あっそ。せいぜいやられないようにね」	PRINTFORMW 「啊、是吗。最好不要搞砸了」
PRINTFORM 　今なら、赤ちゃんができないから……	PRINTFORM 　如果是现在的话、不会有孩子的……
PRINTFORM 　もし出来たら、受け入れるから……	PRINTFORM 　如果射出来的话、我会全部接受的……
PRINTFORMW 「ふふ……好きなだけ出していいのよ？」	PRINTFORMW 「呵呵……想射就射出来吧？」
PRINTFORMW 「無駄打ちしたら怒られるもん……」	PRINTFORMW 「用无效的攻击可能会惹怒它……」
PRINTFORMW 「いっぱい使ったら怒られるかな……」	PRINTFORMW 「要是用太多会不会惹怒它……」
PRINTFORMW 「まとめて吹き飛んでくれたら……！」	PRINTFORMW 「如果能把它们一起打飞……！」
PRINTFORMW 「このままじゃだめ、待たなきゃ……」	PRINTFORMW 「这样下去不行、必须等待……」
PRINTFORMW 「いたっ……、このままじゃ危ないのかな」	PRINTFORMW 「痛……这样下去很危险吧」
PRINTFORMW 「は、肌に、くっかないでよっ……！」	PRINTFORMW 「哈、皮肤、不要舔啊……！」
PRINTFORMW 「まずあいつらと引き離さなきゃ……！」	PRINTFORMW 「先把他们分开才行……！」
PRINTFORMW 「まぁ、あんたの心配なんて不要でしょうけど」	PRINTFORMW 「嘛，不用你担心吧」
PRINTFORMW 「ごめん……しばらくの間、頼るわ……」	PRINTFORMW 「抱歉……暂时靠你了……」
PRINTFORML 「うぅ、もう私が見張る時間……？	PRINTFORML 「唔、已经到我站岗的时间了……？
PRINTFORMW 「あんた達なんかに吸われたくない……！」	PRINTFORMW 「不想让你们吸啊……！」
PRINTFORMW 　私は外から探るから、頑張りなさい」	PRINTFORMW 　我会在外面探索的，加油吧」
PRINTFORMDW 霊夢が博麗神社に戻って、数週間後。	PRINTFORMDW 灵梦回到博丽神社，几周后。
PRINTFORMDW 「……私も、大概お人好しだよな」	PRINTFORMDW 「……我、大概也是个好人吧」
PRINTFORMW 「はぁっ……このっ、またっ……！」	PRINTFORMW 「哈啊……你这个、又在……！」
PRINTFORMW 「はぁ、はぁっ……大きく、なってる」	PRINTFORMW 「哈、哈啊……肚子、变大了」
PRINTFORMW 「づっ……、なに、これぇ……！？」	PRINTFORMW 「呃……、什么、这个……！？」
PRINTFORMW 「多分、足を引っ張ることになるから……」	PRINTFORMW 「大概、会拖后腿吧……」
PRINTFORMW 「避ける必要ないわね……服ないし」	PRINTFORMW 「没必要躲避……反正没穿衣服」
PRINTFORMW 「疲れても諦めないもんね、みんな」	PRINTFORMW 「就算累了也不会放弃的，大家」
PRINTFORMW 「なかだけは、今はだめなの……！」	PRINTFORMW 「只有里面、现在不行啊……！」
PRINTFORML 「じゃあね、そっちは大丈夫なんだよね？	PRINTFORML 「再见啦、你那应该没事吧？
PRINTFORMW 「だから、そういうのやめなさいっての」	PRINTFORMW 「所以说，不要那样做啊」
PRINTFORMW （い、今されちゃったら、だめ……）	PRINTFORMW （现、现在做的话、不行……）
PRINTFORMW 「足りない……たりない、のぉ……♪」	PRINTFORMW 「不够……还、不够……♪」
PRINTFORMW 「これで事態は進展するのかしら？」	PRINTFORMW 「这样的话事态会有进展吗？」
PRINTFORMW 「倒して……解決、するのかしら」	PRINTFORMW 「把她打倒就……解決了、吗？」
PRINTFORMW 「……今の戦力でやれるかしら？」	PRINTFORMW 「……以现在的战斗力能赢吗？」
PRINTFORMW 「周りの状況……わかる……？」	PRINTFORMW 「周围的情况……你知道吗……？」
PRINTFORMW 「ほっとくわけにもいかないでしょ……」	PRINTFORMW 「也不能放着不管吧……」
PRINTFORMW 「少しは体が楽になるといいんだけど」	PRINTFORMW 「希望身体能稍微舒服一点」
PRINTFORMW 「このっ、とっとと倒れなさいよ！」	PRINTFORMW 「你这个、赶快给我倒下吧！」
PRINTFORMW 「疲労困憊くらいじゃ納得しないみたいね」	PRINTFORMW 「怎么好像不知疲倦啊」
PRINTFORMW 「ぶつける感触が気持ち悪いのよね……」	PRINTFORMW 「打中的感触好恶心……」
PRINTFORMW 「このっ……離せ、離してよぉ！」	PRINTFORMW 「可恶……放开我，放开我啊！」
PRINTFORMW 「それで、こっちの管理は……」	PRINTFORMW 「所以、这里的管理该怎么办……」
PRINTFORMW そこまで言うと、霊夢は視線を逸らす。	PRINTFORMW 说到这里，灵梦移开了视线。
PRINTFORMW 「魔理沙おねーちゃんも遊ぼうよー！」	PRINTFORMW 「魔理沙姐姐也一起玩吧！」
PRINTFORMW 「――ここはきっと、宝の山よ！」	PRINTFORMW 「――这里一定是、一座宝山！」
PRINTFORMDW 「嫌だ、また犯されるの嫌ー！」	PRINTFORMDW 「讨厌、不想再次被侵犯了！」
PRINTFORMW （……な、なに考えてるのよ、私は！）	PRINTFORMW （……我、我在想什么啊！）
PRINTFORMW 「集中しなきゃ……集中……集中」	PRINTFORMW 「必须要集中……集中……集中」
PRINTFORMW 　どっかで隠れてなさいよ。いい？」	PRINTFORMW 　找个地方躲起来吧。好吗？」
PRINTFORMW 　文句をつける奴がもういないんだし」	PRINTFORMW 　因为已经没有人会抱怨了」
PRINTFORM 「ちゅっ、んむぅ……んふ、おいひ……	PRINTFORM 「啾、嗯姆……嗯哼、好好次……
PRINTFORMW 「おもいっきり近づくしかないかな……」	PRINTFORMW 「只能尽量靠近了吧……」
PRINTFORMW 「えへへ……よろしくね、ママ！」	PRINTFORMW 「诶嘿嘿……请多指教、妈妈！」
PRINTFORMW 「な、何見せてるのよ……！？」	PRINTFORMW 「什、什么都看不到了……！？」
PRINTFORMW （…………！　気配が、遠く？）	PRINTFORMW （…………！　气息、变远了？）
PRINTFORMW 「なら、さっさと片付けさせてもらう！」	PRINTFORMW 「那就尽快收拾你吧！」
PRINTFORMW 「ありがと……私は、大丈夫よ……」	PRINTFORMW 「谢谢……我、没事的……」
PRINTFORMW 「まだよ、まだ使っちゃダメ……！」	PRINTFORMW 「不行、还不能使用……！」
PRINTFORMW 「中だけはもう、絶対いや……！」	PRINTFORMW 「只有里面、绝对不行……！」
PRINTFORMDW 「もう少し考えてから結論を……」	PRINTFORMDW 「再想一想找出结论……」
PRINTFORMDW 橙の言葉に、霊夢はそう返す。	PRINTFORMDW 对橙的话，灵梦是这么回答的。
PRINTFORMDW ぐい、っと霊夢は涙を拭った。	PRINTFORMDW 抽泣了一声、灵梦擦了擦眼泪。
PRINTFORMDW だって彼女は――友達、なのだから。	PRINTFORMDW 因为她――是我的朋友。
PRINTFORMW 「待つのは……趣味じゃないのよね！」	PRINTFORMW 「我可……没兴趣等你！」
PRINTFORMW 「……そろそろ休まないとまずいわね」	PRINTFORMW 「……差不多该休息了吧」
PRINTFORMW 「ふぅ。陣の設置、終了っと……」	PRINTFORMW 「呼。结界的设置、结束……」
PRINTFORMW 「できれば休みたいけど……」	PRINTFORMW 「如果可以的话我想休息一下……」
PRINTFORMW 「な、なにこれ、離れっ……！」	PRINTFORMW 「这、这是什么、离远点……！」
PRINTFORMW 「そんな長さじゃ、私には届かないわよ」	PRINTFORMW 「这长度可够不到我哦」
PRINTFORMW 「こんなの、飛べばいいだけよ」	PRINTFORMW 「这种东西，只要飞起来就行了」
PRINTFORMW 「石なんかに当たるわけないじゃない」	PRINTFORMW 「怎么可能被石头砸中呢」
PRINTFORMW ――何か、おかしなことが起きてる。	PRINTFORMW ――突然发生了奇怪的事情。
PRINTFORMW 「もう手加減しないからね……！」	PRINTFORMW 「我不会再手下留情了……！」
PRINTFORMW 「みんなは、痛くしないとわかんないの」	PRINTFORMW 「非要弄疼大家才行吗」
PRINTFORMW 「いま、胸をすわれちゃったら……」	PRINTFORMW 「现在、胸部被吸的话……」
PRINTFORMW 「ふやっ！？　な、なぁに……？」	PRINTFORMW 「哈呀！？　什、什么……？」
PRINTFORM 「だめぇ……これ吸ったら、私……	PRINTFORM 「不行……这样吸的话、我会……
PRINTFORM 　なんだろ、これ、きもちよくて……	PRINTFORM 　怎么感觉、这个、好舒服……
PRINTFORMW 「あうっ！　な、なに……！？」	PRINTFORMW 「啊呜！　什、什么……！？」
PRINTFORMW 「退治完了。そこで萎びてなさい」	PRINTFORMW 「退治完了。就在那自灭吧」
PRINTFORMW 「そ、そんなに近づかないで……！」	PRINTFORMW 「别、别靠那么近……！」
PRINTFORMW 「魔理沙がどこかで落としたの？」	PRINTFORMW 「这是魔理沙在哪里掉的？」
PRINTFORMW 「無駄打ちするわけには……！」	PRINTFORMW 「即使是无用的攻击也……！」
PRINTFORMW 「中は……だめ、おねがい……」	PRINTFORMW 「里面……不行、求你了……」
PRINTFORMDW 「え……えっと、ある程度は」	PRINTFORMDW 「诶……诶多、某种程度上」
PRINTFORMW 『だから――気に食わないのよねぇ』	PRINTFORMW 『所以才――令人讨厌啊』
PRINTFORMW 「……弱った所をご案内ってわけね」	PRINTFORMW 「……我来带你解除困境」
PRINTFORMW 「……いいのよ、バレなければ」	PRINTFORMW 「……没关系，只要不被发现」
PRINTFORMW 「あ、だぜおねーちゃんだー！」	PRINTFORMW 「啊、是da☆ze大姐姐！」
PRINTFORM 「前ここに来た時、お茶とかお酒とか	PRINTFORM 「上次来这里的时候，茶啊酒啊
PRINTFORM 「あ、あぁっ、ああああああぁっ……	PRINTFORM 「啊、啊啊、啊啊啊啊啊啊……
PRINTFORMW 「づっ……前と、違う……？」	PRINTFORMW 「呃……和之前、不一样……？」
PRINTFORMW （そう……あの快感が、また……）	PRINTFORMW （啊……那种快感、又……）
PRINTFORMW 「私は私で動くわ。邪魔しないで」	PRINTFORMW 「我自己会做。不用麻烦了」
PRINTFORMW （あぁ……ごめん、みんな……）	PRINTFORMW （啊啊……对不起、大家……）
PRINTFORMW 「たす、かったの……わたし……？」	PRINTFORMW 「我……得救了吗……？」
PRINTFORMW 「こういう時は確か……結界！」	PRINTFORMW 「这种时候的确得……结界！」
PRINTFORMW 「まずは当てないといけないの……！」	PRINTFORMW 「得先打中才行……！」
PRINTFORMW 「やぁ……もう、やだ……！」	PRINTFORMW 「呀……已经、不想要了……！」
PRINTFORMW 「い、今だけは絶対だめだよ！」	PRINTFORMW 「只、只有现在绝对不行啊！」
PRINTFORM にバレたら、おこられる、かなっ……	PRINTFORM 被发现的话、会生气、的吧……
PRINTFORMW 「や、やだっ、はなれぇっ！？」	PRINTFORMW 「不、不要、不要过来！？」
PRINTFORMW 「この……気色悪いんだってば！」	PRINTFORMW 「这个……感觉好恶心！」
PRINTFORM 　中に入ってくるって、わかるの……	PRINTFORM 　感觉得到进到里面来了……
PRINTFORMDW 霊夢は悲しそうに首を振っている……	PRINTFORMDW 灵梦悲伤地摇头……
PRINTFORMW 　…………私、死んじゃうのかな）	PRINTFORMW 　…………我、要死了吗）
PRINTFORMW 「紫の仇……討たせてもらうわ」	PRINTFORMW 「紫的仇……让我来讨伐你」
PRINTFORMW （……無事じゃなきゃよかったのに）	PRINTFORMW （……要是没事就好了）
PRINTFORMW 「さっさと退治されてほしいんだけど」	PRINTFORMW 「希望能尽早消灭掉」
PRINTFORMW 「軽く振るくらいならまだ……」	PRINTFORMW 「只是轻轻一击的话还……」
PRINTFORMW 「いい加減倒れてくれない？」	PRINTFORMW 「你能不能就直接给我倒下？」
PRINTFORMW 「はやく……早くしなきゃ……！」	PRINTFORMW 「快……必须快点……！」
PRINTFORMW 「ま、いつも通りのやり方じゃない」	PRINTFORMW 「嘛，不是往常的做法」
PRINTFORMDW 「……しばらく留守にするって？」	PRINTFORMDW 「……暂时不在家？」
PRINTFORMW 「私は……どうすればいいの……」	PRINTFORMW 「我……我该怎么办……」
PRINTFORMDW 「もうやだ、家に帰る！」	PRINTFORMDW 「已经不想继续了、回家啦！」
PRINTFORMDW 「二人で帰ればいいだろ！」	PRINTFORMDW 「两个人回去不就行了吗！」
PRINTFORMW 「……また、何か仕込まれたのね」	PRINTFORMW 「……又有什么、进来了」
PRINTFORMW 「なんか、嫌な感じがするわ……」	PRINTFORMW 「总觉得有点不对劲……」
PRINTFORMW 「んっ……ほんと面倒ね……！」	PRINTFORMW 「啊……真是麻烦啊……！」
PRINTFORMW 「や、やめなさい、やめ……！」	PRINTFORMW 「住、住手啊、不要……！」
PRINTFORMW 「も～、ちょこまか逃げないで！」	PRINTFORMW 「啊～、别跑这么快啊！」
PRINTFORMW 「避けさせてなんて、あげないから♪」	PRINTFORMW 「不会让你逃走哦♪」
PRINTFORMW 「これで終わってくれるといいな」	PRINTFORMW 「要是能就此结束就好了」
PRINTFORMW 「軽く振るくらいならできるよ」	PRINTFORMW 「轻轻打一下还是能做到的」
PRINTFORMW 「こ……こんなの、もぉ……」	PRINTFORMW 「这……这样的、已经……」
PRINTFORMW 「うあっ……なに、これ……」	PRINTFORMW 「呜啊……什么、这个……」
PRINTFORMW 「そういう攻撃なら慣れてるわ」	PRINTFORMW 「这种攻击我已经习惯了」
PRINTFORMW 「この、はり付くなっ……！」	PRINTFORMW 「可恶、不要贴上来……！」
PRINTFORMW 「どうして、こんな事に……」	PRINTFORMW 「为什么会发生这种事……」
PRINTFORMW 「何やってんのよ馬鹿……！」	PRINTFORMW 「在干什么啊，笨蛋……！」
PRINTFORMW 「大事に使うわ……一生……」	PRINTFORMW 「我会一生好好使用的……」
PRINTFORMW 「意外と便利なのね、眼鏡って」	PRINTFORMW 「眼镜真是意外的方便啊」
PRINTFORMW 「布団に畳が恋しいわ……」	PRINTFORMW 「我想念被褥和榻榻米了……」
PRINTFORMW 「ケチってる場合じゃないようね」	PRINTFORMW 「现在不是吝啬的时候」
PRINTFORMW 「もう容赦しないわよ……！」	PRINTFORMW 「我不会再原谅你了……！」
PRINTFORMDW 「……わかったよ、ったく」	PRINTFORMDW 「……我知道了、真是的」
PRINTFORML 「ふーん、無事だったみたいね」	PRINTFORML 「呼——、好像是没事呢」
PRINTFORM 　たたかうの、わすれちゃうよぉ……	PRINTFORM 　要忘记、怎么战斗了……
PRINTFORMW 「づっ……頭が、いたぃ……！」	PRINTFORMW 「呃……头、好疼……！」
PRINTFORMW 「あれ？　調子、よくなってる。	PRINTFORMW 「啊咧？　感觉、变好了。
PRINTFORMW 「休む準備、さっさとしましょ」	PRINTFORMW 「赶紧做好休息的装备吧」
PRINTFORMW 「……自分でなんとかしなさいよ」	PRINTFORMW 「……你自己想办法吧」
PRINTFORMW 「……こいつ、違う！？」	PRINTFORMW 「……这家伙、有点不对劲！？」
PRINTFORMW ――八雲紫とは違う神隠し。	PRINTFORMW ――不同于八紫云的突然失踪。
PRINTFORM 「ちゃんと弾幕で勝負しなさいって、	PRINTFORM 「好好用弹幕一决胜负吧、
PRINTFORMW 「そこの子、動かないでね？」	PRINTFORMW 「那边的孩子、不要动哦？」
PRINTFORMW 「これくらいならできるかな……」	PRINTFORMW 「这样的话能行吗……」
PRINTFORMW 「もうっ、これで倒れてぇ……！」	PRINTFORMW 「就这样倒下吧……！」
PRINTFORMW 「痛くしないとわからないかな？」	PRINTFORMW 「非要弄疼你才行吗？」
PRINTFORMW 「や……もう、やめ……！」	PRINTFORMW 「不……已经、不要……！」
PRINTFORMW 「い、今だけは絶対だめ！」	PRINTFORMW 「只、只有现在绝对不行！」
PRINTFORMW 「なら、魔理沙の仇を討つ！」	PRINTFORMW 「那我就替魔理沙报仇！」
PRINTFORMW 「まぁ、ないよりはマシかな？」	PRINTFORMW 「嘛，总比没有强吧？」
PRINTFORMW 「はぁっ、はぁ、次……！」	PRINTFORMW 「哈啊、哈、下一个……！」
PRINTFORMW 「さっさと潰れなさい、化物！」	PRINTFORMW 「赶快去死吧、怪物！」
PRINTFORMW 「傷めつけないとわからない？」	PRINTFORMW 「不见棺材不落泪吗？」
PRINTFORMW 「うっ……だめ、力が……」	PRINTFORMW 「嗯……不行、力量被……」
PRINTFORMW 「ったく、じれったいわねぇ！」	PRINTFORMW 「啊、真让人着急啊！」
PRINTFORMW 「お願い……吸わないで……」	PRINTFORMW 「拜托了……不要吸……」
PRINTFORMW 「霊夢、準備はできたかしら？」	PRINTFORMW 「灵梦，准备好了吗？」
PRINTFORMW 「いっくよー、おねーちゃん！」	PRINTFORMW 「开始了哦、大姐姐！」
PRINTFORMDW 「ああ、そうだな。で？」	PRINTFORMDW 「啊啊、是啊。然后呢？」
PRINTFORMW 「……うぅん、なにか変だわ」	PRINTFORMW 「……嗯，感觉有点奇怪」
PRINTFORMW 「お、おなか、いたい……！」	PRINTFORMW 「肚、肚子、好疼……！」
PRINTFORMW 「いいわ。さっさと片付ける！」	PRINTFORMW 「好啊。迅速解决吧！」
PRINTFORMW 「あはっ、ママ、かわいい♪」	PRINTFORMW 「啊哈、妈妈、好可爱♪」
PRINTFORMW 「すぐ退治しないといけないのかな」	PRINTFORMW 「必须马上消灭吗」
PRINTFORMW 「当てるくらいならできるよ！」	PRINTFORMW 「至少还是能打中的！」
PRINTFORMW 「うぅ、早く出たいよぉ……」	PRINTFORMW 「唔、想赶快攻击啊……」
PRINTFORMW 「あーあ、脱げちゃったぁ……」	PRINTFORMW 「啊ー啊、脱掉了……」
PRINTFORM 　もっと、ほしくなっちゃうよぉ……	PRINTFORM 　更多、变得想要了……
PRINTFORMW 「このっ、これくらいで……」	PRINTFORMW 「可恶、这种程度……」
PRINTFORMW 「い、いや、子供が……！」	PRINTFORMW 「不、不行、孩子……！」
PRINTFORMW 「ぐ……冗談じゃないわよ！」	PRINTFORMW 「咕……别开玩笑了！」
PRINTFORMW 「コンティニューはもう不要よ」	PRINTFORMW 「不要再继续了……」
PRINTFORMW （……何か企んでるのかしら）	PRINTFORMW （……是有什么阴谋吗）
PRINTFORMW 「今のうちに……準備を！」	PRINTFORMW 「趁现在……做好准备！」
PRINTFORMW 「まとめて退治してあげるわ」	PRINTFORMW 「我会把你们消灭干净」
PRINTFORMW 「近づきたくないけど……」	PRINTFORMW 「虽然不想离得太近……」
PRINTFORMW 「痛くしないとわからない？」	PRINTFORMW 「不撞南墙不回头吗？」
PRINTFORMW 「……これで、終わりよね」	PRINTFORMW 「……这样就、结束了吧」
PRINTFORMW 「だぜー、遊ぼうよー！」	PRINTFORMW 「da☆ze、一起玩吧！」
PRINTFORMDW 幻想郷はすべてを受け入れる。	PRINTFORMDW 幻想乡能接受一切。
PRINTFORMW 「あ、魔理沙、それ……」	PRINTFORMW 「啊、魔理沙、那个是……」
PRINTFORMW 「よし。借りはすぐ返すから」	PRINTFORMW 「好吧。人情马上就还」
PRINTFORMW 「ふぇ……？　んひぃっ！？」	PRINTFORMW 「诶……？　布要！？」
PRINTFORMW 「！？　な、何をしたぁ！」	PRINTFORMW 「！？　什、什么东西！」
PRINTFORMW 「誰があんたなんかと……！」	PRINTFORMW 「谁会和你一起……！」
PRINTFORMW 「まとめて退治してあげるね」	PRINTFORMW 「我会一块收拾你们的」
PRINTFORMW 「うぅっ、体が重いよぉ……」	PRINTFORMW 「唔、身体好重啊……」
PRINTFORMW 「安心して、私は強いよ！」	PRINTFORMW 「放心吧、我很强的哦！」
PRINTFORMW 「お、おなかはだめぇっ……」	PRINTFORMW 「里、里面不行……」
PRINTFORMW 「……さっさと倒さないと」	PRINTFORMW 「……不赶快把它打倒」
PRINTFORMW （……そう。そういうこと）	PRINTFORMW （……没错。就是那样）
PRINTFORMW 「無茶はしないこと。いい？」	PRINTFORMW 「不要乱来。好吗？」
PRINTFORMW 「この機械は、確か……」	PRINTFORMW 「这台机器、好像是……」
PRINTFORMW 「も、もう、限界……」	PRINTFORMW 「已、已经、到极限了……」
PRINTFORMW 「わざわざ避けさせてなんてあげない」	PRINTFORMW 「别想躲开」
PRINTFORMDW 「おじ……さん……！？」	PRINTFORMDW 「叔……叔……！？」
PRINTFORMDW 「……私は、人じゃないし」	PRINTFORMDW 「……我又不是人」
PRINTFORMDW あれから、半年が経った。	PRINTFORMDW 从那以后，过了半年。
PRINTFORMW 色々見つかったでしょ」	PRINTFORMW 之类的，找到了很多东西哦」
PRINTFORM 　きもちいいの、いっぱい……	PRINTFORM 　好舒服啊、太舒服了……
PRINTFORMW 「また、体の中に……！」	PRINTFORMW 「又在、我的体内……！」
PRINTFORMW 「く、くるしぃ、よぉ……」	PRINTFORMW 「好、好难受、啊……」
PRINTFORMW 「うぁ……は、あひっ……」	PRINTFORMW 「呜……哈、啊哈……」
PRINTFORMW ちっちゃい子のせーえきくるっ！	PRINTFORMW 小孩子的精液来了！
PRINTFORMW 「もうっ、はやく離してぇ！」	PRINTFORMW 「够了、快放开我！」
PRINTFORMW 「お、おなかはやだぁっ……」	PRINTFORMW 「肚、肚子不要……」
PRINTFORMW 「避けないと駄目かも……」	PRINTFORMW 「也许应该避一避……」
PRINTFORMW 「私は博麗の娘だもん！」	PRINTFORMW 「我可是博丽的女儿啊！」
PRINTFORMW 「私のこと……嫌い……？」	PRINTFORMW 「讨厌……我吗……？」
PRINTFORMW 「避けられたみたいね……」	PRINTFORMW 「不得不撤退了……」
PRINTFORMW 「いい気分じゃないわね……」	PRINTFORMW 「感觉不太好……」
PRINTFORML 「じゃあ、そっちは任せるわ。	PRINTFORML 「那边就交给你了。
PRINTFORMW 「まずは当てなきゃ……！」	PRINTFORMW 「先打中才行……！」
PRINTFORMW 「そ。左に動くみたいね」	PRINTFORMW 「嗯。向左移动的样子」
PRINTFORMW 「いちか、ばちかっ……！」	PRINTFORMW 「中还是不中……！」
PRINTFORMW 「くっ、ちょこまか逃げるな！」	PRINTFORMW 「喂，别跑啊！」
PRINTFORMW 「見張り、よろしく頼むわね」	PRINTFORMW 「看守就拜托你了」
PRINTFORM 　これぇ、すごすぎるよぉ……	PRINTFORM 　这个，舒服过头了……
PRINTFORMW 「今の私じゃ……ごめん」	PRINTFORMW 「以现在的我……抱歉」
PRINTFORMW 「ここが、そうみたいね」	PRINTFORMW 「看起来就是这个地方」
PRINTFORMW 「ほら、早く出しなさいよ」	PRINTFORMW 「来、快点射出来吧」
PRINTFORMW 「少しもったいないかなぁ」	PRINTFORMW 「是不是有点浪费啊」
PRINTFORMW 「吹き飛ばしてあげるから！」	PRINTFORMW 「看我把你打飞！」
PRINTFORMW 「あうぅっ……離してぇ！」	PRINTFORMW 「啊呜……放开我！」
PRINTFORMW 「避けないと駄目ね……」	PRINTFORMW 「不得不撤退了……」
PRINTFORMW 「づっ……まずい、かな」	PRINTFORMW 「啧……不妙了、吗」
PRINTFORMW 「……何見せてるのよ」	PRINTFORMW 「……什么都看不到了」
PRINTFORMW 「気色悪いのよ……！」	PRINTFORMW 「感觉好恶心啊……！」
PRINTFORMW 「早く突破しないと……」	PRINTFORMW 「必须尽快突破……」
PRINTFORMW 「足を引っ張らないでね」	PRINTFORMW 「不要拖我的后腿哦」
PRINTFORMW 「いらないかな。私には」	PRINTFORMW 「对我来说不需要吧」
PRINTFORMW 「これくらいならまだ……」	PRINTFORMW 「这样还不够……」
PRINTFORMW 「少しもったいないかしら」	PRINTFORMW 「稍微有点浪费吧」
PRINTFORMDW ――自分と、同じように。	PRINTFORMDW ――和自己一样。
PRINTFORMW 「それじゃ、着替えましょう」	PRINTFORMW 「那就换衣服吧」
PRINTFORMW 　それじゃ、おやすみ……」	PRINTFORMW 　那么，晚安……」
PRINTFORMW 「おなかが、何か……」	PRINTFORMW 「肚子里、有什么……」
PRINTFORMW 「え？　妊、娠……？」	PRINTFORMW 「诶？　妊、娠……？」
PRINTFORMW 「ごめん……助かったわ」	PRINTFORMW 「抱歉……麻烦你了」
PRINTFORMW 「もうっ、はやく倒れて！」	PRINTFORMW 「快给我倒下吧！」
PRINTFORMW 「いや、はなれてぇっ！」	PRINTFORMW 「不要、离我远点！」
PRINTFORMW 「ママは私が守るよっ！」	PRINTFORMW 「妈妈由我来守护！」
PRINTFORMW 「ぶっ飛ばされたいようね」	PRINTFORMW 「想被踢飞是吧」
PRINTFORMW 「………………嘘」	PRINTFORMW 「………………骗人的吧」
PRINTFORMW 「私が守らなきゃ……」	PRINTFORMW 「我必须保护它……」
PRINTFORMW 「持ってて損はないかな」	PRINTFORMW 「拿着总不会吃亏」
PRINTFORMW 「お願い、当たって！」	PRINTFORMW 「拜托了、击中吧！」
PRINTFORMW 「これなら届くはず」	PRINTFORMW 「这样的话应该足够了」
PRINTFORMW 「ぐっ、体が重い……」	PRINTFORMW 「唔、身体好重……」
PRINTFORMW 「足を止めさせてもらうわ」	PRINTFORMW 「给我停下脚步」
PRINTFORMDW 出産を行う時だった。	PRINTFORMDW 这是在出产的时候。
PRINTFORMW 「逃がさないよ？」	PRINTFORMW 「我不会让你逃走的哦？」
PRINTFORMW 「えーい、当たってぇ！」	PRINTFORMW 「嘿、吃我这招！」
PRINTFORMW 「床のタイルになっちゃえ！」	PRINTFORMW 「给我躺下！」
PRINTFORMW 「これなら届くね！」	PRINTFORMW 「这个的话能打中吧！」
PRINTFORMW 「少しは効くのかな？」	PRINTFORMW 「会有一点效果吗？」
PRINTFORMW 「いい加減、負けてよ」	PRINTFORMW 「快点给我、认输吧」
PRINTFORMW 「あ、危なかったぁ……」	PRINTFORMW 「啊、好险啊……」
PRINTFORM 　きもちいいの、すてき……	PRINTFORM 　好舒服啊、好棒……
PRINTFORMW 「…………あ、やば」	PRINTFORMW 「…………啊、糟了」
PRINTFORMW 「……最悪の気分だわ」	PRINTFORMW 「……真是糟透了」
PRINTFORMW 「……空飛ぶ靴、ねぇ。	PRINTFORMW 「……飞天鞋、嗯。
PRINTFORMW 「お茶のほうがいいわ」	PRINTFORMW 「还是喝茶比较好」
PRINTFORMW 「ふぅ……つっかれたぁ」	PRINTFORMW 「呼……好累啊」
PRINTFORMW 「おやすみー、ぐー……」	PRINTFORMW 「晚安、唔……」
PRINTFORMW 「捉えた……真正面」	PRINTFORMW 「得手了……正前方」
PRINTFORMW 「ママ、どうしたの？」	PRINTFORMW 「妈妈，怎么啦？」
PRINTFORMW 色々見つかったのよね」	PRINTFORMW 找到了很多东西呢」
PRINTFORMDW 「ふーん……で？」	PRINTFORMDW 「哼……然后呢？」
PRINTFORM 　きもちいぃ、きもちいいっ	PRINTFORM 　好舒服、好舒服啊
PRINTFORMW 「……ああ、やっぱり」	PRINTFORMW 「……啊啊、果然」
PRINTFORMW 「た、助かったぁ……」	PRINTFORMW 「得、得救了……」
PRINTFORMW 「私に触れちゃだめっ！」	PRINTFORMW 「不要碰我啊！」
PRINTFORMW 「ん、左に動くの？」	PRINTFORMW 「嗯、向左移动吗？」
PRINTFORMW 「そこだぁ、真正面！」	PRINTFORMW 「在那里、冲啊！」
PRINTFORMW 「し、しつこいよっ！」	PRINTFORMW 「真、真难缠啊！」
PRINTFORMW 「これくらいで十分だよ」	PRINTFORMW 「这样就足够了」
PRINTFORMW 「う、うぅんっ……！」	PRINTFORMW 「呜、唔嗯……！」
PRINTFORMW 「ん……あむっ……」	PRINTFORMW 「呃……嗯姆……」
PRINTFORMW 「うっ、服が……！」	PRINTFORMW 「唔、衣服……！」
PRINTFORMW 「こいつ……！？」	PRINTFORMW 「这个家伙……！？」
PRINTFORMW 「さっさと片づけるわ」	PRINTFORMW 「迅速解决掉吧」
PRINTFORMW 「た、助かった……」	PRINTFORMW 「啊，得救了……」
PRINTFORMW 「あ、何か見つけた」	PRINTFORMW 「啊，发现什么了」
PRINTFORMW 「これで終わりよ！」	PRINTFORMW 「这样就结束了！」
PRINTFORMW 「これくらいで十分よ」	PRINTFORMW 「这样就足够了」
PRINTFORMW 「早く潰れてっ！」	PRINTFORMW 「赶紧给我倒下吧！」
PRINTFORMW 「吹き飛ばしてあげる」	PRINTFORMW 「看我把你打飞」
PRINTFORMW 「け、牽制を……」	PRINTFORMW 「呃、牵制一下……」
PRINTFORMW 「ええ、それじゃ！」	PRINTFORMW 「嗯、那么再见！」
PRINTFORMW 「……大丈夫かしら」	PRINTFORMW 「……应该没事吧」
PRINTFORMW 「……紫がいれば」	PRINTFORMW 「……要是紫在的话」
PRINTFORMDL 思わず、呟く。	PRINTFORMDL 不由自主地小声说着。
PRINTFORMW 「はやく潰れてっ！」	PRINTFORMW 「赶紧给我倒下！」
PRINTFORMW 「足を止めちゃうよ！」	PRINTFORMW 「给我停下来！」
PRINTFORMW 「…………あは♪」	PRINTFORMW 「…………啊哈♪」
PRINTFORM 「はぁあっ、きてるぅ……	PRINTFORM 「哈啊、来了……
PRINTFORMW 「…………ん……」	PRINTFORMW 「…………嗯……」
PRINTFORMW 「こんな時に！」	PRINTFORMW 「居然在这种时候！」
PRINTFORMW 「に、逃げ切れた……	PRINTFORMW 「逃、逃掉了……
PRINTFORMW 「…………じゃあね」	PRINTFORMW 「…………再见」
PRINTFORMW 「私に触れないでぇっ！」	PRINTFORMW 「别碰我！」
PRINTFORMW 「そこ、動くな！」	PRINTFORMW 「那边、别乱动！」
PRINTFORMW 「逃がさないわ」	PRINTFORMW 「我不会让你逃走的」
PRINTFORMW 「し、しつこいっ！」	PRINTFORMW 「呃、真难缠！」
PRINTFORMW 「ああ、もうっ！」	PRINTFORMW 「啊啊、真是的！」
PRINTFORMW 「少しは効くはず」	PRINTFORMW 「应该有一点效果」
PRINTFORMW 「負けない。絶対に」	PRINTFORMW 「不会输。绝对」
PRINTFORMDW 「いや、私は……」	PRINTFORMDW 「不、我……」
PRINTFORMDW 「……本当か？」	PRINTFORMDW 「……真的吗？」
PRINTFORMW 「ひあぁんっ！？」	PRINTFORMW 「ひあぁんっ！？」
PRINTFORMW 「う……あ……？」	PRINTFORMW 「呜……啊……？」
PRINTFORMW 娘のせーえきくるっ！	PRINTFORMW 女儿的精液来了！
PRINTFORMW 「もう潰れちゃえ！」	PRINTFORMW 「给我倒下吧！」
PRINTFORMW 「来ない……でっ！」	PRINTFORMW 「别过……来！」
PRINTFORMW 「…………えへ♪」	PRINTFORMW 「…………诶嘿♪」
PRINTFORMW 「やんっ、服が……」	PRINTFORMW 「呀、衣服……」
PRINTFORMW 「あ……うぅ……」	PRINTFORMW 「啊……嗯……」
PRINTFORMW 「や、やばっ……」	PRINTFORMW 「糟、糟了……」
PRINTFORMW 「……あんた誰？」	PRINTFORMW 「……你是谁？」
PRINTFORMW 「来る……なっ！」	PRINTFORMW 「别过……来！」
PRINTFORMDW 足を踏み出す。	PRINTFORMDW 灵梦踏上了旅程。
PRINTFORMW （私は、もう……）	PRINTFORMW （我、已经……）
PRINTFORMW 「んっ……面倒ね」	PRINTFORMW 「嗯……真麻烦」
PRINTFORMW 「うーん、もうっ！」	PRINTFORMW 「唔，够了！」
PRINTFORMW 「しまっ……！？」	PRINTFORMW 「糟……！？」
PRINTFORMW 「冗談じゃないわ」	PRINTFORMW 「别开玩笑了」
PRINTFORMW 「あ、服が……」	PRINTFORMW 「啊、衣服……」
PRINTFORMDW 舌打ちをした……	PRINTFORMDW 咂了咂嘴……
PRINTFORMDW 睨み返した……	PRINTFORMDW 回瞪了一眼……
PRINTFORMW 「当てるくらいなら！」	PRINTFORMW 「接招！」
PRINTFORMW 「これはどう？」	PRINTFORMW 「这个怎么样？」
PRINTFORMDW 「……そうだな」	PRINTFORMDW 「……是啊」
PRINTFORMW 「……参ったわね」	PRINTFORMW 「……我败了」
PRINTFORMW 「……消えて！」	PRINTFORMW 「……消失吧！」
PRINTFORMDW 戦いは終わった。	PRINTFORMDW 战斗结束了。
PRINTFORMW 「……それでも」	PRINTFORMW 「……尽管如此」
PRINTFORMW 「いっくわよー！」	PRINTFORMW 「开始了哦！」
PRINTFORMDW 商談成立である。	PRINTFORMDW 商谈成立了。
PRINTFORM 「あぁ、おっきい……	PRINTFORM 「啊啊、好大……
PRINTFORMW 「逃がさないよーだ」	PRINTFORMW 「别想跑哦」
PRINTFORMW 「……許して」	PRINTFORMW 「……放过我吧」
PRINTFORMDW 「……よっ！」	PRINTFORMDW 「……哟！」
PRINTFORMW の味方だから！」	PRINTFORMW 是的伙伴啊！」
PRINTFORMW 「消えちゃえっ！」	PRINTFORMW 「消失吧！」
PRINTFORMW 「やっ……！？」	PRINTFORMW 「呀……！？」
PRINTFORM 「はぁ、はぁっ……	PRINTFORM 「哈、哈啊……
PRINTFORMW 「……ったく」	PRINTFORMW 「……真是的」
PRINTFORMW 「け、結界！」	PRINTFORMW 「结、結界！」
PRINTFORMW 「消えてぇっ！」	PRINTFORMW 「消失吧！」
PRINTFORMDW 「……は？」	PRINTFORMDW 「……哈？」
PRINTFORMDL 光る掌。	PRINTFORMDL 手掌发出了光芒。
PRINTFORMW 「邪魔だよ？」	PRINTFORMW 「很碍事哦？」
PRINTFORMW 「いたいよ？」	PRINTFORMW 「很痛的哦？」
PRINTFORMW 「ちっ……！」	PRINTFORMW 「等……！」
PRINTFORMW 「……えっ？」	PRINTFORMW 「……诶？」
PRINTFORMDW 「ぐっ……」	PRINTFORMDW 「咕……」
PRINTFORMW 「……あー！」	PRINTFORMW 「……啊！」
PRINTFORMDW 「帰る」	PRINTFORMDW 「我们回去吧」
PRINTFORMW 「にゅう……」	PRINTFORMW 「喵呜……」
PRINTFORMW が言ってた！」	PRINTFORMW 这么说了！」
PRINTFORMW 「つぎは右」	PRINTFORMW 「这次是右边」
PRINTFORMW 「……ひくっ」	PRINTFORMW 「……咕」
PRINTFORMW 「次は右」	PRINTFORMW 「这次是右边」
PRINTFORMW 「逃がさない」	PRINTFORMW 「别想跑」
PRINTFORM 「吸われてる……	PRINTFORM 「在吸着……
PRINTFORMW 「……あぅっ」	PRINTFORMW 「……啊」
PRINTFORM 魔理沙おねーちゃん	PRINTFORM 魔理沙姐姐
PRINTFORMW 「あぅ……」	PRINTFORMW 「啊……」
PRINTFORMW 「……ふん」	PRINTFORMW 「……嗯」
PRINTFORMW 「このっ！」	PRINTFORMW 「可恶！」
PRINTFORMW 「親馬鹿」	PRINTFORMW 「笨蛋父母」
PRINTFORMW 「……私は」	PRINTFORMW 「……我」
PRINTFORM 紫お……ねぇさん	PRINTFORM 紫……姐姐
PRINTFORMW 「えいっ！」	PRINTFORMW 「接招！」
PRINTFORM 「はぁっ……♪	PRINTFORM 「哈啊……♪
PRINTFORMW 「痛っ！」	PRINTFORMW 「好疼！」
PRINTFORMW 「あ……」	PRINTFORMW 「啊……」
PRINTFORMW 「邪魔よ」	PRINTFORMW 「碍事啦」
PRINTFORMW 「ママ？」	PRINTFORMW 「妈妈？」
PRINTFORMW 「うんー！」	PRINTFORMW 「嗯！」
PRINTFORMW 「オッケー」	PRINTFORMW 「OK」
PRINTFORM 「ま……たぁっ	PRINTFORM 「又……要
PRINTFORM 「今の私は、	PRINTFORM 「现在的我、
PRINTFORMW 「うん！」	PRINTFORMW 「嗯！」
PRINTFORM 「ぷはっ……	PRINTFORM 「噗哈……
PRINTFORM 外の機械とか	PRINTFORM 外面的机器
PRINTFORM 凄い剣とか	PRINTFORM 很厉害的剑
PRINTFORMW 「ん～」	PRINTFORMW 「嗯～」
PRINTFORM 「ほしぃ	PRINTFORM 「想要……
PRINTFORM 空飛ぶ靴とか	PRINTFORM 飞天鞋
PRINTFORM 「はっ……	PRINTFORM 「哈……
PRINTFORM 紫おねぇさん	PRINTFORM 紫姐姐
PRINTFORM 「あはぁっ	PRINTFORM 「啊哈
PRINTFORM ママ	PRINTFORM 妈妈
