角色名字:
スターサファイア	斯塔薩菲雅
クラウンピース	克労恩皮絲
ルナチャイルド	露娜切露德
サニーミルク	桑尼米爾克
ひまわり妖精	向日葵妖精
フランドール	芙蘭朶露
ヘカーティア	赫喀提亜
リリーホワイト	莉莉白
リリーブラック	莉莉黑
ミスティア	米斯蒂亜
ちびアリス	小愛麗絲
レミリア	蕾米莉亜
わかさぎ姫	若鷺姫
メディスン	梅蒂欣
レイセン	鈴仙二号
パチュリー	琶秋莉
上海人形	上海人形
蓬莱人形	蓬莱人形
ナズーリン	納茲琳
ドレミー	多来米
リリーＷ	莉莉Ｗ
メルラン	梅露蘭
ルーミア	露米亜
リリーＢ	莉莉Ｂ
オレンジ	奧蓮姫
パルスィ	琶露西
ありす	愛麗絲酱
ひまわり	向日葵
屠自古	屠自古
マミゾウ	猯藏
赤蛮奇	赤蛮奇
針妙丸	針妙丸
ラルバ	拉瓦爾
ネムノ	合歡乃
隠岐奈	隠岐奈
アリス	愛麗絲
リリカ	莉莉喀
ルナサ	露娜薩
魔理沙	魔理沙
幽々子	幽幽子
八雲藍	八雲藍
八雲紫	八雲紫
リグル	莉格露
大妖精	大妖精
神奈子	神奈子
諏訪子	諏訪子
チルノ	琪露諾
ルイズ	露易茲
紅美鈴	紅美鈴
小兎姫	小兎姫
理香子	理香子
小悪魔	小悪魔
ちゆり	千百合
キスメ	琪斯美
朱鷺子	朱鷺子
フラン	芙蘭
レティ	蕾蒂
サグメ	探女
あうん	阿吽
にとり	荷取
サニー	桑尼
スター	斯塔
メリー	梅莉
エレン	艾倫
くるみ	胡桃
エリー	艾麗
ヤマメ	山女
おくう	阿空
ムラサ	水蜜
霊夢	霊夢
響子	響子
芳香	芳香
青娥	青娥
布都	布都
神子	神子
小鈴	小鈴
こころ	心
影狼	影狼
弁々	弁弁
八橋	八橋
正邪	正邪
雷鼓	雷鼓
菫子	菫子
清蘭	清蘭
鈴瑚	鈴瑚
純狐	純狐
成美	成美
里乃	里乃
妖夢	妖夢
萃香	萃香
慧音	慧音
鈴仙	鈴仙
永琳	永琳
輝夜	輝夜
妹紅	妹紅
幽香	幽香
小町	小町
映姫	映姫
静葉	静葉
穣子	穣子
早苗	早苗
ルナ	露娜
阿求	阿求
蓮子	蓮子
魅魔	魅魔
神綺	神綺
豊姫	豊姫
依姫	依姫
サラ	薩拉
美鈴	美鈴
夢子	夢子
衣玖	衣玖
天子	天子
里香	里香
明羅	明羅
カナ	喀娜
夢美	夢美
夢月	夢月
幻月	幻月
勇儀	勇儀
さとり	覚
お燐	阿燐
こいし	恋
華扇	華扇
半霊	半霊
上海	上海
蓬莱	蓬莱
咲夜	咲夜
小傘	小傘
一輪	一輪
白蓮	白蓮
はたて	極
てゐ	帝
ユキ	雪
マイ	舞
ぬえ	鵺
舞	舞
橙	橙
藍	藍
紫	紫
文	文
雛	雛
椛	椛
燐	燐
空	空
星	星
