//口上:

PRINTFORMDW 迷宮が崩壊しているのかと焦る%ARGS:0%だったが、耳を澄ませるとそこら中から少女達の雄叫びと魔物の悲鳴が聞こえてくる。	PRINTFORMDW 迷宮が崩壊しているのかと焦る%ARGS:0%だったが、耳を澄ませるとそこら中から少女達の雄叫びと魔物の悲鳴が聞こえてくる。
PRINTFORMDW どうやらクイーンの死によって封印されていた能力が使えるようになったのか、他の少女達が大暴れしているだけのようだ。	PRINTFORMDW どうやらクイーンの死によって封印されていた能力が使えるようになったのか、他の少女達が大暴れしているだけのようだ。
PRINTFORMDW そう疑問に思いつつも、ここまで来たのだからと意を決して%ARGS:0%%TACHI()%は光の渦に飛び込んだ。	PRINTFORMDW そう疑問に思いつつも、ここまで来たのだからと意を決して%ARGS:0%%TACHI()%は光の渦に飛び込んだ。
PRINTFORMDW %ARGS:0%%TACHI()%の前に立ち塞がるガーディアンが崩れ落ち、ついに出口への障害は消えた。	PRINTFORMDW %ARGS:0%%TACHI()%の前に立ち塞がるガーディアンが崩れ落ち、ついに出口への障害は消えた。
PRINTFORMW 「誰のものか（ﾁﾗｯ）知らないけど（ﾁﾗｯ）、せっかくだし（ﾁﾗｯ）借りておくぜ（ﾁﾗｯ）、死ぬまで」	PRINTFORMW 「誰のものか（ﾁﾗｯ）知らないけど（ﾁﾗｯ）、せっかくだし（ﾁﾗｯ）借りておくぜ（ﾁﾗｯ）、死ぬまで」
PRINTFORMDW なにぜ外へ出た途端に出入り口どころか迷宮の痕跡すら跡形もなく消え、再突入できなくなってしまったのだ。	PRINTFORMDW なにぜ外へ出た途端に出入り口どころか迷宮の痕跡すら跡形もなく消え、再突入できなくなってしまったのだ。
PRINTFORMDW もっとも魔理沙のほうも反論してこない霊夢にバツが悪くなったらしく、微妙な表情を浮かべて話題を変えた。	PRINTFORMDW もっとも魔理沙のほうも反論してこない霊夢にバツが悪くなったらしく、微妙な表情を浮かべて話題を変えた。
PRINTFORMDW そう決心した魔理沙だったが、ふとガーディアンの遺体が縮んでいく様子に気付き……少しだけ寄り道をした。	PRINTFORMDW そう決心した魔理沙だったが、ふとガーディアンの遺体が縮んでいく様子に気付き……少しだけ寄り道をした。
PRINTFORMDW このままでは自分達も脱出ができなくなってしまう。　まずは先に脱出して、後から応援を呼んで来よう──	PRINTFORMDW このままでは自分達も脱出ができなくなってしまう。　まずは先に脱出して、後から応援を呼んで来よう──
PRINTFORMDW そう決心した魔理沙だったが、ふとガーディアンの遺体が縮んでいく様子に気付き、ついでに拾おうとして、	PRINTFORMDW そう決心した魔理沙だったが、ふとガーディアンの遺体が縮んでいく様子に気付き、ついでに拾おうとして、
PRINTFORMDW 何度も何度も、目に付くものに魔砲を撃って、何もなくなったら違う場所で同じ事を始める。その繰り返し。	PRINTFORMDW 何度も何度も、目に付くものに魔砲を撃って、何もなくなったら違う場所で同じ事を始める。その繰り返し。
PRINTFORMDW 神隠しに遭っていた者達が徐々に帰ってくるようになり、時期を同じくして神隠しもパタリと止んだからだ。	PRINTFORMDW 神隠しに遭っていた者達が徐々に帰ってくるようになり、時期を同じくして神隠しもパタリと止んだからだ。
PRINTFORMW 　あんな目に遭って、あんな事されてっ、逃げ切れたからいいだなんて終わりで納得できるわけ、ないだろ！」	PRINTFORMW 　あんな目に遭って、あんな事されてっ、逃げ切れたからいいだなんて終わりで納得できるわけ、ないだろ！」
PRINTFORMDW ふと、魔理沙の耳に誰かが迷宮内の自分の活躍を大声で語っている様子が響いてきた。それが好評なことも。	PRINTFORMDW ふと、魔理沙の耳に誰かが迷宮内の自分の活躍を大声で語っている様子が響いてきた。それが好評なことも。
PRINTFORMDW 霊夢は死体を拾い直すと、それを突きつけながら問いかける。魔理沙は、魚のように口を開閉させるだけだ。	PRINTFORMDW 霊夢は死体を拾い直すと、それを突きつけながら問いかける。魔理沙は、魚のように口を開閉させるだけだ。
PRINTFORMDW とはいえ、それで終わりというわけにもいかない。魔理沙と霊夢は、事態を究明するべく探索を続けていた。	PRINTFORMDW とはいえ、それで終わりというわけにもいかない。魔理沙と霊夢は、事態を究明するべく探索を続けていた。
PRINTFORMDW あれから数週間、魔理沙の調査は成果が上がっていない。霊夢は僅かとはいえ発見しているのにも関わらず。	PRINTFORMDW あれから数週間、魔理沙の調査は成果が上がっていない。霊夢は僅かとはいえ発見しているのにも関わらず。
PRINTFORMW 「バカにしたりしないから。魔理沙が戦わなくても私は気にしないから……そんな顔で、頑張ろうとしないで」	PRINTFORMW 「バカにしたりしないから。魔理沙が戦わなくても私は気にしないから……そんな顔で、頑張ろうとしないで」
PRINTFORMW 「はぁ？　私の方がいっぱい倒したけどな。そもそも私が先頭に立ってたんだから、今回は私が主役だぜ？」	PRINTFORMW 「はぁ？　私の方がいっぱい倒したけどな。そもそも私が先頭に立ってたんだから、今回は私が主役だぜ？」
PRINTFORMDW 無事に脱出した魔理沙は、博麗神社の縁側でむくれていた。理由は簡単、彼女はやる気を持て余している。	PRINTFORMDW 無事に脱出した魔理沙は、博麗神社の縁側でむくれていた。理由は簡単、彼女はやる気を持て余している。
PRINTFORMDW この状況でもいつもの調子でつるむ魔理沙は……そんな自分に霊夢が不安を覚えていることに気付かない。	PRINTFORMDW この状況でもいつもの調子でつるむ魔理沙は……そんな自分に霊夢が不安を覚えていることに気付かない。
PRINTFORMDW はぁ、と湿った吐息を漏らす魔理沙。始めは単なる興味からだったが、今やこの行為は日課となっていた。	PRINTFORMDW はぁ、と湿った吐息を漏らす魔理沙。始めは単なる興味からだったが、今やこの行為は日課となっていた。
PRINTFORMDW 自慰にも似た、甘美な秘め事。体が疼くのか、魔理沙は下着だけつけた体をむず痒そうにくねらせている。	PRINTFORMDW 自慰にも似た、甘美な秘め事。体が疼くのか、魔理沙は下着だけつけた体をむず痒そうにくねらせている。
PRINTFORMDW クイーンを殺しただけでは気が済まない。焼き尽くさねば収まらない。全て消し去らないと安心できない。	PRINTFORMDW クイーンを殺しただけでは気が済まない。焼き尽くさねば収まらない。全て消し去らないと安心できない。
PRINTFORMDW 光の奔流に翻弄されてから数秒後、うっすらと目を開けると、見知った魔法の森の風景が広がっていた……	PRINTFORMDW 光の奔流に翻弄されてから数秒後、うっすらと目を開けると、見知った魔法の森の風景が広がっていた……
PRINTFORMW 「はっきり言うわ。意地を張るのは、もうやめなさい。私の真似はしなくていい。もう……戦わなくていい。	PRINTFORMW 「はっきり言うわ。意地を張るのは、もうやめなさい。私の真似はしなくていい。もう……戦わなくていい。
PRINTFORMDW 真っ向から突きつけられた言葉に、魔理沙は何も言い返せなかった。いつものような強がりすら言えない。	PRINTFORMDW 真っ向から突きつけられた言葉に、魔理沙は何も言い返せなかった。いつものような強がりすら言えない。
PRINTFORMW 「異変は解決しているのに変に長引かせるなんて、面倒でしょ。だから戦わなくても、文句は言われないわ。	PRINTFORMW 「異変は解決しているのに変に長引かせるなんて、面倒でしょ。だから戦わなくても、文句は言われないわ。
PRINTFORMDW 邪魔者扱いされるならいい、無視して戦うだけだから。けれど、今の霊夢は本当に自分を心配していて……	PRINTFORMDW 邪魔者扱いされるならいい、無視して戦うだけだから。けれど、今の霊夢は本当に自分を心配していて……
PRINTFORMDW 情けなさか、辛いからか、安心したのか、嬉しかったのか、自身にも分からない。ただ泣くしかできない。	PRINTFORMDW 情けなさか、辛いからか、安心したのか、嬉しかったのか、自身にも分からない。ただ泣くしかできない。
PRINTFORMDW おまけに、彼女が居を構えるのは魔法の森。数々の茸が持つ幻覚作用は、今の彼女にとって最悪の効果だ。	PRINTFORMDW おまけに、彼女が居を構えるのは魔法の森。数々の茸が持つ幻覚作用は、今の彼女にとって最悪の効果だ。
PRINTFORMW 「そもそも分かってないみたいだけど、今回のはいつものと違うのよ。だから仮に活躍しててもノーカン」	PRINTFORMW 「そもそも分かってないみたいだけど、今回のはいつものと違うのよ。だから仮に活躍しててもノーカン」
PRINTFORMDW ようやく立ち直った魔理沙の反論にも、霊夢は涼しげな表情だ。もっとも、それが気に食わないのだが。	PRINTFORMDW ようやく立ち直った魔理沙の反論にも、霊夢は涼しげな表情だ。もっとも、それが気に食わないのだが。
PRINTFORMDW 完全に死に絶えただの破片になっていたはずのそれは、いつの間にか少しずつ生気を取り戻しつつある。	PRINTFORMDW 完全に死に絶えただの破片になっていたはずのそれは、いつの間にか少しずつ生気を取り戻しつつある。
PRINTFORMDW そう思い浮かべただけで、魔理沙は吐きそうになった。迷宮内で味わった、悪夢のような体験のせいで。	PRINTFORMDW そう思い浮かべただけで、魔理沙は吐きそうになった。迷宮内で味わった、悪夢のような体験のせいで。
PRINTFORMDW 外へ出た途端に出入り口どころか迷宮の痕跡すら跡形もなく消え、再突入できなくなってしまったのだ。	PRINTFORMDW 外へ出た途端に出入り口どころか迷宮の痕跡すら跡形もなく消え、再突入できなくなってしまったのだ。
PRINTFORMW 「なんでって、あいつらの足取りを掴むためのれっきとした証拠よ？　見つけなきゃいけないものでしょ。	PRINTFORMW 「なんでって、あいつらの足取りを掴むためのれっきとした証拠よ？　見つけなきゃいけないものでしょ。
PRINTFORMDW 反論しようとしても、できない。遺体を見るだけで迷宮で味わった悪夢が脳裏に走り、足が震えてくる。	PRINTFORMDW 反論しようとしても、できない。遺体を見るだけで迷宮で味わった悪夢が脳裏に走り、足が震えてくる。
PRINTFORMDW 彼女が異変を解決するのは霊夢に負けたくないからで、張り合いたいからで、肩を並べたいからだった。	PRINTFORMDW 彼女が異変を解決するのは霊夢に負けたくないからで、張り合いたいからで、肩を並べたいからだった。
PRINTFORMDW 邪魔者扱いされるならいい、無視して戦うだけだ。最悪なのは、今の霊夢は泣きそうな顔をしていて……	PRINTFORMDW 邪魔者扱いされるならいい、無視して戦うだけだ。最悪なのは、今の霊夢は泣きそうな顔をしていて……
PRINTFORMDW あの時……外へ出た途端に出入り口どころか迷宮の痕跡すら跡形もなく消え、再突入はできなくなった。	PRINTFORMDW あの時……外へ出た途端に出入り口どころか迷宮の痕跡すら跡形もなく消え、再突入はできなくなった。
PRINTFORMDW 死ぬよりも恐ろしい目に遭うような異変を知った心に、その優しさを振り払って進める余力はなかった。	PRINTFORMDW 死ぬよりも恐ろしい目に遭うような異変を知った心に、その優しさを振り払って進める余力はなかった。
PRINTFORMDW ただ一つだけ――自分はもう二度と、異変解決なんて真似はできないだろうということだけ、分かった。	PRINTFORMDW ただ一つだけ――自分はもう二度と、異変解決なんて真似はできないだろうということだけ、分かった。
PRINTFORMDW そう言って、魔理沙は枕を壁に投げつけた。その目に涙が浮かんでいるのは、眠気からではないだろう。	PRINTFORMDW そう言って、魔理沙は枕を壁に投げつけた。その目に涙が浮かんでいるのは、眠気からではないだろう。
PRINTFORMDW もちろん、霊夢や魔理沙が入ってきた入り口も既に無い。これでは他の少女を救出する以前の問題だ。	PRINTFORMDW もちろん、霊夢や魔理沙が入ってきた入り口も既に無い。これでは他の少女を救出する以前の問題だ。
PRINTFORMDW 霊夢と一緒に突入する手段を探してはいるが、魔理沙の言うとおり手がかりすら掴めない有様である。	PRINTFORMDW 霊夢と一緒に突入する手段を探してはいるが、魔理沙の言うとおり手がかりすら掴めない有様である。
PRINTFORMW 「こっち見てる……なんだかこうして見つめられると、いい気分になってくるな……可愛いからかな？」	PRINTFORMW 「こっち見てる……なんだかこうして見つめられると、いい気分になってくるな……可愛いからかな？」
PRINTFORMDW 当初は賛同者もいたが、成果が上がらない探索にみな飽きてしまい、今やこれに拘るのは魔理沙一人。	PRINTFORMDW 当初は賛同者もいたが、成果が上がらない探索にみな飽きてしまい、今やこれに拘るのは魔理沙一人。
PRINTFORMDW いつもの異変が解決された時のような達成感も、敵に打ち勝った爽快感もない。ただ逃げてきただけ。	PRINTFORMDW いつもの異変が解決された時のような達成感も、敵に打ち勝った爽快感もない。ただ逃げてきただけ。
PRINTFORML ただし追い込まれている場面では女性口調になることも多いため、抵抗のある方は使用をお控え下さい。	PRINTFORML ただし追い込まれている場面では女性口調になることも多いため、抵抗のある方は使用をお控え下さい。
PRINTFORMW 「嘘だ、そんなはずない……化け物に犯されて受精しただなんて、そんなことあるはずないんだっ！」	PRINTFORMW 「嘘だ、そんなはずない……化け物に犯されて受精しただなんて、そんなことあるはずないんだっ！」
PRINTFORMDW 放たれた魔砲は相手の身体を覆い尽くし、断末魔の悲鳴と共にクイーンを跡形もなく消滅させた……	PRINTFORMDW 放たれた魔砲は相手の身体を覆い尽くし、断末魔の悲鳴と共にクイーンを跡形もなく消滅させた……
PRINTFORMDW 他の参加者が騒いでいる横で霊夢が酒を飲んでいると、魔理沙が自慢げな顔をしながら隣に座った。	PRINTFORMDW 他の参加者が騒いでいる横で霊夢が酒を飲んでいると、魔理沙が自慢げな顔をしながら隣に座った。
PRINTFORMW 「言ってませんー。だいたい私のほうがちゃんと活躍してたんだから、認めたくもないも何もないわ」	PRINTFORMW 「言ってませんー。だいたい私のほうがちゃんと活躍してたんだから、認めたくもないも何もないわ」
PRINTFORMDW バチバチと火花を散らす二人の視線。止めるどころか、面白い見世物とばかりに注目する他の面々。	PRINTFORMDW バチバチと火花を散らす二人の視線。止めるどころか、面白い見世物とばかりに注目する他の面々。
PRINTFORMDW 撃ち貫かれ、崩れ落ちていくクイーンの巨体。この様子ならば、放っておいても死ぬだろう。だが。	PRINTFORMDW 撃ち貫かれ、崩れ落ちていくクイーンの巨体。この様子ならば、放っておいても死ぬだろう。だが。
PRINTFORMDW 走りはじめた悪寒に立っていることすらできず、魔理沙は自分の身体を押さえつけながら座り込む。	PRINTFORMDW 走りはじめた悪寒に立っていることすらできず、魔理沙は自分の身体を押さえつけながら座り込む。
PRINTFORMDW そこにいるのは生意気で活発な魔法使いの姿ではなく……ただ怯え惑うだけの、純真な少女だった。	PRINTFORMDW そこにいるのは生意気で活発な魔法使いの姿ではなく……ただ怯え惑うだけの、純真な少女だった。
PRINTFORMDW 霊夢は何の前置きもなく、手に持ったものをゆっくりと放り投げた。とっさに魔理沙はキャッチし、	PRINTFORMDW 霊夢は何の前置きもなく、手に持ったものをゆっくりと放り投げた。とっさに魔理沙はキャッチし、
PRINTFORMDW その場に崩れ落ちた魔理沙に、背を向けて霊夢は歩き出す。なんとか止めようと、声を絞り出した。	PRINTFORMDW その場に崩れ落ちた魔理沙に、背を向けて霊夢は歩き出す。なんとか止めようと、声を絞り出した。
PRINTFORMDW その台詞に魔理沙はヒビが入りそうな勢いで固まったが、霊夢はお構いなしだ。更に続けていく。	PRINTFORMDW その台詞に魔理沙はヒビが入りそうな勢いで固まったが、霊夢はお構いなしだ。更に続けていく。
PRINTFORMDW 地面に倒れ、断末魔の悲鳴をあげながら悶えていたガーディアンは、やがて完全に動きを止める。	PRINTFORMDW 地面に倒れ、断末魔の悲鳴をあげながら悶えていたガーディアンは、やがて完全に動きを止める。
PRINTFORMDW しかしその途端、まるで迷宮自体が意思を持っているかのように、出口が音を立てて閉じ始めた。	PRINTFORMDW しかしその途端、まるで迷宮自体が意思を持っているかのように、出口が音を立てて閉じ始めた。
PRINTFORMDW 所在無さげに足をばたつかせながら、魔理沙はため息をつく。そのまま空を見上げながら、一言。	PRINTFORMDW 所在無さげに足をばたつかせながら、魔理沙はため息をつく。そのまま空を見上げながら、一言。
PRINTFORMW （あれを持ち帰ろうとしたことといい……これがいつもの異変とは違うこと、分かってるのかしら？	PRINTFORMW （あれを持ち帰ろうとしたことといい……これがいつもの異変とは違うこと、分かってるのかしら？
PRINTFORMDW 絡ませるように指を動かし蓋を少し開けると、その表情は更に恍惚としたそれへと変わっていく。	PRINTFORMDW 絡ませるように指を動かし蓋を少し開けると、その表情は更に恍惚としたそれへと変わっていく。
PRINTFORMDW 完全に死に絶えリュックサックほどに縮んでいたそれは、いつの間にか少しずつ膨らみつつある。	PRINTFORMDW 完全に死に絶えリュックサックほどに縮んでいたそれは、いつの間にか少しずつ膨らみつつある。
PRINTFORMDW 脱出については光の渦が開きっぱなしになっていたからだが、神隠しが止んだ理由はわからない。	PRINTFORMDW 脱出については光の渦が開きっぱなしになっていたからだが、神隠しが止んだ理由はわからない。
PRINTFORMDW もちろん、霊夢や魔理沙が入ってきた入り口も既に無い。他の少女を救出する以前の問題である。	PRINTFORMDW もちろん、霊夢や魔理沙が入ってきた入り口も既に無い。他の少女を救出する以前の問題である。
PRINTFORMDW あれからずっと、毎日のように悪夢を見ていた。苦しんだこと。犯されたこと。泣き叫んだこと。	PRINTFORMDW あれからずっと、毎日のように悪夢を見ていた。苦しんだこと。犯されたこと。泣き叫んだこと。
PRINTFORMDW お茶を飲み干して立ち上がった霊夢は、外に出ようとする様子もなく二杯目を取ろうとしている。	PRINTFORMDW お茶を飲み干して立ち上がった霊夢は、外に出ようとする様子もなく二杯目を取ろうとしている。
PRINTFORMDW 絡ませるように指を動かし顔を近づけると、その表情は更に恍惚としたそれへと変わっていく。	PRINTFORMDW 絡ませるように指を動かし顔を近づけると、その表情は更に恍惚としたそれへと変わっていく。
PRINTFORMDW 憎悪か、不安か、或いは両方か。今まで縁遠いものだった感情が、彼女を復讐に走らせている。	PRINTFORMDW 憎悪か、不安か、或いは両方か。今まで縁遠いものだった感情が、彼女を復讐に走らせている。
PRINTFORMDW ――しかし。守護者の死が引き金となったのか、その出口が閉じられるかのように崩れ始める。	PRINTFORMDW ――しかし。守護者の死が引き金となったのか、その出口が閉じられるかのように崩れ始める。
PRINTFORMW 「異変を解決するのが、私の役目だから。私がやらなきゃいけない。でも、あんたは違うでしょ」	PRINTFORMW 「異変を解決するのが、私の役目だから。私がやらなきゃいけない。でも、あんたは違うでしょ」
PRINTFORMDW 人里を――どこか縮こまりながら――訪れた魔理沙は、ふと聞こえた噂話で更に顔を曇らせた。	PRINTFORMDW 人里を――どこか縮こまりながら――訪れた魔理沙は、ふと聞こえた噂話で更に顔を曇らせた。
PRINTFORMDW もちろん、魔理沙が入ってきた入り口も既に無い。これでは他の少女を救出する以前の問題だ。	PRINTFORMDW もちろん、魔理沙が入ってきた入り口も既に無い。これでは他の少女を救出する以前の問題だ。
PRINTFORMW 「いいじゃない。もう神隠しは起こらないんだし、全員帰ってきたし。拘る必要はないと思うわ」	PRINTFORMW 「いいじゃない。もう神隠しは起こらないんだし、全員帰ってきたし。拘る必要はないと思うわ」
PRINTFORMDW それでも何か強がりを言おうと、声を絞り出そうとして……それより先に、霊夢がごまかした。	PRINTFORMDW それでも何か強がりを言おうと、声を絞り出そうとして……それより先に、霊夢がごまかした。
PRINTFORMDW %ARGS:0%%TACHI()%の攻撃が、ついにガーディアンの巨大な目玉を貫いた。	PRINTFORMDW %ARGS:0%%TACHI()%の攻撃が、ついにガーディアンの巨大な目玉を貫いた。
PRINTFORMDW %ARGS:0%は残りの力を振り絞り、満身創痍のクイーンへ向け、極大の魔砲を放った！	PRINTFORMDW %ARGS:0%は残りの力を振り絞り、満身創痍のクイーンへ向け、極大の魔砲を放った！
PRINTFORMDW それは真っ直ぐにクイーンの身体を貫き、断末魔の悲鳴と共に、全ての触手を打ち砕いた……	PRINTFORMDW それは真っ直ぐにクイーンの身体を貫き、断末魔の悲鳴と共に、全ての触手を打ち砕いた……
PRINTFORMDW だが仲間が他の者と迷宮の出入り口を探す中、魔理沙一人だけは手伝わずに家に篭っていた。	PRINTFORMDW だが仲間が他の者と迷宮の出入り口を探す中、魔理沙一人だけは手伝わずに家に篭っていた。
PRINTFORMDW 例え少女たちの話題に上がらなくなっても、この異変については彼女自身が強く覚えている。	PRINTFORMDW 例え少女たちの話題に上がらなくなっても、この異変については彼女自身が強く覚えている。
PRINTFORMDW 脱出の好機は今しかないと判断した魔理沙は、詫びるように呟きながら出口へと走りだした。	PRINTFORMDW 脱出の好機は今しかないと判断した魔理沙は、詫びるように呟きながら出口へと走りだした。
PRINTFORMDW 既に新たな神隠しの犠牲者も出て、霊夢はある程度手がかりを発見しているのにも関わらず。	PRINTFORMDW 既に新たな神隠しの犠牲者も出て、霊夢はある程度手がかりを発見しているのにも関わらず。
PRINTFORMDW それは、乾いた触手の死体だったから……もっとも、あまりにも過敏に過ぎる反応だったが。	PRINTFORMDW それは、乾いた触手の死体だったから……もっとも、あまりにも過敏に過ぎる反応だったが。
PRINTFORMDW そんな問いかけをしても意味は無い。だって、霊夢は振り向くことすらしなかったのだから。	PRINTFORMDW そんな問いかけをしても意味は無い。だって、霊夢は振り向くことすらしなかったのだから。
PRINTFORMDW あんな体験を思い起こすだけでも泣きたくなるのに、口に出して言うなどできるわけがない。	PRINTFORMDW あんな体験を思い起こすだけでも泣きたくなるのに、口に出して言うなどできるわけがない。
PRINTFORML 素の魔理沙は乙女という拘りがあるので、特に貞操絡みと妊娠絡みはダイレクトヒットします。	PRINTFORML 素の魔理沙は乙女という拘りがあるので、特に貞操絡みと妊娠絡みはダイレクトヒットします。
PRINTFORMW 「面倒くさくない異変なんてあるもんか！　というわけで、来ないならお前の出番はないぜ！」	PRINTFORMW 「面倒くさくない異変なんてあるもんか！　というわけで、来ないならお前の出番はないぜ！」
PRINTFORMDW 洞窟の前で箒を片手に、魔理沙はえへんと胸を張る。その足元の草は、不自然に凹んでいた。	PRINTFORMDW 洞窟の前で箒を片手に、魔理沙はえへんと胸を張る。その足元の草は、不自然に凹んでいた。
PRINTFORMDW 好機と見た%ARGS:0%は残りの力を振り絞り、霊夢と共に体勢を整えながら構えた！	PRINTFORMDW 好機と見た%ARGS:0%は残りの力を振り絞り、霊夢と共に体勢を整えながら構えた！
PRINTFORMDW それはガーディアンの遺体。脱出する際に、密かに彼女が研究材料として回収したものだ。	PRINTFORMDW それはガーディアンの遺体。脱出する際に、密かに彼女が研究材料として回収したものだ。
PRINTFORMDW 他の参加者が騒いでいる中で、しかし、魔理沙だけはそれに参加せず、迷宮に残っていた。	PRINTFORMDW 他の参加者が騒いでいる中で、しかし、魔理沙だけはそれに参加せず、迷宮に残っていた。
PRINTFORMDW 生還した者たちは口々に異変の元凶を懲らしめてやれなかったのが残念だと言っていたが、	PRINTFORMDW 生還した者たちは口々に異変の元凶を懲らしめてやれなかったのが残念だと言っていたが、
PRINTFORMDW 他の参加者が騒いでいる中で、しかし、魔理沙だけは境内裏で一人静かに酒を飲んでいた。	PRINTFORMDW 他の参加者が騒いでいる中で、しかし、魔理沙だけは境内裏で一人静かに酒を飲んでいた。
PRINTFORMDW 二人は今、迷宮に再突入する方法を探している。未だ止まらない神隠しを解決するために。	PRINTFORMDW 二人は今、迷宮に再突入する方法を探している。未だ止まらない神隠しを解決するために。
PRINTFORMDW 霊夢と一緒に突入する手段を探してはいるが、魔理沙の調査は全く成果が上がっていない。	PRINTFORMDW 霊夢と一緒に突入する手段を探してはいるが、魔理沙の調査は全く成果が上がっていない。
PRINTFORMDW 十秒近くかけてやっと絞り出した答えは……自分に染み付いた恐怖を肯定する言葉だった。	PRINTFORMDW 十秒近くかけてやっと絞り出した答えは……自分に染み付いた恐怖を肯定する言葉だった。
PRINTFORMDW 本当に自分を心配して、自分を守るために突き放したのだと、魔理沙は気付いてしまった。	PRINTFORMDW 本当に自分を心配して、自分を守るために突き放したのだと、魔理沙は気付いてしまった。
PRINTFORML いつもの異変と同じだと思っている魔理沙の心がへし折れていく様子に力を入れた口上です。	PRINTFORML いつもの異変と同じだと思っている魔理沙の心がへし折れていく様子に力を入れた口上です。
PRINTFORMW 「なあ、身代わりタイプじゃなくて砲撃型に改造とかできないか？　やっぱりパワーだろ」	PRINTFORMW 「なあ、身代わりタイプじゃなくて砲撃型に改造とかできないか？　やっぱりパワーだろ」
PRINTFORMDW この症状に嫌なものを感じたのか、魔理沙はブツブツと何か独り言を繰り返している……	PRINTFORMDW この症状に嫌なものを感じたのか、魔理沙はブツブツと何か独り言を繰り返している……
PRINTFORMW 「痛いよ、苦しいよ、子供のせいで……こども、の――うわぁ、うわぁぁぁぁぁぁんっ！」	PRINTFORMW 「痛いよ、苦しいよ、子供のせいで……こども、の――うわぁ、うわぁぁぁぁぁぁんっ！」
PRINTFORMW 　そんなの絶対おかしいよ、産みたくない子供に気持ちよくされるなんてやだよぉ……！」	PRINTFORMW 　そんなの絶対おかしいよ、産みたくない子供に気持ちよくされるなんてやだよぉ……！」
PRINTFORMDW こうして異変は終わり、迷宮から脱出した記念の宴会を最後にこの話は風化していった。	PRINTFORMDW こうして異変は終わり、迷宮から脱出した記念の宴会を最後にこの話は風化していった。
PRINTFORMDW 蕩けきり、熱っぽくなったその瞳は魅入られたかのようにフラスコ以外のものを見ない。	PRINTFORMDW 蕩けきり、熱っぽくなったその瞳は魅入られたかのようにフラスコ以外のものを見ない。
PRINTFORMDW 魔理沙は冷たい表情を浮かべ更に魔砲を叩きこみ、その身体を跡形もなく消滅させた……	PRINTFORMDW 魔理沙は冷たい表情を浮かべ更に魔砲を叩きこみ、その身体を跡形もなく消滅させた……
PRINTFORMDW 無事に脱出した魔理沙は、博麗神社の境内で霊夢に頭を下げていた。その両手はカラだ。	PRINTFORMDW 無事に脱出した魔理沙は、博麗神社の境内で霊夢に頭を下げていた。その両手はカラだ。
PRINTFORMW 　ね？　だからもう、魔理沙は戦わなくていい。無理に私に張り合おうとしなくてもいい」	PRINTFORMW 　ね？　だからもう、魔理沙は戦わなくていい。無理に私に張り合おうとしなくてもいい」
PRINTFORMW 「人も妖怪も妖精も神隠しって噂だぞ！　しかも女だけ！　私の予測じゃあ紫が何か……」	PRINTFORMW 「人も妖怪も妖精も神隠しって噂だぞ！　しかも女だけ！　私の予測じゃあ紫が何か……」
PRINTFORMW 「よかった、ここにいる連中みたいなのじゃなくて。あれが服を縫うなんてぞっとする」	PRINTFORMW 「よかった、ここにいる連中みたいなのじゃなくて。あれが服を縫うなんてぞっとする」
PRINTFORMW 「うあぁあっ……ばけものなのに、犯されてるのに、みるく飲まれるのきもちいぃ……」	PRINTFORMW 「うあぁあっ……ばけものなのに、犯されてるのに、みるく飲まれるのきもちいぃ……」
PRINTFORMDW 魔理沙は周囲にいる触手を見た途端、明らかに怯えた表情をして駆け出していった……	PRINTFORMDW 魔理沙は周囲にいる触手を見た途端、明らかに怯えた表情をして駆け出していった……
PRINTFORMW 「い、言い訳すんなよ。どうせ私の活躍を認めたくないからって適当言ってるんだろ？」	PRINTFORMW 「い、言い訳すんなよ。どうせ私の活躍を認めたくないからって適当言ってるんだろ？」
PRINTFORMW 「こんな生き物――何もわからないのにこのまま放っておくなんて、もったいないよな」	PRINTFORMW 「こんな生き物――何もわからないのにこのまま放っておくなんて、もったいないよな」
PRINTFORMDW 魔法薬に満ちたフラスコの中。不気味に浮かぶ残骸に、魔理沙の視線は注がれていた。	PRINTFORMDW 魔法薬に満ちたフラスコの中。不気味に浮かぶ残骸に、魔理沙の視線は注がれていた。
PRINTFORMDW それはクイーンの欠片。脱出する際に、密かに彼女が研究材料として回収したものだ。	PRINTFORMDW それはクイーンの欠片。脱出する際に、密かに彼女が研究材料として回収したものだ。
PRINTFORMW 「いい匂い……こいつの体液を利用したら、きっと凄い魔法薬が出来るに違いない……」	PRINTFORMW 「いい匂い……こいつの体液を利用したら、きっと凄い魔法薬が出来るに違いない……」
PRINTFORMDW 魔法薬に満ちたフラスコの中。不気味に浮かぶ球体に、魔理沙の視線は注がれていた。	PRINTFORMDW 魔法薬に満ちたフラスコの中。不気味に浮かぶ球体に、魔理沙の視線は注がれていた。
PRINTFORMDW 心中に溜まった澱みを吐き出すように、魔理沙は来る日も来る日も魔砲を撃ち続ける。	PRINTFORMDW 心中に溜まった澱みを吐き出すように、魔理沙は来る日も来る日も魔砲を撃ち続ける。
PRINTFORMDW その例外が、魔理沙だった。彼女はあれからずっと、迷宮の入り口を探し続けている。	PRINTFORMDW その例外が、魔理沙だった。彼女はあれからずっと、迷宮の入り口を探し続けている。
PRINTFORMDW 吐き捨てるように呟く。今の彼女には、皆が繰り広げている騒ぎが遠いものに思えた。	PRINTFORMDW 吐き捨てるように呟く。今の彼女には、皆が繰り広げている騒ぎが遠いものに思えた。
PRINTFORMDW そう言い残して、霊夢はどこかへ飛んでいく。魔理沙に、それを追うことはできない。	PRINTFORMDW そう言い残して、霊夢はどこかへ飛んでいく。魔理沙に、それを追うことはできない。
PRINTFORMDW その例外が、魔理沙だった。彼女は今日も、ベッドの上で枕を抱えて座り込んでいる。	PRINTFORMDW その例外が、魔理沙だった。彼女は今日も、ベッドの上で枕を抱えて座り込んでいる。
PRINTFORML 「あぐっ、うぅっ……もう、わかったから……ぐすっ、諦めてっ、犯されるからぁ……	PRINTFORML 「あぐっ、うぅっ……もう、わかったから……ぐすっ、諦めてっ、犯されるからぁ……
PRINTFORMDW それは幻想郷ではよくある風景で――――いつも通りの日常が戻ってきた証だった。	PRINTFORMDW それは幻想郷ではよくある風景で――――いつも通りの日常が戻ってきた証だった。
PRINTFORMDW 月日が経つにつれこの異変は忘れ去られてゆく事となった……一部の例外を除いて。	PRINTFORMDW 月日が経つにつれこの異変は忘れ去られてゆく事となった……一部の例外を除いて。
PRINTFORMW 「れ、霊夢は……怖く、ないの？　あんなことされたのに！？　なんで戦うんだよ！」	PRINTFORMW 「れ、霊夢は……怖く、ないの？　あんなことされたのに！？　なんで戦うんだよ！」
PRINTFORMDW それでも手がかりを探すことくらい魔理沙にはできたのかもしれない。……けれど。	PRINTFORMDW それでも手がかりを探すことくらい魔理沙にはできたのかもしれない。……けれど。
PRINTFORMDW 話を聞かなかったことにして、魔理沙は歩いて行く。顔を俯かせて、逃げるように。	PRINTFORMDW 話を聞かなかったことにして、魔理沙は歩いて行く。顔を俯かせて、逃げるように。
PRINTFORMW 「忘れたい……忘れたいのに……あんなひどいコト、忘れられるわけ、ないよぉ……」	PRINTFORMW 「忘れたい……忘れたいのに……あんなひどいコト、忘れられるわけ、ないよぉ……」
PRINTFORMDW 走りはじめた悪寒に顔を上げることすらできず、魔理沙は自分の目元を布団で覆う。	PRINTFORMDW 走りはじめた悪寒に顔を上げることすらできず、魔理沙は自分の目元を布団で覆う。
PRINTFORMW 「私ならこういう感じじゃなくて、もっとかっこよくスペルカードを書くけどなー」	PRINTFORMW 「私ならこういう感じじゃなくて、もっとかっこよくスペルカードを書くけどなー」
PRINTFORMW 「く、くそっ、変な真似をして……こんなので、どうにかなるわけないだろ……！」	PRINTFORMW 「く、くそっ、変な真似をして……こんなので、どうにかなるわけないだろ……！」
PRINTFORMW 「でてくる……くるしいのに、いたいはずなのにぃ、なんでっ……こんなぁっ！？」	PRINTFORMW 「でてくる……くるしいのに、いたいはずなのにぃ、なんでっ……こんなぁっ！？」
PRINTFORMW 「また産んじゃうぅっ！　産むの、嫌なのにぃ、またおかしくされちゃっ……！？」	PRINTFORMW 「また産んじゃうぅっ！　産むの、嫌なのにぃ、またおかしくされちゃっ……！？」
PRINTFORMW 　絶対おかしいのに、また、気持ちよく、なっ……んっ、んううううううぅっ！？」	PRINTFORMW 　絶対おかしいのに、また、気持ちよく、なっ……んっ、んううううううぅっ！？」
PRINTFORMW 「ねぇ、私だけに任せないでよ……せめて動いて、私の話相手になって、ねぇ……」	PRINTFORMW 「ねぇ、私だけに任せないでよ……せめて動いて、私の話相手になって、ねぇ……」
PRINTFORMDW こうして異変は終わり、今は迷宮から脱出した記念に開かれた宴会の真っ最中だ。	PRINTFORMDW こうして異変は終わり、今は迷宮から脱出した記念に開かれた宴会の真っ最中だ。
PRINTFORMW 「それにしても、私は大活躍だったよな？　少しは霊夢も見直したんじゃないか？」	PRINTFORMW 「それにしても、私は大活躍だったよな？　少しは霊夢も見直したんじゃないか？」
PRINTFORMW 「この様子だと、今まで攫われた奴の情報は全て役に立たないと見ていいだろうな。	PRINTFORMW 「この様子だと、今まで攫われた奴の情報は全て役に立たないと見ていいだろうな。
PRINTFORMDW 一方がのんびりとお茶を飲んでいるもう一方に、食ってかかっているだけだから。	PRINTFORMDW 一方がのんびりとお茶を飲んでいるもう一方に、食ってかかっているだけだから。
PRINTFORMW 　……それにしてもなんだろう、これ。一部の茸の分泌物に似てないこともないが」	PRINTFORMW 　……それにしてもなんだろう、これ。一部の茸の分泌物に似てないこともないが」
PRINTFORMW 　は、はははは、冗談だろ。どうせどっかに隠れて、悪戯しようって考えだろう？	PRINTFORMW 　は、はははは、冗談だろ。どうせどっかに隠れて、悪戯しようって考えだろう？
PRINTFORMW 「無理に早く片付けるよりも、動きを封じて手出しされないようにしないと……」	PRINTFORMW 「無理に早く片付けるよりも、動きを封じて手出しされないようにしないと……」
PRINTFORM 　相手はにんげんじゃないのに、私……せーえき、きもちいいって思っちゃってるぅ	PRINTFORM 　相手はにんげんじゃないのに、私……せーえき、きもちいいって思っちゃってるぅ
PRINTFORMW 「……こいつらに勝っても嬉しくないな。かと言って、負けるのは絶対に嫌だが」	PRINTFORMW 「……こいつらに勝っても嬉しくないな。かと言って、負けるのは絶対に嫌だが」
PRINTFORMW 「あ、あぁぁぁぁぁっ！！　そんな……今まで頑張って、守ってきたのにっ……！	PRINTFORMW 「あ、あぁぁぁぁぁっ！！　そんな……今まで頑張って、守ってきたのにっ……！
PRINTFORMW 「……ひどい、よ……こんなんじゃ、帰っても……まともに暮らせないよぉ……」	PRINTFORMW 「……ひどい、よ……こんなんじゃ、帰っても……まともに暮らせないよぉ……」
PRINTFORMW 「やあぁっ！？　もう、もうわけわかんないよぉ……何で私がこんな目にっ……」	PRINTFORMW 「やあぁっ！？　もう、もうわけわかんないよぉ……何で私がこんな目にっ……」
PRINTFORMW 「いつまで戦わなくちゃいけないの……帰してよ、私を幻想郷に帰してよぉ……」	PRINTFORMW 「いつまで戦わなくちゃいけないの……帰してよ、私を幻想郷に帰してよぉ……」
PRINTFORMW 「このままじゃ、またおかしくなる……気持ちいいのを受け入れちゃうよぉ……」	PRINTFORMW 「このままじゃ、またおかしくなる……気持ちいいのを受け入れちゃうよぉ……」
PRINTFORMDW 触手の殆どを弾幕によって焼き払われた迷宮の主は、苦しそうに呻いている……	PRINTFORMDW 触手の殆どを弾幕によって焼き払われた迷宮の主は、苦しそうに呻いている……
PRINTFORMDW 露骨な嫌味に屁理屈を追加され、横に座っていた霊夢はそっぽを向いてしまう。	PRINTFORMDW 露骨な嫌味に屁理屈を追加され、横に座っていた霊夢はそっぽを向いてしまう。
PRINTFORMW 　変なことされてからじゃ手遅れなのに。なんとか次までに自覚させないと……）	PRINTFORMW 　変なことされてからじゃ手遅れなのに。なんとか次までに自覚させないと……）
PRINTFORMDW みないつも通りの生活に戻る中、魔理沙一人だけは家に篭りがちになっていた。	PRINTFORMDW みないつも通りの生活に戻る中、魔理沙一人だけは家に篭りがちになっていた。
PRINTFORMDW 反面、フラスコを愛おしげになぞる魔理沙の顔はどこか理性が抜け落ちていた。	PRINTFORMDW 反面、フラスコを愛おしげになぞる魔理沙の顔はどこか理性が抜け落ちていた。
PRINTFORMDW だが魔理沙は迷宮の出入り口を探そうとすらせず、一人だけで家に篭っていた。	PRINTFORMDW だが魔理沙は迷宮の出入り口を探そうとすらせず、一人だけで家に篭っていた。
PRINTFORMW 「消してやる、全部！　絶対に蘇れないように、世界から消し去ってやる……！」	PRINTFORMW 「消してやる、全部！　絶対に蘇れないように、世界から消し去ってやる……！」
PRINTFORMDW ――例え事態が終わっても、その事態があったことを消す力は魔理沙にはない。	PRINTFORMDW ――例え事態が終わっても、その事態があったことを消す力は魔理沙にはない。
PRINTFORMW 「私一人のほうが戦える。分からない？　あんたじゃ、足を引っ張るだけなのよ」	PRINTFORMW 「私一人のほうが戦える。分からない？　あんたじゃ、足を引っ張るだけなのよ」
PRINTFORMDW 何の犠牲者かは言うまでもない。魔理沙も経験した、あの迷宮への拉致である。	PRINTFORMDW 何の犠牲者かは言うまでもない。魔理沙も経験した、あの迷宮への拉致である。
PRINTFORMDW あの迷宮について、彼女は誰にも話そうとしなかった。話せるわけがなかった。	PRINTFORMDW あの迷宮について、彼女は誰にも話そうとしなかった。話せるわけがなかった。
PRINTFORMDW 今日も魔理沙は、博麗神社の境内で霊夢に頭を下げていた。その両手はカラだ。	PRINTFORMDW 今日も魔理沙は、博麗神社の境内で霊夢に頭を下げていた。その両手はカラだ。
PRINTFORMDW 再度振り返ってきた霊夢の視線が突き刺さる。魔理沙は何も言い返せなかった。	PRINTFORMDW 再度振り返ってきた霊夢の視線が突き刺さる。魔理沙は何も言い返せなかった。
PRINTFORMDW そんな時間にこんな事をしているのは、眠りが浅いから以外の何ものでもない。	PRINTFORMDW そんな時間にこんな事をしているのは、眠りが浅いから以外の何ものでもない。
PRINTFORMW 「……ようやく見つかった。私の調べによると、異変の原因はここで間違いない」	PRINTFORMW 「……ようやく見つかった。私の調べによると、異変の原因はここで間違いない」
PRINTFORMDW 現実の苦痛から悪夢を見ているのか、魔理沙はうなされながら泣いている……	PRINTFORMDW 現実の苦痛から悪夢を見ているのか、魔理沙はうなされながら泣いている……
PRINTFORMW 「霊夢、落とし物だぜ……え、落とした覚えなんてない？　どういうことだ？」	PRINTFORMW 「霊夢、落とし物だぜ……え、落とした覚えなんてない？　どういうことだ？」
PRINTFORMW 「…………はぁ、はぁ、ここまで必死に守ってきたんだ、絶対にやるもんか！」	PRINTFORMW 「…………はぁ、はぁ、ここまで必死に守ってきたんだ、絶対にやるもんか！」
PRINTFORMDW また望まない子供を産むという現実に打ちのめされ、魔理沙は泣いている……	PRINTFORMDW また望まない子供を産むという現実に打ちのめされ、魔理沙は泣いている……
PRINTFORM 　いっつもみるく吸われてイってるの、またみるく吸われて気持ちよくなるのぉっ	PRINTFORM 　いっつもみるく吸われてイってるの、またみるく吸われて気持ちよくなるのぉっ
PRINTFORMW 「……ただでさえこんな現実の中にいるのに、更に悪夢を見るなんてごめんだ」	PRINTFORMW 「……ただでさえこんな現実の中にいるのに、更に悪夢を見るなんてごめんだ」
PRINTFORMDW 触手の殆どを弾幕によって焼き払われた迷宮の主は、苦しそうに呻いている…	PRINTFORMDW 触手の殆どを弾幕によって焼き払われた迷宮の主は、苦しそうに呻いている…
PRINTFORMDW こうして脱出できた魔理沙だったが、彼女が再び迷宮に潜ることはなかった。	PRINTFORMDW こうして脱出できた魔理沙だったが、彼女が再び迷宮に潜ることはなかった。
PRINTFORMDW 肉壁は轟音を立てながら零れ落ち、浄化された大気に耐え切れず溶けていく。	PRINTFORMDW 肉壁は轟音を立てながら零れ落ち、浄化された大気に耐え切れず溶けていく。
PRINTFORMDW なぜ手がかりを見つけられないのか。なぜあんな反応をしたのか。それは……	PRINTFORMDW なぜ手がかりを見つけられないのか。なぜあんな反応をしたのか。それは……
PRINTFORMDL 口上の内容と魔理沙の開発具合に合わせて素質などが変わるようにしますか？	PRINTFORMDL 口上の内容と魔理沙の開発具合に合わせて素質などが変わるようにしますか？
PRINTFORMDW 博麗神社の縁側。曇天の微妙な明るさの下で、二人の少女が言い争っている。	PRINTFORMDW 博麗神社の縁側。曇天の微妙な明るさの下で、二人の少女が言い争っている。
PRINTFORMW 「私の弾幕なら、後ろからでも十分な威力……それだけだぜ、それだけ……」	PRINTFORMW 「私の弾幕なら、後ろからでも十分な威力……それだけだぜ、それだけ……」
PRINTFORMW 「どうせなら盾になるんじゃなくて、支援攻撃でもしてくれるといいんだが」	PRINTFORMW 「どうせなら盾になるんじゃなくて、支援攻撃でもしてくれるといいんだが」
PRINTFORMW 　……犯されてはじめてを奪われるよりましだと思うしかない、の……かな」	PRINTFORMW 　……犯されてはじめてを奪われるよりましだと思うしかない、の……かな」
PRINTFORMW 「副作用は気になるけど、こんな状況だ。無理にでも気を張っていかないと」	PRINTFORMW 「副作用は気になるけど、こんな状況だ。無理にでも気を張っていかないと」
PRINTFORMDW 魔理沙の顔は快楽と悲痛が織り交ざった涙でぐちゃぐちゃになっている……	PRINTFORMDW 魔理沙の顔は快楽と悲痛が織り交ざった涙でぐちゃぐちゃになっている……
PRINTFORMW 「あいつらを連れ歩くなんて嫌だし、連れ歩く奴に犯されるのはもっと嫌だ」	PRINTFORMW 「あいつらを連れ歩くなんて嫌だし、連れ歩く奴に犯されるのはもっと嫌だ」
PRINTFORMDW 胸を張る魔理沙。あんな相手だったからだろう、いつも以上に自信満々だ。	PRINTFORMDW 胸を張る魔理沙。あんな相手だったからだろう、いつも以上に自信満々だ。
PRINTFORMDW だが霊夢はというと、それを横目で見やりながら眉一つ動かずに言い返す。	PRINTFORMDW だが霊夢はというと、それを横目で見やりながら眉一つ動かずに言い返す。
PRINTFORMW 「あんな事があったのに、馬鹿騒ぎするとか頭おかしいんじゃないのか……」	PRINTFORMW 「あんな事があったのに、馬鹿騒ぎするとか頭おかしいんじゃないのか……」
PRINTFORMDW もし自分があそこにいたら話をせがまれて、話せば大受けするのだろうか？	PRINTFORMDW もし自分があそこにいたら話をせがまれて、話せば大受けするのだろうか？
PRINTFORMW 「こ、こんなもの投げつけるなよぉ！　だいたい、なんでこんなもの持って」	PRINTFORMW 「こ、こんなもの投げつけるなよぉ！　だいたい、なんでこんなもの持って」
PRINTFORMW 　――ねぇ、魔理沙。今の貴方、そんな調子で本当にあいつらと戦えるの？」	PRINTFORMW 　――ねぇ、魔理沙。今の貴方、そんな調子で本当にあいつらと戦えるの？」
PRINTFORMW 「……やめといたほうがいいと思うけど。確証もないし、面倒くさそうだし」	PRINTFORMW 「……やめといたほうがいいと思うけど。確証もないし、面倒くさそうだし」
PRINTFORMW 「魔符『スターダストレヴァリエ』！　この弾はお前らでも食えないぜ？」	PRINTFORMW 「魔符『スターダストレヴァリエ』！　この弾はお前らでも食えないぜ？」
PRINTFORMW 「あ、あぁっ、また……とまらないっ、おかしくなるのとまんないぃ！？」	PRINTFORMW 「あ、あぁっ、また……とまらないっ、おかしくなるのとまんないぃ！？」
PRINTFORMW 「本当は近寄りたくもないけど……倒すためならしょうがないんだよっ！」	PRINTFORMW 「本当は近寄りたくもないけど……倒すためならしょうがないんだよっ！」
PRINTFORML 「そのうち、私も……何考えてるんだ私！　あいつらなんかに負けるか！」	PRINTFORML 「そのうち、私も……何考えてるんだ私！　あいつらなんかに負けるか！」
PRINTFORMW 「嫌……前みたいに、なかから犯されて気持ちよくなっちゃうのは嫌ぁ！」	PRINTFORMW 「嫌……前みたいに、なかから犯されて気持ちよくなっちゃうのは嫌ぁ！」
PRINTFORMW 「構えろ霊夢！　私とお前のどっちが強いのか、ここで実証してやるぜ！」	PRINTFORMW 「構えろ霊夢！　私とお前のどっちが強いのか、ここで実証してやるぜ！」
PRINTFORMW 「こっちの台詞よ、あんたの異変解決なんてお遊びだって教えてあげる！」	PRINTFORMW 「こっちの台詞よ、あんたの異変解決なんてお遊びだって教えてあげる！」
PRINTFORMW 「育ったら、もっと見てもらえるのかな……気持ちよくなれるのかな……」	PRINTFORMW 「育ったら、もっと見てもらえるのかな……気持ちよくなれるのかな……」
PRINTFORMDW 以前言われたことを思い出し、魔理沙はギリギリと歯を噛み締めていた。	PRINTFORMDW 以前言われたことを思い出し、魔理沙はギリギリと歯を噛み締めていた。
PRINTFORMW 「ぐっ……にっくきターゲットに集中しっ、優しく放つは恋のまほぉ！」	PRINTFORMW 「ぐっ……にっくきターゲットに集中しっ、優しく放つは恋のまほぉ！」
PRINTFORMW 「み、見られてる……でも……でもっ、こんなの、我慢できないよぉ！」	PRINTFORMW 「み、見られてる……でも……でもっ、こんなの、我慢できないよぉ！」
PRINTFORMW 「ただ、ちょっと太っただけだ……妊娠なんて、有り得ないんだ……！」	PRINTFORMW 「ただ、ちょっと太っただけだ……妊娠なんて、有り得ないんだ……！」
PRINTFORMW 「嫌だ、産みたくない、産みたくないのにっ……がまんできないぃっ！」	PRINTFORMW 「嫌だ、産みたくない、産みたくないのにっ……がまんできないぃっ！」
PRINTFORMW 「何でここにあるんだ？　まあいいや、拾ったからには返してもらうか」	PRINTFORMW 「何でここにあるんだ？　まあいいや、拾ったからには返してもらうか」
PRINTFORML 「――ともない何ともない何ともない何ともない何ともない何とも――」	PRINTFORML 「――ともない何ともない何ともない何ともない何ともない何とも――」
PRINTFORMW 「薬を用意できる状況じゃないし、眠気覚ましはこれに頼るしかないか」	PRINTFORMW 「薬を用意できる状況じゃないし、眠気覚ましはこれに頼るしかないか」
PRINTFORMW 　殺さないで……少しだけでもいいから優しくして……お願いよぉ……」	PRINTFORMW 　殺さないで……少しだけでもいいから優しくして……お願いよぉ……」
PRINTFORMDW 怯えているのか期待しているのか、魔理沙はごくりと喉を鳴らした……	PRINTFORMDW 怯えているのか期待しているのか、魔理沙はごくりと喉を鳴らした……
PRINTFORMW 　だって……もしちゃんとしてなかったらって思うと、それだけで……」	PRINTFORMW 　だって……もしちゃんとしてなかったらって思うと、それだけで……」
PRINTFORMDW 閃光が走る。未だに残る迷宮の残骸に、特大の魔砲を打ち込み続ける。	PRINTFORMDW 閃光が走る。未だに残る迷宮の残骸に、特大の魔砲を打ち込み続ける。
PRINTFORMW 「きゃああああああああああああああああああああああああああああ！」	PRINTFORMW 「きゃああああああああああああああああああああああああああああ！」
PRINTFORMDW かすれ切った小さな声は、今の魔理沙にとって偽らざる本心だった……	PRINTFORMDW かすれ切った小さな声は、今の魔理沙にとって偽らざる本心だった……
PRINTFORMW 　……は、はじめては、好きになった人にあげなきゃ、いけないのに。	PRINTFORMW 　……は、はじめては、好きになった人にあげなきゃ、いけないのに。
PRINTFORMW 「嫌だ……こんなのやだよ、身体の中にいるなんて、そんなの……！」	PRINTFORMW 「嫌だ……こんなのやだよ、身体の中にいるなんて、そんなの……！」
PRINTFORMW 「何でここにあるんだ？　まあいいや、拾ったからには貰っていくか」	PRINTFORMW 「何でここにあるんだ？　まあいいや、拾ったからには貰っていくか」
PRINTFORM 　おかされてるのに、嫌なはずなのにぃ……わらひ、悦んじゃってるぅっ	PRINTFORM 　おかされてるのに、嫌なはずなのにぃ……わらひ、悦んじゃってるぅっ
PRINTFORMW 「凄いものだって分かるけど、無事に持って帰れなきゃ意味ないよな」	PRINTFORMW 「凄いものだって分かるけど、無事に持って帰れなきゃ意味ないよな」
PRINTFORMW 　だって、もしちゃんとしてなかったらって思うと、それだけで……」	PRINTFORMW 　だって、もしちゃんとしてなかったらって思うと、それだけで……」
PRINTFORMDW 限界寸前まで張り詰めていた心の中で、ぽっきりと何かが折れた……	PRINTFORMDW 限界寸前まで張り詰めていた心の中で、ぽっきりと何かが折れた……
PRINTFORM 　もう中にしょくしゅいるから、射精されるのがまんしなくていいよねぇ	PRINTFORM 　もう中にしょくしゅいるから、射精されるのがまんしなくていいよねぇ
PRINTFORMW 「今の私が飲んだら……きっと、どうしようもない気持ちになる……」	PRINTFORMW 「今の私が飲んだら……きっと、どうしようもない気持ちになる……」
PRINTFORMW 　はぁ、もしかすると新しく異変が起こるまで待つしかないのか……」	PRINTFORMW 　はぁ、もしかすると新しく異変が起こるまで待つしかないのか……」
PRINTFORMDW だが――魔理沙の心に宿った闇は、当分の間、消えそうになかった。	PRINTFORMDW だが――魔理沙の心に宿った闇は、当分の間、消えそうになかった。
PRINTFORMDW 草に残る粘液に触れながら首をひねる魔理沙は、視線に気付かない。	PRINTFORMDW 草に残る粘液に触れながら首をひねる魔理沙は、視線に気付かない。
PRINTFORMDW 粘液をまき散らして自分の存在を誇示しながら動きまわった物体が、	PRINTFORMDW 粘液をまき散らして自分の存在を誇示しながら動きまわった物体が、
PRINTFORMW 「お前なら、また助けに来るまで持ちこたえられる……よな……？」	PRINTFORMW 「お前なら、また助けに来るまで持ちこたえられる……よな……？」
PRINTFORMW 「なんか変だけど、それでもこの異変を解決するのは私だからな！」	PRINTFORMW 「なんか変だけど、それでもこの異変を解決するのは私だからな！」
PRINTFORMW 「あ……うっ……嫌、まさか、中から、出て……いや、いやぁっ！」	PRINTFORMW 「あ……うっ……嫌、まさか、中から、出て……いや、いやぁっ！」
PRINTFORMW 「箒のほうがよほど便利だし、頑丈だし、何より魔法使いらしいぜ」	PRINTFORMW 「箒のほうがよほど便利だし、頑丈だし、何より魔法使いらしいぜ」
PRINTFORMW 「誰のものか知らないけど、せっかくだし借りておくぜ。死ぬまで」	PRINTFORMW 「誰のものか知らないけど、せっかくだし借りておくぜ。死ぬまで」
PRINTFORMW 「……もし毒だったりすれば、今の状況だと洒落にならないからな」	PRINTFORMW 「……もし毒だったりすれば、今の状況だと洒落にならないからな」
PRINTFORMW 「ちょ、ちょっと待てよ……こんなやられ方、絶対おかしいって！」	PRINTFORMW 「ちょ、ちょっと待てよ……こんなやられ方、絶対おかしいって！」
PRINTFORMW 「跡形もなく消し去れば動けないだろ――このミニ八卦炉の力で！」	PRINTFORMW 「跡形もなく消し去れば動けないだろ――このミニ八卦炉の力で！」
PRINTFORMW 「や、いやだ、これ以上はっ……やっやだやだやだやだやだぁっ！」	PRINTFORMW 「や、いやだ、これ以上はっ……やっやだやだやだやだやだぁっ！」
PRINTFORM 「ふぁ、うあぁっ！？　ちくび……そうやって、すわれたら、またぁっ	PRINTFORM 「ふぁ、うあぁっ！？　ちくび……そうやって、すわれたら、またぁっ
PRINTFORMW 「やめ、てっ、よわいの、みるく吸われたらイっちゃうのぉっ！？」	PRINTFORMW 「やめ、てっ、よわいの、みるく吸われたらイっちゃうのぉっ！？」
PRINTFORMW 「逃げてばかりじゃ駄目だろうが、それでも持ってた方がいいよな」	PRINTFORMW 「逃げてばかりじゃ駄目だろうが、それでも持ってた方がいいよな」
PRINTFORMDW 持ち主がどんな事をされたか、今の魔理沙には容易に想像できる。	PRINTFORMDW 持ち主がどんな事をされたか、今の魔理沙には容易に想像できる。
PRINTFORMW 「いや、だ……化物なんかに飲ませるものじゃないのに、嫌ぁ……」	PRINTFORMW 「いや、だ……化物なんかに飲ませるものじゃないのに、嫌ぁ……」
PRINTFORMW 「結界……ちゃんとしてる？　私、守られてる？　大丈夫だよね？」	PRINTFORMW 「結界……ちゃんとしてる？　私、守られてる？　大丈夫だよね？」
PRINTFORMDW 迷宮の主の死と時を同じくして、にわかに迷宮全体が震え始める。	PRINTFORMDW 迷宮の主の死と時を同じくして、にわかに迷宮全体が震え始める。
PRINTFORMDW 安心した%ARGS:0%は、ふとクイーンの遺体に目を向けた。	PRINTFORMDW 安心した%ARGS:0%は、ふとクイーンの遺体に目を向けた。
PRINTFORMW 「育ったら、もっと嗅げるのかな……気持ちよくなれるのかな……」	PRINTFORMW 「育ったら、もっと嗅げるのかな……気持ちよくなれるのかな……」
PRINTFORMDW 完全に女王の虜になった魔理沙は、顔を紅潮させて呟くのだった。	PRINTFORMDW 完全に女王の虜になった魔理沙は、顔を紅潮させて呟くのだった。
PRINTFORMDL 脱出後、出入り口は愚か迷宮の痕跡すら跡形もなく消えてしまい、	PRINTFORMDL 脱出後、出入り口は愚か迷宮の痕跡すら跡形もなく消えてしまい、
PRINTFORMDW 完全に魔眼の虜になった魔理沙は、顔を紅潮させて呟くのだった。	PRINTFORMDW 完全に魔眼の虜になった魔理沙は、顔を紅潮させて呟くのだった。
PRINTFORMDW だが――彼女の心に宿った闇は、当分の間、消えそうになかった。	PRINTFORMDW だが――彼女の心に宿った闇は、当分の間、消えそうになかった。
PRINTFORMDW 既に果たせる見込みが無いという現実から、目を背かせるほどに。	PRINTFORMDW 既に果たせる見込みが無いという現実から、目を背かせるほどに。
PRINTFORMW 「逃げるしか……ない、よな。ここにいない奴には、悪いけど……」	PRINTFORMW 「逃げるしか……ない、よな。ここにいない奴には、悪いけど……」
PRINTFORMDW 不満気にそれを見る魔理沙だったが、思い直すように胸を張った。	PRINTFORMDW 不満気にそれを見る魔理沙だったが、思い直すように胸を張った。
PRINTFORMW （な、なに、この気持ち……縛られてるのに、むずむずする……）	PRINTFORMW （な、なに、この気持ち……縛られてるのに、むずむずする……）
PRINTFORMW 「いやぁ、やめてよ……お嫁に、行けなくなっちゃうよぉ……！」	PRINTFORMW 「いやぁ、やめてよ……お嫁に、行けなくなっちゃうよぉ……！」
PRINTFORM 「ま、まって、へん、なにか変っ、たすけて、誰かたすけっ、てぇっ	PRINTFORM 「ま、まって、へん、なにか変っ、たすけて、誰かたすけっ、てぇっ
PRINTFORMW 「念のため、見張りも欲しいけど……結界に頼るしかないな……」	PRINTFORMW 「念のため、見張りも欲しいけど……結界に頼るしかないな……」
PRINTFORMW 「もう、もぉいい……だろぉ、はなしっ……うぁ、ふあぁっ！？」	PRINTFORMW 「もう、もぉいい……だろぉ、はなしっ……うぁ、ふあぁっ！？」
PRINTFORMW 「ん、落とし物じゃないか。もったいないし、借りていいよな？」	PRINTFORMW 「ん、落とし物じゃないか。もったいないし、借りていいよな？」
PRINTFORMW 「困っている時はお互い様……そう。お互い様、だからな……？」	PRINTFORMW 「困っている時はお互い様……そう。お互い様、だからな……？」
PRINTFORMW 「よ、よかった……単にちょっと調子が悪かっただけなんだ……」	PRINTFORMW 「よ、よかった……単にちょっと調子が悪かっただけなんだ……」
PRINTFORMW （人形が代わりに変なことされるのは、アリス的にはいいのか？）	PRINTFORMW （人形が代わりに変なことされるのは、アリス的にはいいのか？）
PRINTFORM 　吸うのうまいの、また赤ちゃんにみるくあげながらイっちゃうぅっ	PRINTFORM 　吸うのうまいの、また赤ちゃんにみるくあげながらイっちゃうぅっ
PRINTFORMW 「……今までのこと、全て綺麗に治せるわけじゃないんだろうな」	PRINTFORMW 「……今までのこと、全て綺麗に治せるわけじゃないんだろうな」
PRINTFORMDW やがて魔物達は完全に殲滅され、出口もあっけなく見つかった。	PRINTFORMDW やがて魔物達は完全に殲滅され、出口もあっけなく見つかった。
PRINTFORMDW 故に、魔理沙と霊夢がそれぞれの得物を構えるのは道理だった。	PRINTFORMDW 故に、魔理沙と霊夢がそれぞれの得物を構えるのは道理だった。
PRINTFORMW 「せめてあいつを回収してれば、変わったかもしれないのになー」	PRINTFORMW 「せめてあいつを回収してれば、変わったかもしれないのになー」
PRINTFORMW 「いなくなったなら、いいだと……この異変は終わっただと……！	PRINTFORMW 「いなくなったなら、いいだと……この異変は終わっただと……！
PRINTFORMW 「そ、そんなの！　異変の元凶を懲らしめてないじゃないか……」	PRINTFORMW 「そ、そんなの！　異変の元凶を懲らしめてないじゃないか……」
PRINTFORMW 「床は綺麗に掃いておいてやるぜ？　寝転がってみたらどうだ」	PRINTFORMW 「床は綺麗に掃いておいてやるぜ？　寝転がってみたらどうだ」
PRINTFORMW 「こ、こういうことは好きな人以外とやっちゃだめってぇ！？」	PRINTFORMW 「こ、こういうことは好きな人以外とやっちゃだめってぇ！？」
PRINTFORMW 「ふっ、んんぅ……♪　みんな……ちゃんと寝てる、よな……」	PRINTFORMW 「ふっ、んんぅ……♪　みんな……ちゃんと寝てる、よな……」
PRINTFORMW 「…………はぁ、はぁ、危ない……よくもやりやがったなっ！」	PRINTFORMW 「…………はぁ、はぁ、危ない……よくもやりやがったなっ！」
PRINTFORMW 「……次は肥満か。こういう症状が当てはまるのはなんだっけ」	PRINTFORMW 「……次は肥満か。こういう症状が当てはまるのはなんだっけ」
PRINTFORMW 「膨らんだここに……子供が……そ、そんな事、あるもんか！」	PRINTFORMW 「膨らんだここに……子供が……そ、そんな事、あるもんか！」
PRINTFORMW 　産みたくない、化け物の子供なんて産みたくないよぉ……！」	PRINTFORMW 　産みたくない、化け物の子供なんて産みたくないよぉ……！」
PRINTFORMW 「こ、これって……そんな、私、本当に、ははおや、に……？」	PRINTFORMW 「こ、これって……そんな、私、本当に、ははおや、に……？」
PRINTFORMW 「うそ、なんでっ……なんで私、母親になったみたいにっ！？」	PRINTFORMW 「うそ、なんでっ……なんで私、母親になったみたいにっ！？」
PRINTFORMW 「あ、あぁ……そんな……わ、私の中に、あんなものが……！」	PRINTFORMW 「あ、あぁ……そんな……わ、私の中に、あんなものが……！」
PRINTFORMW 　あ、うわああああぁぁぁあああああああああっ！！！！！！」	PRINTFORMW 　あ、うわああああぁぁぁあああああああああっ！！！！！！」
PRINTFORMW 「お……お前らなんかのでぇ、おかしくなったりっ、しない！」	PRINTFORMW 「お……お前らなんかのでぇ、おかしくなったりっ、しない！」
PRINTFORMW 「例え服の切れっ端だろうと、お前らにやりたくなんかないぜ」	PRINTFORMW 「例え服の切れっ端だろうと、お前らにやりたくなんかないぜ」
PRINTFORMW 「今までお前たちにやられた分……物理的にやり返してやる！」	PRINTFORMW 「今までお前たちにやられた分……物理的にやり返してやる！」
PRINTFORMW 「ちくしょおっ……！　すぐ、絶対すぐに助けに行くからな！」	PRINTFORMW 「ちくしょおっ……！　すぐ、絶対すぐに助けに行くからな！」
PRINTFORMW 「い、いくらやってもぉ！　へーき、なん……だからぁっ！？」	PRINTFORMW 「い、いくらやってもぉ！　へーき、なん……だからぁっ！？」
PRINTFORMW 「いやだ、またあいつらの子供を産むなんて嫌だ、いやだぁ！」	PRINTFORMW 「いやだ、またあいつらの子供を産むなんて嫌だ、いやだぁ！」
PRINTFORMW 「なんでここにあるかはともかく、威力はあてにしていいよな」	PRINTFORMW 「なんでここにあるかはともかく、威力はあてにしていいよな」
PRINTFORMW 「結界の最終確認してくれ。ちゃんとしてないと安心できない」	PRINTFORMW 「結界の最終確認してくれ。ちゃんとしてないと安心できない」
PRINTFORMW 「うん……よく分からないが、もう少しなら行けそうな感じだ」	PRINTFORMW 「うん……よく分からないが、もう少しなら行けそうな感じだ」
PRINTFORMW 「私は強いんだ、今まで何度も異変を解決してきたんだぁっ！」	PRINTFORMW 「私は強いんだ、今まで何度も異変を解決してきたんだぁっ！」
PRINTFORML 「うぐっ……ひぐっ、えぐっ、もうなかだしやめてよぉ……！」	PRINTFORML 「うぐっ……ひぐっ、えぐっ、もうなかだしやめてよぉ……！」
PRINTFORMW （少し火力を上げたくらいで、ここから抜け出せるのかな……）	PRINTFORMW （少し火力を上げたくらいで、ここから抜け出せるのかな……）
PRINTFORMW 「無理矢理にでも頑張って、それでも脱出できなかったら……」	PRINTFORMW 「無理矢理にでも頑張って、それでも脱出できなかったら……」
PRINTFORMDW 魔理沙の心に刻まれた疵は、あまりにも大きなものだった……	PRINTFORMDW 魔理沙の心に刻まれた疵は、あまりにも大きなものだった……
PRINTFORMW 「爆風で埋め尽くしてやるぜ……『メテオニックデブリ』！」	PRINTFORMW 「爆風で埋め尽くしてやるぜ……『メテオニックデブリ』！」
PRINTFORMW 「服がボロボロなのは、負けたみたいで気に食わないな……」	PRINTFORMW 「服がボロボロなのは、負けたみたいで気に食わないな……」
PRINTFORMW 「こんなのだめ、だめ……なの、にぃ、イっちゃうぅっ！？」	PRINTFORMW 「こんなのだめ、だめ……なの、にぃ、イっちゃうぅっ！？」
PRINTFORMW 　わたしの……はじめて……こんな……こんな、こと、で……	PRINTFORMW 　わたしの……はじめて……こんな……こんな、こと、で……
PRINTFORMW 　いや……いやあああああああああああああああああ！！！」	PRINTFORMW 　いや……いやあああああああああああああああああ！！！」
PRINTFORMW 「あ……も、問題ない、異変解決なら、私の出番だよな……」	PRINTFORMW 「あ……も、問題ない、異変解決なら、私の出番だよな……」
PRINTFORMW 「やっぱ、この洞窟にある茸を食べたのはまずかったぜ……」	PRINTFORMW 「やっぱ、この洞窟にある茸を食べたのはまずかったぜ……」
PRINTFORMW 「食べる茸はもう少し選んだほうがいいかもしれないな……」	PRINTFORMW 「食べる茸はもう少し選んだほうがいいかもしれないな……」
PRINTFORMW 「へえ、外の世界はこういう武器が主流なのかぁ。面白いな」	PRINTFORMW 「へえ、外の世界はこういう武器が主流なのかぁ。面白いな」
PRINTFORMW 「服以外も直したり拾ってきてくれると便利なんだけどなぁ」	PRINTFORMW 「服以外も直したり拾ってきてくれると便利なんだけどなぁ」
PRINTFORMW 「はぁ……気が休まるけど、そろそろ出発したほうがいいか」	PRINTFORMW 「はぁ……気が休まるけど、そろそろ出発したほうがいいか」
PRINTFORMW 「こっちに手出しする気がなくなるまで焼き尽くしてやる！」	PRINTFORMW 「こっちに手出しする気がなくなるまで焼き尽くしてやる！」
PRINTFORMW 「まとめてぶち込んでやるぜ……動かなくなるまでな……！」	PRINTFORMW 「まとめてぶち込んでやるぜ……動かなくなるまでな……！」
PRINTFORMW 「う……うわ、うわあっ！　な、何もされてない、よな！？」	PRINTFORMW 「う……うわ、うわあっ！　な、何もされてない、よな！？」
PRINTFORMW 　許さない、許さない、許さないっ！　絶対、許さない！！」	PRINTFORMW 　許さない、許さない、許さないっ！　絶対、許さない！！」
PRINTFORMW 「……こ、こっち来るなよ。最低５メートル離れて口を開け」	PRINTFORMW 「……こ、こっち来るなよ。最低５メートル離れて口を開け」
PRINTFORMW 「こ、これって……そんな、私、本当に、ははおや、に……」	PRINTFORMW 「こ、これって……そんな、私、本当に、ははおや、に……」
PRINTFORMW 「うそ……そだってる、私の胸で化け物がそだってぇっ！？」	PRINTFORMW 「うそ……そだってる、私の胸で化け物がそだってぇっ！？」
PRINTFORMDW 悪夢を振り払うように、魔理沙は自分の首を振っている……	PRINTFORMDW 悪夢を振り払うように、魔理沙は自分の首を振っている……
PRINTFORMW 「もうやだ……化け物も疼いちゃう自分の体もやだぁ……！」	PRINTFORMW 「もうやだ……化け物も疼いちゃう自分の体もやだぁ……！」
PRINTFORMW （こんな状態じゃ……逃げまわることしか、できないよ……）	PRINTFORMW （こんな状態じゃ……逃げまわることしか、できないよ……）
PRINTFORMW （集めて置いてある辺り、私、見張られてるんだろうか……）	PRINTFORMW （集めて置いてある辺り、私、見張られてるんだろうか……）
PRINTFORMW 「うん……よく分からないけど、もう少し頑張れるかも……」	PRINTFORMW 「うん……よく分からないけど、もう少し頑張れるかも……」
PRINTFORMW 「余計な手間が増えただけよ。私一人でもなんとかなったわ」	PRINTFORMW 「余計な手間が増えただけよ。私一人でもなんとかなったわ」
PRINTFORMDW 飛び交い始める弾幕、やんややんやと騒ぎ立てる観客たち。	PRINTFORMDW 飛び交い始める弾幕、やんややんやと騒ぎ立てる観客たち。
PRINTFORMW 「早く神隠しが起こらないかなぁ……やっ、痛いって霊夢！」	PRINTFORMW 「早く神隠しが起こらないかなぁ……やっ、痛いって霊夢！」
PRINTFORMDW 新たな神隠しの犠牲者が出たのは、その翌日のことだった。	PRINTFORMDW 新たな神隠しの犠牲者が出たのは、その翌日のことだった。
PRINTFORMW （もう、終わったんだ……早く風化して。忘れさせてよ……）	PRINTFORMW （もう、終わったんだ……早く風化して。忘れさせてよ……）
PRINTFORMW 「にっくきターゲットに集中し、優しく放つは恋の魔法！」	PRINTFORMW 「にっくきターゲットに集中し、優しく放つは恋の魔法！」
PRINTFORMW 「だ、出すのだけは、お願いだから……いや、いやぁっ！」	PRINTFORMW 「だ、出すのだけは、お願いだから……いや、いやぁっ！」
PRINTFORMW 「やめてぇ……こんな、いたぶる、ような、やりかたぁ！」	PRINTFORMW 「やめてぇ……こんな、いたぶる、ような、やりかたぁ！」
PRINTFORMW 「変なものが入ってないか、警戒しといたほうがいいだろ」	PRINTFORMW 「変なものが入ってないか、警戒しといたほうがいいだろ」
PRINTFORMW 「ばばばば馬鹿なこと言うなヘンタイ、とっとと離れろ！」	PRINTFORMW 「ばばばば馬鹿なこと言うなヘンタイ、とっとと離れろ！」
PRINTFORMW 「……こんなに揃って落ちてる辺り、誰か集めてるのか？」	PRINTFORMW 「……こんなに揃って落ちてる辺り、誰か集めてるのか？」
PRINTFORMW 「変なものが入っていないかどうか、識別しておかないと」	PRINTFORMW 「変なものが入っていないかどうか、識別しておかないと」
PRINTFORMW 「こ、この形……やっぱりそういうことに使うのかな……」	PRINTFORMW 「こ、この形……やっぱりそういうことに使うのかな……」
PRINTFORMW 「魔力を使わずに済むのなら、それに越したことはないか」	PRINTFORMW 「魔力を使わずに済むのなら、それに越したことはないか」
PRINTFORMW 「霊夢……れいむ、わたし、私はぁ――うああああぁっ！」	PRINTFORMW 「霊夢……れいむ、わたし、私はぁ――うああああぁっ！」
PRINTFORML 「今はこうでも、産む時はまた、気持ちよくされるの……？	PRINTFORML 「今はこうでも、産む時はまた、気持ちよくされるの……？
PRINTFORMW 「結界の中に、私一人だけ……怖いよ……寂しい、よ……」	PRINTFORMW 「結界の中に、私一人だけ……怖いよ……寂しい、よ……」
PRINTFORMDW それでも、彼女は迷宮を探し続けている。理由は簡単だ。	PRINTFORMDW それでも、彼女は迷宮を探し続けている。理由は簡単だ。
PRINTFORMW 「なら、聞くけど。魔理沙は、本当に元凶と戦いたいの？」	PRINTFORMW 「なら、聞くけど。魔理沙は、本当に元凶と戦いたいの？」
PRINTFORMW 「レーザー照準……『実りやすいマスタースパーク』！」	PRINTFORMW 「レーザー照準……『実りやすいマスタースパーク』！」
PRINTFORMW 　………………………………酷いこと、しないでよ……」	PRINTFORMW 　………………………………酷いこと、しないでよ……」
PRINTFORMW 「なんとか無事に済んだが……やっぱり、何かおかしい」	PRINTFORMW 「なんとか無事に済んだが……やっぱり、何かおかしい」
PRINTFORMW 「わ、私、まさか、本当に……中まで、おか、されて……	PRINTFORMW 「わ、私、まさか、本当に……中まで、おか、されて……
PRINTFORMW 「……はぁ、拾うのもおっくうだなんて、私らしくない」	PRINTFORMW 「……はぁ、拾うのもおっくうだなんて、私らしくない」
PRINTFORMW 「ド、ドコカデミタカナ？　ワタシニハワカラナイナー」	PRINTFORMW 「ド、ドコカデミタカナ？　ワタシニハワカラナイナー」
PRINTFORMW （こういう小さな火力でも、ちゃんと積み重ねないとな）	PRINTFORMW （こういう小さな火力でも、ちゃんと積み重ねないとな）
PRINTFORMW 「うん、私が考えた通り、やっぱり隠し通路があったな」	PRINTFORMW 「うん、私が考えた通り、やっぱり隠し通路があったな」
PRINTFORMW 「……う、おかしいな……鑑定眼には自信があるんだが」	PRINTFORMW 「……う、おかしいな……鑑定眼には自信があるんだが」
PRINTFORMW 「魔法の森に比べればなんてことな……な、なんだアレ」	PRINTFORMW 「魔法の森に比べればなんてことな……な、なんだアレ」
PRINTFORMW 「ん、落とし物じゃないか。私が有効活用して……！？」	PRINTFORMW 「ん、落とし物じゃないか。私が有効活用して……！？」
PRINTFORMDW 魔理沙は相手に近づく事を、明らかに嫌がっている……	PRINTFORMDW 魔理沙は相手に近づく事を、明らかに嫌がっている……
PRINTFORMW 「は……ああぁんっ！　しゃせー、やめてってばぁ！？」	PRINTFORMW 「は……ああぁんっ！　しゃせー、やめてってばぁ！？」
PRINTFORMW 「お、お前たちなんかに、吸わせるものじゃあぁっ！？」	PRINTFORMW 「お、お前たちなんかに、吸わせるものじゃあぁっ！？」
PRINTFORMW 「こんなのを拾ってもなぁ……魔砲を撃ったほうが早い」	PRINTFORMW 「こんなのを拾ってもなぁ……魔砲を撃ったほうが早い」
PRINTFORMW 「もっ、もう、やめへっ……も、まんぞく、してぇ……」	PRINTFORMW 「もっ、もう、やめへっ……も、まんぞく、してぇ……」
PRINTFORMW 「だ……だめ……急に、変な気持ちに、なってぇ……！」	PRINTFORMW 「だ……だめ……急に、変な気持ちに、なってぇ……！」
PRINTFORMW 「来るな来るな来るな来るな来るな来るな来るなぁっ！」	PRINTFORMW 「来るな来るな来るな来るな来るな来るな来るなぁっ！」
PRINTFORM 　子供できちゃうのにぃ、できちゃうのにぃ、悦んじゃうぅ	PRINTFORM 　子供できちゃうのにぃ、できちゃうのにぃ、悦んじゃうぅ
PRINTFORMW 「やっぱりここから抜け出すなんて、無理なのか……？」	PRINTFORMW 「やっぱりここから抜け出すなんて、無理なのか……？」
PRINTFORMW 「よ、よかった。ちゃんと予測通り、まともな薬だった」	PRINTFORMW 「よ、よかった。ちゃんと予測通り、まともな薬だった」
PRINTFORMDW 果たしてあの石碑に書かれていた内容は真実なのか……	PRINTFORMDW 果たしてあの石碑に書かれていた内容は真実なのか……
PRINTFORMW 「やっぱ、後ろでびくついているのは性に合わないな」	PRINTFORMW 「やっぱ、後ろでびくついているのは性に合わないな」
PRINTFORMW 「狙う必要もないくらい、派手に撃つほうが簡単だ！」	PRINTFORMW 「狙う必要もないくらい、派手に撃つほうが簡単だ！」
PRINTFORMW 「とっておき……『ファイナルマスタースパーク』！」	PRINTFORMW 「とっておき……『ファイナルマスタースパーク』！」
PRINTFORMW 「ちょ、ちょっと待てよ、こんな状態なのに……！？」	PRINTFORMW 「ちょ、ちょっと待てよ、こんな状態なのに……！？」
PRINTFORMW 　なんで私のむね……こんなことに、なってるの……）	PRINTFORMW 　なんで私のむね……こんなことに、なってるの……）
PRINTFORMW 「お前、運がいいな。この私が助けに来てやったぜ！」	PRINTFORMW 「お前、運がいいな。この私が助けに来てやったぜ！」
PRINTFORMW 「いっ、痛い……！　私の体、どうなるんだよぉ……」	PRINTFORMW 「いっ、痛い……！　私の体、どうなるんだよぉ……」
PRINTFORMW 「うっ……んっ、ダメだ、薬で誤魔化しても辛い……」	PRINTFORMW 「うっ……んっ、ダメだ、薬で誤魔化しても辛い……」
PRINTFORMW 「私の魔砲に比べれば、こんなの飾りみたいなもんだ」	PRINTFORMW 「私の魔砲に比べれば、こんなの飾りみたいなもんだ」
PRINTFORMW 「スパークを再現するなんて、私には何てことないぜ」	PRINTFORMW 「スパークを再現するなんて、私には何てことないぜ」
PRINTFORMW 「？　服か……？　なんでこんな所に落ちてるんだ？」	PRINTFORMW 「？　服か……？　なんでこんな所に落ちてるんだ？」
PRINTFORMW 　な、霊夢。もう出てこいよ。れい、む………………」	PRINTFORMW 　な、霊夢。もう出てこいよ。れい、む………………」
PRINTFORMW 　何も考えられないくらい、めちゃくちゃにして……」	PRINTFORMW 　何も考えられないくらい、めちゃくちゃにして……」
PRINTFORMW 「や、やめろっ、射精するなっ、なかは嫌だぁっ！？」	PRINTFORMW 「や、やめろっ、射精するなっ、なかは嫌だぁっ！？」
PRINTFORM 「いっ、イきたくない、イきたくない、イきたくなひぃっ	PRINTFORM 「いっ、イきたくない、イきたくない、イきたくなひぃっ
PRINTFORMW 「……そこで止まれよ。私がいいって言うまで動くな」	PRINTFORMW 「……そこで止まれよ。私がいいって言うまで動くな」
PRINTFORMW 「今のうちに、少しでも、消しておかない、と……！」	PRINTFORMW 「今のうちに、少しでも、消しておかない、と……！」
PRINTFORMW 「……もし毒だったりしたら、どうしようもなくなる」	PRINTFORMW 「……もし毒だったりしたら、どうしようもなくなる」
PRINTFORMW 「どんな手を使っても殺してやる、霊夢の仇……！！」	PRINTFORMW 「どんな手を使っても殺してやる、霊夢の仇……！！」
PRINTFORMW 「こんなの相手に、戦い続けられるわけないよぉ……」	PRINTFORMW 「こんなの相手に、戦い続けられるわけないよぉ……」
PRINTFORMW 「怖い、出たくない、あいつらの前に出たくないっ！」	PRINTFORMW 「怖い、出たくない、あいつらの前に出たくないっ！」
PRINTFORMW 「もしかして、あれ……やっぱり霊夢だ、助かった！」	PRINTFORMW 「もしかして、あれ……やっぱり霊夢だ、助かった！」
PRINTFORMW 「次はちゃんと、解毒薬を用意できればいいんだけど」	PRINTFORMW 「次はちゃんと、解毒薬を用意できればいいんだけど」
PRINTFORMW 「……こんな状況でこんなのとか、バカにしてるのか」	PRINTFORMW 「……こんな状況でこんなのとか、バカにしてるのか」
PRINTFORMDW いつかは、迷宮が跡形もなく消える日も来るだろう。	PRINTFORMDW いつかは、迷宮が跡形もなく消える日も来るだろう。
PRINTFORMDW 背を向けると、遺体をどこかへぽい、と投げ捨てた。	PRINTFORMDW 背を向けると、遺体をどこかへぽい、と投げ捨てた。
PRINTFORMDW 時間は朝四時、眠るにも起きるにも中途半端な時間。	PRINTFORMDW 時間は朝四時、眠るにも起きるにも中途半端な時間。
PRINTFORMW 「くそ、手応えがあったかどうか分かりづらい……」	PRINTFORMW 「くそ、手応えがあったかどうか分かりづらい……」
PRINTFORMW 「きゃあっ！？　…………はっ、今のなし、今の！」	PRINTFORMW 「きゃあっ！？　…………はっ、今のなし、今の！」
PRINTFORMW 「こするの……もう、やめ……だっ、やめっろぉ！」	PRINTFORMW 「こするの……もう、やめ……だっ、やめっろぉ！」
PRINTFORMW 　好きになった人にあげないといけないのに……！」	PRINTFORMW 　好きになった人にあげないといけないのに……！」
PRINTFORMW 「まぁ、少なくともあの地下よりは広いよな、ここ」	PRINTFORMW 「まぁ、少なくともあの地下よりは広いよな、ここ」
PRINTFORMW 「えっ、な、何をして……ちょ、ちょっと急用が！」	PRINTFORMW 「えっ、な、何をして……ちょ、ちょっと急用が！」
PRINTFORMW 「無闇に組んだら、私の取り分が減ってしまうだろ」	PRINTFORMW 「無闇に組んだら、私の取り分が減ってしまうだろ」
PRINTFORMW はじめて産んだ子供が……あんな……ばけも、の……	PRINTFORMW はじめて産んだ子供が……あんな……ばけも、の……
PRINTFORMW 「さすがに、薬でごまかせる眠さじゃないかな……」	PRINTFORMW 「さすがに、薬でごまかせる眠さじゃないかな……」
PRINTFORMW 「眠気覚ましなんて、薬を使ったほうが早いのにな」	PRINTFORMW 「眠気覚ましなんて、薬を使ったほうが早いのにな」
PRINTFORMW 「な、なんだよこの形……何に使うんだこんなの？」	PRINTFORMW 「な、なんだよこの形……何に使うんだこんなの？」
PRINTFORMW 「……やっぱ、私が世話してやらないとまずいよな」	PRINTFORMW 「……やっぱ、私が世話してやらないとまずいよな」
PRINTFORMW 「……落とし主には悪いけど、こっちも大変なんだ」	PRINTFORMW 「……落とし主には悪いけど、こっちも大変なんだ」
PRINTFORMW 「何か、今の状況を打開できるような……わっ！？」	PRINTFORMW 「何か、今の状況を打開できるような……わっ！？」
PRINTFORMW 「よし……よく分からないが、もっと行けそうだ！」	PRINTFORMW 「よし……よく分からないが、もっと行けそうだ！」
PRINTFORMDW 魔理沙は穴の先にあるものを見て絶句している……	PRINTFORMDW 魔理沙は穴の先にあるものを見て絶句している……
PRINTFORMW 「大丈夫、へーきだぜ、さっさと探検を続けよう！」	PRINTFORMW 「大丈夫、へーきだぜ、さっさと探検を続けよう！」
PRINTFORMW 「…………ゆるさないっ！　あいつらは、絶対に！」	PRINTFORMW 「…………ゆるさないっ！　あいつらは、絶対に！」
PRINTFORMW 「そっちがその気なら、ぶっ飛ばしてやるっ……！」	PRINTFORMW 「そっちがその気なら、ぶっ飛ばしてやるっ……！」
PRINTFORMW 「い、いやだ、やだっ……もぉっ、嫌なのにぃっ！」	PRINTFORMW 「い、いやだ、やだっ……もぉっ、嫌なのにぃっ！」
PRINTFORMW 「あ、うあぁ！？　出さないで……出さないでぇ！」	PRINTFORMW 「あ、うあぁ！？　出さないで……出さないでぇ！」
PRINTFORMW 「ちくしょう……出すなよ、出さないでよぉ……！」	PRINTFORMW 「ちくしょう……出すなよ、出さないでよぉ……！」
PRINTFORMW 　イってるのに、むねダメなのにせめないでぇ！？」	PRINTFORMW 　イってるのに、むねダメなのにせめないでぇ！？」
PRINTFORMW 「うぅっ……あいつらの毒が残っているのかな……」	PRINTFORMW 「うぅっ……あいつらの毒が残っているのかな……」
PRINTFORMW 「次はちゃんと、解毒薬を用意できればいいんだが」	PRINTFORMW 「次はちゃんと、解毒薬を用意できればいいんだが」
PRINTFORMW 「……落とし主には悪いけど……こうでもしないと」	PRINTFORMW 「……落とし主には悪いけど……こうでもしないと」
PRINTFORMW 　見間違いでも、冗談でも、悪戯でも……ないよな。	PRINTFORMW 　見間違いでも、冗談でも、悪戯でも……ないよな。
PRINTFORMW 「動くな、動くな、動くな……動かないでぇ……！」	PRINTFORMW 「動くな、動くな、動くな……動かないでぇ……！」
PRINTFORM 　すわれるのきもちいい、母乳でるとかんじちゃうよぉ	PRINTFORM 　すわれるのきもちいい、母乳でるとかんじちゃうよぉ
PRINTFORMW 「よかった。あいつらみたいな奴じゃないみたいだ」	PRINTFORMW 「よかった。あいつらみたいな奴じゃないみたいだ」
PRINTFORMW 「いっ！？　な、なにっ、何かのぼってきてぇっ！」	PRINTFORMW 「いっ！？　な、なにっ、何かのぼってきてぇっ！」
PRINTFORMW 「すごいな、はっきり分かるくらい再生し始めてる」	PRINTFORMW 「すごいな、はっきり分かるくらい再生し始めてる」
PRINTFORML 「何かが這って行った後が、露骨に残っているしな！	PRINTFORML 「何かが這って行った後が、露骨に残っているしな！
PRINTFORMDW 暗い洞窟の中で手ぐすね引いて待ち受けている――	PRINTFORMDW 暗い洞窟の中で手ぐすね引いて待ち受けている――
PRINTFORMW 「逃げても無駄だぜ、『グリーンスプレッド』！」	PRINTFORMW 「逃げても無駄だぜ、『グリーンスプレッド』！」
PRINTFORML 「あ……あぁ！　わ、わたし……やっちゃった……	PRINTFORML 「あ……あぁ！　わ、わたし……やっちゃった……
PRINTFORMW 「まあ、我慢はできるけど……無理は禁物だよな」	PRINTFORMW 「まあ、我慢はできるけど……無理は禁物だよな」
PRINTFORMW 「凄いな、これ……箒とかに組み込めないかな？」	PRINTFORMW 「凄いな、これ……箒とかに組み込めないかな？」
PRINTFORMW 「いっ！？　な、何だ、なにかのぼってきてっ！」	PRINTFORMW 「いっ！？　な、何だ、なにかのぼってきてっ！」
PRINTFORMW 「い、いやだ、あんな目に遭うのはもう嫌ぁっ！」	PRINTFORMW 「い、いやだ、あんな目に遭うのはもう嫌ぁっ！」
PRINTFORMW 「鈍らせれば、近づいても大丈夫……大丈夫……」	PRINTFORMW 「鈍らせれば、近づいても大丈夫……大丈夫……」
PRINTFORM 「はぁ、んっ、はぁっ、もぉ、がまんできないぃ……	PRINTFORM 「はぁ、んっ、はぁっ、もぉ、がまんできないぃ……
PRINTFORM 「……気づいてないみたいだな。さっさと片付けよう	PRINTFORM 「……気づいてないみたいだな。さっさと片付けよう
PRINTFORMW 　わたしっ、いんらんじゃ、ないの、にぃっ！？」	PRINTFORMW 　わたしっ、いんらんじゃ、ないの、にぃっ！？」
PRINTFORMW 「……できるだけ頑張る……だから、助けてくれ」	PRINTFORMW 「……できるだけ頑張る……だから、助けてくれ」
PRINTFORMW 「分かってる。ここで一人になるのは自殺行為だ」	PRINTFORMW 「分かってる。ここで一人になるのは自殺行為だ」
PRINTFORMW 「どうして、なんで、なんで私がこんな目に……」	PRINTFORMW 「どうして、なんで、なんで私がこんな目に……」
PRINTFORMW 「うっ……んっ、ダメだ、薬で誤魔化しても辛い」	PRINTFORMW 「うっ……んっ、ダメだ、薬で誤魔化しても辛い」
PRINTFORMW 「封は……うん、ちゃんと密閉されてるみたいだ」	PRINTFORMW 「封は……うん、ちゃんと密閉されてるみたいだ」
PRINTFORM 「あ……赤ちゃん、あかちゃんぅ……ふぅっ、ンンッ	PRINTFORM 「あ……赤ちゃん、あかちゃんぅ……ふぅっ、ンンッ
PRINTFORMW 「早く消えて！　もう何もしないでぇえっ！！！」	PRINTFORMW 「早く消えて！　もう何もしないでぇえっ！！！」
PRINTFORMW 「休みたい……寝たい……ぐっすり眠りたい……」	PRINTFORMW 「休みたい……寝たい……ぐっすり眠りたい……」
PRINTFORM 「きもちいいの、たくさぁん……♪　しあわせぇ……	PRINTFORM 「きもちいいの、たくさぁん……♪　しあわせぇ……
PRINTFORMW 「何でもいいから、私の助けになるものっ……！」	PRINTFORMW 「何でもいいから、私の助けになるものっ……！」
PRINTFORMDW その理由は、彼女が見つめる存在が示している。	PRINTFORMDW その理由は、彼女が見つめる存在が示している。
PRINTFORMDW 汗にまみれたその表情は、鬼気迫るものだった。	PRINTFORMDW 汗にまみれたその表情は、鬼気迫るものだった。
PRINTFORMW 「レーザーで飲みこむのも貫通って言うだろ？」	PRINTFORMW 「レーザーで飲みこむのも貫通って言うだろ？」
PRINTFORMW 「お、おい……ちょっと破き過ぎじゃないか？」	PRINTFORMW 「お、おい……ちょっと破き過ぎじゃないか？」
PRINTFORMW 「……スペルカードルールはどこ行ったんだか」	PRINTFORMW 「……スペルカードルールはどこ行ったんだか」
PRINTFORML 「はぁ、うああぁっ！？　え……あ、えっ……？	PRINTFORML 「はぁ、うああぁっ！？　え……あ、えっ……？
PRINTFORMW 「とりあえず、今は適当にしまっておくか……」	PRINTFORMW 「とりあえず、今は適当にしまっておくか……」
PRINTFORMDW 魔理沙は怯えているように無言で後退した……	PRINTFORMDW 魔理沙は怯えているように無言で後退した……
PRINTFORMW 「来るなら来い、片っ端から全部倒してやる！」	PRINTFORMW 「来るなら来い、片っ端から全部倒してやる！」
PRINTFORMW 　わたしのからだっ、おかひくなってぇっ！？」	PRINTFORMW 　わたしのからだっ、おかひくなってぇっ！？」
PRINTFORMW 「悪いが、お前とは組まない。少なくとも今は」	PRINTFORMW 「悪いが、お前とは組まない。少なくとも今は」
PRINTFORMW 「とりあえず、今は適当にしまっておこう……」	PRINTFORMW 「とりあえず、今は適当にしまっておこう……」
PRINTFORMW 「なんで……なんでまだ溜め終わらないの！？」	PRINTFORMW 「なんで……なんでまだ溜め終わらないの！？」
PRINTFORM 「からだ、変わってるの、どんどんいじられてぇっ	PRINTFORM 「からだ、変わってるの、どんどんいじられてぇっ
PRINTFORM 「もっと、もっと、もっとぉ、そのまま、はひぃっ	PRINTFORM 「もっと、もっと、もっとぉ、そのまま、はひぃっ
PRINTFORMW 「無事な相手と会えて、ほんとよかった……！」	PRINTFORMW 「無事な相手と会えて、ほんとよかった……！」
PRINTFORM 　なか、からっぽになってスースーしてるよぉ……	PRINTFORM 　なか、からっぽになってスースーしてるよぉ……
PRINTFORMW 「よ、よしっ……！　これならもう少しは……」	PRINTFORMW 「よ、よしっ……！　これならもう少しは……」
PRINTFORMW 「わ、私……そんなヘンタイじゃないっ……！」	PRINTFORMW 「わ、私……そんなヘンタイじゃないっ……！」
PRINTFORMW 「戦わないと。霊夢の仇を――――討つんだ！」	PRINTFORMW 「戦わないと。霊夢の仇を――――討つんだ！」
PRINTFORMDW 潜ろうにも潜れないのが理由の一つではある。	PRINTFORMDW 潜ろうにも潜れないのが理由の一つではある。
PRINTFORMW 「ごめん、霊夢……また何も見つからなかった」	PRINTFORMW 「ごめん、霊夢……また何も見つからなかった」
PRINTFORMW 「もう……嫌だよ、異変を解決するなんて……」	PRINTFORMW 「もう……嫌だよ、異変を解決するなんて……」
PRINTFORMDW そんな魔理沙を、霊夢はじっと見つめた後……	PRINTFORMDW そんな魔理沙を、霊夢はじっと見つめた後……
PRINTFORMW 「じゃ、私が一人で解決しちゃっていいよな？」	PRINTFORMW 「じゃ、私が一人で解決しちゃっていいよな？」
PRINTFORMW 「これくらいでも、十分なんだからな……！」	PRINTFORMW 「これくらいでも、十分なんだからな……！」
PRINTFORMW 「動くと全部撃つ、動かなくても全部撃つ！」	PRINTFORMW 「動くと全部撃つ、動かなくても全部撃つ！」
PRINTFORMW 「こ、ここから、逆転すればいいだけだ……」	PRINTFORMW 「こ、ここから、逆転すればいいだけだ……」
PRINTFORMW 「あうぅっ……なんでっ、こんなことぉ……」	PRINTFORMW 「あうぅっ……なんでっ、こんなことぉ……」
PRINTFORMW 「こいつを倒せば終わるんだな……よぉし！」	PRINTFORMW 「こいつを倒せば終わるんだな……よぉし！」
PRINTFORMW 「く、くそっ……何なんだよこいつら……！」	PRINTFORMW 「く、くそっ……何なんだよこいつら……！」
PRINTFORMW 「……悪いが、後は自力でなんとかしてくれ」	PRINTFORMW 「……悪いが、後は自力でなんとかしてくれ」
PRINTFORM 「い、嫌だ、見られてるのに、イくの、やだぁっ	PRINTFORM 「い、嫌だ、見られてるのに、イくの、やだぁっ
PRINTFORMW 「おい偽者！　変な笑い方するのはやめろ！」	PRINTFORMW 「おい偽者！　変な笑い方するのはやめろ！」
PRINTFORMW 「嘘だろ……本当に、お腹にいるのか……？」	PRINTFORMW 「嘘だろ……本当に、お腹にいるのか……？」
PRINTFORMW 　　　　　　　　　　　　　まさ……か……」	PRINTFORMW 　　　　　　　　　　　　　まさ……か……」
PRINTFORMW 「ゃ、いや……胸弱いのに、そんなにぃ！？」	PRINTFORMW 「ゃ、いや……胸弱いのに、そんなにぃ！？」
PRINTFORMW 「さすがにこれだけ仕込めば通れない、よな」	PRINTFORMW 「さすがにこれだけ仕込めば通れない、よな」
PRINTFORMW 「あ……あれ……なんだろ、この気持ち……」	PRINTFORMW 「あ……あれ……なんだろ、この気持ち……」
PRINTFORMW 「まずい、な……何かおかしな胞子か……？」	PRINTFORMW 「まずい、な……何かおかしな胞子か……？」
PRINTFORMW 「あの感じ、私の識別では何か怪しいと見た」	PRINTFORMW 「あの感じ、私の識別では何か怪しいと見た」
PRINTFORMW 「こんくらいでも、十分なんだからな……！」	PRINTFORMW 「こんくらいでも、十分なんだからな……！」
PRINTFORMW 「弾幕はパワー……だから、すぐに落とす！」	PRINTFORMW 「弾幕はパワー……だから、すぐに落とす！」
PRINTFORMW 「お前たちにかける情けなんてないぜ……！」	PRINTFORMW 「お前たちにかける情けなんてないぜ……！」
PRINTFORM 「は……ああぁん♪　しゃせー、やめてってばぁ	PRINTFORM 「は……ああぁん♪　しゃせー、やめてってばぁ
PRINTFORMW 「お前の……お前たちのせいで、霊夢は！！」	PRINTFORMW 「お前の……お前たちのせいで、霊夢は！！」
PRINTFORMW 「できれば、助けたいんだ……だけど……！」	PRINTFORMW 「できれば、助けたいんだ……だけど……！」
PRINTFORML 「ひぐっ、えぐっ、うぐぅっ……ひっく……」	PRINTFORML 「ひぐっ、えぐっ、うぐぅっ……ひっく……」
PRINTFORMW 「……細かい奴でも、もし見逃したりしたら」	PRINTFORMW 「……細かい奴でも、もし見逃したりしたら」
PRINTFORMW 「箒に仕込んで――も、あんまり意味ないか」	PRINTFORMW 「箒に仕込んで――も、あんまり意味ないか」
PRINTFORMW 「今は大丈夫だけど、でも、これじゃあ……」	PRINTFORMW 「今は大丈夫だけど、でも、これじゃあ……」
PRINTFORMW 「……………………………仇は、討たなきゃ」	PRINTFORMW 「……………………………仇は、討たなきゃ」
PRINTFORMW 「あいつら相手に接近戦なんて無理だよ……」	PRINTFORMW 「あいつら相手に接近戦なんて無理だよ……」
PRINTFORM 「はぁ、んっ、はぁっ、もぉ、がまんできないぃ	PRINTFORM 「はぁ、んっ、はぁっ、もぉ、がまんできないぃ
PRINTFORMW 「そ、そんなの見せるな……見せないでぇ！」	PRINTFORMW 「そ、そんなの見せるな……見せないでぇ！」
PRINTFORM 　もうがまんむりぃ、あたま真っ白にしゅるぅっ	PRINTFORM 　もうがまんむりぃ、あたま真っ白にしゅるぅっ
PRINTFORML 「はぁっ……ああぁっ、いやぁ、いやぁっ……	PRINTFORML 「はぁっ……ああぁっ、いやぁ、いやぁっ……
PRINTFORMW 　霊夢、霊夢、霊夢霊夢……れい、む……！」	PRINTFORMW 　霊夢、霊夢、霊夢霊夢……れい、む……！」
PRINTFORMDW それは、魔理沙にとって最悪の一言だった。	PRINTFORMDW それは、魔理沙にとって最悪の一言だった。
PRINTFORMDW その場に崩れ落ちた魔理沙は、泣いていた。	PRINTFORMDW その場に崩れ落ちた魔理沙は、泣いていた。
PRINTFORMDW いや、争っているという表現は正しくない。	PRINTFORMDW いや、争っているという表現は正しくない。
PRINTFORMW 「変な事されたくらいで、負けるかぁっ！」	PRINTFORMW 「変な事されたくらいで、負けるかぁっ！」
PRINTFORMW 「こっちのパワーには自信ないんだが……」	PRINTFORMW 「こっちのパワーには自信ないんだが……」
PRINTFORMW （す、少しだけ……すぐ終わらせれば……）	PRINTFORMW （す、少しだけ……すぐ終わらせれば……）
PRINTFORMW 「い、いや、こんなの見たくないのに……」	PRINTFORMW 「い、いや、こんなの見たくないのに……」
PRINTFORMW 「こっ……こんなやり方、卑怯だぞっ……」	PRINTFORMW 「こっ……こんなやり方、卑怯だぞっ……」
PRINTFORMW 「こ、この、気持ち悪い縛り方するなぁ！」	PRINTFORMW 「こ、この、気持ち悪い縛り方するなぁ！」
PRINTFORMW 「こういう時に効く薬は……なんだったか」	PRINTFORMW 「こういう時に効く薬は……なんだったか」
PRINTFORML 「い、いやだ、いやだいやだいやだいやだ！	PRINTFORML 「い、いやだ、いやだいやだいやだいやだ！
PRINTFORM 「ぁ……あ、あぁ……あれが、こども……？　	PRINTFORM 「ぁ……あ、あぁ……あれが、こども……？　
PRINTFORMW ばけものに犯されて……でき、た、私の……	PRINTFORMW ばけものに犯されて……でき、た、私の……
PRINTFORMW 「……これが魔法使いの武器？　マジで？」	PRINTFORMW 「……これが魔法使いの武器？　マジで？」
PRINTFORMW 「温泉というには趣がないよなー、暗いし」	PRINTFORMW 「温泉というには趣がないよなー、暗いし」
PRINTFORMW 「……………………………………許さない」	PRINTFORMW 「……………………………………許さない」
PRINTFORMW 「強くする必要はない……ないんだ……！」	PRINTFORMW 「強くする必要はない……ないんだ……！」
PRINTFORMW 「これくらいっ、なんとも……ないっ……」	PRINTFORMW 「これくらいっ、なんとも……ないっ……」
PRINTFORMW 「来るって分かってれば我慢できる……！」	PRINTFORMW 「来るって分かってれば我慢できる……！」
PRINTFORMW 「くそっ……こんな所でやられるもんか！」	PRINTFORMW 「くそっ……こんな所でやられるもんか！」
PRINTFORMW 「嫌だ……またあんな目に遭うのは嫌ぁ！」	PRINTFORMW 「嫌だ……またあんな目に遭うのは嫌ぁ！」
PRINTFORMW 「酷いよぉ……こんなのって、ない……！」	PRINTFORMW 「酷いよぉ……こんなのって、ない……！」
PRINTFORMW 「わたしの、からだ……どう、なって……」	PRINTFORMW 「わたしの、からだ……どう、なって……」
PRINTFORMW 「見たことのない柄だけど……誰のだろう」	PRINTFORMW 「見たことのない柄だけど……誰のだろう」
PRINTFORMW 「ふざけんなヘンタイ、とっとと離れろ！」	PRINTFORMW 「ふざけんなヘンタイ、とっとと離れろ！」
PRINTFORMW 「何か脱出の役に立つといいんだが……」」	PRINTFORMW 「何か脱出の役に立つといいんだが……」」
PRINTFORMW 　ここは……そういうところ、だから……」	PRINTFORMW 　ここは……そういうところ、だから……」
PRINTFORMW 「そのうち…………私も、こうなるのかな」	PRINTFORMW 「そのうち…………私も、こうなるのかな」
PRINTFORM 「ふあぁっ！　いじられ、てるぅ……からだぁ	PRINTFORM 「ふあぁっ！　いじられ、てるぅ……からだぁ
PRINTFORMW 「や、やっぱり……これでも受精して……」	PRINTFORMW 「や、やっぱり……これでも受精して……」
PRINTFORM 　にんげんじゃないせーえき、きもちいぃ……	PRINTFORM 　にんげんじゃないせーえき、きもちいぃ……
PRINTFORMW 「これ以上、体をおかしくされたら……！」	PRINTFORMW 「これ以上、体をおかしくされたら……！」
PRINTFORMW 「……これなら、しばらくは大丈夫そうだ」	PRINTFORMW 「……これなら、しばらくは大丈夫そうだ」
PRINTFORMW 「……どうせ、元はあいつらの仲間なんだ」	PRINTFORMW 「……どうせ、元はあいつらの仲間なんだ」
PRINTFORMW 「きゃあっ！　あ……敵、じゃない……？」	PRINTFORMW 「きゃあっ！　あ……敵、じゃない……？」
PRINTFORMW 「……お前でもまだ、解決できないのか？」	PRINTFORMW 「……お前でもまだ、解決できないのか？」
PRINTFORMW 「やっぱり……こんなの、意味ないのかな」	PRINTFORMW 「やっぱり……こんなの、意味ないのかな」
PRINTFORMW 「もう、帰りたい……家で寝たいよぉ……」	PRINTFORMW 「もう、帰りたい……家で寝たいよぉ……」
PRINTFORMW 「きもいからそばに置きたくないけど……」	PRINTFORMW 「きもいからそばに置きたくないけど……」
PRINTFORMW 「脱出口に繋がってたりしてないかな……」	PRINTFORMW 「脱出口に繋がってたりしてないかな……」
PRINTFORMW （何かの瘴気か……？　危なかったぁ……）	PRINTFORMW （何かの瘴気か……？　危なかったぁ……）
PRINTFORMW 「何かにはなったかもしれないじゃないか」	PRINTFORMW 「何かにはなったかもしれないじゃないか」
PRINTFORMW 「犠牲者が出るのを期待してどうすんのよ」	PRINTFORMW 「犠牲者が出るのを期待してどうすんのよ」
PRINTFORMW 「まだまだ箒は折れない……よな……？」	PRINTFORMW 「まだまだ箒は折れない……よな……？」
PRINTFORMW 「恋符、『マスタースパーク』っ……！」	PRINTFORMW 「恋符、『マスタースパーク』っ……！」
PRINTFORMW 「まとめて、ふっ飛ばしてやるっ……！」	PRINTFORMW 「まとめて、ふっ飛ばしてやるっ……！」
PRINTFORMW 「だめ……こんなの、おかしいよぉ……」	PRINTFORMW 「だめ……こんなの、おかしいよぉ……」
PRINTFORMW 「……これは、ちょっと、まずいかな？」	PRINTFORMW 「……これは、ちょっと、まずいかな？」
PRINTFORMW 「……どうもあいつらは信頼できないぜ」	PRINTFORMW 「……どうもあいつらは信頼できないぜ」
PRINTFORMW 「や、やめろ！　やめ……やめて……！」	PRINTFORMW 「や、やめろ！　やめ……やめて……！」
PRINTFORMW 「べ……別に……私、ひとりでやれるぜ」	PRINTFORMW 「べ……別に……私、ひとりでやれるぜ」
PRINTFORMW 「さっさと焼き尽くしておかないと……」	PRINTFORMW 「さっさと焼き尽くしておかないと……」
PRINTFORMW 「浄化なんて、ミニ八卦炉だけで十分さ」	PRINTFORMW 「浄化なんて、ミニ八卦炉だけで十分さ」
PRINTFORMW 「んっ……甘ったるい香りが、頭に……」	PRINTFORMW 「んっ……甘ったるい香りが、頭に……」
PRINTFORMW 「よし、これならなんとかなりそうだ！」	PRINTFORMW 「よし、これならなんとかなりそうだ！」
PRINTFORMW 「うわぁっ！　ぐにぐに……してぇ！？」	PRINTFORMW 「うわぁっ！　ぐにぐに……してぇ！？」
PRINTFORMW 「……倒せる、これでも戦える、戦える」	PRINTFORMW 「……倒せる、これでも戦える、戦える」
PRINTFORMW 「負けるもんか、もし負けたらっ……！」	PRINTFORMW 「負けるもんか、もし負けたらっ……！」
PRINTFORMW 「これ以上、変な真似させてたまるか！」	PRINTFORMW 「これ以上、変な真似させてたまるか！」
PRINTFORMW 「お前らのやり方はもう知ってる……！」	PRINTFORMW 「お前らのやり方はもう知ってる……！」
PRINTFORMW 「な、何かっ、何か手はないの……！？」	PRINTFORMW 「な、何かっ、何か手はないの……！？」
PRINTFORMW 「ああもう……なんかイライラするな！」	PRINTFORMW 「ああもう……なんかイライラするな！」
PRINTFORMW 「やばい……どこかで、休まないと……」	PRINTFORMW 「やばい……どこかで、休まないと……」
PRINTFORMW 「きもいし、あんまり使いたくない……」	PRINTFORMW 「きもいし、あんまり使いたくない……」
PRINTFORMW 「……もしかして、そういう薬かコレ？」	PRINTFORMW 「……もしかして、そういう薬かコレ？」
PRINTFORML 「結界の最終確認、してくれないか……？	PRINTFORML 「結界の最終確認、してくれないか……？
PRINTFORMW 「きゃあっ！　ぐにぐに……してぇ！？」	PRINTFORMW 「きゃあっ！　ぐにぐに……してぇ！？」
PRINTFORMW （何かの瘴気か……？　危なかった……）	PRINTFORMW （何かの瘴気か……？　危なかった……）
PRINTFORMW 「に、逃げるチャンスを考えないと……」	PRINTFORMW 「に、逃げるチャンスを考えないと……」
PRINTFORMW 「はなして、お願い、はなしてぇっ……」	PRINTFORMW 「はなして、お願い、はなしてぇっ……」
PRINTFORMW 「霊夢、霊夢、助けて、私を助けてぇ！」	PRINTFORMW 「霊夢、霊夢、助けて、私を助けてぇ！」
PRINTFORMW 「許さない、お前は許さないからなっ！」	PRINTFORMW 「許さない、お前は許さないからなっ！」
PRINTFORM 　えぐっ、もうなかだしやめてよぉ……！」	PRINTFORM 　えぐっ、もうなかだしやめてよぉ……！」
PRINTFORMW 「このままじゃ、犯される……また……」	PRINTFORMW 「このままじゃ、犯される……また……」
PRINTFORMW 「な、なんだよ、何者なんだよお前！？」	PRINTFORMW 「な、なんだよ、何者なんだよお前！？」
PRINTFORM 「おっぱい、出しながら……イく、なんてっ	PRINTFORM 「おっぱい、出しながら……イく、なんてっ
PRINTFORMW 「こういう時に効く薬は……なんだっけ」	PRINTFORMW 「こういう時に効く薬は……なんだっけ」
PRINTFORMW 「おなか、膨らんで――――――まさか。	PRINTFORMW 「おなか、膨らんで――――――まさか。
PRINTFORMW 「……もう、そのまま、生えてこないで」	PRINTFORMW 「……もう、そのまま、生えてこないで」
PRINTFORM 　する、気持ちいい事する、しなきゃだめぇ	PRINTFORM 　する、気持ちいい事する、しなきゃだめぇ
PRINTFORMW 「何か、脱出の役に立ってくれれば……」	PRINTFORMW 「何か、脱出の役に立ってくれれば……」
PRINTFORMW 　ここは……そういうところ、だから……	PRINTFORMW 　ここは……そういうところ、だから……
PRINTFORMW 「……っ、泣いてる、場合じゃ……ない」	PRINTFORMW 「……っ、泣いてる、場合じゃ……ない」
PRINTFORMW 「あんたに言われなくてもそのつもりよ」	PRINTFORMW 「あんたに言われなくてもそのつもりよ」
PRINTFORMDW こうして、異変はあっけなく終わった。	PRINTFORMDW こうして、異変はあっけなく終わった。
PRINTFORMW 「さよなら。もう帰って、休んでなさい」	PRINTFORMW 「さよなら。もう帰って、休んでなさい」
PRINTFORMW 「霊夢！　霊夢！　異変だぜ！　異変！」	PRINTFORMW 「霊夢！　霊夢！　異変だぜ！　異変！」
PRINTFORMW 「撃たなきゃ動かない、私が動かない」	PRINTFORMW 「撃たなきゃ動かない、私が動かない」
PRINTFORMW 「気持ち悪いのを振りまくなっ……！」	PRINTFORMW 「気持ち悪いのを振りまくなっ……！」
PRINTFORMW 「ち、近寄るくらい……平気だぜっ！」	PRINTFORMW 「ち、近寄るくらい……平気だぜっ！」
PRINTFORMW 「私のパワーならこれでも十分だぜ！」	PRINTFORMW 「私のパワーならこれでも十分だぜ！」
PRINTFORMW 「準備よし……『ナロースパーク』！」	PRINTFORMW 「準備よし……『ナロースパーク』！」
PRINTFORMW 「せーの、『ミアズマスウィープ』！」	PRINTFORMW 「せーの、『ミアズマスウィープ』！」
PRINTFORMW 「行くぜ、『ウィッチレイライン』！」	PRINTFORMW 「行くぜ、『ウィッチレイライン』！」
PRINTFORMW 「せ、せめて……ちょっとだけに……」	PRINTFORMW 「せ、せめて……ちょっとだけに……」
PRINTFORMW 「へっへーん、グレイズグレイズ～♪」	PRINTFORMW 「へっへーん、グレイズグレイズ～♪」
PRINTFORMW 「あんな戦い方、おかしいって……！」	PRINTFORMW 「あんな戦い方、おかしいって……！」
PRINTFORMW 　うそ……これ、吸っ、てえぇっ！？」	PRINTFORMW 　うそ……これ、吸っ、てえぇっ！？」
PRINTFORMW 「はぁっ……大丈夫……だよ、な……」	PRINTFORMW 「はぁっ……大丈夫……だよ、な……」
PRINTFORMW 「わっ！　あ……敵、じゃない……？」	PRINTFORMW 「わっ！　あ……敵、じゃない……？」
PRINTFORMW （……えっと、何を言えばいいんだ？）	PRINTFORMW （……えっと、何を言えばいいんだ？）
PRINTFORMW 「……何か変なキノコでも食ったかな」	PRINTFORMW 「……何か変なキノコでも食ったかな」
PRINTFORMW 「ったく、地面も壁も天井も敵か……」	PRINTFORMW 「ったく、地面も壁も天井も敵か……」
PRINTFORMW 「？　？？？　興奮剤の一種か……？」	PRINTFORMW 「？　？？？　興奮剤の一種か……？」
PRINTFORMW 「よ、よかった。これで着替えられる」	PRINTFORMW 「よ、よかった。これで着替えられる」
PRINTFORMW 「ちゃんと見張り、してくれよ……？」	PRINTFORMW 「ちゃんと見張り、してくれよ……？」
PRINTFORMW 「うげ、洒落にならないだろあれ……」	PRINTFORMW 「うげ、洒落にならないだろあれ……」
PRINTFORMW 「あ、焦っちゃだめだ、焦っちゃ……」	PRINTFORMW 「あ、焦っちゃだめだ、焦っちゃ……」
PRINTFORML 「……もう……好きにすればいいだろ。	PRINTFORML 「……もう……好きにすればいいだろ。
PRINTFORMW 「つかまっちゃ、駄目なのにぃ……！」	PRINTFORMW 「つかまっちゃ、駄目なのにぃ……！」
PRINTFORM 「気色悪い、だけなのに……なん、で……	PRINTFORM 「気色悪い、だけなのに……なん、で……
PRINTFORMW 「もう、こいつらの相手は嫌だ……！」	PRINTFORMW 「もう、こいつらの相手は嫌だ……！」
PRINTFORMW 「やられない事を優先しないと……！」	PRINTFORMW 「やられない事を優先しないと……！」
PRINTFORMW 「化物なんかが……吸う、なぁあっ！」	PRINTFORMW 「化物なんかが……吸う、なぁあっ！」
PRINTFORMW 「……こんな状態で戦うのは無理だよ」	PRINTFORMW 「……こんな状態で戦うのは無理だよ」
PRINTFORMW 「膨らまないで……成長しないでぇ！」	PRINTFORMW 「膨らまないで……成長しないでぇ！」
PRINTFORM 「こんなっ、こんなやり方ずるいよぉ……	PRINTFORM 「こんなっ、こんなやり方ずるいよぉ……
PRINTFORMW 「こわいよ、近づきたくないよ……！」	PRINTFORMW 「こわいよ、近づきたくないよ……！」
PRINTFORM 「んぅっ……♪　おなか、いっぱぁい……	PRINTFORM 「んぅっ……♪　おなか、いっぱぁい……
PRINTFORM 　イったばかりなのにまたイっちゃうぅっ	PRINTFORM 　イったばかりなのにまたイっちゃうぅっ
PRINTFORMDW 魔理沙の足は明らかに震えている……	PRINTFORMDW 魔理沙の足は明らかに震えている……
PRINTFORML 「結界の最終確認……してくれないか？	PRINTFORML 「結界の最終確認……してくれないか？
PRINTFORMW 　も、にげられ、なっ……いあぁっ！」	PRINTFORMW 　も、にげられ、なっ……いあぁっ！」
PRINTFORMDW それでも、魔理沙は攻撃をやめない。	PRINTFORMDW それでも、魔理沙は攻撃をやめない。
PRINTFORMW 「こ、これくらい、平気だぜ……！」	PRINTFORMW 「こ、これくらい、平気だぜ……！」
PRINTFORMW 「無駄打ちするわけにはいかないな」	PRINTFORMW 「無駄打ちするわけにはいかないな」
PRINTFORMW 「恋符――『マスタースパーク』！」	PRINTFORMW 「恋符――『マスタースパーク』！」
PRINTFORMW 「殴り合いなら勝てると思うなよ？」	PRINTFORMW 「殴り合いなら勝てると思うなよ？」
PRINTFORML 「こ、降参、降参するぜ、だから……	PRINTFORML 「こ、降参、降参するぜ、だから……
PRINTFORMW 「もぉ、こうさん、してるのに……」	PRINTFORMW 「もぉ、こうさん、してるのに……」
PRINTFORMW 「え……中に、何か……そ、そんな」	PRINTFORMW 「え……中に、何か……そ、そんな」
PRINTFORMW 「わ、私の速さをなめるなよ……？」	PRINTFORMW 「わ、私の速さをなめるなよ……？」
PRINTFORMW 「……狙いがどうも浅かったような」	PRINTFORMW 「……狙いがどうも浅かったような」
PRINTFORMW 「あれ……なんでお前がこんな所に」	PRINTFORMW 「あれ……なんでお前がこんな所に」
PRINTFORMW 「異変解決なら、この私に任せな！」	PRINTFORMW 「異変解決なら、この私に任せな！」
PRINTFORMW 「んぐっ！？　あむっ、んふーっ！」	PRINTFORMW 「んぐっ！？　あむっ、んふーっ！」
PRINTFORMW 「……やっぱ、前に出ないと駄目か」	PRINTFORMW 「……やっぱ、前に出ないと駄目か」
PRINTFORMW 「い……いつも通りに、撃てば……」	PRINTFORMW 「い……いつも通りに、撃てば……」
PRINTFORM 　うあぁ、だめぇ、がまんしないとぉっ	PRINTFORM 　うあぁ、だめぇ、がまんしないとぉっ
PRINTFORMW 「くそっ、変なことばっかり……！」	PRINTFORMW 「くそっ、変なことばっかり……！」
PRINTFORM 　がまんしないで、イっていいよねぇっ	PRINTFORM 　がまんしないで、イっていいよねぇっ
PRINTFORM 　こんな、されたら、もぉ……わらひぃ	PRINTFORM 　こんな、されたら、もぉ……わらひぃ
PRINTFORMW 「っと、すまん。敵かと思ったんだ」	PRINTFORMW 「っと、すまん。敵かと思ったんだ」
PRINTFORMW 「よし、できるだけ早く倒そうぜ！」	PRINTFORMW 「よし、できるだけ早く倒そうぜ！」
PRINTFORMW 「さっさと焼き尽くしておかないと」	PRINTFORMW 「さっさと焼き尽くしておかないと」
PRINTFORMW 「ここは安全……でも、私一人……」	PRINTFORMW 「ここは安全……でも、私一人……」
PRINTFORMW 「もっと休んでいきたいけどな……」	PRINTFORMW 「もっと休んでいきたいけどな……」
PRINTFORMW （瘴気、みたいだな。危なかったぜ）	PRINTFORMW （瘴気、みたいだな。危なかったぜ）
PRINTFORMW 「こんな戦い方したくないよぉ……」	PRINTFORMW 「こんな戦い方したくないよぉ……」
PRINTFORMW 「だれか、誰かっ、私を助けてぇ！」	PRINTFORMW 「だれか、誰かっ、私を助けてぇ！」
PRINTFORMW 「助けに……行けるのか。私は……」	PRINTFORMW 「助けに……行けるのか。私は……」
PRINTFORM 　きもちいいのっ、うけいれちゃうのぉ	PRINTFORM 　きもちいいのっ、うけいれちゃうのぉ
PRINTFORMW 「助けて……お願い、助けて……！」	PRINTFORMW 「助けて……お願い、助けて……！」
PRINTFORMW 「そんな……あの時、みたい……に」	PRINTFORMW 「そんな……あの時、みたい……に」
PRINTFORM 　こんなのがまんできるわけないよぉっ	PRINTFORM 　こんなのがまんできるわけないよぉっ
PRINTFORMW 「やばい……どこかで、休まないと」	PRINTFORMW 「やばい……どこかで、休まないと」
PRINTFORMW 「もう、ずっと休んでいきたい……」	PRINTFORMW 「もう、ずっと休んでいきたい……」
PRINTFORMW 「何か、何かいい道具……わっ！？」	PRINTFORMW 「何か、何かいい道具……わっ！？」
PRINTFORMW 「撃つんだ……いつも通りに……」	PRINTFORMW 「撃つんだ……いつも通りに……」
PRINTFORMW 「こ……ここから、逆転…………」	PRINTFORMW 「こ……ここから、逆転…………」
PRINTFORMW 「わわ、触るな、あっち行けぇ！」	PRINTFORMW 「わわ、触るな、あっち行けぇ！」
PRINTFORMW 「こ、これって……うそだろ……」	PRINTFORMW 「こ、これって……うそだろ……」
PRINTFORMW 「こんなの……聞いてないよ……」	PRINTFORMW 「こんなの……聞いてないよ……」
PRINTFORMW 「こ、これ……どういう、事だよ」	PRINTFORMW 「こ、これ……どういう、事だよ」
PRINTFORMW 「その動き方、気色悪いんだよ！」	PRINTFORMW 「その動き方、気色悪いんだよ！」
PRINTFORMW 「事故って当たるといけないしな」	PRINTFORMW 「事故って当たるといけないしな」
PRINTFORMW 「ったく、油断も隙もないな……」	PRINTFORMW 「ったく、油断も隙もないな……」
PRINTFORMW 「こ、このままじゃ、またっ……」	PRINTFORMW 「こ、このままじゃ、またっ……」
PRINTFORMW 「気持ち悪いのを振りまくなっ！」	PRINTFORMW 「気持ち悪いのを振りまくなっ！」
PRINTFORMW 「思いっきり全力で叩いてやる！」	PRINTFORMW 「思いっきり全力で叩いてやる！」
PRINTFORMW 「きゃっ！？　う、うぅっ……！」	PRINTFORMW 「きゃっ！？　う、うぅっ……！」
PRINTFORM 「だ、め、こんなの、変、なのに……	PRINTFORM 「だ、め、こんなの、変、なのに……
PRINTFORMW 「し、しまった……捕まったら！」	PRINTFORMW 「し、しまった……捕まったら！」
PRINTFORMW （服の次は、どう考えても……！）	PRINTFORMW （服の次は、どう考えても……！）
PRINTFORMW 「……服だけで済んだだけマシだ」	PRINTFORMW 「……服だけで済んだだけマシだ」
PRINTFORMW 「……よし……なんとか、なった」	PRINTFORMW 「……よし……なんとか、なった」
PRINTFORM 　きもちいい……きもちいいよぉ……	PRINTFORM 　きもちいい……きもちいいよぉ……
PRINTFORMW 「くそっ、好き勝手やって……！」	PRINTFORMW 「くそっ、好き勝手やって……！」
PRINTFORMW 「無事だったんだな……よかった」	PRINTFORMW 「無事だったんだな……よかった」
PRINTFORMW 「うっ……どうも気持ち悪い……」	PRINTFORMW 「うっ……どうも気持ち悪い……」
PRINTFORMW 「ったく、地面も壁も天井も敵か」	PRINTFORMW 「ったく、地面も壁も天井も敵か」
PRINTFORMW 「休みたい、けど……大丈夫かな」	PRINTFORMW 「休みたい、けど……大丈夫かな」
PRINTFORMW 「……よし。飲んでも大丈夫そう」	PRINTFORMW 「……よし。飲んでも大丈夫そう」
PRINTFORMW 「わ、私に、近づかないで……！」	PRINTFORMW 「わ、私に、近づかないで……！」
PRINTFORMW 「そ、そんなに死にたいのか！？」	PRINTFORMW 「そ、そんなに死にたいのか！？」
PRINTFORM 　もう……嗅ぐだけで、興奮して……	PRINTFORM 　もう……嗅ぐだけで、興奮して……
PRINTFORMW 「怖い……もう、こわいよぉ……」	PRINTFORMW 「怖い……もう、こわいよぉ……」
PRINTFORMW 「い、今の状態で勝てるわけ……」	PRINTFORMW 「い、今の状態で勝てるわけ……」
PRINTFORMW 「戦わないと、いけないの……？」	PRINTFORMW 「戦わないと、いけないの……？」
PRINTFORMW 「あ……逃げ切れ、ちゃった……」	PRINTFORMW 「あ……逃げ切れ、ちゃった……」
PRINTFORMW 「私、何回……産まされれば……」	PRINTFORMW 「私、何回……産まされれば……」
PRINTFORMW 「…………いい加減、休みたいよ」	PRINTFORMW 「…………いい加減、休みたいよ」
PRINTFORMW 「よし、これで確実に逃げられる」	PRINTFORMW 「よし、これで確実に逃げられる」
PRINTFORMW 「ちゃんと使っていかないと……」	PRINTFORMW 「ちゃんと使っていかないと……」
PRINTFORMW （だ、大丈夫、防げたみたい……）	PRINTFORMW （だ、大丈夫、防げたみたい……）
PRINTFORMW 「もう、だめ……死んじゃう……」	PRINTFORMW 「もう、だめ……死んじゃう……」
PRINTFORMW 「あんなの回収して何になるのよ」	PRINTFORMW 「あんなの回収して何になるのよ」
PRINTFORMDW クイーンの再生は、遠くはない。	PRINTFORMDW クイーンの再生は、遠くはない。
PRINTFORMW 「一人より、二人のほうが――！」	PRINTFORMW 「一人より、二人のほうが――！」
PRINTFORMW 「なんだよ、何か知ってるのか？」	PRINTFORMW 「なんだよ、何か知ってるのか？」
PRINTFORMW 「放せ、この……放してよぉ！」	PRINTFORMW 「放せ、この……放してよぉ！」
PRINTFORMW 「な、何を見せてるんだよ！？」	PRINTFORMW 「な、何を見せてるんだよ！？」
PRINTFORMW 「なんだよ、気色悪いな……！」	PRINTFORMW 「なんだよ、気色悪いな……！」
PRINTFORMW 「……ん、なにか……あっ！？」	PRINTFORMW 「……ん、なにか……あっ！？」
PRINTFORMW 「事前調査の必要があるかもな」	PRINTFORMW 「事前調査の必要があるかもな」
PRINTFORM 　わ、わたしの、からだ……あんっ	PRINTFORM 　わ、わたしの、からだ……あんっ
PRINTFORM 「い、嫌だ、こんな、とこ、でぇっ	PRINTFORM 「い、嫌だ、こんな、とこ、でぇっ
PRINTFORMW 「だ……だれか……助けて……」	PRINTFORMW 「だ……だれか……助けて……」
PRINTFORMW 「まさか、何か仕込まれて……」	PRINTFORMW 「まさか、何か仕込まれて……」
PRINTFORMW 「ん……夜更かしは慣れてるさ」	PRINTFORMW 「ん……夜更かしは慣れてるさ」
PRINTFORMW 「こんなきもい奴隷、イヤ……」	PRINTFORMW 「こんなきもい奴隷、イヤ……」
PRINTFORMW 「ふぅ、見立て通りで助かった」	PRINTFORMW 「ふぅ、見立て通りで助かった」
PRINTFORMW 「ひゃっ！　つ、つめたぁっ！」	PRINTFORMW 「ひゃっ！　つ、つめたぁっ！」
PRINTFORMW 「うん、私の見立て通りだな！」	PRINTFORMW 「うん、私の見立て通りだな！」
PRINTFORMW 「……なんか急に疲れてきたな」	PRINTFORMW 「……なんか急に疲れてきたな」
PRINTFORMW 「助けて……誰か、助けてぇ！」	PRINTFORMW 「助けて……誰か、助けてぇ！」
PRINTFORMW 「こんなんじゃ無理だよ……！」	PRINTFORMW 「こんなんじゃ無理だよ……！」
PRINTFORMW 「倒れろ、倒れろ、倒れろぉ！」	PRINTFORMW 「倒れろ、倒れろ、倒れろぉ！」
PRINTFORMW 「焦るな……焦ったらまた……」	PRINTFORMW 「焦るな……焦ったらまた……」
PRINTFORMW 「痛いだけなら慣れてる……！」	PRINTFORMW 「痛いだけなら慣れてる……！」
PRINTFORM 「あ、うぁ、出さないで……はひっ	PRINTFORM 「あ、うぁ、出さないで……はひっ
PRINTFORMW （少しでも隙を見せたら……！）	PRINTFORMW （少しでも隙を見せたら……！）
PRINTFORMW 「……こんなの……むり、だよ」	PRINTFORMW 「……こんなの……むり、だよ」
PRINTFORMW 「すぐ、助けに行くから……！」	PRINTFORMW 「すぐ、助けに行くから……！」
PRINTFORMW 「……ふぅ、敵じゃなかったか」	PRINTFORMW 「……ふぅ、敵じゃなかったか」
PRINTFORMW 「まさか……あの時、みたいに」	PRINTFORMW 「まさか……あの時、みたいに」
PRINTFORMW 「頼むからもう、動くなよ……」	PRINTFORMW 「頼むからもう、動くなよ……」
PRINTFORMW 「あ、あんな所に落ちたら……」	PRINTFORMW 「あ、あんな所に落ちたら……」
PRINTFORMW 「来るなよ……絶対来るなよ！」	PRINTFORMW 「来るなよ……絶対来るなよ！」
PRINTFORMW 「死ね、死ねっ、早く死ねぇ！」	PRINTFORMW 「死ね、死ねっ、早く死ねぇ！」
PRINTFORMW 「……やめて……おねがい……」	PRINTFORMW 「……やめて……おねがい……」
PRINTFORM 　こんなの……もぉ、逆らえないぃ	PRINTFORM 　こんなの……もぉ、逆らえないぃ
PRINTFORMW 「きゃあっ！？　な、なに！？」	PRINTFORMW 「きゃあっ！？　な、なに！？」
PRINTFORMW 「これじゃ戦えないよぉ……！」	PRINTFORMW 「これじゃ戦えないよぉ……！」
PRINTFORMW 「…………ごめん、なさい……」	PRINTFORMW 「…………ごめん、なさい……」
PRINTFORM 「すごく、いいの……はぁ、はぁっ	PRINTFORM 「すごく、いいの……はぁ、はぁっ
PRINTFORMW 　はぁっ、あぁ、ああぁっ……」	PRINTFORMW 　はぁっ、あぁ、ああぁっ……」
PRINTFORMW 「あ、すまん……敵かと思って」	PRINTFORMW 「あ、すまん……敵かと思って」
PRINTFORMW 「なにを拾っても、どうせ……」	PRINTFORMW 「なにを拾っても、どうせ……」
PRINTFORMW 「誰かにあげたほうがいいか？」	PRINTFORMW 「誰かにあげたほうがいいか？」
PRINTFORMW 「……何もかも、怪しく見える」	PRINTFORMW 「……何もかも、怪しく見える」
PRINTFORMW 「さっさと逃げなさいよバカ！」	PRINTFORMW 「さっさと逃げなさいよバカ！」
PRINTFORMW 「あーあ、結局手がかりなしか」	PRINTFORMW 「あーあ、結局手がかりなしか」
PRINTFORMDW そして殴られる魔理沙だった。	PRINTFORMDW そして殴られる魔理沙だった。
PRINTFORMDW 迷宮は既に幻想郷から消えた。	PRINTFORMDW 迷宮は既に幻想郷から消えた。
PRINTFORMDW まるで、人目を避けるように。	PRINTFORMDW まるで、人目を避けるように。
PRINTFORMDW 霊夢は――帰って来なかった。	PRINTFORMDW 霊夢は――帰って来なかった。
PRINTFORMW 「……なんか変だな、こいつ」	PRINTFORMW 「……なんか変だな、こいつ」
PRINTFORMW 「当てると動く、私が動く！」	PRINTFORMW 「当てると動く、私が動く！」
PRINTFORMW 「な……なんだこれ……！？」	PRINTFORMW 「な……なんだこれ……！？」
PRINTFORMW 　は、ぁ……もう、やめてぇ」	PRINTFORMW 　は、ぁ……もう、やめてぇ」
PRINTFORM 　いや、いやなのにっ……またぁ	PRINTFORM 　いや、いやなのにっ……またぁ
PRINTFORML （なにが……吸われてるの……	PRINTFORML （なにが……吸われてるの……
PRINTFORMW 「い、いや、それだけは……」	PRINTFORMW 「い、いや、それだけは……」
PRINTFORMW 「ん、まともな人影っぽいな」	PRINTFORMW 「ん、まともな人影っぽいな」
PRINTFORMW 「なんかイライラするぜ……」	PRINTFORMW 「なんかイライラするぜ……」
PRINTFORMW 「じ、地面が、うわわっ！？」	PRINTFORMW 「じ、地面が、うわわっ！？」
PRINTFORMW 「残念、グレイズいただき！」	PRINTFORMW 「残念、グレイズいただき！」
PRINTFORMW 「……前にいるのは危険だぜ」	PRINTFORMW 「……前にいるのは危険だぜ」
PRINTFORMW 「動きを止める……だけなら」	PRINTFORMW 「動きを止める……だけなら」
PRINTFORMW 「痛い、だけ……ならっ……」	PRINTFORMW 「痛い、だけ……ならっ……」
PRINTFORMW 「これ以上脱がされたら……」	PRINTFORMW 「これ以上脱がされたら……」
PRINTFORMW 「こ、こんなの無理だって！」	PRINTFORMW 「こ、こんなの無理だって！」
PRINTFORM 「嫌ぁ、やめてっ、やめて、やっ	PRINTFORM 「嫌ぁ、やめてっ、やめて、やっ
PRINTFORM 　ま、だ、きて……やだ、やだぁ	PRINTFORM 　ま、だ、きて……やだ、やだぁ
PRINTFORMW 「……また、何かされたのか」	PRINTFORMW 「……また、何かされたのか」
PRINTFORMW 「この感覚……クソッ……！」	PRINTFORMW 「この感覚……クソッ……！」
PRINTFORMW 「……まともな服、だよな？」	PRINTFORMW 「……まともな服、だよな？」
PRINTFORMW 「もし、敵が隠れてたら……」	PRINTFORMW 「もし、敵が隠れてたら……」
PRINTFORMW 「これで死んでしまえぇっ！」	PRINTFORMW 「これで死んでしまえぇっ！」
PRINTFORM 　もっと……このまま、もっとぉ	PRINTFORM 　もっと……このまま、もっとぉ
PRINTFORM 「わらひ、からだっ、へんなのぉ	PRINTFORM 「わらひ、からだっ、へんなのぉ
PRINTFORMW 「よかった……逃げられそう」	PRINTFORMW 「よかった……逃げられそう」
PRINTFORM 「しゅごい、しゅごしゅぎるのっ	PRINTFORM 「しゅごい、しゅごしゅぎるのっ
PRINTFORM 「き、きもちいい……きもちいい	PRINTFORM 「き、きもちいい……きもちいい
PRINTFORMW 「……ふぅ、敵じゃなかった」	PRINTFORMW 「……ふぅ、敵じゃなかった」
PRINTFORMW 「頼むからもう……動くなよ」	PRINTFORMW 「頼むからもう……動くなよ」
PRINTFORMW 「……こんな物があったって」	PRINTFORMW 「……こんな物があったって」
PRINTFORMW 「いよっし、決めるぜ霊夢！」	PRINTFORMW 「いよっし、決めるぜ霊夢！」
PRINTFORMDW 新たな迷宮の誕生は、近い。	PRINTFORMDW 新たな迷宮の誕生は、近い。
PRINTFORMDW あれから、数週間が経った。	PRINTFORMDW あれから、数週間が経った。
PRINTFORMW 「また、出たんだ……犠牲者」	PRINTFORMW 「また、出たんだ……犠牲者」
PRINTFORMW 「弾幕は……パワーだっ！」	PRINTFORMW 「弾幕は……パワーだっ！」
PRINTFORMW 「連射、連射、連射だぜ！」	PRINTFORMW 「連射、連射、連射だぜ！」
PRINTFORMW 「悪いが、離してもらう！」	PRINTFORMW 「悪いが、離してもらう！」
PRINTFORMW 「物量も一種のパワーだな」	PRINTFORMW 「物量も一種のパワーだな」
PRINTFORMW 「この……臭い、って……」	PRINTFORMW 「この……臭い、って……」
PRINTFORMW 「早く、倒さないと……！」	PRINTFORMW 「早く、倒さないと……！」
PRINTFORMW 「なっ、お前何者……！？」	PRINTFORMW 「なっ、お前何者……！？」
PRINTFORMW 「へへん、どんなもんだ！」	PRINTFORMW 「へへん、どんなもんだ！」
PRINTFORM 　やぁぁぁぁぁああぁぁぁぁっ	PRINTFORM 　やぁぁぁぁぁああぁぁぁぁっ
PRINTFORMW ！？　どう、なってぇ……」	PRINTFORMW ！？　どう、なってぇ……」
PRINTFORMW 「なんだ、結局来たのか？」	PRINTFORMW 「なんだ、結局来たのか？」
PRINTFORMW 「おっと、敵じゃないのか」	PRINTFORMW 「おっと、敵じゃないのか」
PRINTFORMW 「だ……大丈夫、やれるぜ」	PRINTFORMW 「だ……大丈夫、やれるぜ」
PRINTFORMW 「これ、スコアになるか？」	PRINTFORMW 「これ、スコアになるか？」
PRINTFORMW 「普通の服、だよな……？」	PRINTFORMW 「普通の服、だよな……？」
PRINTFORMW 「まとめて倒せれば……！」	PRINTFORMW 「まとめて倒せれば……！」
PRINTFORMW 「射程に入っているなら！」	PRINTFORMW 「射程に入っているなら！」
PRINTFORMW 「ふ……ざ……けるなぁ！」	PRINTFORMW 「ふ……ざ……けるなぁ！」
PRINTFORMW 「……まずは足止めからだ」	PRINTFORMW 「……まずは足止めからだ」
PRINTFORMW 「全部片付けてやる……！」	PRINTFORMW 「全部片付けてやる……！」
PRINTFORMW 　こ、こんなの、でぇっ♪」	PRINTFORMW 　こ、こんなの、でぇっ♪」
PRINTFORMW 「もう驚かされるもんか！」	PRINTFORMW 「もう驚かされるもんか！」
PRINTFORMW 「こいつ、まさか……！？」	PRINTFORMW 「こいつ、まさか……！？」
PRINTFORMW 「こ、ここまで来れば……」	PRINTFORMW 「こ、ここまで来れば……」
PRINTFORM 　自分でするの凄くキモチイイ	PRINTFORM 　自分でするの凄くキモチイイ
PRINTFORM 　くるの、のぼってくるの……	PRINTFORM 　くるの、のぼってくるの……
PRINTFORM 「ひんっ、あひっ、や……あぁ	PRINTFORM 「ひんっ、あひっ、や……あぁ
PRINTFORMW 「だめ、だめ、だめぇっ！」	PRINTFORMW 「だめ、だめ、だめぇっ！」
PRINTFORM 　私、ドキドキしてる……よぉ	PRINTFORM 　私、ドキドキしてる……よぉ
PRINTFORMW 「あ、あぶなかった……！」	PRINTFORMW 「あ、あぶなかった……！」
PRINTFORMW きっ、きもち、いぃっ！？」	PRINTFORMW きっ、きもち、いぃっ！？」
PRINTFORMW 「れ、霊夢……そんな……」	PRINTFORMW 「れ、霊夢……そんな……」
PRINTFORMW 「あう……気分、悪い……」	PRINTFORMW 「あう……気分、悪い……」
PRINTFORMW 「この感覚……嫌ぁ……！」	PRINTFORMW 「この感覚……嫌ぁ……！」
PRINTFORMW 「そういう薬、だよな……」	PRINTFORMW 「そういう薬、だよな……」
PRINTFORMW 「やぁ、来ないでよぉっ！」	PRINTFORMW 「やぁ、来ないでよぉっ！」
PRINTFORMW 「このっ……落ちろよ！」	PRINTFORMW 「このっ……落ちろよ！」
PRINTFORM 　からだ、あつっ……あんっ	PRINTFORM 　からだ、あつっ……あんっ
PRINTFORMW 「ま、まだそこは……！」	PRINTFORMW 「ま、まだそこは……！」
PRINTFORMW 「や、やだ、服が……！」	PRINTFORMW 「や、やだ、服が……！」
PRINTFORM 「ふうぅんっ、はっ……あっ	PRINTFORM 「ふうぅんっ、はっ……あっ
PRINTFORMW 「あれは毒だな、きっと」	PRINTFORMW 「あれは毒だな、きっと」
PRINTFORMW 「こ、これ……霊夢の……	PRINTFORMW 「こ、これ……霊夢の……
PRINTFORMW 「い、嫌だ、けど……！」	PRINTFORMW 「い、嫌だ、けど……！」
PRINTFORMW 「早く、早く、早く……」	PRINTFORMW 「早く、早く、早く……」
PRINTFORMW 「動くなよ、倒れろよ！」	PRINTFORMW 「動くなよ、倒れろよ！」
PRINTFORMW 「やめろ……近寄るな！」	PRINTFORMW 「やめろ……近寄るな！」
PRINTFORMW 「ど真ん中を撃ち抜く！」	PRINTFORMW 「ど真ん中を撃ち抜く！」
PRINTFORMW 「しつこいんだよ……！」	PRINTFORMW 「しつこいんだよ……！」
PRINTFORMW 「……やりやがったな！」	PRINTFORMW 「……やりやがったな！」
PRINTFORMW 「え……だ、だめっ！？」	PRINTFORMW 「え……だ、だめっ！？」
PRINTFORMW （勝てない、かな……？）	PRINTFORMW （勝てない、かな……？）
PRINTFORM 「化け物相手じゃないからっ	PRINTFORM 「化け物相手じゃないからっ
PRINTFORMW 「た、助けないと……！」	PRINTFORMW 「た、助けないと……！」
PRINTFORMW 「……結局、来てたのか」	PRINTFORMW 「……結局、来てたのか」
PRINTFORMW 「正直、安心したぜ……」	PRINTFORMW 「正直、安心したぜ……」
PRINTFORMW 「役に立つといいんだが」	PRINTFORMW 「役に立つといいんだが」
PRINTFORMW 「うわっ、うわぁっ！？」	PRINTFORMW 「うわっ、うわぁっ！？」
PRINTFORMW 「たすからない……もう」	PRINTFORMW 「たすからない……もう」
PRINTFORMW 「もう戦うの、いや……」	PRINTFORMW 「もう戦うの、いや……」
PRINTFORMW 「……今更、これくらい」	PRINTFORMW 「……今更、これくらい」
PRINTFORMW 　ぁ――あっ、あ……♪」	PRINTFORMW 　ぁ――あっ、あ……♪」
PRINTFORM 「ふぅっ、うっ、んんっ……	PRINTFORM 「ふぅっ、うっ、んんっ……
PRINTFORM 「うっ、は……はあぁぁぁっ	PRINTFORM 「うっ、は……はあぁぁぁっ
PRINTFORMW 「また、何かされ……て」	PRINTFORMW 「また、何かされ……て」
PRINTFORMW 「……何か、されたのか」	PRINTFORMW 「……何か、されたのか」
PRINTFORM 　おっぱいまた吸われてるっ	PRINTFORM 　おっぱいまた吸われてるっ
PRINTFORMW 「はぁ、はあぁっ……！」	PRINTFORMW 「はぁ、はあぁっ……！」
PRINTFORMW 　――怖いんでしょう？」	PRINTFORMW 　――怖いんでしょう？」
PRINTFORMW 「私に……できることは」	PRINTFORMW 「私に……できることは」
PRINTFORMW 「……もう、やめよっか」	PRINTFORMW 「……もう、やめよっか」
PRINTFORMW 「それはないんじゃない」	PRINTFORMW 「それはないんじゃない」
PRINTFORMW 「……当たってくれ！」	PRINTFORMW 「……当たってくれ！」
PRINTFORMW 「止まれよ、このぉ！」	PRINTFORMW 「止まれよ、このぉ！」
PRINTFORMW 「変な動きするなっ！」	PRINTFORMW 「変な動きするなっ！」
PRINTFORMW 「この、来るな……！」	PRINTFORMW 「この、来るな……！」
PRINTFORMW 「弾幕はパワーだぜ！」	PRINTFORMW 「弾幕はパワーだぜ！」
PRINTFORMW 「痛っ……やったな！」	PRINTFORMW 「痛っ……やったな！」
PRINTFORM 「な、なに、こ、れぇ……	PRINTFORM 「な、なに、こ、れぇ……
PRINTFORMW 「変なところ触るな！」	PRINTFORMW 「変なところ触るな！」
PRINTFORMW 「また会ったな、霊夢」	PRINTFORMW 「また会ったな、霊夢」
PRINTFORMW 「――――――まさか。	PRINTFORMW 「――――――まさか。
PRINTFORMW 「……体が、重く……」	PRINTFORMW 「……体が、重く……」
PRINTFORMW 「よし、休憩終わり！」	PRINTFORMW 「よし、休憩終わり！」
PRINTFORMW 「私に、触るな……！」	PRINTFORMW 「私に、触るな……！」
PRINTFORMW 「これが、当たれば！」	PRINTFORMW 「これが、当たれば！」
PRINTFORMW 「もう終わってくれ！」	PRINTFORMW 「もう終わってくれ！」
PRINTFORMW 「お前たちなんかっ！」	PRINTFORMW 「お前たちなんかっ！」
PRINTFORMW 「粉々になっちまえ！」	PRINTFORMW 「粉々になっちまえ！」
PRINTFORM 　からだ、あつく……てぇ	PRINTFORM 　からだ、あつく……てぇ
PRINTFORMW 「まだ……犯すの……」	PRINTFORMW 「まだ……犯すの……」
PRINTFORMW 「好き勝手させるか！」	PRINTFORMW 「好き勝手させるか！」
PRINTFORM 　イかせるのもぉやめぇっ	PRINTFORM 　イかせるのもぉやめぇっ
PRINTFORM 「は――ふっ、あああぁっ	PRINTFORM 「は――ふっ、あああぁっ
PRINTFORM 「とぶっ、意識とんじゃう	PRINTFORM 「とぶっ、意識とんじゃう
PRINTFORMW 「………………ごめん」	PRINTFORMW 「………………ごめん」
PRINTFORMW 「武器、武器を……！」	PRINTFORMW 「武器、武器を……！」
PRINTFORMW 「い、たい、よぉ……」	PRINTFORMW 「い、たい、よぉ……」
PRINTFORMW 「反撃、しなきゃ……」	PRINTFORMW 「反撃、しなきゃ……」
PRINTFORM 「きたぁ、しゃせーきたぁ	PRINTFORM 「きたぁ、しゃせーきたぁ
PRINTFORMW 「どれだけ……戦えば」	PRINTFORMW 「どれだけ……戦えば」
PRINTFORM 　イくのとまんないぃ……	PRINTFORM 　イくのとまんないぃ……
PRINTFORM 　むね、吸われてるぅ……	PRINTFORM 　むね、吸われてるぅ……
PRINTFORMW 「何か……ある……？」	PRINTFORMW 「何か……ある……？」
PRINTFORMW 「ここにも、ない……」	PRINTFORMW 「ここにも、ない……」
PRINTFORMW 「ねぇ、魔理沙。これ」	PRINTFORMW 「ねぇ、魔理沙。これ」
PRINTFORMDL ※魔理沙口上初期設定	PRINTFORMDL ※魔理沙口上初期設定
PRINTFORMW 「…………（ずずず）」	PRINTFORMW 「…………（ずずず）」
﻿PRINTFORMW 「や、やめろ……！」	PRINTFORMW 「や、やめろ……！」
PRINTFORMW 「私に触るな……！」	PRINTFORMW 「私に触るな……！」
PRINTFORMW 「でかいの撃つぜ！」	PRINTFORMW 「でかいの撃つぜ！」
PRINTFORMW 「…………ぃゃ……」	PRINTFORMW 「…………ぃゃ……」
PRINTFORMW 「く、来るな……！」	PRINTFORMW 「く、来るな……！」
PRINTFORMW 「あ……危ない……」	PRINTFORMW 「あ……危ない……」
PRINTFORMW 「くぅ……くぅ……」	PRINTFORMW 「くぅ……くぅ……」
PRINTFORMW 「れ、霊夢……！？」	PRINTFORMW 「れ、霊夢……！？」
PRINTFORMW 「なぁんだ、お前か」	PRINTFORMW 「なぁんだ、お前か」
PRINTFORMW 「お、何かあるぞ？」	PRINTFORMW 「お、何かあるぞ？」
PRINTFORMW （ん……瘴気、か？）	PRINTFORMW （ん……瘴気、か？）
PRINTFORMW 「これでもくらえ！」	PRINTFORMW 「これでもくらえ！」
PRINTFORMW 「反、げきを……！」	PRINTFORMW 「反、げきを……！」
PRINTFORMW 「ふん、ざまぁみろ」	PRINTFORMW 「ふん、ざまぁみろ」
PRINTFORM 「はぁっ、はぁっー……	PRINTFORM 「はぁっ、はぁっー……
PRINTFORMW 「何か……落ちてる」	PRINTFORMW 「何か……落ちてる」
PRINTFORMW 「服……だけ……？」	PRINTFORMW 「服……だけ……？」
PRINTFORM 　たまら……ない、よぉ	PRINTFORM 　たまら……ない、よぉ
PRINTFORM 「む、ねぇ、よわくてぇ	PRINTFORM 「む、ねぇ、よわくてぇ
PRINTFORMW 「…………これって」	PRINTFORMW 「…………これって」
PRINTFORM 「はひっ、しゅごいのぉ	PRINTFORM 「はひっ、しゅごいのぉ
PRINTFORM 　なかからこすられてっ	PRINTFORM 　なかからこすられてっ
PRINTFORM 「んうぅ、ふうぅん……	PRINTFORM 「んうぅ、ふうぅん……
PRINTFORM 　また、産まれるぅ……	PRINTFORM 　また、産まれるぅ……
PRINTFORMW 「来るな、このぉ！」	PRINTFORMW 「来るな、このぉ！」
PRINTFORMW 「……死んじまえ！」	PRINTFORMW 「……死んじまえ！」
PRINTFORMW 「はぁ、はぁっ……」	PRINTFORMW 「はぁ、はぁっ……」
PRINTFORMW 「う……え、ぇ……」	PRINTFORMW 「う……え、ぇ……」
PRINTFORMDL 設定しませんでした	PRINTFORMDL 設定しませんでした
PRINTFORMW 「まずは当てる！」	PRINTFORMW 「まずは当てる！」
PRINTFORMW 「これでどうだ！」	PRINTFORMW 「これでどうだ！」
PRINTFORMW 「こんのっ……！」	PRINTFORMW 「こんのっ……！」
PRINTFORMW 「まだまだ……！」	PRINTFORMW 「まだまだ……！」
PRINTFORMW 「…………服……」	PRINTFORMW 「…………服……」
PRINTFORMW 「ん……なんだ？」	PRINTFORMW 「ん……なんだ？」
PRINTFORMW 「よし……やるか」	PRINTFORMW 「よし……やるか」
PRINTFORMW 　眠れ、ない……」	PRINTFORMW 　眠れ、ない……」
PRINTFORMW 「よし、任せろ！」	PRINTFORMW 「よし、任せろ！」
PRINTFORMW 「こんなもんだろ」	PRINTFORMW 「こんなもんだろ」
PRINTFORMW 「く、くそっ……」	PRINTFORMW 「く、くそっ……」
PRINTFORMW 「しまった……！」	PRINTFORMW 「しまった……！」
PRINTFORMW 「来るな、この！」	PRINTFORMW 「来るな、この！」
PRINTFORM 「はぁ、この匂い……	PRINTFORM 「はぁ、この匂い……
PRINTFORMW 「きゃああっ！？」	PRINTFORMW 「きゃああっ！？」
PRINTFORM 　こんなに、されたら	PRINTFORM 　こんなに、されたら
PRINTFORMW 「もう、むり……」	PRINTFORMW 「もう、むり……」
PRINTFORMD ふふん、と得意げに	PRINTFORMD ふふん、と得意げに
PRINTFORMdW 霊夢に叩かれた。	PRINTFORMdW 霊夢に叩かれた。
PRINTFORMDW あれから、数日。	PRINTFORMDW あれから、数日。
PRINTFORMW 「やめるって……」	PRINTFORMW 「やめるって……」
PRINTFORMW 「また……あの夢」	PRINTFORMW 「また……あの夢」
PRINTFORMDW …………数日後。	PRINTFORMDW …………数日後。
PRINTFORMW 「殴って叩く！」	PRINTFORMW 「殴って叩く！」
PRINTFORMW 「あ……ん……」	PRINTFORMW 「あ……ん……」
PRINTFORMW 「やぁ…………」	PRINTFORMW 「やぁ…………」
PRINTFORMW 「遅いんだよ！」	PRINTFORMW 「遅いんだよ！」
PRINTFORM 「あぁっ……これぇ	PRINTFORM 「あぁっ……これぇ
PRINTFORM 「あ……きてる……	PRINTFORM 「あ……きてる……
PRINTFORM 「うぐっ……ひぐっ	PRINTFORM 「うぐっ……ひぐっ
PRINTFORM 「うあっ、またぁっ	PRINTFORM 「うあっ、またぁっ
PRINTFORM 「ふあぁ……むねぇ	PRINTFORM 「ふあぁ……むねぇ
PRINTFORM 　わらひ、のぉ……	PRINTFORM 　わらひ、のぉ……
PRINTFORM 「あ……これぇ……	PRINTFORM 「あ……これぇ……
PRINTFORM 　あむっ、んふーっ	PRINTFORM 　あむっ、んふーっ
PRINTFORMW 「いったぁ！？」	PRINTFORMW 「いったぁ！？」
PRINTFORMW 「れい、む……」	PRINTFORMW 「れい、む……」
PRINTFORMW 「…………くそ」	PRINTFORMW 「…………くそ」
PRINTFORMDL [1] いいえ	PRINTFORMDL [1] いいえ
PRINTFORM 「はぁ……はぁっ	PRINTFORM 「はぁ……はぁっ
PRINTFORMW 「次を……！」	PRINTFORMW 「次を……！」
PRINTFORM 　やめ、やあぁっ	PRINTFORM 　やめ、やあぁっ
PRINTFORM 「なん、でぇ……	PRINTFORM 「なん、でぇ……
PRINTFORM 「やめ……やめぇ	PRINTFORM 「やめ……やめぇ
PRINTFORML 「あ…………」	PRINTFORML 「あ…………」
PRINTFORMW 「あ、動いた」	PRINTFORMW 「あ、動いた」
PRINTFORMDW 投げ捨てた。	PRINTFORMDW 投げ捨てた。
PRINTFORMDL [0] はい	PRINTFORMDL [0] はい
PRINTFORMDL 設定しました	PRINTFORMDL 設定しました
PRINTFORMW 「しっしっ」	PRINTFORMW 「しっしっ」
PRINTFORMW 「潰れろ！」	PRINTFORMW 「潰れろ！」
PRINTFORMW 「ひ……！」	PRINTFORMW 「ひ……！」
PRINTFORM 「はっ、はひっ	PRINTFORM 「はっ、はひっ
PRINTFORM 「だめなのにぃ	PRINTFORM 「だめなのにぃ
PRINTFORM 　出さないでぇ	PRINTFORM 　出さないでぇ
PRINTFORM 「あぁんっ……	PRINTFORM 「あぁんっ……
PRINTFORMW 「ひっ！？」	PRINTFORMW 「ひっ！？」
PRINTFORM 　おかされてっ	PRINTFORM 　おかされてっ
PRINTFORM 　あっ、あ、あ	PRINTFORM 　あっ、あ、あ
PRINTFORMW 「次だ！」	PRINTFORMW 「次だ！」
PRINTFORM 「はぁっ……	PRINTFORM 「はぁっ……
PRINTFORM 「あっ――あ	PRINTFORM 「あっ――あ
PRINTFORM 　変なのにぃ	PRINTFORM 　変なのにぃ
PRINTFORM 「あ、きてる	PRINTFORM 「あ、きてる
PRINTFORM 「んぐっ……	PRINTFORM 「んぐっ……
PRINTFORM 「あ……ひっ	PRINTFORM 「あ……ひっ
PRINTFORMW 「ん……」	PRINTFORMW 「ん……」
PRINTFORMW 「ないわ」	PRINTFORMW 「ないわ」
PRINTFORM 「――やっ	PRINTFORM 「――やっ
PRINTFORM 「やっ……	PRINTFORM 「やっ……
PRINTFORM 「あはぁっ	PRINTFORM 「あはぁっ
PRINTFORM 　またイく	PRINTFORM 　またイく
PRINTFORM 　すぐイく	PRINTFORM 　すぐイく
PRINTFORM 「ぅ……あ	PRINTFORM 「ぅ……あ
PRINTFORMW 「？」	PRINTFORMW 「？」
PRINTFORM 「イイっ	PRINTFORM 「イイっ
PRINTFORMW 「勘」	PRINTFORMW 「勘」
PRINTFORMW ぜ」	PRINTFORMW ぜ」
PRINTFORMD 無い	PRINTFORMD 無い
PRINTFORML 」	PRINTFORML 」
PRINTFORML 	PRINTFORML 
PRINTFORMW 	PRINTFORMW 
