//口上:

PRINTFORMDL %CALLNAME:(ARG:2)%は申し訳なさそうに大妖精をちらりと見ると背を向け駆け出した	PRINTFORMDL %CALLNAME:(ARG:2)%は申し訳なさそうに大妖精をちらりと見ると背を向け駆け出した
PRINTFORML 「%CALLNAME:(ARG:1)%ちゃん！いっつもいっつも最後に我慢してるの私なんだよ！？」	PRINTFORML 「%CALLNAME:(ARG:1)%ちゃん！いっつもいっつも最後に我慢してるの私なんだよ！？」
PRINTFORMDL すがるような叫びを背中に受けながらも%CALLNAME:1%は自身が生き延びる為に逃げ出した	PRINTFORMDL すがるような叫びを背中に受けながらも%CALLNAME:1%は自身が生き延びる為に逃げ出した
PRINTFORMDW そしてその手はぐにょりとした何かを掴むと「それ」は意思を持っているかのように腕にも絡みつく	PRINTFORMDW そしてその手はぐにょりとした何かを掴むと「それ」は意思を持っているかのように腕にも絡みつく
PRINTFORMDL 痛む喉から必死にかすれた声を出そうとも聞こえてくるのは自身を貪る触手と汚濁液の水音だけ…	PRINTFORMDL 痛む喉から必死にかすれた声を出そうとも聞こえてくるのは自身を貪る触手と汚濁液の水音だけ…
PRINTFORML 「うえええええええん！%CALLNAME:(ARG:1)%ちゃーん！びぇええええぇえ！」	PRINTFORML 「うえええええええん！%CALLNAME:(ARG:1)%ちゃーん！びぇええええぇえ！」
PRINTFORMDW 草と枯葉と枯れ枝でいっぱいの地面に投げ出される衝撃を避けようと反射的に伸びた手が伸びる	PRINTFORMDW 草と枯葉と枯れ枝でいっぱいの地面に投げ出される衝撃を避けようと反射的に伸びた手が伸びる
PRINTFORMDL 脱出を諦めた大妖精の全身から力が抜けると肉壁は悦ぶようにさらに激しく脈動を始めた	PRINTFORMDL 脱出を諦めた大妖精の全身から力が抜けると肉壁は悦ぶようにさらに激しく脈動を始めた
PRINTFORMDL 小さくなっていく背中に悲痛な声で問いかける大妖精の体に触手は次々に絡み付いていく	PRINTFORMDL 小さくなっていく背中に悲痛な声で問いかける大妖精の体に触手は次々に絡み付いていく
PRINTFORMDL 涙で顔をボロボロに汚しながら叫ぶ大妖精の目の前には洞窟の暗闇しか広がっていない…	PRINTFORMDL 涙で顔をボロボロに汚しながら叫ぶ大妖精の目の前には洞窟の暗闇しか広がっていない…
PRINTFORMDL 奥へ奥へと侵入しようとのた打ち回る異物が作る激痛に何度も何度も痛々しい声を漏らし	PRINTFORMDL 奥へ奥へと侵入しようとのた打ち回る異物が作る激痛に何度も何度も痛々しい声を漏らし
PRINTFORMDW オニ役の妖精が明後日の方向へと飛んでいくのを木陰から眺め大妖精はクスクスと笑った	PRINTFORMDW オニ役の妖精が明後日の方向へと飛んでいくのを木陰から眺め大妖精はクスクスと笑った
PRINTFORMDW 大妖精が何をされているか頭で理解するより先に細いウエストに、丸みを帯びた太股に、	PRINTFORMDW 大妖精が何をされているか頭で理解するより先に細いウエストに、丸みを帯びた太股に、
PRINTFORMDW 無防備な胴体に、太い肉の紐のようなものが次々に巻きつき、その小さな体を力強く引く	PRINTFORMDW 無防備な胴体に、太い肉の紐のようなものが次々に巻きつき、その小さな体を力強く引く
PRINTFORMDL 叫びつかれ、喉が痛みぐったりと肉壁に身をゆだねる大妖精はハッとして気づいた。	PRINTFORMDL 叫びつかれ、喉が痛みぐったりと肉壁に身をゆだねる大妖精はハッとして気づいた。
PRINTFORMDW 狭い膣を力づくで押し広げられる激痛に大妖精はひゅーひゅーと荒い呼吸を繰り返す	PRINTFORMDW 狭い膣を力づくで押し広げられる激痛に大妖精はひゅーひゅーと荒い呼吸を繰り返す
PRINTFORMDL 弱々しいくぐもった悲鳴を背に、%CALLNAME:1%はその場を後にした…	PRINTFORMDL 弱々しいくぐもった悲鳴を背に、%CALLNAME:1%はその場を後にした…
PRINTFORMDL ぐったりとしている大妖精の小さな体を%CALLNAME:1%は抱えあげた	PRINTFORMDL ぐったりとしている大妖精の小さな体を%CALLNAME:1%は抱えあげた
PRINTFORMW 「ふふっ、チルノちゃんが場外に行かなければ今回のかくれんぼ私の勝ちかな？」	PRINTFORMW 「ふふっ、チルノちゃんが場外に行かなければ今回のかくれんぼ私の勝ちかな？」
PRINTFORML 「ここでこんなことが…え？違うよこうだったもん！そっちが間違えてるよ！」	PRINTFORML 「ここでこんなことが…え？違うよこうだったもん！そっちが間違えてるよ！」
PRINTFORML 「え……これってまさか%CALLNAME:(ARG:1)%ちゃんの……」	PRINTFORML 「え……これってまさか%CALLNAME:(ARG:1)%ちゃんの……」
PRINTFORMDL だとしたら悲鳴や抵抗する音くらい聞こえてもいいはずだ。そう思い悟った	PRINTFORMDL だとしたら悲鳴や抵抗する音くらい聞こえてもいいはずだ。そう思い悟った
PRINTFORML 「もう%CALLNAME:TARGET%さんのことなんて知らないっ！」	PRINTFORML 「もう%CALLNAME:TARGET%さんのことなんて知らないっ！」
PRINTFORML 「あ…%CALLNAME:(ARG:1)%ちゃん…一人じゃ危ない……」	PRINTFORML 「あ…%CALLNAME:(ARG:1)%ちゃん…一人じゃ危ない……」
PRINTFORMDL 大妖精はぐしゃぐしゃの顔を拭うこともできないまま泣きじゃくっている	PRINTFORMDL 大妖精はぐしゃぐしゃの顔を拭うこともできないまま泣きじゃくっている
PRINTFORMDL 大妖精は何度も蹲り、何度も青ざめた顔で膨らんだ腹部をさすっている…	PRINTFORMDL 大妖精は何度も蹲り、何度も青ざめた顔で膨らんだ腹部をさすっている…
PRINTFORML 大妖精は頭を抱えて座り込みひとしきり叫んだ後、めそめそと泣き始めた…	PRINTFORML 大妖精は頭を抱えて座り込みひとしきり叫んだ後、めそめそと泣き始めた…
PRINTFORMDL 大妖精は漏れそうな声を我慢しようと奥歯を噛み締め目を強く瞑ったが	PRINTFORMDL 大妖精は漏れそうな声を我慢しようと奥歯を噛み締め目を強く瞑ったが
PRINTFORMDL 全身を陵辱しようと迫る触手に怯えながらも何度も何度も助けを求めた	PRINTFORMDL 全身を陵辱しようと迫る触手に怯えながらも何度も何度も助けを求めた
PRINTFORMDL %CALLNAME:1%では大妖精を助けることは出来そうにない…	PRINTFORMDL %CALLNAME:1%では大妖精を助けることは出来そうにない…
PRINTFORML 「%CALLNAME:(ARG:1)%ちゃん覚えられる？本当に？」	PRINTFORML 「%CALLNAME:(ARG:1)%ちゃん覚えられる？本当に？」
PRINTFORML 「もう%CALLNAME:(ARG:1)%ちゃんなんて知らない！」	PRINTFORML 「もう%CALLNAME:(ARG:1)%ちゃんなんて知らない！」
PRINTFORML (捕まったら身体のうずうずもきっと…ってダメダメ！にげなきゃ！)	PRINTFORML (捕まったら身体のうずうずもきっと…ってダメダメ！にげなきゃ！)
PRINTFORML 「よしっ、逃げ切った！みんなと鬼ごっこで鍛えてた甲斐があったわ」	PRINTFORML 「よしっ、逃げ切った！みんなと鬼ごっこで鍛えてた甲斐があったわ」
PRINTFORMDL 力なく横たわっている大妖精に近づくが大妖精はぴくりとも動かない	PRINTFORMDL 力なく横たわっている大妖精に近づくが大妖精はぴくりとも動かない
PRINTFORML 大妖精はここが危険な場所であることも忘れて座り込んで泣き続けた…	PRINTFORML 大妖精はここが危険な場所であることも忘れて座り込んで泣き続けた…
PRINTFORML 「ぁあぁああ！やだぁあやだぁああ！ぎもじいいぃいやだぁあ！！」	PRINTFORML 「ぁあぁああ！やだぁあやだぁああ！ぎもじいいぃいやだぁあ！！」
PRINTFORML （このネバネバを体の中に入れられるところだったのね･･･ぅぅ）	PRINTFORML （このネバネバを体の中に入れられるところだったのね･･･ぅぅ）
PRINTFORML 「%CALLNAME:(ARG:1)%ちゃんなんか大変そう…」	PRINTFORML 「%CALLNAME:(ARG:1)%ちゃんなんか大変そう…」
PRINTFORMDW 大妖精は不意に足をとられ短い悲鳴をあげて派手に転んでしまった	PRINTFORMDW 大妖精は不意に足をとられ短い悲鳴をあげて派手に転んでしまった
PRINTFORML 「誰か！誰か助けて！チルノちゃん！ルーミアちゃん！誰かぁ！」	PRINTFORML 「誰か！誰か助けて！チルノちゃん！ルーミアちゃん！誰かぁ！」
PRINTFORMDL 満身創痍で身動きすら取れない大妖精を連れて歩く余裕はない…	PRINTFORMDL 満身創痍で身動きすら取れない大妖精を連れて歩く余裕はない…
PRINTFORML 「弾幕ッ！瞬間移動ッ！また弾幕のッ！さらにもう一発です！」	PRINTFORML 「弾幕ッ！瞬間移動ッ！また弾幕のッ！さらにもう一発です！」
PRINTFORML 「…話しかけたらまた戦争の時みたいに面倒なことになるかも」	PRINTFORML 「…話しかけたらまた戦争の時みたいに面倒なことになるかも」
PRINTFORMDL %CALLNAME:1%は大妖精をそっと物陰に横たえた…	PRINTFORMDL %CALLNAME:1%は大妖精をそっと物陰に横たえた…
PRINTFORML 「だって相手は怪物だし！産んだ後何されるかわかんないし！」	PRINTFORML 「だって相手は怪物だし！産んだ後何されるかわかんないし！」
PRINTFORML 「こんなに汚れちゃったら洗ってもそう簡単にはおちないわね」	PRINTFORML 「こんなに汚れちゃったら洗ってもそう簡単にはおちないわね」
PRINTFORML 「これって…ぅ、ぅぅぅ･･･違うよねそんなことないよね…」	PRINTFORML 「これって…ぅ、ぅぅぅ･･･違うよねそんなことないよね…」
PRINTFORMDW 「きゅーじゅーく、ひゃーく！よーし、見つけちゃうぞー！」	PRINTFORMDW 「きゅーじゅーく、ひゃーく！よーし、見つけちゃうぞー！」
PRINTFORMDL 大妖精は這い出そうと必死に肉壁に指をかけようとしている	PRINTFORMDL 大妖精は這い出そうと必死に肉壁に指をかけようとしている
PRINTFORM 「なに！？なに！？私どうなっちゃうの！？ふぁ…ぁああぁああ	PRINTFORM 「なに！？なに！？私どうなっちゃうの！？ふぁ…ぁああぁああ
PRINTFORML 「ごめんね%CALLNAME:(ARG:1)%ちゃん…」	PRINTFORML 「ごめんね%CALLNAME:(ARG:1)%ちゃん…」
PRINTFORML 「ふぇえぇぇ…何かがおなかの中でガサガサいってるよぉ…」	PRINTFORML 「ふぇえぇぇ…何かがおなかの中でガサガサいってるよぉ…」
PRINTFORMDW 怯えた瞳で自分の秘所にねじ込まれたものを見つめている…	PRINTFORMDW 怯えた瞳で自分の秘所にねじ込まれたものを見つめている…
PRINTFORMDW	上機嫌で口にした大ちゃんはころっと表情を不安げに変えた	PRINTFORMDW	上機嫌で口にした大ちゃんはころっと表情を不安げに変えた
PRINTFORMDW 今度、いつまで立っても見つからなかったらほうっておこう	PRINTFORMDW 今度、いつまで立っても見つからなかったらほうっておこう
PRINTFORML 「えへへ、外に出たらこの武器でイタズラしてみようかな」	PRINTFORML 「えへへ、外に出たらこの武器でイタズラしてみようかな」
PRINTFORML 「チャンバラごっこってあんまりやらないんだけどなぁ…」	PRINTFORML 「チャンバラごっこってあんまりやらないんだけどなぁ…」
PRINTFORML 「武器を持ってると物語の中のヒーローになったみたい♪」	PRINTFORML 「武器を持ってると物語の中のヒーローになったみたい♪」
PRINTFORML 「ふえぇええん！出してよぉー！食べられたくないよぉ！」	PRINTFORML 「ふえぇええん！出してよぉー！食べられたくないよぉ！」
PRINTFORML 「好きな人にしかなにかさせちゃダメな場所なんです…！」	PRINTFORML 「好きな人にしかなにかさせちゃダメな場所なんです…！」
PRINTFORMDL 自力で這い出そうとしても既に上も下も分からない状態で	PRINTFORMDL 自力で這い出そうとしても既に上も下も分からない状態で
PRINTFORML 「%CALLNAME:(ARG:1)%ちゃん大丈夫？」	PRINTFORML 「%CALLNAME:(ARG:1)%ちゃん大丈夫？」
PRINTFORML 「見張りの交代ですね。大丈夫、おかげさまで元気です！」	PRINTFORML 「見張りの交代ですね。大丈夫、おかげさまで元気です！」
PRINTFORML 「こうなったらヤケクソ！至近距離で撃ち込んじゃう！」	PRINTFORML 「こうなったらヤケクソ！至近距離で撃ち込んじゃう！」
PRINTFORML (はやく逃げなきゃはやく逃げなきゃはやく逃げなきゃ)	PRINTFORML (はやく逃げなきゃはやく逃げなきゃはやく逃げなきゃ)
PRINTFORML 「ど、どうしてそんなとこ触ろうとするんですかー！？」	PRINTFORML 「ど、どうしてそんなとこ触ろうとするんですかー！？」
PRINTFORMDL ガタガタ震えながらも大妖精は大切な場所を庇っている	PRINTFORMDL ガタガタ震えながらも大妖精は大切な場所を庇っている
PRINTFORML (声…止まんない…頭真っ白……もう…何も考えられ…)	PRINTFORML (声…止まんない…頭真っ白……もう…何も考えられ…)
PRINTFORML 「はぁ･･･はぁ･･･鬼ごっこは得意なんだからね！」	PRINTFORML 「はぁ･･･はぁ･･･鬼ごっこは得意なんだからね！」
PRINTFORML 「どこもかしこもにょろにょろぬるぬる気持ち悪いね…」	PRINTFORML 「どこもかしこもにょろにょろぬるぬる気持ち悪いね…」
PRINTFORML 「私もみんなみたいにかくれんぼ向きの能力ほしいなぁ」	PRINTFORML 「私もみんなみたいにかくれんぼ向きの能力ほしいなぁ」
PRINTFORML 「えっちな怪物ばっかりなんだもん。いやになっちゃう」	PRINTFORML 「えっちな怪物ばっかりなんだもん。いやになっちゃう」
PRINTFORML 「うん、大丈夫ですよ。横になって少し楽になりました」	PRINTFORML 「うん、大丈夫ですよ。横になって少し楽になりました」
PRINTFORML 「くるなら早くきて…ううん、やっぱり何もこないでー」	PRINTFORML 「くるなら早くきて…ううん、やっぱり何もこないでー」
PRINTFORML 「うう…どうしてこんなことになっちゃったんだろ……」	PRINTFORML 「うう…どうしてこんなことになっちゃったんだろ……」
PRINTFORML 「え、えーと…とりあえず周りをよく調べてみなきゃ！」	PRINTFORML 「え、えーと…とりあえず周りをよく調べてみなきゃ！」
PRINTFORML 「そ、そんなことないよね！きっと似てるだけだよね！」	PRINTFORML 「そ、そんなことないよね！きっと似てるだけだよね！」
PRINTFORML 「これに懲りたらもうエッチなことはめっ！ですよ！」	PRINTFORML 「これに懲りたらもうエッチなことはめっ！ですよ！」
PRINTFORMDL 大妖精の全身を揉みしだく肉壁にもみくちゃにされ、	PRINTFORMDL 大妖精の全身を揉みしだく肉壁にもみくちゃにされ、
PRINTFORML 「チルノちゃんの次はにょろにょろ相手に戦争なの？」	PRINTFORML 「チルノちゃんの次はにょろにょろ相手に戦争なの？」
PRINTFORMDL イヤでも感じる腹の圧迫感に大妖精の表情は晴れない	PRINTFORMDL イヤでも感じる腹の圧迫感に大妖精の表情は晴れない
PRINTFORML 「あかちゃん･･･ばけもののあかちゃんがいるの…」	PRINTFORML 「あかちゃん･･･ばけもののあかちゃんがいるの…」
PRINTFORML 「そろそろ誰かがこの異変解決してくれてもいいのに」	PRINTFORML 「そろそろ誰かがこの異変解決してくれてもいいのに」
PRINTFORML 「えへへ…どうせなら…かわいい女の子が欲しいな…」	PRINTFORML 「えへへ…どうせなら…かわいい女の子が欲しいな…」
﻿PRINTFORML いつも一生懸命な大ちゃんをいじめたい追い詰めたい	PRINTFORML いつも一生懸命な大ちゃんをいじめたい追い詰めたい
PRINTFORML 「えっちなことしちゃめっ！なんですよ！きゃあ！」	PRINTFORML 「えっちなことしちゃめっ！なんですよ！きゃあ！」
PRINTFORML 「は、早く着替え見つけないと裸になっちゃうっ…」	PRINTFORML 「は、早く着替え見つけないと裸になっちゃうっ…」
PRINTFORML 「%CALLNAME:(ARG:1)%ちゃん…」	PRINTFORML 「%CALLNAME:(ARG:1)%ちゃん…」
PRINTFORML 「ここではこんな事があって…こんな事もあって…」	PRINTFORML 「ここではこんな事があって…こんな事もあって…」
PRINTFORML 「ぅぅ…大丈夫です。見張りの役目はできますから」	PRINTFORML 「ぅぅ…大丈夫です。見張りの役目はできますから」
PRINTFORML 「私と遊んでくれませんか？ふふ…ふふふふふふふ」	PRINTFORML 「私と遊んでくれませんか？ふふ…ふふふふふふふ」
PRINTFORML 「今回だってそう！私ばっかり酷い目にあってる！」	PRINTFORML 「今回だってそう！私ばっかり酷い目にあってる！」
PRINTFORML 「…もうやだ！一緒にいるなんて我慢できないよ！」	PRINTFORML 「…もうやだ！一緒にいるなんて我慢できないよ！」
PRINTFORML 「着替えるべきかまだ取っておくべきか…うーん…」	PRINTFORML 「着替えるべきかまだ取っておくべきか…うーん…」
PRINTFORML 弱い子が必死なのってそそるよね！興奮するよね！	PRINTFORML 弱い子が必死なのってそそるよね！興奮するよね！
PRINTFORML 「これだけ用意すれば！避けれないでしょう！？」	PRINTFORML 「これだけ用意すれば！避けれないでしょう！？」
PRINTFORML 「この量のクナイ弾、避けれますか？うふふっ♪」	PRINTFORML 「この量のクナイ弾、避けれますか？うふふっ♪」
PRINTFORML 大妖精は這い出そうと手足をばたつかせ暴れている	PRINTFORML 大妖精は這い出そうと手足をばたつかせ暴れている
PRINTFORML 「どうしてこんな目にあわなきゃいけないの！？」	PRINTFORML 「どうしてこんな目にあわなきゃいけないの！？」
PRINTFORML 「ひゃんっ！？へんなとこ触んないでください！」	PRINTFORML 「ひゃんっ！？へんなとこ触んないでください！」
PRINTFORMDL ぐったりとした大妖精の身体を触手が弄んでいる	PRINTFORMDL ぐったりとした大妖精の身体を触手が弄んでいる
PRINTFORML 「うひゃぁ！？どこ触ろうとしてるんですか！？」	PRINTFORML 「うひゃぁ！？どこ触ろうとしてるんですか！？」
PRINTFORML 「ぅぅう…これじゃいつか変なことされちゃう…」	PRINTFORML 「ぅぅう…これじゃいつか変なことされちゃう…」
PRINTFORML 「ふんふん、そんなとこにそんなのがあったんだ」	PRINTFORML 「ふんふん、そんなとこにそんなのがあったんだ」
PRINTFORML 「空気が悪くて…あんまり寝れる気がしないなぁ」	PRINTFORML 「空気が悪くて…あんまり寝れる気がしないなぁ」
PRINTFORML 「おやすみなさい。ありがとうございます…すぅ」	PRINTFORML 「おやすみなさい。ありがとうございます…すぅ」
PRINTFORML 「おやすみなさい。久しぶりに安心して眠れます」	PRINTFORML 「おやすみなさい。久しぶりに安心して眠れます」
PRINTFORML 「もうっ…もう抵抗しないからぁ…許してぇえ！」	PRINTFORML 「もうっ…もう抵抗しないからぁ…許してぇえ！」
PRINTFORML 「こんなのヤダ！赤ちゃんなんて産みたくない！」	PRINTFORML 「こんなのヤダ！赤ちゃんなんて産みたくない！」
PRINTFORML 「うぅ…なんでもいいから役に立つものでてよぉ」	PRINTFORML 「うぅ…なんでもいいから役に立つものでてよぉ」
PRINTFORMDW そして逆方向の茂みの深いほうへと駆けていった	PRINTFORMDW そして逆方向の茂みの深いほうへと駆けていった
PRINTFORMW 「…チルノちゃん、場外禁止！って忘れてるかも」	PRINTFORMW 「…チルノちゃん、場外禁止！って忘れてるかも」
PRINTFORML 「チルノちゃんをも苦しめた必殺の弾幕です！」	PRINTFORML 「チルノちゃんをも苦しめた必殺の弾幕です！」
PRINTFORML 「……きっと私…このまま食べられちゃうんだ」	PRINTFORML 「……きっと私…このまま食べられちゃうんだ」
PRINTFORML 「なんで…こんなことになっちゃったんだろ…」	PRINTFORML 「なんで…こんなことになっちゃったんだろ…」
PRINTFORML 「ひゃああ！汚いっ！変なのださないでよぉ！」	PRINTFORML 「ひゃああ！汚いっ！変なのださないでよぉ！」
PRINTFORM 「もう…いっか…一回休みで…気持ちいいんだもん	PRINTFORM 「もう…いっか…一回休みで…気持ちいいんだもん
PRINTFORML 「こんな格好見られたらお嫁にいけないよぉ！」	PRINTFORML 「こんな格好見られたらお嫁にいけないよぉ！」
PRINTFORMDL 酸欠でボーっとする頭で必死に意識を繋ぎとめ	PRINTFORMDL 酸欠でボーっとする頭で必死に意識を繋ぎとめ
PRINTFORMW (え…どうして…？みんなやられちゃったの？)	PRINTFORMW (え…どうして…？みんなやられちゃったの？)
PRINTFORML （この娘達なら放っておいても多分大丈夫よね）	PRINTFORML （この娘達なら放っておいても多分大丈夫よね）
PRINTFORML 「う～、なんとなく話しかけ辛い感じだなぁ…」	PRINTFORML 「う～、なんとなく話しかけ辛い感じだなぁ…」
PRINTFORML 「その･･･気分は…良いわけないですよね…」	PRINTFORML 「その･･･気分は…良いわけないですよね…」
PRINTFORML 「空気が悪くて…あんまり寝た気がしないです」	PRINTFORML 「空気が悪くて…あんまり寝た気がしないです」
PRINTFORMDL 大妖精は瞳に涙を浮かべながら探索をしている	PRINTFORMDL 大妖精は瞳に涙を浮かべながら探索をしている
PRINTFORMDL 大妖精は拘束された手足で必死に抵抗している	PRINTFORMDL 大妖精は拘束された手足で必死に抵抗している
PRINTFORMDL 涙でぐしゃぐしゃな顔で大妖精は必死に叫んだ	PRINTFORMDL 涙でぐしゃぐしゃな顔で大妖精は必死に叫んだ
PRINTFORMDW 大妖精は普段出さないような悲痛な声をあげた	PRINTFORMDW 大妖精は普段出さないような悲痛な声をあげた
PRINTFORMDL 大妖精は必死の形相で助けを求めて駆け出した	PRINTFORMDL 大妖精は必死の形相で助けを求めて駆け出した
PRINTFORML 「どうして酷いことばっかりお願いするの！？」	PRINTFORML 「どうして酷いことばっかりお願いするの！？」
PRINTFORML 「……どうしてこんな目にあわなきゃダメなの」	PRINTFORML 「……どうしてこんな目にあわなきゃダメなの」
PRINTFORML (･･･もう…どこでもいいから…寝かせて)」	PRINTFORML (･･･もう…どこでもいいから…寝かせて)」
PRINTFORML 「きっと…ひっく…きっとそう…ふぇえぇえ…」	PRINTFORML 「きっと…ひっく…きっとそう…ふぇえぇえ…」
PRINTFORML 大ちゃんの胸が【巨乳】の状態でスタートします	PRINTFORML 大ちゃんの胸が【巨乳】の状態でスタートします
PRINTFORML 大ちゃんの胸が【貧乳】の状態でスタートします	PRINTFORML 大ちゃんの胸が【貧乳】の状態でスタートします
PRINTFORML 大ちゃんの胸が【絶壁】の状態でスタートします	PRINTFORML 大ちゃんの胸が【絶壁】の状態でスタートします
PRINTFORML 「私に…オトリになれって言うんですか！？」	PRINTFORML 「私に…オトリになれって言うんですか！？」
PRINTFORML 「え？あれ？きゃあ！いつのまに目の前に！」	PRINTFORML 「え？あれ？きゃあ！いつのまに目の前に！」
PRINTFORMDL 大妖精はガタガタと震える腕で武器を構えた	PRINTFORMDL 大妖精はガタガタと震える腕で武器を構えた
PRINTFORML 「……きっと私…このまま殺されちゃうんだ」	PRINTFORML 「……きっと私…このまま殺されちゃうんだ」
PRINTFORML (こんな状況だからこそチャンスを狙って…)	PRINTFORML (こんな状況だからこそチャンスを狙って…)
PRINTFORML 「ここだけはぜーったいにダメですからね！」	PRINTFORML 「ここだけはぜーったいにダメですからね！」
PRINTFORML 「ひぃいいぃ！いやぁああ！いやあぁああ！」	PRINTFORML 「ひぃいいぃ！いやぁああ！いやあぁああ！」
PRINTFORMDL こみ上げる快感に耐えることはできなかった	PRINTFORMDL こみ上げる快感に耐えることはできなかった
PRINTFORMDL 厚い肉の向こう側から何も聞こえないのだ。	PRINTFORMDL 厚い肉の向こう側から何も聞こえないのだ。
PRINTFORMDL さらに出口も肉襞に隠されてしまっている…	PRINTFORMDL さらに出口も肉襞に隠されてしまっている…
PRINTFORML 「ごめん、私じゃ何もしてあげられないや…」	PRINTFORML 「ごめん、私じゃ何もしてあげられないや…」
PRINTFORML 「ごめんなさい…何もしてあげられなくて…」	PRINTFORML 「ごめんなさい…何もしてあげられなくて…」
PRINTFORML 「また機会があればよろしくおねがいします」	PRINTFORML 「また機会があればよろしくおねがいします」
PRINTFORML 「ありがとうございます…体調が…悪くて…」	PRINTFORML 「ありがとうございます…体調が…悪くて…」
PRINTFORM 「せめて…せめてもうちょっとやさし…ふぁぁあ	PRINTFORM 「せめて…せめてもうちょっとやさし…ふぁぁあ
PRINTFORM 「ふぇぇ！？…お、おねがいっやめ…やめ…ぁ…	PRINTFORM 「ふぇぇ！？…お、おねがいっやめ…やめ…ぁ…
PRINTFORML 「痛いよぉ……もうどうしょうもないの…？」	PRINTFORML 「痛いよぉ……もうどうしょうもないの…？」
PRINTFORML 「脱出の手がかりは…手がかりはないの…？」	PRINTFORML 「脱出の手がかりは…手がかりはないの…？」
PRINTFORML 「やだやだやだ！赤ちゃんできちゃうよお！」	PRINTFORML 「やだやだやだ！赤ちゃんできちゃうよお！」
PRINTFORML 「誰か…助けてくれるって…しんじてた……」	PRINTFORML 「誰か…助けてくれるって…しんじてた……」
PRINTFORML 「私はただ…守って欲しかっただけなのに…」	PRINTFORML 「私はただ…守って欲しかっただけなのに…」
PRINTFORML 「早く帰ってのんびりご本の続きよみたいな」	PRINTFORML 「早く帰ってのんびりご本の続きよみたいな」
PRINTFORML 「…ぅぅ…何をいれられちゃったんだろう…」	PRINTFORML 「…ぅぅ…何をいれられちゃったんだろう…」
PRINTFORML 「もうこんなにボロボロ…着替えようかしら」	PRINTFORML 「もうこんなにボロボロ…着替えようかしら」
PRINTFORML 「･･･この匂い、私の体からしているの？」	PRINTFORML 「･･･この匂い、私の体からしているの？」
PRINTFORML イタズラ好きでちょっと天然でちょっと黒い	PRINTFORML イタズラ好きでちょっと天然でちょっと黒い
PRINTFORMDL 大妖精は頬を紅色に染めて身を守っている	PRINTFORMDL 大妖精は頬を紅色に染めて身を守っている
PRINTFORMDL 大妖精は肩を抱き震えて座り込んでいる…	PRINTFORMDL 大妖精は肩を抱き震えて座り込んでいる…
PRINTFORML 「私、妖精の中では強いコなんですから！」	PRINTFORML 「私、妖精の中では強いコなんですから！」
PRINTFORML 「おもちゃみたいでちょっと面白いかも♪」	PRINTFORML 「おもちゃみたいでちょっと面白いかも♪」
PRINTFORML (おちついて私、まだチャンスはあるわ！)	PRINTFORML (おちついて私、まだチャンスはあるわ！)
PRINTFORML 「もっと素敵な人にあげるんですから…！」	PRINTFORML 「もっと素敵な人にあげるんですから…！」
PRINTFORML 「このままじゃ下着までやぶけちゃうよぉ」	PRINTFORML 「このままじゃ下着までやぶけちゃうよぉ」
PRINTFORML 「追いかけて…よかったぁ…きてないんだ」	PRINTFORML 「追いかけて…よかったぁ…きてないんだ」
PRINTFORML 「どうか見つからないように気をつけて…」	PRINTFORML 「どうか見つからないように気をつけて…」
PRINTFORML 「脚をひっぱらないように気をつけます…」	PRINTFORML 「脚をひっぱらないように気をつけます…」
PRINTFORML 「助かりました。…その、ちょっと辛くて」	PRINTFORML 「助かりました。…その、ちょっと辛くて」
PRINTFORML 「ありがとう。これで安心して眠れます！」	PRINTFORML 「ありがとう。これで安心して眠れます！」
PRINTFORML 「えへへ、洗濯もお掃除も得意なんですよ」	PRINTFORML 「えへへ、洗濯もお掃除も得意なんですよ」
PRINTFORML (見つかっちゃダメ…気をつけなくちゃ…)	PRINTFORML (見つかっちゃダメ…気をつけなくちゃ…)
PRINTFORML 「ばーんときたところをガツンッ！です♪」	PRINTFORML 「ばーんときたところをガツンッ！です♪」
PRINTFORML 「だ、だめぇ！そんなとこさわんないで！」	PRINTFORML 「だ、だめぇ！そんなとこさわんないで！」
PRINTFORMW (消えちゃう……消えちゃうの…私……？)	PRINTFORMW (消えちゃう……消えちゃうの…私……？)
PRINTFORML 「着替え！着替えどこにしまったっけ！？」	PRINTFORML 「着替え！着替えどこにしまったっけ！？」
PRINTFORML 「頑張って直せばまだ大丈夫そうだけど…」	PRINTFORML 「頑張って直せばまだ大丈夫そうだけど…」
PRINTFORML 「きゃっ！？…いつのまに汚れたのかしら」	PRINTFORML 「きゃっ！？…いつのまに汚れたのかしら」
PRINTFORML 「せめて身を隠せる場所だけでもあれば…」	PRINTFORML 「せめて身を隠せる場所だけでもあれば…」
PRINTFORML 「は、はやく外に出ないと私もそのうち…」	PRINTFORML 「は、はやく外に出ないと私もそのうち…」
PRINTFORMW 「ふぇ！？え？え？きゃああぁあああ！？」	PRINTFORMW 「ふぇ！？え？え？きゃああぁあああ！？」
PRINTFORML 大ちゃんの胸は普通の状態でスタートします	PRINTFORML 大ちゃんの胸は普通の状態でスタートします
PRINTFORMDL 大妖精は頭を抱えてぷるぷる震えている	PRINTFORMDL 大妖精は頭を抱えてぷるぷる震えている
PRINTFORML 「オトリなんてやっぱりできませーん！」	PRINTFORML 「オトリなんてやっぱりできませーん！」
PRINTFORML 「無駄遣いしないように気をつけなきゃ」	PRINTFORML 「無駄遣いしないように気をつけなきゃ」
PRINTFORML 「助けて！助けてよお！早く助けてぇ！」	PRINTFORML 「助けて！助けてよお！早く助けてぇ！」
PRINTFORML 「ぅぅ…次で絶対逃げてやるんだから！」	PRINTFORML 「ぅぅ…次で絶対逃げてやるんだから！」
PRINTFORML 「どうして…誰も助けてくれないの…？」	PRINTFORML 「どうして…誰も助けてくれないの…？」
PRINTFORML 「やだやだこないで！私おいしくない！」	PRINTFORML 「やだやだこないで！私おいしくない！」
PRINTFORM 「だめぇええ！一回休みになっちゃぅうーー	PRINTFORM 「だめぇええ！一回休みになっちゃぅうーー
PRINTFORML 「いやぁああ！お腹の中に変なのがぁ！」	PRINTFORML 「いやぁああ！お腹の中に変なのがぁ！」
PRINTFORMW 「どうして…ひどいよ……ひどいよぉ…」	PRINTFORMW 「どうして…ひどいよ……ひどいよぉ…」
PRINTFORML 「うー…一体何匹いるんですか…も～…」	PRINTFORML 「うー…一体何匹いるんですか…も～…」
PRINTFORML 「ゆっくりお話してる場合じゃないよね」	PRINTFORML 「ゆっくりお話してる場合じゃないよね」
PRINTFORML 「そんなことが…えーと、私はですね…」	PRINTFORML 「そんなことが…えーと、私はですね…」
PRINTFORML （…だって、これ以上つれていけないよ）	PRINTFORML （…だって、これ以上つれていけないよ）
PRINTFORML 「はい、見張り一生懸命頑張りますよ！」	PRINTFORML 「はい、見張り一生懸命頑張りますよ！」
PRINTFORML 「そのうち私が見張りしてあげますね！」	PRINTFORML 「そのうち私が見張りしてあげますね！」
PRINTFORMDL 大妖精はしきりに下腹部を気にしている	PRINTFORMDL 大妖精はしきりに下腹部を気にしている
PRINTFORML (お願い……誰も私に気づかないで……)	PRINTFORML (お願い……誰も私に気づかないで……)
PRINTFORMDL 悲痛な大妖精の叫びが洞窟内に木霊した	PRINTFORMDL 悲痛な大妖精の叫びが洞窟内に木霊した
PRINTFORMW (もう…怖い思いも…気持ち悪いのも…)	PRINTFORMW (もう…怖い思いも…気持ち悪いのも…)
PRINTFORMDL 大妖精は幸せそうに湯船に浸かっている	PRINTFORMDL 大妖精は幸せそうに湯船に浸かっている
PRINTFORML 「洗濯物、どうなっちゃったんだろう…」	PRINTFORML 「洗濯物、どうなっちゃったんだろう…」
PRINTFORML 「壁を上に上にほっていけばいつかは…」	PRINTFORML 「壁を上に上にほっていけばいつかは…」
PRINTFORML 「私の能力…役に立たないわね…くすん」	PRINTFORML 「私の能力…役に立たないわね…くすん」
PRINTFORML 「はぁっ…はぁっ……このままじゃ…」	PRINTFORML 「はぁっ…はぁっ……このままじゃ…」
PRINTFORMDL 大妖精はガタガタと震える腕を構えた	PRINTFORMDL 大妖精はガタガタと震える腕を構えた
PRINTFORML 「もっと…もっとすごいのをイメージ」	PRINTFORML 「もっと…もっとすごいのをイメージ」
PRINTFORMDL 大妖精は初めてを奪われまいと必死だ	PRINTFORMDL 大妖精は初めてを奪われまいと必死だ
PRINTFORML 「怖かったぁ…捕まったら大変だもん」	PRINTFORML 「怖かったぁ…捕まったら大変だもん」
PRINTFORML 「うぅぅ…ボロボロになっちゃった…」	PRINTFORML 「うぅぅ…ボロボロになっちゃった…」
PRINTFORML 「待って！？どうして逃げちゃうの！」	PRINTFORML 「待って！？どうして逃げちゃうの！」
PRINTFORML (ボロボロだけど…大丈夫よねたぶん)	PRINTFORML (ボロボロだけど…大丈夫よねたぶん)
PRINTFORML 「ぅぅ…育ってる……絶対育ってる…」	PRINTFORML 「ぅぅ…育ってる……絶対育ってる…」
PRINTFORML (え…お腹の中で…なにかが動いて…)	PRINTFORML (え…お腹の中で…なにかが動いて…)
PRINTFORML 「はやく、はやくなんとかしないと！」	PRINTFORML 「はやく、はやくなんとかしないと！」
PRINTFORML (怖いよぉ…みつかりませんように…)	PRINTFORML (怖いよぉ…みつかりませんように…)
PRINTFORMW (目…醒めたら…きっと全部夢で……)	PRINTFORMW (目…醒めたら…きっと全部夢で……)
PRINTFORML 「……このまま私…捕まっちゃうの？」	PRINTFORML 「……このまま私…捕まっちゃうの？」
PRINTFORML (も、もうえっちな気持ちが…ぅぅぅ)	PRINTFORML (も、もうえっちな気持ちが…ぅぅぅ)
PRINTFORML 「着替えもってるんだし早く着なきゃ」	PRINTFORML 「着替えもってるんだし早く着なきゃ」
PRINTFORML 「気にするほどの汚れではないけど…」	PRINTFORML 「気にするほどの汚れではないけど…」
PRINTFORML しっかりもののお姉さんだけど怖がり	PRINTFORML しっかりもののお姉さんだけど怖がり
PRINTFORML 「私だってやる時はやるんだから！」	PRINTFORML 「私だってやる時はやるんだから！」
PRINTFORML 「もっともっと距離をとらなきゃ！」	PRINTFORML 「もっともっと距離をとらなきゃ！」
PRINTFORML 「おいかけてこないでくださーい！」	PRINTFORML 「おいかけてこないでくださーい！」
PRINTFORML 「私って意外とおてんばなんですよ」	PRINTFORML 「私って意外とおてんばなんですよ」
PRINTFORML 「えっちなことしないでください！」	PRINTFORML 「えっちなことしないでください！」
PRINTFORML (あはは…食べられちゃうのかな…)	PRINTFORML (あはは…食べられちゃうのかな…)
PRINTFORML (い、いまの捕まっちゃってたら…)	PRINTFORML (い、いまの捕まっちゃってたら…)
PRINTFORML 「ひっ！？な、なにかがズルって…」	PRINTFORML 「ひっ！？な、なにかがズルって…」
PRINTFORML 「今は何もしてあげられないけど…」	PRINTFORML 「今は何もしてあげられないけど…」
PRINTFORML (･･･なんかピリピリしてて怖い)	PRINTFORML (･･･なんかピリピリしてて怖い)
PRINTFORML 「へ、へえ…時代は情報戦なんだ…」	PRINTFORML 「へ、へえ…時代は情報戦なんだ…」
PRINTFORML 「ごめん、ちょっとだけ待っててね」	PRINTFORML 「ごめん、ちょっとだけ待っててね」
PRINTFORML 「お互い、早く帰れるといいですね」	PRINTFORML 「お互い、早く帰れるといいですね」
PRINTFORML 「よかったぁ…やっと服を着れる…」	PRINTFORML 「よかったぁ…やっと服を着れる…」
PRINTFORML 「くるしいよぉ…気持ち悪いよぉ…」	PRINTFORML 「くるしいよぉ…気持ち悪いよぉ…」
PRINTFORML 「ふぁあ…そろそろおやすみなさい」	PRINTFORML 「ふぁあ…そろそろおやすみなさい」
PRINTFORM 「だ…だめっ！一回休みになっちゃうっ	PRINTFORM 「だ…だめっ！一回休みになっちゃうっ
PRINTFORML 「はぁ…少しは疲れとれたかな…？」	PRINTFORML 「はぁ…少しは疲れとれたかな…？」
PRINTFORML (足音立てないように気をつけて…)	PRINTFORML (足音立てないように気をつけて…)
PRINTFORML 「うえええん！やだぁ！怖いよお！」	PRINTFORML 「うえええん！やだぁ！怖いよお！」
PRINTFORML 「こんな鬼ごっこたのしくないよぉ」	PRINTFORML 「こんな鬼ごっこたのしくないよぉ」
PRINTFORML 「やだっ…おなかの中で動いてる…」	PRINTFORML 「やだっ…おなかの中で動いてる…」
PRINTFORMDL 大妖精は暗い笑顔を浮かべている…	PRINTFORMDL 大妖精は暗い笑顔を浮かべている…
PRINTFORML 「ひっ…こんなとこにまで粘液が…」	PRINTFORML 「ひっ…こんなとこにまで粘液が…」
PRINTFORML 「ひっ…誰かがやられちゃったの…」	PRINTFORML 「ひっ…誰かがやられちゃったの…」
PRINTFORML 「やだなぁ…私もいつか……ぅぅ…」	PRINTFORML 「やだなぁ…私もいつか……ぅぅ…」
PRINTFORML 「ゾクゾクして……何もできない」	PRINTFORML 「ゾクゾクして……何もできない」
PRINTFORML 「きゃあ！きゃあ！怖い！近い！」	PRINTFORML 「きゃあ！きゃあ！怖い！近い！」
PRINTFORML 「当たって！ねえ当たってよお！」	PRINTFORML 「当たって！ねえ当たってよお！」
PRINTFORML 「もっと…もっとすごい弾幕なら」	PRINTFORML 「もっと…もっとすごい弾幕なら」
PRINTFORML 「………やらなきゃやられちゃう」	PRINTFORML 「………やらなきゃやられちゃう」
PRINTFORML 「手加減無しの全力の弾幕です！」	PRINTFORML 「手加減無しの全力の弾幕です！」
PRINTFORML 「もう…諦めてくださいよお……」	PRINTFORML 「もう…諦めてくださいよお……」
PRINTFORML 「いやぁああ！誰か助けてーー！」	PRINTFORML 「いやぁああ！誰か助けてーー！」
PRINTFORML 「やだぁ！変なことしないでえ！」	PRINTFORML 「やだぁ！変なことしないでえ！」
PRINTFORML (もう…力が…はいんないよぉ…)	PRINTFORML (もう…力が…はいんないよぉ…)
PRINTFORML 「やだ！おっきな穴があいてる…」	PRINTFORML 「やだ！おっきな穴があいてる…」
PRINTFORML 「もー！ケンカなんてできないよ」	PRINTFORML 「もー！ケンカなんてできないよ」
PRINTFORML 「声かけられる雰囲気じゃないや」	PRINTFORML 「声かけられる雰囲気じゃないや」
PRINTFORML 「よーし！みんなでかえろうね！」	PRINTFORML 「よーし！みんなでかえろうね！」
PRINTFORML 「頑張って役に立ってみせます！」	PRINTFORML 「頑張って役に立ってみせます！」
PRINTFORML 「どっちが先に帰れるか競争だよ」	PRINTFORML 「どっちが先に帰れるか競争だよ」
PRINTFORML 「な、なんとか逃げまわります…」	PRINTFORML 「な、なんとか逃げまわります…」
PRINTFORML 「私…どうなっちゃうんだろう…」	PRINTFORML 「私…どうなっちゃうんだろう…」
PRINTFORML 「あ…見張り交代の時間ですか？」	PRINTFORML 「あ…見張り交代の時間ですか？」
PRINTFORML 「寝れる時に寝とかなきゃですね」	PRINTFORML 「寝れる時に寝とかなきゃですね」
PRINTFORML 「見張りお願いします…眠いの…」	PRINTFORML 「見張りお願いします…眠いの…」
PRINTFORM 「あ…あたまっ･･･おかしくっ……	PRINTFORM 「あ…あたまっ･･･おかしくっ……
PRINTFORML (……また…できるまでおなかに)	PRINTFORML (……また…できるまでおなかに)
PRINTFORML 「や、やだ！やだやだやだやだ！」	PRINTFORML 「や、やだ！やだやだやだやだ！」
PRINTFORML 「短距離ワープを上手に使って…」	PRINTFORML 「短距離ワープを上手に使って…」
PRINTFORML 「たっから探し♪たっから探し♪」	PRINTFORML 「たっから探し♪たっから探し♪」
PRINTFORML 「あり…がとう……ございます…」	PRINTFORML 「あり…がとう……ございます…」
PRINTFORML 「どうしよう…あやまらなきゃ…」	PRINTFORML 「どうしよう…あやまらなきゃ…」
PRINTFORML 「いっ…痛いッ……暴れないでッ」	PRINTFORML 「いっ…痛いッ……暴れないでッ」
PRINTFORML 「ぅぅぅ…つかれちゃったよぉ…」	PRINTFORML 「ぅぅぅ…つかれちゃったよぉ…」
PRINTFORML 「化物のおかあさんなんてやだ…」	PRINTFORML 「化物のおかあさんなんてやだ…」
PRINTFORML 「たしか着替えもってたよね…？」	PRINTFORML 「たしか着替えもってたよね…？」
PRINTFORML 「ふぇえん、着替えないのぉ…？」	PRINTFORML 「ふぇえん、着替えないのぉ…？」
PRINTFORML 「もう布が殆どのこってないわ…」	PRINTFORML 「もう布が殆どのこってないわ…」
PRINTFORML 「こっち見ないでくださーい！」	PRINTFORML 「こっち見ないでくださーい！」
PRINTFORML 「落ち着いて、集中しなきゃ…」	PRINTFORML 「落ち着いて、集中しなきゃ…」
PRINTFORML 「私なんて美味しくないよお！」	PRINTFORML 「私なんて美味しくないよお！」
PRINTFORML 「ぬるぬるして気持ち悪いよぉ」	PRINTFORML 「ぬるぬるして気持ち悪いよぉ」
PRINTFORML 「ちょちょちょちょちょ…！？」	PRINTFORML 「ちょちょちょちょちょ…！？」
PRINTFORML 「赤ちゃんなんていらないっ…」	PRINTFORML 「赤ちゃんなんていらないっ…」
PRINTFORML 「ひゃっ、あぶないなあもう！」	PRINTFORML 「ひゃっ、あぶないなあもう！」
PRINTFORML 「な、なにをされちゃったの…」	PRINTFORML 「な、なにをされちゃったの…」
PRINTFORML 「うわーん！ごめんなさーい！」	PRINTFORML 「うわーん！ごめんなさーい！」
PRINTFORMW (私…見捨てられちゃった！？)	PRINTFORMW (私…見捨てられちゃった！？)
PRINTFORML 「私…？大丈夫じゃないよぉ…」	PRINTFORML 「私…？大丈夫じゃないよぉ…」
PRINTFORML 「えへへ、みんなと一緒だぁ♪」	PRINTFORML 「えへへ、みんなと一緒だぁ♪」
PRINTFORML 「きっと誰か助けてくれるよ…」	PRINTFORML 「きっと誰か助けてくれるよ…」
PRINTFORML 「うぅ…一人は不安ですよお…」	PRINTFORML 「うぅ…一人は不安ですよお…」
PRINTFORML 「ん～、ゆっくりやすもうっと」	PRINTFORML 「ん～、ゆっくりやすもうっと」
PRINTFORML 「おかげでやっと寝れます……」	PRINTFORML 「おかげでやっと寝れます……」
PRINTFORML 「気持ち悪いの全部お掃除よ！」	PRINTFORML 「気持ち悪いの全部お掃除よ！」
PRINTFORML 「うわーん！誰か助けてよー！」	PRINTFORML 「うわーん！誰か助けてよー！」
PRINTFORML 「急がなきゃ…急がなきゃ…！」	PRINTFORML 「急がなきゃ…急がなきゃ…！」
PRINTFORML 「きゃあ！…あ、私の影だった」	PRINTFORML 「きゃあ！…あ、私の影だった」
PRINTFORML 「……あ、あれ？私、寝てた？」	PRINTFORML 「……あ、あれ？私、寝てた？」
PRINTFORMDW そう思ったまさにその時だった	PRINTFORMDW そう思ったまさにその時だった
PRINTFORML そんなイメージの大ちゃんです	PRINTFORML そんなイメージの大ちゃんです
PRINTFORML 「ひゃんっ…！？………すぅ」	PRINTFORML 「ひゃんっ…！？………すぅ」
PRINTFORML 「ふぇええ…動けないよぉ…」	PRINTFORML 「ふぇええ…動けないよぉ…」
PRINTFORML 「ふぇ…？ま、前にでるの？」	PRINTFORML 「ふぇ…？ま、前にでるの？」
PRINTFORML 「近くにいたら…危ない…！」	PRINTFORML 「近くにいたら…危ない…！」
PRINTFORML 「誰…か…助け……助けてっ」	PRINTFORML 「誰…か…助け……助けてっ」
PRINTFORML 「いきますよー！必殺炎弾！」	PRINTFORML 「いきますよー！必殺炎弾！」
PRINTFORML 「そんなとこ汚いですよー！」	PRINTFORML 「そんなとこ汚いですよー！」
PRINTFORML 「やめて！やめてください！」	PRINTFORML 「やめて！やめてください！」
PRINTFORML 「気持ち悪い！気持ち悪い！」	PRINTFORML 「気持ち悪い！気持ち悪い！」
PRINTFORML 「変態さんは大ッ嫌いです！」	PRINTFORML 「変態さんは大ッ嫌いです！」
PRINTFORML 「抜いてえ！抜いてよぉお！」	PRINTFORML 「抜いてえ！抜いてよぉお！」
PRINTFORML 「きゃあ！下着みえちゃう！」	PRINTFORML 「きゃあ！下着みえちゃう！」
PRINTFORML 「はぁぁあぁ…こわかったぁ」	PRINTFORML 「はぁぁあぁ…こわかったぁ」
PRINTFORML 「離して！やめて！助けて！」	PRINTFORML 「離して！やめて！助けて！」
PRINTFORMDL 誰かが居るような気がする…	PRINTFORMDL 誰かが居るような気がする…
PRINTFORML 「今は探検のほうが大切よね」	PRINTFORML 「今は探検のほうが大切よね」
PRINTFORML 「私はこんなことがあったの」	PRINTFORML 「私はこんなことがあったの」
PRINTFORMDL (ほうっておけないよね…)	PRINTFORMDL (ほうっておけないよね…)
PRINTFORML 「うん、一緒に頑張ろうね！」	PRINTFORML 「うん、一緒に頑張ろうね！」
PRINTFORML 「えへへ、頑張りましょうね」	PRINTFORML 「えへへ、頑張りましょうね」
PRINTFORML 「眠いよぉ……すぅ…すぅ…」	PRINTFORML 「眠いよぉ……すぅ…すぅ…」
PRINTFORML 「怖いの、きませんように…」	PRINTFORML 「怖いの、きませんように…」
PRINTFORM 「いやっ！やっやっいやっ…ぁ…	PRINTFORM 「いやっ！やっやっいやっ…ぁ…
PRINTFORML 「それ！ふきとばしちゃえ！」	PRINTFORML 「それ！ふきとばしちゃえ！」
PRINTFORML 「ぬきあしー…さしあしー…」	PRINTFORML 「ぬきあしー…さしあしー…」
PRINTFORML 「いいもの見つかるといいな」	PRINTFORML 「いいもの見つかるといいな」
PRINTFORML 「えっち！やだ！やめてぇ！」	PRINTFORML 「えっち！やだ！やめてぇ！」
PRINTFORML 「うふふっ、遊びましょー♪」	PRINTFORML 「うふふっ、遊びましょー♪」
PRINTFORMW (おしまい…なんだ…ね……)	PRINTFORMW (おしまい…なんだ…ね……)
PRINTFORMW (…意識…が…一回…休みに)	PRINTFORMW (…意識…が…一回…休みに)
PRINTFORML 「私だって怒るんですよ！？」	PRINTFORML 「私だって怒るんですよ！？」
PRINTFORMDL 大妖精は虚空を眺めている…	PRINTFORMDL 大妖精は虚空を眺めている…
PRINTFORML 「大空をとびまわりたーい！」	PRINTFORML 「大空をとびまわりたーい！」
PRINTFORML 「ふぁ…あくびとまんない…」	PRINTFORML 「ふぁ…あくびとまんない…」
PRINTFORML 「着替えがないのは不安ね…」	PRINTFORML 「着替えがないのは不安ね…」
PRINTFORML 「早くお風呂にはいりたいわ」	PRINTFORML 「早くお風呂にはいりたいわ」
PRINTFORML 「あら？……気のせいかしら」	PRINTFORML 「あら？……気のせいかしら」
PRINTFORML 「お願い…こないでよぉ…」	PRINTFORML 「お願い…こないでよぉ…」
PRINTFORML 「こんなの勝てないよぉ…」	PRINTFORML 「こんなの勝てないよぉ…」
PRINTFORML 「お願い！これで倒れて！」	PRINTFORML 「お願い！これで倒れて！」
PRINTFORML 「落ち着いて、集中して…」	PRINTFORML 「落ち着いて、集中して…」
PRINTFORML 「変態さんは嫌いです…！」	PRINTFORML 「変態さんは嫌いです…！」
PRINTFORML 「きゃっ！？なになに！？」	PRINTFORML 「きゃっ！？なになに！？」
PRINTFORML 「変なトコさわんないで！」	PRINTFORML 「変なトコさわんないで！」
PRINTFORML 「やめて！汚さないでえ！」	PRINTFORML 「やめて！汚さないでえ！」
PRINTFORML 「…やだ…やだ…怖いよぉ」	PRINTFORML 「…やだ…やだ…怖いよぉ」
PRINTFORML 「私たちじゃ無理だよぉ！」	PRINTFORML 「私たちじゃ無理だよぉ！」
PRINTFORML 「きっと助けていくからね」	PRINTFORML 「きっと助けていくからね」
PRINTFORML 「早く外に出たいですね…」	PRINTFORML 「早く外に出たいですね…」
PRINTFORML 「ふぇ！？え、えっと……」	PRINTFORML 「ふぇ！？え、えっと……」
PRINTFORML 「よろしくお願いします！」	PRINTFORML 「よろしくお願いします！」
PRINTFORML 「きっと出口はあります！」	PRINTFORML 「きっと出口はあります！」
PRINTFORML 「きっと迎えにいくからね」	PRINTFORML 「きっと迎えにいくからね」
PRINTFORML 「その…うまく逃げてね？」	PRINTFORML 「その…うまく逃げてね？」
PRINTFORML 「二手にわかれませんか？」	PRINTFORML 「二手にわかれませんか？」
PRINTFORML 「ふぁぁ…これで一安心…」	PRINTFORML 「ふぁぁ…これで一安心…」
PRINTFORML 「ん～～やっと寝れますね」	PRINTFORML 「ん～～やっと寝れますね」
PRINTFORML (怪物がきませんように…)	PRINTFORML (怪物がきませんように…)
PRINTFORML 「誰か…助けにきてよぉ…」	PRINTFORML 「誰か…助けにきてよぉ…」
PRINTFORML 「あ……私…いったい……」	PRINTFORML 「あ……私…いったい……」
PRINTFORML 「うねうねきもち悪いなぁ」	PRINTFORML 「うねうねきもち悪いなぁ」
PRINTFORML 「目がしょぼしょぼする…」	PRINTFORML 「目がしょぼしょぼする…」
PRINTFORML 「ぅぅぅ…はずかしいよぉ」	PRINTFORML 「ぅぅぅ…はずかしいよぉ」
PRINTFORML 「だいぶ汚れちゃったわ…」	PRINTFORML 「だいぶ汚れちゃったわ…」
PRINTFORML 「ちょっと汚れちゃったわ」	PRINTFORML 「ちょっと汚れちゃったわ」
PRINTFORML 「今は進むしかないわね…」	PRINTFORML 「今は進むしかないわね…」
PRINTFORML 「………げほっ…やっ…」	PRINTFORML 「………げほっ…やっ…」
PRINTFORML 「ひゃっ…っ……ぅぅ…」	PRINTFORML 「ひゃっ…っ……ぅぅ…」
PRINTFORML 「近づくなんて…怖い…」	PRINTFORML 「近づくなんて…怖い…」
PRINTFORML 「それっ！あたってー！」	PRINTFORML 「それっ！あたってー！」
PRINTFORML 「むぐぐぐぐぐぐぐ…！」	PRINTFORML 「むぐぐぐぐぐぐぐ…！」
PRINTFORML 「おうち…帰りたい……」	PRINTFORML 「おうち…帰りたい……」
PRINTFORML 「ぐすっ…ひどいです…」	PRINTFORML 「ぐすっ…ひどいです…」
PRINTFORML 「もう･･･やめて……」	PRINTFORML 「もう･･･やめて……」
PRINTFORML 「…ふぁ…くすぐったい」	PRINTFORML 「…ふぁ…くすぐったい」
PRINTFORML 「ふふっ、残念でした♪」	PRINTFORML 「ふふっ、残念でした♪」
PRINTFORML 「っ！？きゃぁあああ！」	PRINTFORML 「っ！？きゃぁあああ！」
PRINTFORML 「終わった…のかなあ？」	PRINTFORML 「終わった…のかなあ？」
PRINTFORML 「着替えだぁ！わあい♪」	PRINTFORML 「着替えだぁ！わあい♪」
PRINTFORML 「ちゃんと寝れるかな…」	PRINTFORML 「ちゃんと寝れるかな…」
PRINTFORML 「……すごく助かります」	PRINTFORML 「……すごく助かります」
PRINTFORML (そーっと…そーっと…)	PRINTFORML (そーっと…そーっと…)
PRINTFORML 「く、くるならこーい！」	PRINTFORML 「く、くるならこーい！」
PRINTFORML 「いたズら 楽しイなー」	PRINTFORML 「いたズら 楽しイなー」
PRINTFORMW (……えへへ…そっか…)	PRINTFORMW (……えへへ…そっか…)
PRINTFORML 「助けて……おねがい…」	PRINTFORML 「助けて……おねがい…」
PRINTFORML 「ふぁぁ…しあわせー…」	PRINTFORML 「ふぁぁ…しあわせー…」
PRINTFORML 「すごくさっぱりするね」	PRINTFORML 「すごくさっぱりするね」
PRINTFORML 「ふぁぁ…眠いよぉ……」	PRINTFORML 「ふぁぁ…眠いよぉ……」
PRINTFORML 「おなかが気にになる…」	PRINTFORML 「おなかが気にになる…」
PRINTFORML 「新しい服欲しいよぉ…」	PRINTFORML 「新しい服欲しいよぉ…」
PRINTFORML 「一回休みはやだよぉ」	PRINTFORML 「一回休みはやだよぉ」
PRINTFORML 「ここだけは…ダメ…」	PRINTFORML 「ここだけは…ダメ…」
PRINTFORML 「……死んじゃうよぉ」	PRINTFORML 「……死んじゃうよぉ」
PRINTFORML 「乱暴しないでよぉ！」	PRINTFORML 「乱暴しないでよぉ！」
PRINTFORML 「うえええぇえぇん！」	PRINTFORML 「うえええぇえぇん！」
PRINTFORML 「こ、怖かったよぉ…」	PRINTFORML 「こ、怖かったよぉ…」
PRINTFORML 「び、びっくりしたぁ」	PRINTFORML 「び、びっくりしたぁ」
PRINTFORML （こ、こわかったぁ…）	PRINTFORML （こ、こわかったぁ…）
PRINTFORML 「痛い…痛いよぉ……」	PRINTFORML 「痛い…痛いよぉ……」
PRINTFORML 「もう…動けない……」	PRINTFORML 「もう…動けない……」
PRINTFORML 「……疲れ…ちゃった」	PRINTFORML 「……疲れ…ちゃった」
PRINTFORML 「こわ…かったぁ……」	PRINTFORML 「こわ…かったぁ……」
PRINTFORML 「ぅぅ…もうやだよぉ」	PRINTFORML 「ぅぅ…もうやだよぉ」
PRINTFORML 「た、たすけてーー！」	PRINTFORML 「た、たすけてーー！」
PRINTFORML 「私、頑張るからね！」	PRINTFORML 「私、頑張るからね！」
PRINTFORML 「ふぁあ…もう限界…」	PRINTFORML 「ふぁあ…もう限界…」
PRINTFORM 「誰か…誰かたすけぇええ	PRINTFORM 「誰か…誰かたすけぇええ
PRINTFORMDL 「…･･･どうして」	PRINTFORMDL 「…･･･どうして」
PRINTFORML (うぅ…つかれたよぉ)	PRINTFORML (うぅ…つかれたよぉ)
PRINTFORML 「ひっく…えっく……」	PRINTFORML 「ひっく…えっく……」
PRINTFORML 「お風呂気持ちいい…」	PRINTFORML 「お風呂気持ちいい…」
PRINTFORML 「意識が……眠くて…」	PRINTFORML 「意識が……眠くて…」
PRINTFORML 「おなかいたいよぉ…」	PRINTFORML 「おなかいたいよぉ…」
PRINTFORML 「着替え…ないかしら」	PRINTFORML 「着替え…ないかしら」
PRINTFORML 「出口…どこかしら？」	PRINTFORML 「出口…どこかしら？」
PRINTFORML 「帰れるのかしら……」	PRINTFORML 「帰れるのかしら……」
PRINTFORMDL [0]胸も大ちゃん！	PRINTFORMDL [0]胸も大ちゃん！
PRINTFORMDL [1]胸は中ちゃん！	PRINTFORMDL [1]胸は中ちゃん！
PRINTFORMDL [2]胸はぺったん！	PRINTFORMDL [2]胸はぺったん！
PRINTFORML 「………むにゃ…？」	PRINTFORML 「………むにゃ…？」
PRINTFORML 「見ちゃダメです…」	PRINTFORML 「見ちゃダメです…」
PRINTFORML 「ひっく…怖いよぉ」	PRINTFORML 「ひっく…怖いよぉ」
PRINTFORML 「道具を使います！」	PRINTFORML 「道具を使います！」
PRINTFORML 「誰か助けてーー！」	PRINTFORML 「誰か助けてーー！」
PRINTFORML 「もう…諦めて……」	PRINTFORML 「もう…諦めて……」
PRINTFORML 「効いてないの…？」	PRINTFORML 「効いてないの…？」
PRINTFORML 「離してよエッチ！」	PRINTFORML 「離してよエッチ！」
PRINTFORML 「ひやぁあああ！？」	PRINTFORML 「ひやぁあああ！？」
PRINTFORM 「ぁ…んんんっ…ふぁぁ	PRINTFORM 「ぁ…んんんっ…ふぁぁ
PRINTFORML 「ふ、服！服が！？」	PRINTFORML 「ふ、服！服が！？」
PRINTFORML 「ど、どうしよう…」	PRINTFORML 「ど、どうしよう…」
PRINTFORML （誰かいるみたい…）	PRINTFORML （誰かいるみたい…）
PRINTFORML 「･･･心配だなぁ」	PRINTFORML 「･･･心配だなぁ」
PRINTFORML 「え？私ですか…？」	PRINTFORML 「え？私ですか…？」
PRINTFORML 「二手に分かれよう」	PRINTFORML 「二手に分かれよう」
PRINTFORML 「はい、交代ですね」	PRINTFORML 「はい、交代ですね」
PRINTFORML 「ふにゃぁああ！？」	PRINTFORML 「ふにゃぁああ！？」
PRINTFORML 「ふぇえええぇ！？」	PRINTFORML 「ふぇえええぇ！？」
PRINTFORML 「なにかないかなー」	PRINTFORML 「なにかないかなー」
PRINTFORMW (……いし…き…が)	PRINTFORMW (……いし…き…が)
PRINTFORMW (夢で…あって……)	PRINTFORMW (夢で…あって……)
PRINTFORML 「…怒らせちゃった」	PRINTFORML 「…怒らせちゃった」
PRINTFORML 「つかれちゃった…」	PRINTFORML 「つかれちゃった…」
PRINTFORML 「すごいにおい……」	PRINTFORML 「すごいにおい……」
PRINTFORML 「いたっ……ん…」	PRINTFORML 「いたっ……ん…」
PRINTFORML 「離れて弾幕っ！」	PRINTFORML 「離れて弾幕っ！」
PRINTFORML 「に、逃げろー！」	PRINTFORML 「に、逃げろー！」
PRINTFORML 「………よしっ！」	PRINTFORML 「………よしっ！」
PRINTFORML 「は、外れた…？」	PRINTFORML 「は、外れた…？」
PRINTFORML (ふらふらする…)	PRINTFORML (ふらふらする…)
PRINTFORML 「その……あの…」	PRINTFORML 「その……あの…」
PRINTFORML 「またあとでね！」	PRINTFORML 「またあとでね！」
PRINTFORML 「怖い夢見そう…」	PRINTFORML 「怖い夢見そう…」
PRINTFORML 「やぁああん！？」	PRINTFORML 「やぁああん！？」
PRINTFORML (……体…調子が)	PRINTFORML (……体…調子が)
PRINTFORML 「怖い…よぉ……」	PRINTFORML 「怖い…よぉ……」
PRINTFORML 「いぎぃいい！？」	PRINTFORML 「いぎぃいい！？」
PRINTFORMW (やだ…怖い……)	PRINTFORMW (やだ…怖い……)
PRINTFORML 「えへへ…幸せ♪」	PRINTFORML 「えへへ…幸せ♪」
PRINTFORML 「もうやだよお…」	PRINTFORML 「もうやだよお…」
PRINTFORML 「体が重いなぁ…」	PRINTFORML 「体が重いなぁ…」
PRINTFORML (ふわふわする…)	PRINTFORML (ふわふわする…)
PRINTFORML 「もう、散々ね…」	PRINTFORML 「もう、散々ね…」
PRINTFORMDL [3]胸は絶壁！	PRINTFORMDL [3]胸は絶壁！
PRINTFORML 「怖いよぉ……」	PRINTFORML 「怖いよぉ……」
PRINTFORML 「こないで……」	PRINTFORML 「こないで……」
PRINTFORML 「もうやだー!」	PRINTFORML 「もうやだー!」
PRINTFORML 「きゃああ！？」	PRINTFORML 「きゃああ！？」
PRINTFORML 「痛いよぉ……」	PRINTFORML 「痛いよぉ……」
PRINTFORML 「いったーい！」	PRINTFORML 「いったーい！」
PRINTFORM 「ーーーーーーーっ	PRINTFORM 「ーーーーーーーっ
PRINTFORML 「はぁ…はぁ…」	PRINTFORML 「はぁ…はぁ…」
PRINTFORML 「助けて………」	PRINTFORML 「助けて………」
PRINTFORML 「怖かったぁ…」	PRINTFORML 「怖かったぁ…」
PRINTFORML (本当かなぁ…)	PRINTFORML (本当かなぁ…)
PRINTFORML 「のりこめー！」	PRINTFORML 「のりこめー！」
PRINTFORML 「逃げなきゃ…」	PRINTFORML 「逃げなきゃ…」
PRINTFORML 「………ぐすっ」	PRINTFORML 「………ぐすっ」
PRINTFORML 「もうやだ……」	PRINTFORML 「もうやだ……」
PRINTFORML 「誰か………」	PRINTFORML 「誰か………」
PRINTFORML 「怖いよぉ…」	PRINTFORML 「怖いよぉ…」
PRINTFORML 「あ……ぁ…」	PRINTFORML 「あ……ぁ…」
PRINTFORML 「ふぇ……？」	PRINTFORML 「ふぇ……？」
PRINTFORML 「きゃあ！？」	PRINTFORML 「きゃあ！？」
PRINTFORML 「きゃあっ！」	PRINTFORML 「きゃあっ！」
PRINTFORML 「ひぃい！？」	PRINTFORML 「ひぃい！？」
PRINTFORML 「ふぇぇぇ…」	PRINTFORML 「ふぇぇぇ…」
PRINTFORML (ん？人影？)	PRINTFORML (ん？人影？)
PRINTFORML 「きゃっ…？」	PRINTFORML 「きゃっ…？」
PRINTFORML 「いそげー！」	PRINTFORML 「いそげー！」
PRINTFORML 「いっけー！」	PRINTFORML 「いっけー！」
PRINTFORML 「…怖いよお」	PRINTFORML 「…怖いよお」
PRINTFORML 「えっち！」	PRINTFORML 「えっち！」
PRINTFORML 「ふぇ……」	PRINTFORML 「ふぇ……」
PRINTFORML 「ぅぅぅ…」	PRINTFORML 「ぅぅぅ…」
PRINTFORML 「助け……」	PRINTFORML 「助け……」
PRINTFORML …はっ！？」	PRINTFORML …はっ！？」
PRINTFORML 「ひっ……」	PRINTFORML 「ひっ……」
PRINTFORML 「ぐすっ…」	PRINTFORML 「ぐすっ…」
PRINTFORML 「へ？私…」	PRINTFORML 「へ？私…」
PRINTFORML 「ん～……」	PRINTFORML 「ん～……」
PRINTFORML 「え？え？」	PRINTFORML 「え？え？」
PRINTFORML 「妊娠……」	PRINTFORML 「妊娠……」
PRINTFORML 「はぁ……」	PRINTFORML 「はぁ……」
PRINTFORMDL 大ちゃんは	PRINTFORMDL 大ちゃんは
PRINTFORML （…？）	PRINTFORML （…？）
PRINTFORM 「あっ…	PRINTFORM 「あっ…
PRINTFORM 「ふぁ…	PRINTFORM 「ふぁ…
PRINTFORM 」	PRINTFORM 」
PRINTFORM 「	PRINTFORM 「
