//口上:

PRINTFORMW 「さ・・・さっさと来てよっ！　こないと凍らせてやるんだからぁっ！」	PRINTFORMW 「さ・・・さっさと来てよっ！　こないと凍らせてやるんだからぁっ！」
PRINTFORMW 「パンツがなくても恥ずかし・・・やっぱり恥ずかしい・・・」	PRINTFORMW 「パンツがなくても恥ずかし・・・やっぱり恥ずかしい・・・」
PRINTFORMW 「おかしい・・・な・・・あたいさいきょぉ、なのに・・・」	PRINTFORMW 「おかしい・・・な・・・あたいさいきょぉ、なのに・・・」
PRINTFORMW 「あたいにサイキョーっぷりはこんな所じゃ留まらない！」	PRINTFORMW 「あたいにサイキョーっぷりはこんな所じゃ留まらない！」
PRINTFORMW 「サイキョーに最速が合わさってサイキョーに見えそう！」	PRINTFORMW 「サイキョーに最速が合わさってサイキョーに見えそう！」
PRINTFORMW 「あたい・・・ちんチルノなんかじゃないのにぃ・・・」	PRINTFORMW 「あたい・・・ちんチルノなんかじゃないのにぃ・・・」
PRINTFORMW は「;」を左につけるか消すかしたほうがよいでしょう	PRINTFORMW は「;」を左につけるか消すかしたほうがよいでしょう
PRINTFORMW 「あたいってばサイキョーめっ！・・・かんでないっ」	PRINTFORMW 「あたいってばサイキョーめっ！・・・かんでないっ」
PRINTFORMW 「あたいってば・・・本当におバカさんね・・・全く」	PRINTFORMW 「あたいってば・・・本当におバカさんね・・・全く」
PRINTFORMW 「魔理沙じゃないけどちょっと借りるだけだし・・・」	PRINTFORMW 「魔理沙じゃないけどちょっと借りるだけだし・・・」
PRINTFORMW 「低速ひこーしかできないわくじゃないけど・・・」	PRINTFORMW 「低速ひこーしかできないわくじゃないけど・・・」
PRINTFORMW 「ねんがんの　アイスソードを　てにいれてないっ」	PRINTFORMW 「ねんがんの　アイスソードを　てにいれてないっ」
PRINTFORMW 「コンゴトモヨロシク・・・あれ、違ったっけ？」	PRINTFORMW 「コンゴトモヨロシク・・・あれ、違ったっけ？」
PRINTFORMW 「あたいのサイキョーさに舌抜かれてなさいっ！」	PRINTFORMW 「あたいのサイキョーさに舌抜かれてなさいっ！」
PRINTFORMW 「へんなもんひろいぐいはー、変なのしかないし」	PRINTFORMW 「へんなもんひろいぐいはー、変なのしかないし」
PRINTFORMW 「こんなところにいられ・・・るかっての・・・」	PRINTFORMW 「こんなところにいられ・・・るかっての・・・」
PRINTFORMW 「お前らなんて怖くないんだからっ…本当よっ」	PRINTFORMW 「お前らなんて怖くないんだからっ…本当よっ」
PRINTFORMW 「あ・・あれ・・・ちからがはいらない・・・」	PRINTFORMW 「あ・・あれ・・・ちからがはいらない・・・」
PRINTFORMW 「結構やるじゃないの・・・でもまだよ・・・」	PRINTFORMW 「結構やるじゃないの・・・でもまだよ・・・」
PRINTFORMW 「あたいのおっぱいたべられぇ、んんぅぅうう」	PRINTFORMW 「あたいのおっぱいたべられぇ、んんぅぅうう」
PRINTFORMW 「ねんがんの　アイスソードを　じゃなかった」	PRINTFORMW 「ねんがんの　アイスソードを　じゃなかった」
PRINTFORMW 「あたいが歩いても棒にも当たらないんだから」	PRINTFORMW 「あたいが歩いても棒にも当たらないんだから」
PRINTFORMW 「ひにぁっ！　・・・お、おち・・・ええ？！」	PRINTFORMW 「ひにぁっ！　・・・お、おち・・・ええ？！」
PRINTFORMW 「えたーなるふぉーすー・・・くりーんっ！」	PRINTFORMW 「えたーなるふぉーすー・・・くりーんっ！」
PRINTFORMW 「なんでだろう・・・さむい・・・や・・・」	PRINTFORMW 「なんでだろう・・・さむい・・・や・・・」
PRINTFORMW 「きゅーそくチャージサイキョーキープっ！」	PRINTFORMW 「きゅーそくチャージサイキョーキープっ！」
PRINTFORMW 「もっとぉ・・もっとしろいぃのぉ・・・」	PRINTFORMW 「もっとぉ・・もっとしろいぃのぉ・・・」
PRINTFORMW 「あたいのサイキョーさに参ってなさい！」	PRINTFORMW 「あたいのサイキョーさに参ってなさい！」
PRINTFORMW 「もっとぉ・・・もっと熱いのがぁ・・・」	PRINTFORMW 「もっとぉ・・・もっと熱いのがぁ・・・」
PRINTFORMW 「サイキョーなあたいにふさわしーかしら」	PRINTFORMW 「サイキョーなあたいにふさわしーかしら」
PRINTFORMW 「はぁ・・・きゅーけーしたいなぁ・・・」	PRINTFORMW 「はぁ・・・きゅーけーしたいなぁ・・・」
PRINTFORMW 「涼しくなってから倒すんだからぁ・・・」	PRINTFORMW 「涼しくなってから倒すんだからぁ・・・」
PRINTFORMW 「あたいすいとりゃれ・・・んんぅ・・・」	PRINTFORMW 「あたいすいとりゃれ・・・んんぅ・・・」
PRINTFORMW 小さな郡を出して解けるのを見ているようだ	PRINTFORMW 小さな郡を出して解けるのを見ているようだ
PRINTFORMW 「あたいのさいきょーさ・・・なおった？」	PRINTFORMW 「あたいのさいきょーさ・・・なおった？」
PRINTFORMW 「あつぅっ、　あついのがぁぁああ！！」	PRINTFORMW 「あつぅっ、　あついのがぁぁああ！！」
PRINTFORMW 「変なのとれた・・・出たら取れるのね」	PRINTFORMW 「変なのとれた・・・出たら取れるのね」
PRINTFORMW はその行の左にある「;」を消しましょう	PRINTFORMW はその行の左にある「;」を消しましょう
PRINTFORMW 「裂けちゃぅ・・・ところだった・・・」	PRINTFORMW 「裂けちゃぅ・・・ところだった・・・」
PRINTFORMW 「この借りは後でたくさん返しね・・・」	PRINTFORMW 「この借りは後でたくさん返しね・・・」
PRINTFORMW 「最強なあたいが、どーにかしないとね」	PRINTFORMW 「最強なあたいが、どーにかしないとね」
PRINTFORMW 「抜き足差しあり時雨足・・・違った？」	PRINTFORMW 「抜き足差しあり時雨足・・・違った？」
PRINTFORMW 「ゆっくり浮いたらバレずにいいのかな」	PRINTFORMW 「ゆっくり浮いたらバレずにいいのかな」
PRINTFORML 「あたいは一人でもサイキョーだしっ！」	PRINTFORML 「あたいは一人でもサイキョーだしっ！」
PRINTFORMW 「さいきょーなあたいのさいたんねっ！」	PRINTFORMW 「さいきょーなあたいのさいたんねっ！」
PRINTFORMW 「あたいのサイキョーさには及ばないわ」	PRINTFORMW 「あたいのサイキョーさには及ばないわ」
PRINTFORMW 「濡れる服がないから透けないもんっ！」	PRINTFORMW 「濡れる服がないから透けないもんっ！」
PRINTFORMW 「・・・・・・・もげちゃった・・・」	PRINTFORMW 「・・・・・・・もげちゃった・・・」
PRINTFORMW 「うぅぅ・・・き、休憩よ休憩・・・」	PRINTFORMW 「うぅぅ・・・き、休憩よ休憩・・・」
PRINTFORMW 「う・・・うっかりしてないし・・・」	PRINTFORMW 「う・・・うっかりしてないし・・・」
PRINTFORMW 「最強なあたいに任せてなさいっての」	PRINTFORMW 「最強なあたいに任せてなさいっての」
PRINTFORMW 「後で拾うからっちょっとまってて！」	PRINTFORMW 「後で拾うからっちょっとまってて！」
PRINTFORMW 「おっぱいたべ・・ちゃぁああ・・・」	PRINTFORMW 「おっぱいたべ・・ちゃぁああ・・・」
PRINTFORMW 「やだっやだァァあ！！・・・ぁぁっ」	PRINTFORMW 「やだっやだァァあ！！・・・ぁぁっ」
PRINTFORMW 「あたいの冷気邪魔でしょ、どーせっ」	PRINTFORMW 「あたいの冷気邪魔でしょ、どーせっ」
PRINTFORMW 「よく寝て育つ、だからサイキョー！」	PRINTFORMW 「よく寝て育つ、だからサイキョー！」
PRINTFORMW 「あたいのさいきょーさ・・・復活？」	PRINTFORMW 「あたいのさいきょーさ・・・復活？」
PRINTFORMW 「あたいの氷はぶちぬくドリルよ！」	PRINTFORMW 「あたいの氷はぶちぬくドリルよ！」
PRINTFORMW 「ま、まだあきらめてなんてないし」	PRINTFORMW 「ま、まだあきらめてなんてないし」
PRINTFORMW 「一気にけりつけるんだから・・・」	PRINTFORMW 「一気にけりつけるんだから・・・」
PRINTFORMW 「戦略的なんたらだからいいのよっ」	PRINTFORMW 「戦略的なんたらだからいいのよっ」
PRINTFORMW 「いっ、痛っ痛いぃってぇのぉっ！」	PRINTFORMW 「いっ、痛っ痛いぃってぇのぉっ！」
PRINTFORMW 「な、なにさ。どーってことないし」	PRINTFORMW 「な、なにさ。どーってことないし」
PRINTFORMW 「ばかめっ！ぶらふにかかったな！」	PRINTFORMW 「ばかめっ！ぶらふにかかったな！」
PRINTFORMW 「ぅー、ほんちょーしじゃないかも」	PRINTFORMW 「ぅー、ほんちょーしじゃないかも」
PRINTFORML 「じゃんけんで先寝るの決めましょ」	PRINTFORML 「じゃんけんで先寝るの決めましょ」
PRINTFORMW 「こーたいの時間ってこれくらい？」	PRINTFORMW 「こーたいの時間ってこれくらい？」
PRINTFORMW 「たのんだ・・か・・・ぁぅ」ぱたっ	PRINTFORMW 「たのんだ・・か・・・ぁぅ」ぱたっ
PRINTFORMW 「凍らせちゃダメ？だめかぁ・・・」	PRINTFORMW 「凍らせちゃダメ？だめかぁ・・・」
PRINTFORMW 「ゃ・・う、変なのついてる・・・」	PRINTFORMW 「ゃ・・う、変なのついてる・・・」
PRINTFORMW 「こ、これくらいどーって・・・」	PRINTFORMW 「こ、これくらいどーって・・・」
PRINTFORMW 「あつぅいの・・・でたぁ・・・」	PRINTFORMW 「あつぅいの・・・でたぁ・・・」
PRINTFORMW 「ぁはぅっ　ひ、んんぅぅうう！」	PRINTFORMW 「ぁはぅっ　ひ、んんぅぅうう！」
PRINTFORMW 「ひんぅぅうっ　で、ちゃぁあ！」	PRINTFORMW 「ひんぅぅうっ　で、ちゃぁあ！」
PRINTFORMW 「よくわからんがとにかくよしっ」	PRINTFORMW 「よくわからんがとにかくよしっ」
PRINTFORML 「あと・・・おねが・・・がくっ」	PRINTFORML 「あと・・・おねが・・・がくっ」
PRINTFORMW 「氷風呂ってばさいきょーねっ！」	PRINTFORMW 「氷風呂ってばさいきょーねっ！」
PRINTFORMW 「飛べない妖精はただの妖精よっ」	PRINTFORMW 「飛べない妖精はただの妖精よっ」
PRINTFORMW 「次は勝つからいいのよ・・・」	PRINTFORMW 「次は勝つからいいのよ・・・」
PRINTFORMW 「あーもーっ、むかつく～～っ」	PRINTFORMW 「あーもーっ、むかつく～～っ」
PRINTFORMW 「ぅ・・・んんぅ・・・ぁあっ」	PRINTFORMW 「ぅ・・・んんぅ・・・ぁあっ」
PRINTFORMW 「大ちゃん・・・一回休み中？」	PRINTFORMW 「大ちゃん・・・一回休み中？」
PRINTFORMW 「・・・・・・・へんじがない」	PRINTFORMW 「・・・・・・・へんじがない」
PRINTFORMW 「はぁ・・・どしたもんかなぁ」	PRINTFORMW 「はぁ・・・どしたもんかなぁ」
PRINTFORMW 「コレこれしかうまってことね」	PRINTFORMW 「コレこれしかうまってことね」
PRINTFORMW 「あたいについてらっしゃい！」	PRINTFORMW 「あたいについてらっしゃい！」
PRINTFORMW 「おったからーかーらっぽー？」	PRINTFORMW 「おったからーかーらっぽー？」
PRINTFORMW 「氷風呂ダメ？・・・だめかぁ」	PRINTFORMW 「氷風呂ダメ？・・・だめかぁ」
PRINTFORMW 「場所は覚えた！・・・多分！」	PRINTFORMW 「場所は覚えた！・・・多分！」
PRINTFORMW 「届くわけ無いでしょバーカっ」	PRINTFORMW 「届くわけ無いでしょバーカっ」
PRINTFORMW 「大ちゃんのに似てる・・・？」	PRINTFORMW 「大ちゃんのに似てる・・・？」
PRINTFORMW 「アイシクルマシンガンっ！」	PRINTFORMW 「アイシクルマシンガンっ！」
PRINTFORMW 「喰らいボムだからセーフっ」	PRINTFORMW 「喰らいボムだからセーフっ」
PRINTFORMW 「で、ちゃぁああ・・・！！」	PRINTFORMW 「で、ちゃぁああ・・・！！」
PRINTFORMW 「ぁっ・・・ひんぅっ・・・」	PRINTFORMW 「ぁっ・・・ひんぅっ・・・」
PRINTFORMW 「あたいサイキョーだもんっ」	PRINTFORMW 「あたいサイキョーだもんっ」
PRINTFORMW 「いいもの欲しいなぁ・・・」	PRINTFORMW 「いいもの欲しいなぁ・・・」
PRINTFORMW 「今じゃなくていいし・・・」	PRINTFORMW 「今じゃなくていいし・・・」
PRINTFORMW 「これでもっっくらえっ！」	PRINTFORMW 「これでもっっくらえっ！」
PRINTFORMW 「うつべしっうつべしっ！」	PRINTFORMW 「うつべしっうつべしっ！」
PRINTFORMW 「ぁ・・・たべられ・・・」	PRINTFORMW 「ぁ・・・たべられ・・・」
PRINTFORMW 　「ぅ・・・んんぅ・・・」	PRINTFORMW 　「ぅ・・・んんぅ・・・」
PRINTFORMW 「なっ、何したしっ・・・」	PRINTFORMW 「なっ、何したしっ・・・」
PRINTFORMW 「このロリコンどもめっ！」	PRINTFORMW 「このロリコンどもめっ！」
PRINTFORMW 「これくらいぶゆーだしっ」	PRINTFORMW 「これくらいぶゆーだしっ」
PRINTFORMW 「とりっくおあなんとか！」	PRINTFORMW 「とりっくおあなんとか！」
PRINTFORMW 「なんかいまいちね・・・」	PRINTFORMW 「なんかいまいちね・・・」
PRINTFORMW 「もぉ・・・らめぇ・・・」	PRINTFORMW 「もぉ・・・らめぇ・・・」
PRINTFORMW 「面白そうなのないかな～」	PRINTFORMW 「面白そうなのないかな～」
PRINTFORMW 「コインいっこ　入った！」	PRINTFORMW 「コインいっこ　入った！」
PRINTFORML 「アイシクルフォール！」	PRINTFORML 「アイシクルフォール！」
PRINTFORMW ちゃんとノーマルのようだ	PRINTFORMW ちゃんとノーマルのようだ
PRINTFORMW 「ぅぐ・・・ふ、ふんっ」	PRINTFORMW 「ぅぐ・・・ふ、ふんっ」
PRINTFORMW 「へ・・へへんっ・・・」	PRINTFORMW 「へ・・へへんっ・・・」
PRINTFORMW 「ぅ・・・や、やばい？」	PRINTFORMW 「ぅ・・・や、やばい？」
PRINTFORMW 「・・・、、。あたい？」	PRINTFORMW 「・・・、、。あたい？」
PRINTFORMW 「ぁ・・・ぁはぁ・・・」	PRINTFORMW 「ぁ・・・ぁはぁ・・・」
PRINTFORMW 「・・・・・・ありがと」	PRINTFORMW 「・・・・・・ありがと」
PRINTFORMW 「んみ・・・眠い・・・」	PRINTFORMW 「んみ・・・眠い・・・」
PRINTFORMW 「んじゃあ任せるわよ～」	PRINTFORMW 「んじゃあ任せるわよ～」
PRINTFORMW 「寝床はどこよぉ・・・」	PRINTFORMW 「寝床はどこよぉ・・・」
PRINTFORMW 「いっぱつまんぞくっ」	PRINTFORMW 「いっぱつまんぞくっ」
PRINTFORMW 「何するのさバカッ！」	PRINTFORMW 「何するのさバカッ！」
PRINTFORMW 「うぐぅ・・・むむむ」	PRINTFORMW 「うぐぅ・・・むむむ」
PRINTFORMW 「ま、まだまだ・・・」	PRINTFORMW 「ま、まだまだ・・・」
PRINTFORMW 「逃げるが勝ってる！」	PRINTFORMW 「逃げるが勝ってる！」
PRINTFORMW 「また・・・あとでね」	PRINTFORMW 「また・・・あとでね」
PRINTFORMW 「ふぁいとー９はつ！」	PRINTFORMW 「ふぁいとー９はつ！」
PRINTFORMW 「ながしぎりぃっ！」	PRINTFORMW 「ながしぎりぃっ！」
PRINTFORMW 「はーなーせぇーっ」	PRINTFORMW 「はーなーせぇーっ」
PRINTFORMW 「ぅ・・・くぁぅっ」	PRINTFORMW 「ぅ・・・くぁぅっ」
PRINTFORMW 「ふ・・・ふぇぁ？」	PRINTFORMW 「ふ・・・ふぇぁ？」
PRINTFORMW 「よゆーよゆーっ！」	PRINTFORMW 「よゆーよゆーっ！」
PRINTFORMW よたよたと飛び去った	PRINTFORMW よたよたと飛び去った
PRINTFORMW 「ん～・・・？？？」	PRINTFORMW 「ん～・・・？？？」
PRINTFORMW 「・・・あやしいし」	PRINTFORMW 「・・・あやしいし」
PRINTFORMW 「うりゃりゃあ！」	PRINTFORMW 「うりゃりゃあ！」
PRINTFORMW 「けちらせーっ！」	PRINTFORMW 「けちらせーっ！」
PRINTFORMW ・・・負けたようだ	PRINTFORMW ・・・負けたようだ
PRINTFORMW 「・・・ねみゅい」	PRINTFORMW 「・・・ねみゅい」
PRINTFORMW 「ぬぐぐ・・・」	PRINTFORMW 「ぬぐぐ・・・」
PRINTFORMW ぽかんとしている	PRINTFORMW ぽかんとしている
PRINTFORMW 「グレイスよっ」	PRINTFORMW 「グレイスよっ」
PRINTFORMW 「みきったぁ！」	PRINTFORMW 「みきったぁ！」
PRINTFORMW ＼ひゃっはー！／	PRINTFORMW ＼ひゃっはー！／
PRINTFORMW 「ごーごーっ！」	PRINTFORMW 「ごーごーっ！」
PRINTFORMW ～氷精睡眠中～	PRINTFORMW ～氷精睡眠中～
PRINTFORMW 「うぅ・・・」	PRINTFORMW 「うぅ・・・」
PRINTFORMW 「したらば？」	PRINTFORMW 「したらば？」
PRINTFORMW ～氷精雑談中～	PRINTFORMW ～氷精雑談中～
PRINTFORMW 「ぅー・・・」	PRINTFORMW 「ぅー・・・」
PRINTFORMW ～氷精待機中～	PRINTFORMW ～氷精待機中～
PRINTFORMW 「・・・はぅ」	PRINTFORMW 「・・・はぅ」
PRINTFORMW 「・・・ふぅ」	PRINTFORMW 「・・・ふぅ」
PRINTFORMW 「突撃ー！」	PRINTFORMW 「突撃ー！」
PRINTFORMW ちるののうら	PRINTFORMW ちるののうら
PRINTFORMW 「おーっす」	PRINTFORMW 「おーっす」
PRINTFORMW スヤァ・・・	PRINTFORMW スヤァ・・・
﻿PRINTFORMW ＼パリィ／	PRINTFORMW ＼パリィ／
PRINTFORMW ＼やべぇ／	PRINTFORMW ＼やべぇ／
PRINTFORMW	PRINTFORMW
