//口上:

PRINTFORMW （思い出せない思い出せない思い出せない思い出せない思い出せない思い出せない思い出せない思い出せない思い出せない）	PRINTFORMW （思い出せない思い出せない思い出せない思い出せない思い出せない思い出せない思い出せない思い出せない思い出せない）
PRINTFORMDW 美鈴は捕食されていることに気が付いているのか付いていないのか、焦点の合っていない目で何も無い空間を見つめている	PRINTFORMDW 美鈴は捕食されていることに気が付いているのか付いていないのか、焦点の合っていない目で何も無い空間を見つめている
PRINTFORML この口上での美鈴は「勝手に迷い込んだ」のではなく、「レミリアから探索を頼まれた」という設定になっています。	PRINTFORML この口上での美鈴は「勝手に迷い込んだ」のではなく、「レミリアから探索を頼まれた」という設定になっています。
PRINTFORMW 「はぁっ！はぁっ！…%ARGS:1%さんのナカ、んっ、すごくイイです！腰が…くぅっ！止まらないんですっ！」	PRINTFORMW 「はぁっ！はぁっ！…%ARGS:1%さんのナカ、んっ、すごくイイです！腰が…くぅっ！止まらないんですっ！」
PRINTFORMDW 美鈴は自分の体が邪悪な気に対して拒絶を繰り返す痛みと、体内の子が美鈴の気に拒絶を繰り返す痛みを感じている	PRINTFORMDW 美鈴は自分の体が邪悪な気に対して拒絶を繰り返す痛みと、体内の子が美鈴の気に拒絶を繰り返す痛みを感じている
PRINTFORMDL 美鈴の瞳にもはや正気の色は無く、まるで何かに憑りつかれたように%ARGS:1%へゆっくりと向かって行く。	PRINTFORMDL 美鈴の瞳にもはや正気の色は無く、まるで何かに憑りつかれたように%ARGS:1%へゆっくりと向かって行く。
PRINTFORMDW 美鈴が近づいて行った時に一瞬だけ%ARGS:1%の瞳に怯えの色が戻ったが、それに気づいた者は誰もいない…	PRINTFORMDW 美鈴が近づいて行った時に一瞬だけ%ARGS:1%の瞳に怯えの色が戻ったが、それに気づいた者は誰もいない…
PRINTFORMDW %ARGS:1%のアヌスでの射精が終わり、その快感の余韻に浸っているのは間違いなく、あの美鈴であった。	PRINTFORMDW %ARGS:1%のアヌスでの射精が終わり、その快感の余韻に浸っているのは間違いなく、あの美鈴であった。
PRINTFORMDW 美鈴は口の端を吊り上げ、自らの股間に付いていた"ソレ"を%ARGS:1%のヴァギナに突き入れた。	PRINTFORMDW 美鈴は口の端を吊り上げ、自らの股間に付いていた"ソレ"を%ARGS:1%のヴァギナに突き入れた。
PRINTFORMDW 暫くはゆっくりと腰を動かしていたが、アヌスの感触を気に入り始めたのか徐々にスピードを上げて行き…	PRINTFORMDW 暫くはゆっくりと腰を動かしていたが、アヌスの感触を気に入り始めたのか徐々にスピードを上げて行き…
PRINTFORMW 「運動ができるとかできないか、役に立つとか立たないとか、そんなことどうだっていいじゃないですか」	PRINTFORMW 「運動ができるとかできないか、役に立つとか立たないとか、そんなことどうだっていいじゃないですか」
PRINTFORMW 「そういえばよく小悪魔が似たようなものを使ってパチュリー様の実験の手伝いをしていたような…」	PRINTFORMW 「そういえばよく小悪魔が似たようなものを使ってパチュリー様の実験の手伝いをしていたような…」
PRINTFORMDW 美鈴は湧き出るように出てくる精液とそれによってもたらされる快感により痙攣を繰り返している！	PRINTFORMDW 美鈴は湧き出るように出てくる精液とそれによってもたらされる快感により痙攣を繰り返している！
PRINTFORML 「しかし、敵は近くにいないようですね…すぐに損得勘定ができるようになってる自分が怖いです…」	PRINTFORML 「しかし、敵は近くにいないようですね…すぐに損得勘定ができるようになってる自分が怖いです…」
PRINTFORMDL 舌を巧みに操り、口の中をひとしきり蹂躙し終わると、美鈴は%ARGS:1%の股に目を向けた。	PRINTFORMDL 舌を巧みに操り、口の中をひとしきり蹂躙し終わると、美鈴は%ARGS:1%の股に目を向けた。
PRINTFORMDW 美鈴は絶頂による快感を受けながらも必死に手足をバタ付かせているが、敵に効果は無いようだ！	PRINTFORMDW 美鈴は絶頂による快感を受けながらも必死に手足をバタ付かせているが、敵に効果は無いようだ！
PRINTFORMDW 美鈴は精根使い果たしたばかりなのにも拘らず、気を限界まで吸われ意識が飛びそうになっている	PRINTFORMDW 美鈴は精根使い果たしたばかりなのにも拘らず、気を限界まで吸われ意識が飛びそうになっている
PRINTFORML 「い、いえ！ムラムラしてるわけじゃなく！いえしてますけど！あぁもうなんて言えばいいのか…」	PRINTFORML 「い、いえ！ムラムラしてるわけじゃなく！いえしてますけど！あぁもうなんて言えばいいのか…」
PRINTFORMDW 美鈴は胃液が逆流するのを無意識に抑えているようが、口の端から涎がダラダラと垂れている…	PRINTFORMDW 美鈴は胃液が逆流するのを無意識に抑えているようが、口の端から涎がダラダラと垂れている…
PRINTFORMDW 美鈴は必死になって引きはがそうとするが、吸盤が一つは慣れるたびに快楽の波が美鈴を襲う！	PRINTFORMDW 美鈴は必死になって引きはがそうとするが、吸盤が一つは慣れるたびに快楽の波が美鈴を襲う！
PRINTFORMW 「フラン様、あの…そんな張り切らなても、私だってある程度は自分のことを守れますから……」	PRINTFORMW 「フラン様、あの…そんな張り切らなても、私だってある程度は自分のことを守れますから……」
PRINTFORMW 「大体まずリーチがおかしいですよ。向こうは長ったらしい触手を持っているのにこんな―――」	PRINTFORMW 「大体まずリーチがおかしいですよ。向こうは長ったらしい触手を持っているのにこんな―――」
PRINTFORMDL 迷宮を進むと、美鈴は陵辱の末にあられもない姿で打ち捨てられた%ARGS:1%と出会った	PRINTFORMDL 迷宮を進むと、美鈴は陵辱の末にあられもない姿で打ち捨てられた%ARGS:1%と出会った
PRINTFORMDW ……が、"ソレ"に衰えの色は全く見えず、むしろ先程よりも怒張を増しているように見える…	PRINTFORMDW ……が、"ソレ"に衰えの色は全く見えず、むしろ先程よりも怒張を増しているように見える…
PRINTFORMDW オクトパスは苦しさも交じっている声などお構いなしに美鈴の大きな胸に快感を与えている！	PRINTFORMDW オクトパスは苦しさも交じっている声などお構いなしに美鈴の大きな胸に快感を与えている！
PRINTFORMDW 美鈴は必死になって引きはがそうとするが、吸盤が一つ離れるたびに快楽の波が美鈴を襲う！	PRINTFORMDW 美鈴は必死になって引きはがそうとするが、吸盤が一つ離れるたびに快楽の波が美鈴を襲う！
PRINTFORMDW 美鈴は自分の中に禍々しい気があるのがわかるせいか、精神的に大きなショックを受けている	PRINTFORMDW 美鈴は自分の中に禍々しい気があるのがわかるせいか、精神的に大きなショックを受けている
PRINTFORMDW 美鈴は仲間が置いて行かれることを理解していないのかできないのか、ピクリとも動かない…	PRINTFORMDW 美鈴は仲間が置いて行かれることを理解していないのかできないのか、ピクリとも動かない…
PRINTFORMW 「……………フラン様が酷い目にあっている中、救いに行けなかった私をどうかお叱り下さい」	PRINTFORMW 「……………フラン様が酷い目にあっている中、救いに行けなかった私をどうかお叱り下さい」
PRINTFORMW 「お、お嬢様…？そ、そんなわけないですよね？お嬢様があんな奴らに負ける…なんて……」	PRINTFORMW 「お、お嬢様…？そ、そんなわけないですよね？お嬢様があんな奴らに負ける…なんて……」
PRINTFORMDW 美鈴は魔法についてはからきしだが、これが役に立つものだということは本能的に理解した	PRINTFORMDW 美鈴は魔法についてはからきしだが、これが役に立つものだということは本能的に理解した
PRINTFORMDW 美鈴は紅魔館の思い出が頭をよぎったが、快感により一瞬で思考をすることができなくなる	PRINTFORMDW 美鈴は紅魔館の思い出が頭をよぎったが、快感により一瞬で思考をすることができなくなる
PRINTFORMDW 美鈴は自分の肺が小さくなったことを実感しながら、その小さな体躯で必死に呼吸している	PRINTFORMDW 美鈴は自分の肺が小さくなったことを実感しながら、その小さな体躯で必死に呼吸している
PRINTFORMDW 美鈴はケダモノのように%ARGS:1%をがっちりと掴みながら腰を振り続けている！	PRINTFORMDW 美鈴はケダモノのように%ARGS:1%をがっちりと掴みながら腰を振り続けている！
PRINTFORMDW 美鈴は自分の中に自分のものではない気が強引に入ってくるのを感じながら呻いている！	PRINTFORMDW 美鈴は自分の中に自分のものではない気が強引に入ってくるのを感じながら呻いている！
PRINTFORMDW 美鈴は時計から感じるほんのわずかな咲夜の気から、昔咲夜が失くしたものだと推理した	PRINTFORMDW 美鈴は時計から感じるほんのわずかな咲夜の気から、昔咲夜が失くしたものだと推理した
PRINTFORMDL 美鈴は%ARGS:1%の頬に両手を添え、まるで吟味するかのように目を覗きこんだ。	PRINTFORMDL 美鈴は%ARGS:1%の頬に両手を添え、まるで吟味するかのように目を覗きこんだ。
PRINTFORMDW そこには触手に弄び尽くされ、物欲しそうに開閉を繰り返す%ARGS:1%の性器が…	PRINTFORMDW そこには触手に弄び尽くされ、物欲しそうに開閉を繰り返す%ARGS:1%の性器が…
PRINTFORMDW 美鈴は敵が目の前からいなくなったことに対して何のリアクションも起こさなかった…	PRINTFORMDW 美鈴は敵が目の前からいなくなったことに対して何のリアクションも起こさなかった…
PRINTFORMDW 美鈴はフランが空虚な瞳で、どこか見ているようでどこも見ていない瞳で、倒れていた	PRINTFORMDW 美鈴はフランが空虚な瞳で、どこか見ているようでどこも見ていない瞳で、倒れていた
PRINTFORMDW 美鈴はすぐに駆け寄り声をかけたが、どうやら精神的に「壊れて」しまっているらしい	PRINTFORMDW 美鈴はすぐに駆け寄り声をかけたが、どうやら精神的に「壊れて」しまっているらしい
PRINTFORMDW 美鈴はオクトパスに陰核を吸いつかれているのをこらえ、反撃をしようとしている！	PRINTFORMDW 美鈴はオクトパスに陰核を吸いつかれているのをこらえ、反撃をしようとしている！
PRINTFORMW 「…落ち着いて。大丈夫、能力が無くてもここではやって行けるはずですから。ね？」	PRINTFORMW 「…落ち着いて。大丈夫、能力が無くてもここではやって行けるはずですから。ね？」
PRINTFORMW 「そういえばここってルールの範囲外ですし、好きなだけ使ってもいいんですよね？」	PRINTFORMW 「そういえばここってルールの範囲外ですし、好きなだけ使ってもいいんですよね？」
PRINTFORMW 「『この羞恥に誓って』ぅんっ！…『ち、誓って、もう二度と致しません』っくぅ！」	PRINTFORMW 「『この羞恥に誓って』ぅんっ！…『ち、誓って、もう二度と致しません』っくぅ！」
PRINTFORMDW そして仰向けだった%ARGS:1%の体をひっくり返し、うつ伏せの体勢にして…	PRINTFORMDW そして仰向けだった%ARGS:1%の体をひっくり返し、うつ伏せの体勢にして…
PRINTFORMDW 美鈴は何か抗議の声を上げようとしたが何の意味もなく、絶頂による痙攣を続ける	PRINTFORMDW 美鈴は何か抗議の声を上げようとしたが何の意味もなく、絶頂による痙攣を続ける
PRINTFORMDW 美鈴はサンドワームの砂により感じたことのない未知の快感を受け困惑している！	PRINTFORMDW 美鈴はサンドワームの砂により感じたことのない未知の快感を受け困惑している！
PRINTFORMDW 美鈴はレミリアが喪失していることを信じられないのか困惑の表情を浮かべている	PRINTFORMDW 美鈴はレミリアが喪失していることを信じられないのか困惑の表情を浮かべている
PRINTFORMW 「れ、霊夢さん！？どうしたんですかそのお腹…って、一つしかありませんよねー」	PRINTFORMW 「れ、霊夢さん！？どうしたんですかそのお腹…って、一つしかありませんよねー」
PRINTFORMW 「あと前線に出ることになっても無理だけはしないでください。それから――――」	PRINTFORMW 「あと前線に出ることになっても無理だけはしないでください。それから――――」
PRINTFORMW 「…しかし随分と古びていますね。そういえば昔いくつか失くしていましたっけ…」	PRINTFORMW 「…しかし随分と古びていますね。そういえば昔いくつか失くしていましたっけ…」
PRINTFORMDW 美鈴は大人の玩具を使う用途も特に考えずに道具袋の中にがむしゃらに突っ込んだ	PRINTFORMDW 美鈴は大人の玩具を使う用途も特に考えずに道具袋の中にがむしゃらに突っ込んだ
PRINTFORMDW 美鈴は胸に蟲が纏わりつき、腰を抜かしながらもその場から逃げようとしている！	PRINTFORMDW 美鈴は胸に蟲が纏わりつき、腰を抜かしながらもその場から逃げようとしている！
PRINTFORML 「こ、この恰好なんとかならないんですか？そろそろ（色々）限界なんですけど…」	PRINTFORML 「こ、この恰好なんとかならないんですか？そろそろ（色々）限界なんですけど…」
PRINTFORMDW そしてついに%ARGS:1%の目の前に来た美鈴はゆっくりと姿勢を低くした。	PRINTFORMDW そしてついに%ARGS:1%の目の前に来た美鈴はゆっくりと姿勢を低くした。
PRINTFORMDW 美鈴は膣の奥まで貫こうとしている触手をなんとか避けようと体を捻っている！	PRINTFORMDW 美鈴は膣の奥まで貫こうとしている触手をなんとか避けようと体を捻っている！
PRINTFORMDW 美鈴は自分の気の流れに強引に別の気が侵入してくるのを感じ、恐怖している！	PRINTFORMDW 美鈴は自分の気の流れに強引に別の気が侵入してくるのを感じ、恐怖している！
PRINTFORM 「心が痛みます…でもそんなことを言っていられる状況じゃないのが悲しいですね」	PRINTFORM 「心が痛みます…でもそんなことを言っていられる状況じゃないのが悲しいですね」
PRINTFORMW 「ここから出たら返しましょうか…それまでは存分に使わせていただきましょう」	PRINTFORMW 「ここから出たら返しましょうか…それまでは存分に使わせていただきましょう」
PRINTFORMDW 美鈴は金魚のように口をぱくぱくさせ触手の凌辱を受け続けることしかできない	PRINTFORMDW 美鈴は金魚のように口をぱくぱくさせ触手の凌辱を受け続けることしかできない
PRINTFORMDW 美鈴は蟲が陰核を弄りつくすのを喘ぎ、震えながら見つめることしかできない！	PRINTFORMDW 美鈴は蟲が陰核を弄りつくすのを喘ぎ、震えながら見つめることしかできない！
PRINTFORMDL そしていつもの美鈴を知っている者が想像できないほどの妖艶な笑みを浮かべ、	PRINTFORMDL そしていつもの美鈴を知っている者が想像できないほどの妖艶な笑みを浮かべ、
PRINTFORMW 「それにしても心なしか体が軽いですね。さっきまで寝ていたせいでしょうか？」	PRINTFORMW 「それにしても心なしか体が軽いですね。さっきまで寝ていたせいでしょうか？」
PRINTFORMW 「イイ！その顔凄くイイです！素敵です！このまま……食べられてください♪」	PRINTFORMW 「イイ！その顔凄くイイです！素敵です！このまま……食べられてください♪」
PRINTFORMW 「はぁっ、はぁっ…気持ちいですか？…私は、すごく、気持ちいいですぅっ！」	PRINTFORMW 「はぁっ、はぁっ…気持ちいですか？…私は、すごく、気持ちいいですぅっ！」
PRINTFORMDW オクトパスは懇願の声などお構いなしに美鈴の大きな胸に快感を与えている！	PRINTFORMDW オクトパスは懇願の声などお構いなしに美鈴の大きな胸に快感を与えている！
PRINTFORMDW 美鈴はレミリアが完全に触手に負けたという事実を受け止めた途端焦り始めた	PRINTFORMDW 美鈴はレミリアが完全に触手に負けたという事実を受け止めた途端焦り始めた
PRINTFORMW 「え？いえいえ、紫さんみたいな美少女が仲間になってくれて嬉しいな～って」	PRINTFORMW 「え？いえいえ、紫さんみたいな美少女が仲間になってくれて嬉しいな～って」
PRINTFORMDW 美鈴は異形との子が生まれる時に受ける狂いそうな痛みを必死に堪えている！	PRINTFORMDW 美鈴は異形との子が生まれる時に受ける狂いそうな痛みを必死に堪えている！
PRINTFORMDW 美鈴は休む暇も無く押し寄せてくる快楽の波により軽い呼吸困難に陥っている	PRINTFORMDW 美鈴は休む暇も無く押し寄せてくる快楽の波により軽い呼吸困難に陥っている
PRINTFORMW 「……ん？でも疲労は取れないからそれじゃあ単に寝れなくなるだけでは！？」	PRINTFORMW 「……ん？でも疲労は取れないからそれじゃあ単に寝れなくなるだけでは！？」
PRINTFORMW 「恥ずかしいですよね？これに懲りたら、もうしないようにしてくださいね？」	PRINTFORMW 「恥ずかしいですよね？これに懲りたら、もうしないようにしてくださいね？」
PRINTFORMW 「あ、あの…ごめんなさい…本当に反省してますから、ですからこれだけは…」	PRINTFORMW 「あ、あの…ごめんなさい…本当に反省してますから、ですからこれだけは…」
PRINTFORMW 「増援…ですか？止めませんけど、そっちに気を回す余裕はないと思いますよ」	PRINTFORMW 「増援…ですか？止めませんけど、そっちに気を回す余裕はないと思いますよ」
PRINTFORMDW 美鈴は"ソレ"が精液を吐き出すたびに快感に呑みこまれそうになっている！	PRINTFORMDW 美鈴は"ソレ"が精液を吐き出すたびに快感に呑みこまれそうになっている！
PRINTFORMDW %ARGS:1%の口の中に残っていた触手の粘液が更にその獣を高ぶらせた	PRINTFORMDW %ARGS:1%の口の中に残っていた触手の粘液が更にその獣を高ぶらせた
PRINTFORMDW ドクッ、ドクッ、ドクッ、という射精音と共に、獣はゆっくりと顔を上げた。	PRINTFORMDW ドクッ、ドクッ、ドクッ、という射精音と共に、獣はゆっくりと顔を上げた。
PRINTFORML 100日経っても泣き言を言わないしっかりものの美鈴をお楽しみください。	PRINTFORML 100日経っても泣き言を言わないしっかりものの美鈴をお楽しみください。
PRINTFORMW 「んっあああぁぁあ゛あ゛あ゛あ゛あ゛あ゛あ゛あ゛あ゛あ゛あ゛あ゛あ゛」	PRINTFORMW 「んっあああぁぁあ゛あ゛あ゛あ゛あ゛あ゛あ゛あ゛あ゛あ゛あ゛あ゛あ゛」
PRINTFORMDW 美鈴はサンドワームの砂により感じたことのない快感を受け困惑している！	PRINTFORMDW 美鈴はサンドワームの砂により感じたことのない快感を受け困惑している！
PRINTFORMW 「すいませんお嬢様、まさかこんなところで愛を育んでいるとｈグヘェッ！」	PRINTFORMW 「すいませんお嬢様、まさかこんなところで愛を育んでいるとｈグヘェッ！」
PRINTFORMW 「…私が世話をすれば問題ありませんよね？誰にも迷惑はかけませんから。」	PRINTFORMW 「…私が世話をすれば問題ありませんよね？誰にも迷惑はかけませんから。」
PRINTFORMW 「これは…霊夢さんの物に似ていますが、霊夢さんの気は感じ取れませんね」	PRINTFORMW 「これは…霊夢さんの物に似ていますが、霊夢さんの気は感じ取れませんね」
PRINTFORMDW 美鈴の誰に対してか良く分からないお説教は傍から見るととても面白かった	PRINTFORMDW 美鈴の誰に対してか良く分からないお説教は傍から見るととても面白かった
PRINTFORMW 「私たちなんかよりも、寝れなくて困ってる人に渡した方が良いのでは…？」	PRINTFORMW 「私たちなんかよりも、寝れなくて困ってる人に渡した方が良いのでは…？」
PRINTFORMW 「ぐっ…かはっ…あああぁ！！！　はっ！！　うあ゛あああぁぁぁ！！！！」	PRINTFORMW 「ぐっ…かはっ…あああぁ！！！　はっ！！　うあ゛あああぁぁぁ！！！！」
PRINTFORML 「あ、いえ、だからといっていつも好きな時にお昼寝してるわけじゃあ……」	PRINTFORML 「あ、いえ、だからといっていつも好きな時にお昼寝してるわけじゃあ……」
PRINTFORMDW 美鈴は無言のまま抵抗をしない%ARGS:1%に何度も口づけを重ねる…	PRINTFORMDW 美鈴は無言のまま抵抗をしない%ARGS:1%に何度も口づけを重ねる…
PRINTFORMDW %ARGS:1%の呻き声を気にも留めず、美鈴は男の快楽を貪り続ける。	PRINTFORMDW %ARGS:1%の呻き声を気にも留めず、美鈴は男の快楽を貪り続ける。
PRINTFORMW 「……？私が起きてから急いで逃げたのかそれとも上手く隠れているのか…」	PRINTFORMW 「……？私が起きてから急いで逃げたのかそれとも上手く隠れているのか…」
PRINTFORMDW そして美鈴は%ARGS:1%にチラリと目をやり、少し罪悪感を憶えた。	PRINTFORMDW そして美鈴は%ARGS:1%にチラリと目をやり、少し罪悪感を憶えた。
PRINTFORMDW 美鈴は練った気を使い、美しい軌道を描きながら素早い蹴りを繰り出す！	PRINTFORMDW 美鈴は練った気を使い、美しい軌道を描きながら素早い蹴りを繰り出す！
PRINTFORMDW 美鈴は良からぬ考えを振り払い、相手に攻撃することだけに集中している	PRINTFORMDW 美鈴は良からぬ考えを振り払い、相手に攻撃することだけに集中している
PRINTFORMW 「くっ、離してください！どうせ離そうとしてくれないんでしょうけど！」	PRINTFORMW 「くっ、離してください！どうせ離そうとしてくれないんでしょうけど！」
PRINTFORMDW 美鈴は脱出のため、触手からの快楽に耐えながらじっと力を溜めている…	PRINTFORMDW 美鈴は脱出のため、触手からの快楽に耐えながらじっと力を溜めている…
PRINTFORMDW サンドワームは美鈴の嬌声を聞き取ったのか更に攻めを激しくしてきた！	PRINTFORMDW サンドワームは美鈴の嬌声を聞き取ったのか更に攻めを激しくしてきた！
PRINTFORMDW オクトパスは美鈴にかまわず秘所から垂れている愛液を啜り続けている！	PRINTFORMDW オクトパスは美鈴にかまわず秘所から垂れている愛液を啜り続けている！
PRINTFORMW 「…これくらい一人で何とかしろってことですか？冷たい主様ですねぇ…」	PRINTFORMW 「…これくらい一人で何とかしろってことですか？冷たい主様ですねぇ…」
PRINTFORMW 「早苗さんは霊夢さんよりも神に近く、魔理沙さんよりも賢いですから！」	PRINTFORMW 「早苗さんは霊夢さんよりも神に近く、魔理沙さんよりも賢いですから！」
PRINTFORMW 「しかし素敵な恰好ですねぇ。なんて言うんでしたっけ、ほら、あの……」	PRINTFORMW 「しかし素敵な恰好ですねぇ。なんて言うんでしたっけ、ほら、あの……」
PRINTFORMDW 美鈴は「大丈夫だ」という自分の勘を信じ、博麗の御札を道具袋に入れた	PRINTFORMDW 美鈴は「大丈夫だ」という自分の勘を信じ、博麗の御札を道具袋に入れた
PRINTFORMDW 美鈴は自分の中に異形が浸食してくることに対し激しい嫌悪感を抱いた！	PRINTFORMDW 美鈴は自分の中に異形が浸食してくることに対し激しい嫌悪感を抱いた！
PRINTFORMDW 美鈴は予想外のダメージを受け、少し涙目になりながら頭を押さえている	PRINTFORMDW 美鈴は予想外のダメージを受け、少し涙目になりながら頭を押さえている
PRINTFORMDW 口から舌をだらしなく出して腰を振り続けるその姿は獣そのものだった。	PRINTFORMDW 口から舌をだらしなく出して腰を振り続けるその姿は獣そのものだった。
PRINTFORMDW 美鈴はゆっくりと立ち上がり、気絶する前のことの思い出そうとしたが、	PRINTFORMDW 美鈴はゆっくりと立ち上がり、気絶する前のことの思い出そうとしたが、
PRINTFORMDL 美鈴は近くに%ARGS:1%がいないことを思いだし、探してみると…	PRINTFORMDL 美鈴は近くに%ARGS:1%がいないことを思いだし、探してみると…
PRINTFORMW 「あの、スイマセン。私が起きていたら助けられたかもしれないのに……」	PRINTFORMW 「あの、スイマセン。私が起きていたら助けられたかもしれないのに……」
PRINTFORMDW 美鈴は太極拳とエモノを組み合わせた全く新しい戦闘方法で攻撃した！	PRINTFORMDW 美鈴は太極拳とエモノを組み合わせた全く新しい戦闘方法で攻撃した！
PRINTFORMDW 美鈴はエモノがすっぽ抜けないようにきつく握ってから大きく振った！	PRINTFORMDW 美鈴はエモノがすっぽ抜けないようにきつく握ってから大きく振った！
PRINTFORMW 「んふふ。美味しくはありませんが…これは、クセになる味ですね…♪」	PRINTFORMW 「んふふ。美味しくはありませんが…これは、クセになる味ですね…♪」
PRINTFORMDW 美鈴は%ARGS:1%に対する対処法が分からずに犯され続けている	PRINTFORMDW 美鈴は%ARGS:1%に対する対処法が分からずに犯され続けている
PRINTFORMW 「はあ゛あ゛っっ♪ぅぁぁあああああああああ゛あ゛あ゛あ゛あ゛♪♪」	PRINTFORMW 「はあ゛あ゛っっ♪ぅぁぁあああああああああ゛あ゛あ゛あ゛あ゛♪♪」
PRINTFORMDW 美鈴は目を見開いたが、ゆっくり先程までの虚ろな瞳に戻っていった…	PRINTFORMDW 美鈴は目を見開いたが、ゆっくり先程までの虚ろな瞳に戻っていった…
PRINTFORMW 「この程度で私を倒すつもりだったんですか…舐められたものですね！」	PRINTFORMW 「この程度で私を倒すつもりだったんですか…舐められたものですね！」
PRINTFORMW 「おやお嬢様。お元気ですか？ケガとかは…心配するだけ無駄ですかね」	PRINTFORMW 「おやお嬢様。お元気ですか？ケガとかは…心配するだけ無駄ですかね」
PRINTFORMW 「ダメですよ、こういう時だからこそ笑顔を忘れちゃいけないものです」	PRINTFORMW 「ダメですよ、こういう時だからこそ笑顔を忘れちゃいけないものです」
PRINTFORMW (霊夢さんなんかより全然人間だし、色々フォローしてあげないとなぁ)	PRINTFORMW (霊夢さんなんかより全然人間だし、色々フォローしてあげないとなぁ)
PRINTFORMW 「あ、そうだ。紅魔館に戻ったら貸してたマンガ、返してくださいね♪」	PRINTFORMW 「あ、そうだ。紅魔館に戻ったら貸してたマンガ、返してくださいね♪」
PRINTFORMW 「あの～…一度だけでいいので、人形劇を少しやってもらえませんか？」	PRINTFORMW 「あの～…一度だけでいいので、人形劇を少しやってもらえませんか？」
PRINTFORMW 「門番の仕事のある日と重なっちゃってて、まだ見たことないんです…」	PRINTFORMW 「門番の仕事のある日と重なっちゃってて、まだ見たことないんです…」
PRINTFORMW 「ぜひ来てみたいですねぇ。外に出れたら１着貸していただけますか？」	PRINTFORMW 「ぜひ来てみたいですねぇ。外に出れたら１着貸していただけますか？」
PRINTFORMW 「本…ですか？どっちかと言うと、私はマンガの方をよく読みますねぇ」	PRINTFORMW 「本…ですか？どっちかと言うと、私はマンガの方をよく読みますねぇ」
PRINTFORMW 「…あのですね、こんな状況で許可すると思ってるんですか？大体――」	PRINTFORMW 「…あのですね、こんな状況で許可すると思ってるんですか？大体――」
PRINTFORMW 「甘～い匂いに誘われて来てみたら…これは、武器でいいんですよね？」	PRINTFORMW 「甘～い匂いに誘われて来てみたら…これは、武器でいいんですよね？」
PRINTFORMDW 美鈴は寄生体が美鈴の気に対して拒絶を繰り返す度に痛みを感じている	PRINTFORMDW 美鈴は寄生体が美鈴の気に対して拒絶を繰り返す度に痛みを感じている
PRINTFORMDW 美鈴は異形の子を生む時に受ける狂いそうな痛みを必死で堪えている！	PRINTFORMDW 美鈴は異形の子を生む時に受ける狂いそうな痛みを必死で堪えている！
PRINTFORMW 「いいですよね、魔法！何と言うか、夢があって素敵じゃないですか！」	PRINTFORMW 「いいですよね、魔法！何と言うか、夢があって素敵じゃないですか！」
PRINTFORMDW 美鈴は敵にひたすら凌辱され続けている！このままでは時間の問題だ！	PRINTFORMDW 美鈴は敵にひたすら凌辱され続けている！このままでは時間の問題だ！
PRINTFORMDW 美鈴は自分の命とともに気を吸われていくのが分かり、恐怖している！	PRINTFORMDW 美鈴は自分の命とともに気を吸われていくのが分かり、恐怖している！
PRINTFORMDW 美鈴はお腹がボコボコと動く感覚に嫌悪感と快感を同時に感じている！	PRINTFORMDW 美鈴はお腹がボコボコと動く感覚に嫌悪感と快感を同時に感じている！
PRINTFORMDW 美鈴は自らの下腹部を絶望と驚きの入り混じった眼差しで見つめている	PRINTFORMDW 美鈴は自らの下腹部を絶望と驚きの入り混じった眼差しで見つめている
PRINTFORML 「フラン様…花に水を…やりすぎたら…枯れてしまい…ます…むにゃ…」	PRINTFORML 「フラン様…花に水を…やりすぎたら…枯れてしまい…ます…むにゃ…」
PRINTFORMDW 美鈴の思考が、体を纏う気が、一瞬で別の何かに支配されてしまった！	PRINTFORMDW 美鈴の思考が、体を纏う気が、一瞬で別の何かに支配されてしまった！
PRINTFORMDW 美鈴は気が付くと、自分が部屋の隅で寝転がっていることに気が付いた	PRINTFORMDW 美鈴は気が付くと、自分が部屋の隅で寝転がっていることに気が付いた
PRINTFORMW 「生き物相手の場合は『早さ』よりも『落ち着くこと』…鉄則ですね」	PRINTFORMW 「生き物相手の場合は『早さ』よりも『落ち着くこと』…鉄則ですね」
PRINTFORMDW 美鈴は隙を最小限に抑えつつ、エモノを大きく振りかぶり攻撃した！	PRINTFORMDW 美鈴は隙を最小限に抑えつつ、エモノを大きく振りかぶり攻撃した！
PRINTFORMDW 美鈴はバットを構えるようにエモノを振りかぶり敵に攻撃を放った！	PRINTFORMDW 美鈴はバットを構えるようにエモノを振りかぶり敵に攻撃を放った！
PRINTFORMW 「ひゃあああ！だ、ダメっ！それ以上されたら……ッぁあああぁぁ！」	PRINTFORMW 「ひゃあああ！だ、ダメっ！それ以上されたら……ッぁあああぁぁ！」
PRINTFORMDW 美鈴はオクトパスに陰核を吸いつかれ、だらしのない嬌声を上げた！	PRINTFORMDW 美鈴はオクトパスに陰核を吸いつかれ、だらしのない嬌声を上げた！
PRINTFORMDW 美鈴は体の怪我している箇所を手で押さえながら敵から距離を取った	PRINTFORMDW 美鈴は体の怪我している箇所を手で押さえながら敵から距離を取った
PRINTFORMW 「な～んて、こういう時くらいはカッコいいこと言いたいものですね」	PRINTFORMW 「な～んて、こういう時くらいはカッコいいこと言いたいものですね」
PRINTFORMDW 美鈴は咲夜の頬を軽くたたいたり揺さぶっているが反応は一切ない。	PRINTFORMDW 美鈴は咲夜の頬を軽くたたいたり揺さぶっているが反応は一切ない。
PRINTFORMDW 美鈴は行為に罪悪感を感じながらも、自分を納得させようとしている	PRINTFORMDW 美鈴は行為に罪悪感を感じながらも、自分を納得させようとしている
PRINTFORMW 「いやぁ、私もちょっとやってみたいな～なんて思ってるんですよ！」	PRINTFORMW 「いやぁ、私もちょっとやってみたいな～なんて思ってるんですよ！」
PRINTFORMW 「"奴ら"を焼いたら美味しくなるのか、ちょっと試してみません？」	PRINTFORMW 「"奴ら"を焼いたら美味しくなるのか、ちょっと試してみません？」
PRINTFORMW 「でも写真を撮るばっかりじゃなくて、ちゃんと戦ってくださいね？」	PRINTFORMW 「でも写真を撮るばっかりじゃなくて、ちゃんと戦ってくださいね？」
PRINTFORMDW １分後、そこには衣を身に纏って楽しそうに舞っている美鈴の姿が！	PRINTFORMDW １分後、そこには衣を身に纏って楽しそうに舞っている美鈴の姿が！
PRINTFORMDW １分後、そこにはつまみ食いしかけてガチ説教を食らう美鈴の姿が！	PRINTFORMDW １分後、そこにはつまみ食いしかけてガチ説教を食らう美鈴の姿が！
PRINTFORMDW 美鈴は「大丈夫だ」という自分の勘を信じ、陰陽玉を道具袋に入れた	PRINTFORMDW 美鈴は「大丈夫だ」という自分の勘を信じ、陰陽玉を道具袋に入れた
PRINTFORMDW 美鈴は蓋をあけて軽く匂いを嗅ぎ、それが媚薬だとハッキリわかった	PRINTFORMDW 美鈴は蓋をあけて軽く匂いを嗅ぎ、それが媚薬だとハッキリわかった
PRINTFORMW (うぅ…こんな悶々とするくらいならしない方が良かったんじゃ……)	PRINTFORMW (うぅ…こんな悶々とするくらいならしない方が良かったんじゃ……)
PRINTFORMDW 美鈴は自分を犯す触手に対して力無く喘ぎ声を返すことしかできない	PRINTFORMDW 美鈴は自分を犯す触手に対して力無く喘ぎ声を返すことしかできない
PRINTFORMDW 美鈴は既に自分がどこに存在しているのかすらあやふやになっている	PRINTFORMDW 美鈴は既に自分がどこに存在しているのかすらあやふやになっている
PRINTFORMW 「そこあっ！あぁぁああああああ！皮をっ！剥かないっ！でっ！……」	PRINTFORMW 「そこあっ！あぁぁああああああ！皮をっ！剥かないっ！でっ！……」
PRINTFORML 「とりあえず探索でもしてみますか。何か見つかるかもしれませんし」	PRINTFORML 「とりあえず探索でもしてみますか。何か見つかるかもしれませんし」
PRINTFORMDW 美鈴は練った気を自分の前方に集め、虹色に光る弾幕を作り出す！	PRINTFORMDW 美鈴は練った気を自分の前方に集め、虹色に光る弾幕を作り出す！
PRINTFORMDW 美鈴は無言のまま弾幕を重ねあわせ、貫通力を増した攻撃を放つ！	PRINTFORMDW 美鈴は無言のまま弾幕を重ねあわせ、貫通力を増した攻撃を放つ！
PRINTFORML 「八手先を見据えるのは難しいですが…やらないよりはいいはず！」	PRINTFORML 「八手先を見据えるのは難しいですが…やらないよりはいいはず！」
PRINTFORMDW 美鈴は触手に愛撫をされるたび背筋がゾワゾワする感覚に襲われた	PRINTFORMDW 美鈴は触手に愛撫をされるたび背筋がゾワゾワする感覚に襲われた
PRINTFORMDW 美鈴は敵に蹂躙されているにもかかわらずピクリとも反応しない…	PRINTFORMDW 美鈴は敵に蹂躙されているにもかかわらずピクリとも反応しない…
PRINTFORMDW ワームは美鈴の嬌声を聞き取ったのか更に攻めを激しくしてきた！	PRINTFORMDW ワームは美鈴の嬌声を聞き取ったのか更に攻めを激しくしてきた！
PRINTFORMDW 美鈴はオクトパスの吸盤が離れる瞬間、特に大きな快感を受けた！	PRINTFORMDW 美鈴はオクトパスの吸盤が離れる瞬間、特に大きな快感を受けた！
PRINTFORMW (茶化したのに反応できるってことは、まだ大丈夫そうですね……)	PRINTFORMW (茶化したのに反応できるってことは、まだ大丈夫そうですね……)
PRINTFORM 「…何も言わないでください。分かってます、分かってますから……」	PRINTFORM 「…何も言わないでください。分かってます、分かってますから……」
PRINTFORMW 「……いえいえ冗談ですからそんな危ないものは仕舞ってですね…」	PRINTFORMW 「……いえいえ冗談ですからそんな危ないものは仕舞ってですね…」
PRINTFORMW 「あぁ、やっぱり闇を使っても触手には気付かれちゃうんですねぇ」	PRINTFORMW 「あぁ、やっぱり闇を使っても触手には気付かれちゃうんですねぇ」
PRINTFORMDW フランは美鈴のためにも自分が頑張らねば！と内心張り切っている	PRINTFORMDW フランは美鈴のためにも自分が頑張らねば！と内心張り切っている
PRINTFORMW （ここぞと言うところで裏切られそうなのがちょっと怖いですが…）	PRINTFORMW （ここぞと言うところで裏切られそうなのがちょっと怖いですが…）
PRINTFORMW 「あ、そう言えば慧音さんは寺子屋で先生をされてるんですよね？」	PRINTFORMW 「あ、そう言えば慧音さんは寺子屋で先生をされてるんですよね？」
PRINTFORMW 「…え？前に永遠亭に行ったときに永琳さんから教わったんですが」	PRINTFORMW 「…え？前に永遠亭に行ったときに永琳さんから教わったんですが」
PRINTFORMDW 美鈴はどのタイミングで使えば戦闘で有利に立てるのか考えている	PRINTFORMDW 美鈴はどのタイミングで使えば戦闘で有利に立てるのか考えている
PRINTFORMW 「これは…！ヒヒイロカネって本当に揺らめいて見えるんですね！」	PRINTFORMW 「これは…！ヒヒイロカネって本当に揺らめいて見えるんですね！」
PRINTFORMDW 美鈴は部屋が浄化されると少し首を上げたが、また俯いてしまった	PRINTFORMDW 美鈴は部屋が浄化されると少し首を上げたが、また俯いてしまった
PRINTFORMW 「ありがとうございます！１人で捌くには向こうの手数が多くて…」	PRINTFORMW 「ありがとうございます！１人で捌くには向こうの手数が多くて…」
PRINTFORMDW 美鈴は気と生命力を吸われ、体が溶けていくような錯覚を起こした	PRINTFORMDW 美鈴は気と生命力を吸われ、体が溶けていくような錯覚を起こした
PRINTFORMW 「な、なんですかこれ…わ…あ、あああぁぁぁぁぁぁぁぁぁ！！？」	PRINTFORMW 「な、なんですかこれ…わ…あ、あああぁぁぁぁぁぁぁぁぁ！！？」
PRINTFORMW 「う…『私は貴女様を気の迷いとはいえ犯そうとしました』んっ！」	PRINTFORMW 「う…『私は貴女様を気の迷いとはいえ犯そうとしました』んっ！」
PRINTFORMW 「『ですから…この紅美鈴を…お、お許しくださいま』…んんっ！」	PRINTFORMW 「『ですから…この紅美鈴を…お、お許しくださいま』…んんっ！」
PRINTFORMDW そこには全身白濁液まみれになっている%ARGS:1%の姿が！	PRINTFORMDW そこには全身白濁液まみれになっている%ARGS:1%の姿が！
PRINTFORMDW 美鈴は空中で回転しながら勢いをつけ、かかと落としを放った！	PRINTFORMDW 美鈴は空中で回転しながら勢いをつけ、かかと落としを放った！
PRINTFORML 「教えてあげましょう！私に本気を出させるとどうなるのかを！」	PRINTFORML 「教えてあげましょう！私に本気を出させるとどうなるのかを！」
PRINTFORML 「相手が触手ならば覇王…もとい全力を出さざるを得ませんね！」	PRINTFORML 「相手が触手ならば覇王…もとい全力を出さざるを得ませんね！」
PRINTFORML 「あなたが！泣いても！攻撃をやめない！熾撃「大鵬墜撃拳」！」	PRINTFORML 「あなたが！泣いても！攻撃をやめない！熾撃「大鵬墜撃拳」！」
PRINTFORML 「こういう弾幕ってあんまり使わないので慣れないんですよね…」	PRINTFORML 「こういう弾幕ってあんまり使わないので慣れないんですよね…」
PRINTFORMDW 美鈴はエモノを構え、無駄に弾を使わないように攻撃を放った！	PRINTFORMDW 美鈴はエモノを構え、無駄に弾を使わないように攻撃を放った！
PRINTFORMW 「まずは基礎からみっちり、その体に刻み込んであげましょう！」	PRINTFORMW 「まずは基礎からみっちり、その体に刻み込んであげましょう！」
PRINTFORMDW 美鈴は相手の懐へもぐりこみ、切り上げるようにして攻撃した！	PRINTFORMDW 美鈴は相手の懐へもぐりこみ、切り上げるようにして攻撃した！
PRINTFORMDW 美鈴は謎の掛け声とともにエモノを振るい、敵に攻撃を放った！	PRINTFORMDW 美鈴は謎の掛け声とともにエモノを振るい、敵に攻撃を放った！
PRINTFORMDW 美鈴はボソボソと何かを呟きながらゆっくりと敵に近寄って行く	PRINTFORMDW 美鈴はボソボソと何かを呟きながらゆっくりと敵に近寄って行く
PRINTFORMDW 美鈴は快感に呻きながら口の端から涎がダラダラと垂れている…	PRINTFORMDW 美鈴は快感に呻きながら口の端から涎がダラダラと垂れている…
PRINTFORMDW 美鈴はオクトパスの吸盤が離れる瞬間、大きく背中を反らせた！	PRINTFORMDW 美鈴はオクトパスの吸盤が離れる瞬間、大きく背中を反らせた！
PRINTFORMW (倒せたのに…少し残念に思った自分が嫌いになりそうですね…)	PRINTFORMW (倒せたのに…少し残念に思った自分が嫌いになりそうですね…)
PRINTFORMDW 美鈴は先程の敵に犯されたかったという考えが浮かび、動揺する	PRINTFORMDW 美鈴は先程の敵に犯されたかったという考えが浮かび、動揺する
PRINTFORMW 「気が滅入ってるのも分かりますけど、もう少し落ち着いて……」	PRINTFORMW 「気が滅入ってるのも分かりますけど、もう少し落ち着いて……」
PRINTFORMW (その分戦闘は不得意そうですね。妖精というのもありますし…)	PRINTFORMW (その分戦闘は不得意そうですね。妖精というのもありますし…)
PRINTFORMW 「その衣をちょっとだけ触らせてほしいんです！お願いします！」	PRINTFORMW 「その衣をちょっとだけ触らせてほしいんです！お願いします！」
PRINTFORMW 「それは面白そうですね！ぜひ私にもお手伝いさせてください！」	PRINTFORMW 「それは面白そうですね！ぜひ私にもお手伝いさせてください！」
PRINTFORMW 「なんか…凄いオーラをお持ちですね…堂々としてるというか…」	PRINTFORMW 「なんか…凄いオーラをお持ちですね…堂々としてるというか…」
PRINTFORMW 「…あ、じゃあここから出たらおススメの本を教えてくださいな」	PRINTFORMW 「…あ、じゃあここから出たらおススメの本を教えてくださいな」
PRINTFORMDW 美鈴は素肌にスライムが纏わりつくのを濁った眼で見つめている	PRINTFORMDW 美鈴は素肌にスライムが纏わりつくのを濁った眼で見つめている
PRINTFORMDW 美鈴は自分の変化に軽くへこみつつ、ため息を着いたその時…！	PRINTFORMDW 美鈴は自分の変化に軽くへこみつつ、ため息を着いたその時…！
PRINTFORML 「ハァッ、ハァッ、ハァッ、ハァッ、ハァッ、ハァッ、ハァッ…」	PRINTFORML 「ハァッ、ハァッ、ハァッ、ハァッ、ハァッ、ハァッ、ハァッ…」
PRINTFORML 「…う～ん、気絶する直前にあの人に会って、その後がなぁ……」	PRINTFORML 「…う～ん、気絶する直前にあの人に会って、その後がなぁ……」
PRINTFORMW 「こんなことしちゃダメですからね！いいですか、そもそも――」	PRINTFORMW 「こんなことしちゃダメですからね！いいですか、そもそも――」
PRINTFORMDW 美鈴はこれ以上ダメージが蓄積しないよう防御の体勢に入った	PRINTFORMDW 美鈴はこれ以上ダメージが蓄積しないよう防御の体勢に入った
PRINTFORMDW 美鈴は%ARGS:1%を敵に投げつけたが効果は無いようだ	PRINTFORMDW 美鈴は%ARGS:1%を敵に投げつけたが効果は無いようだ
PRINTFORML 「これはこれは。思ってたより苦戦しないんじゃないですか？」	PRINTFORML 「これはこれは。思ってたより苦戦しないんじゃないですか？」
PRINTFORML 「その心臓、貰い受けましょう！！あるのか知りませんが！ 」	PRINTFORML 「その心臓、貰い受けましょう！！あるのか知りませんが！ 」
PRINTFORMDW 美鈴は練った気を全身から発し、強力な気の嵐を巻き起こす！	PRINTFORMDW 美鈴は練った気を全身から発し、強力な気の嵐を巻き起こす！
PRINTFORMDW 美鈴は敵の弱点と思われる部分だけに狙いを定めて攻撃した！	PRINTFORMDW 美鈴は敵の弱点と思われる部分だけに狙いを定めて攻撃した！
PRINTFORMDW 美鈴は顔を真っ赤にしながらもエモノを大きく振り下ろした！	PRINTFORMDW 美鈴は顔を真っ赤にしながらもエモノを大きく振り下ろした！
PRINTFORMDW 美鈴は敵に不規則なリズムで締め上げられ、上手く動けない！	PRINTFORMDW 美鈴は敵に不規則なリズムで締め上げられ、上手く動けない！
PRINTFORMDW 美鈴は陰核に近づきつつある触手をはたき落そうとしている！	PRINTFORMDW 美鈴は陰核に近づきつつある触手をはたき落そうとしている！
PRINTFORMW 「なんだか蒸し暑いですね…ちょっと着替えちゃいましょう♪」	PRINTFORMW 「なんだか蒸し暑いですね…ちょっと着替えちゃいましょう♪」
PRINTFORMW 「ひゃああああああぁぁぁぁぁぁぁああっぁあっぁぁああぁぁ」	PRINTFORMW 「ひゃああああああぁぁぁぁぁぁぁああっぁあっぁぁああぁぁ」
PRINTFORMW 「あ゛あ゛あ゛ッ！？んっぐぅ…ぁ！そ…こは…ぁああぁぁ！」	PRINTFORMW 「あ゛あ゛あ゛ッ！？んっぐぅ…ぁ！そ…こは…ぁああぁぁ！」
PRINTFORMDW オクトパスは美鈴の大きい胸を搾り上げ、先端を啜っている！	PRINTFORMDW オクトパスは美鈴の大きい胸を搾り上げ、先端を啜っている！
PRINTFORMDW オクトパスは美鈴の大きな胸を搾り上げ、先端を啜っている！	PRINTFORMDW オクトパスは美鈴の大きな胸を搾り上げ、先端を啜っている！
PRINTFORMDW 美鈴は一瞬だけ反応したが、すぐに先程までの状態に戻った…	PRINTFORMDW 美鈴は一瞬だけ反応したが、すぐに先程までの状態に戻った…
PRINTFORMDW 美鈴はこれから何をされるのかすぐに察し、顔が青くなった！	PRINTFORMDW 美鈴はこれから何をされるのかすぐに察し、顔が青くなった！
PRINTFORMDW 美鈴は快感・欲望と戦いながらもなんとか敵の攻撃をかわした	PRINTFORMDW 美鈴は快感・欲望と戦いながらもなんとか敵の攻撃をかわした
PRINTFORMW 「ギャッ！咲夜さんごめんなさ……って！いつの間に敵が！？」	PRINTFORMW 「ギャッ！咲夜さんごめんなさ……って！いつの間に敵が！？」
PRINTFORMDW 美鈴は焦点の合っていない目で何も無い空間を見つめている…	PRINTFORMDW 美鈴は焦点の合っていない目で何も無い空間を見つめている…
PRINTFORMW 「…あの、なんで今怒られたんですか？フラグ？何ですかそれ」	PRINTFORMW 「…あの、なんで今怒られたんですか？フラグ？何ですかそれ」
PRINTFORMW 「……そんな目で見ることないじゃないですか（ｲｼﾞｲｼﾞ」	PRINTFORMW 「……そんな目で見ることないじゃないですか（ｲｼﾞｲｼﾞ」
PRINTFORMW 「なんというか、漠然としたカッコよさがあるじゃないですか」	PRINTFORMW 「なんというか、漠然としたカッコよさがあるじゃないですか」
PRINTFORMW 「魔力は感じますし…でもこれだけじゃ使えなさそうですね…」	PRINTFORMW 「魔力は感じますし…でもこれだけじゃ使えなさそうですね…」
PRINTFORMW 「この浄化、どういう原理で行われているんでしょうかね…？」	PRINTFORMW 「この浄化、どういう原理で行われているんでしょうかね…？」
PRINTFORMDW 美鈴は敵の攻撃をなんとか捌きながら感謝の言葉を伝えてきた	PRINTFORMDW 美鈴は敵の攻撃をなんとか捌きながら感謝の言葉を伝えてきた
PRINTFORMW 「背中をさするくらいしかできませんが…楽になりましたか？」	PRINTFORMW 「背中をさするくらいしかできませんが…楽になりましたか？」
PRINTFORMDW 美鈴は取り込まれながらも自嘲気味にうっすら笑みを浮かべた	PRINTFORMDW 美鈴は取り込まれながらも自嘲気味にうっすら笑みを浮かべた
PRINTFORMDW 美鈴は全身が敏感になり、しきりに太ももを擦り合わせている	PRINTFORMDW 美鈴は全身が敏感になり、しきりに太ももを擦り合わせている
PRINTFORMW 「マズいですね…これを狙われたら正気でいられるかどうか…」	PRINTFORMW 「マズいですね…これを狙われたら正気でいられるかどうか…」
PRINTFORMDW 美鈴は突然の落下に少しだけ驚いたようだが目に光は戻らない	PRINTFORMDW 美鈴は突然の落下に少しだけ驚いたようだが目に光は戻らない
PRINTFORMW 「ま、待ってください！こういうのはちゃんと順序がですね…」	PRINTFORMW 「ま、待ってください！こういうのはちゃんと順序がですね…」
PRINTFORMW 「だ、大丈夫ですよ。ちゃんと出れる(ハズ)ですから。ね？」	PRINTFORMW 「だ、大丈夫ですよ。ちゃんと出れる(ハズ)ですから。ね？」
PRINTFORMW 「あなたには失望しましたよ。まさかこんな人だったなんて…」	PRINTFORMW 「あなたには失望しましたよ。まさかこんな人だったなんて…」
PRINTFORMW 「あああっ！とまっ、止まっ―――だっ、ダメェェェェェ！！」	PRINTFORMW 「あああっ！とまっ、止まっ―――だっ、ダメェェェェェ！！」
PRINTFORMW 「あはははははははっ♪あっはははハはハハハはははハはハ♪」	PRINTFORMW 「あはははははははっ♪あっはははハはハハハはははハはハ♪」
PRINTFORMDW 美鈴は目の前の敵と乱れたい衝動を振り払って弾幕を放つ！	PRINTFORMDW 美鈴は目の前の敵と乱れたい衝動を振り払って弾幕を放つ！
PRINTFORMW 「小悪魔さん！一瞬でいいので敵の気を逸らしてください！」	PRINTFORMW 「小悪魔さん！一瞬でいいので敵の気を逸らしてください！」
PRINTFORMW 「この丁度…で…私の心が……動くと思っているんですか！」	PRINTFORMW 「この丁度…で…私の心が……動くと思っているんですか！」
PRINTFORMDW 美鈴は練った気を全て自らの手に纏わせ、連撃を繰り出す！	PRINTFORMDW 美鈴は練った気を全て自らの手に纏わせ、連撃を繰り出す！
PRINTFORMDW 美鈴は快感を必死に否定しながらがむしゃらに撃ちまくる！	PRINTFORMDW 美鈴は快感を必死に否定しながらがむしゃらに撃ちまくる！
PRINTFORMDW 美鈴は短く息を吐くとエモノを敵の方に向けて撃ち続けた！	PRINTFORMDW 美鈴は短く息を吐くとエモノを敵の方に向けて撃ち続けた！
PRINTFORMDW 美鈴は相手から距離を取るためにも下段に攻撃を仕掛けた！	PRINTFORMDW 美鈴は相手から距離を取るためにも下段に攻撃を仕掛けた！
PRINTFORMDW 美鈴は敵にフェイントをかけながら下段に攻撃を仕掛けた！	PRINTFORMDW 美鈴は敵にフェイントをかけながら下段に攻撃を仕掛けた！
PRINTFORMW 「あぁ～…なんだかエッチな気分になってきちゃいました…」	PRINTFORMW 「あぁ～…なんだかエッチな気分になってきちゃいました…」
PRINTFORMDW 美鈴は%ARGS:1%から与えられる快楽に浸っている！	PRINTFORMDW 美鈴は%ARGS:1%から与えられる快楽に浸っている！
PRINTFORMDW 美鈴はだらしなく舌を突き出しながら四肢を痙攣させている	PRINTFORMDW 美鈴はだらしなく舌を突き出しながら四肢を痙攣させている
PRINTFORMDW しかしオクトパスは構わず美鈴の陰核に快感を与えている！	PRINTFORMDW しかしオクトパスは構わず美鈴の陰核に快感を与えている！
PRINTFORMDW 美鈴は焦点の合っていない目で何も無い空間を見つめている	PRINTFORMDW 美鈴は焦点の合っていない目で何も無い空間を見つめている
PRINTFORMDW 美鈴はこれはきっと作戦なんだと自分に言い聞かせている…	PRINTFORMDW 美鈴はこれはきっと作戦なんだと自分に言い聞かせている…
PRINTFORMW (…心なしか嬉しそうなんだけど、どうすればいいんだろう)	PRINTFORMW (…心なしか嬉しそうなんだけど、どうすればいいんだろう)
PRINTFORMW 「フラン様、ご機嫌いかがですか？私？見てのとおりですよ」	PRINTFORMW 「フラン様、ご機嫌いかがですか？私？見てのとおりですよ」
PRINTFORMW 「そこでなんと倉庫の奥からマイクが出てきたんですよ～！」	PRINTFORMW 「そこでなんと倉庫の奥からマイクが出てきたんですよ～！」
PRINTFORMDW アリスはにこりと笑うと、人形達が美鈴の前で踊り始めた！	PRINTFORMDW アリスはにこりと笑うと、人形達が美鈴の前で踊り始めた！
PRINTFORMDW 美鈴はその光景に目を輝かせながら人形劇を鑑賞している！	PRINTFORMDW 美鈴はその光景に目を輝かせながら人形劇を鑑賞している！
PRINTFORMW 「それでですね、妹紅さん。ちょっと提案があるんですが…」	PRINTFORMW 「それでですね、妹紅さん。ちょっと提案があるんですが…」
PRINTFORMDW 美鈴は虹のような笑顔を浮かべながら阿求の手を取っている	PRINTFORMDW 美鈴は虹のような笑顔を浮かべながら阿求の手を取っている
PRINTFORMW 「キョンシーの方と共同戦線とは、中々不思議な体験ですね」	PRINTFORMW 「キョンシーの方と共同戦線とは、中々不思議な体験ですね」
PRINTFORMW 「フラン様、自分がいかに軽率な行動を取っているのか――」	PRINTFORMW 「フラン様、自分がいかに軽率な行動を取っているのか――」
PRINTFORMW 「ま、待ってください！それは私の゛ッ！？…ゲホッゲホ！」	PRINTFORMW 「ま、待ってください！それは私の゛ッ！？…ゲホッゲホ！」
PRINTFORMW 「弾は結構あるようですし、ガンガン使っていきましょう！」	PRINTFORMW 「弾は結構あるようですし、ガンガン使っていきましょう！」
PRINTFORMW 「誰かが使った気を感じますが…会ったことありませんね。」	PRINTFORMW 「誰かが使った気を感じますが…会ったことありませんね。」
PRINTFORMW 「え…？これで、戦うんですか？というか戦えるんですか？」	PRINTFORMW 「え…？これで、戦うんですか？というか戦えるんですか？」
PRINTFORMW 「まぁそのためにもここから脱出しなくちゃいけませんね…」	PRINTFORMW 「まぁそのためにもここから脱出しなくちゃいけませんね…」
PRINTFORML 「止めて止めて止めてぇぇぇぇぁぁぁぁああああああ！！」」	PRINTFORML 「止めて止めて止めてぇぇぇぇぁぁぁぁああああああ！！」」
PRINTFORMW 「あああぁぁぁぁっ！イク！イっちゃうぅあああぁぁぁ！！」	PRINTFORMW 「あああぁぁぁぁっ！イク！イっちゃうぅあああぁぁぁ！！」
PRINTFORMDW 美鈴は自分の純潔が散ったことに対して何も反応しなかった	PRINTFORMDW 美鈴は自分の純潔が散ったことに対して何も反応しなかった
PRINTFORMW (…少しずつ……私の気が無くなっていくのが分かる………)	PRINTFORMW (…少しずつ……私の気が無くなっていくのが分かる………)
PRINTFORMW 「すごく苦いですけど…良薬は口に苦しってやつですかね？」	PRINTFORMW 「すごく苦いですけど…良薬は口に苦しってやつですかね？」
PRINTFORMDW 美鈴は敏感になった全身を抑え込むように自らの体を抑えた	PRINTFORMDW 美鈴は敏感になった全身を抑え込むように自らの体を抑えた
PRINTFORMW 「なんだか…すごく暖かいです…心が落ち着くというか……」	PRINTFORMW 「なんだか…すごく暖かいです…心が落ち着くというか……」
PRINTFORMW 「ダメぇぇぇええ！胸は弱いんでっ！っすぅぁ！ああぁっ！」	PRINTFORMW 「ダメぇぇぇええ！胸は弱いんでっ！っすぅぁ！ああぁっ！」
PRINTFORML 「ま、待ってくださ…い゛い゛い゛ぃぃぃぃぃぃぃぃぃ！？」	PRINTFORML 「ま、待ってくださ…い゛い゛い゛ぃぃぃぃぃぃぃぃぃ！？」
PRINTFORMDL 美鈴は歩くたびチラチラと自らの"ソレ"に目を向けている	PRINTFORMDL 美鈴は歩くたびチラチラと自らの"ソレ"に目を向けている
PRINTFORML 「お嬢様に言われたからあっさり了承しちゃいましたけど…」	PRINTFORML 「お嬢様に言われたからあっさり了承しちゃいましたけど…」
PRINTFORMW 「だ、大丈夫ですか？目は見えますか？耳は聞こえますか？」	PRINTFORMW 「だ、大丈夫ですか？目は見えますか？耳は聞こえますか？」
PRINTFORMDW "ソレ"を%ARGS:1%のアヌスへ一気に押し込んだ！	PRINTFORMDW "ソレ"を%ARGS:1%のアヌスへ一気に押し込んだ！
PRINTFORMW 「ぃよっと！パチュリー様！口開けてると舌噛みますよ！」	PRINTFORMW 「ぃよっと！パチュリー様！口開けてると舌噛みますよ！」
PRINTFORMDW 美鈴は頬を染め、太ももをこすらせながら弾幕を放った！	PRINTFORMDW 美鈴は頬を染め、太ももをこすらせながら弾幕を放った！
PRINTFORMDW 美鈴は気を纏い刀剣のような鋭さを持った腕を振るった！	PRINTFORMDW 美鈴は気を纏い刀剣のような鋭さを持った腕を振るった！
PRINTFORMW 「フラン様！すいませんが少し敵を引き付けてください！」	PRINTFORMW 「フラン様！すいませんが少し敵を引き付けてください！」
PRINTFORMDW 美鈴は頬を染め、太ももをこすらせながら攻撃を放った！	PRINTFORMDW 美鈴は頬を染め、太ももをこすらせながら攻撃を放った！
PRINTFORMDW 美鈴は疼く体を押さえつけ、なんとか集中を続けている！	PRINTFORMDW 美鈴は疼く体を押さえつけ、なんとか集中を続けている！
PRINTFORMDW 美鈴は欲望により少し涙目になりながら攻撃を繰り出す！	PRINTFORMDW 美鈴は欲望により少し涙目になりながら攻撃を繰り出す！
PRINTFORMDW 美鈴は相手を袈裟切りにしようと真っ直ぐ敵に向かった！	PRINTFORMDW 美鈴は相手を袈裟切りにしようと真っ直ぐ敵に向かった！
PRINTFORMDW 美鈴は発情して朦朧となりながらも敵に攻撃を仕掛ける！	PRINTFORMDW 美鈴は発情して朦朧となりながらも敵に攻撃を仕掛ける！
PRINTFORMW 「お嬢様…咲夜さん…フラン様…申し訳ありませ…ん……」	PRINTFORMW 「お嬢様…咲夜さん…フラン様…申し訳ありませ…ん……」
PRINTFORMDW 弱い胸を攻められないように美鈴は必死に抵抗している！	PRINTFORMDW 弱い胸を攻められないように美鈴は必死に抵抗している！
PRINTFORMW 「あれぇ？どんどん、どんどん固くなっていきますねぇ？」	PRINTFORMW 「あれぇ？どんどん、どんどん固くなっていきますねぇ？」
PRINTFORMDW 美鈴は男性器を模した触手の雁首を捻るように攻めている	PRINTFORMDW 美鈴は男性器を模した触手の雁首を捻るように攻めている
PRINTFORMDW 美鈴は触手を胸に挟み、無邪気な笑顔で触手を弄んでいる	PRINTFORMDW 美鈴は触手を胸に挟み、無邪気な笑顔で触手を弄んでいる
PRINTFORMW 「もう我慢しないでいいですよね？答えは聞いてません♪」	PRINTFORMW 「もう我慢しないでいいですよね？答えは聞いてません♪」
PRINTFORMDW 美鈴は目を白黒させながらも貪欲に快楽を受け入れている	PRINTFORMDW 美鈴は目を白黒させながらも貪欲に快楽を受け入れている
PRINTFORMW 「あなたたちがどれだけ来ようと、私は負けたりしない！」	PRINTFORMW 「あなたたちがどれだけ来ようと、私は負けたりしない！」
PRINTFORMW 「精神的な問題なら気を使っても治らないんですよね……」	PRINTFORMW 「精神的な問題なら気を使っても治らないんですよね……」
PRINTFORMW 「前に妖精メイドと庭で遊んでいた時の話なんですが――」	PRINTFORMW 「前に妖精メイドと庭で遊んでいた時の話なんですが――」
PRINTFORMDW 美鈴は心でごめんなさいと謝りつつ、アイテムを物色した	PRINTFORMDW 美鈴は心でごめんなさいと謝りつつ、アイテムを物色した
PRINTFORMW 「いやぁ、やっぱり身内が仲間になると大分安心できます」	PRINTFORMW 「いやぁ、やっぱり身内が仲間になると大分安心できます」
PRINTFORMW 「そういえばよく幽々子さんが半霊をかじっていますが…」	PRINTFORMW 「そういえばよく幽々子さんが半霊をかじっていますが…」
PRINTFORMW 「どんな姿をしていようと幽香さんは幽香さんですからね」	PRINTFORMW 「どんな姿をしていようと幽香さんは幽香さんですからね」
PRINTFORMW 「援護射撃を頼みます。あ、私を撃たないでくださいね？」	PRINTFORMW 「援護射撃を頼みます。あ、私を撃たないでくださいね？」
PRINTFORMW 「やめてください……見ないで…そんな目で見ないで…！」	PRINTFORMW 「やめてください……見ないで…そんな目で見ないで…！」
PRINTFORMDW 美鈴は虚ろな目をしながら体をピクピクと痙攣させている	PRINTFORMDW 美鈴は虚ろな目をしながら体をピクピクと痙攣させている
PRINTFORMDW 美鈴は自分の気の流れが良くなっていることに気が付いた	PRINTFORMDW 美鈴は自分の気の流れが良くなっていることに気が付いた
PRINTFORMW 「あ～、コホン。…助かりました。ありがとうございます」	PRINTFORMW 「あ～、コホン。…助かりました。ありがとうございます」
PRINTFORMDW 運よく美鈴の上からはスライムが降ってこなかったようだ	PRINTFORMDW 運よく美鈴の上からはスライムが降ってこなかったようだ
PRINTFORMDW 美鈴は膣の中を蟲に蹂躙され口の端から涎を垂らしている	PRINTFORMDW 美鈴は膣の中を蟲に蹂躙され口の端から涎を垂らしている
PRINTFORMDW 美鈴はゆっくりと自分の乳房と秘所を触り、自慰を始めた	PRINTFORMDW 美鈴はゆっくりと自分の乳房と秘所を触り、自慰を始めた
PRINTFORML 「えっと、こっちがあの部屋であそこを曲がると…あれ？」	PRINTFORML 「えっと、こっちがあの部屋であそこを曲がると…あれ？」
PRINTFORML 「むむ、こっちの道からはなんだか嫌な予感がしますよ！」	PRINTFORML 「むむ、こっちの道からはなんだか嫌な予感がしますよ！」
PRINTFORMDW 美鈴は%ARGS:1%を一瞥し、足早に去って行った…	PRINTFORMDW 美鈴は%ARGS:1%を一瞥し、足早に去って行った…
PRINTFORML 「こうなるともう気は関係ないんですよね…ごめんなさい」	PRINTFORML 「こうなるともう気は関係ないんですよね…ごめんなさい」
PRINTFORML (―――――――ッ！？な…ぁ…！何ですか…これッ！？)	PRINTFORML (―――――――ッ！？な…ぁ…！何ですか…これッ！？)
PRINTFORML 「ハァー、ハァーッ…んむぅ　じゅる　じゅっ　んん……」	PRINTFORML 「ハァー、ハァーッ…んむぅ　じゅる　じゅっ　んん……」
PRINTFORMW 「耐えることで活路が見いだせることもありますからね」	PRINTFORMW 「耐えることで活路が見いだせることもありますからね」
PRINTFORMDW 美鈴は集中して相手の行動を読み、攻撃をさばいている	PRINTFORMDW 美鈴は集中して相手の行動を読み、攻撃をさばいている
PRINTFORML 「今楽にしてあげますから、そこに直っててください！」	PRINTFORML 「今楽にしてあげますから、そこに直っててください！」
PRINTFORMW 「パチュリー様！防護壁を張れる余裕はありますか！？」	PRINTFORMW 「パチュリー様！防護壁を張れる余裕はありますか！？」
PRINTFORMDW 美鈴は股間の疼きをなんとか抑えながら攻撃を放った！	PRINTFORMDW 美鈴は股間の疼きをなんとか抑えながら攻撃を放った！
PRINTFORMDW 美鈴は触手を足で踏みながら満面の笑みを浮かべている	PRINTFORMDW 美鈴は触手を足で踏みながら満面の笑みを浮かべている
PRINTFORMW 「ひゃあああ！だ、ダメっ！それ以上されたら……ッ！」	PRINTFORMW 「ひゃあああ！だ、ダメっ！それ以上されたら……ッ！」
PRINTFORMDW 美鈴は自分の服がぼろぼろにされショックを受けている	PRINTFORMDW 美鈴は自分の服がぼろぼろにされショックを受けている
PRINTFORMW 「うぅぅぅ…気持ち悪い気持ち悪いキモチワルイぃ……」	PRINTFORMW 「うぅぅぅ…気持ち悪い気持ち悪いキモチワルイぃ……」
PRINTFORMDW 美鈴は敵の攻撃の勢いを利用し、鋭い回し蹴りを放つ！	PRINTFORMDW 美鈴は敵の攻撃の勢いを利用し、鋭い回し蹴りを放つ！
PRINTFORMW 「魔理沙さん、泣き言を言ってても何も始まりませんよ」	PRINTFORMW 「魔理沙さん、泣き言を言ってても何も始まりませんよ」
PRINTFORMW 「魔理沙さぁーん！死んでも骨は拾いませんからねー！」	PRINTFORMW 「魔理沙さぁーん！死んでも骨は拾いませんからねー！」
PRINTFORMW 「危なくなったらすぐ逃げられる位置にいてくださいね」	PRINTFORMW 「危なくなったらすぐ逃げられる位置にいてくださいね」
PRINTFORMW 「咲夜さんはあくまで私のフォローです。いいですね？」	PRINTFORMW 「咲夜さんはあくまで私のフォローです。いいですね？」
PRINTFORMW 「さて…お手を拝借させてもらいましょうか、お嬢様？」	PRINTFORMW 「さて…お手を拝借させてもらいましょうか、お嬢様？」
PRINTFORMW 「控えおろー！ここにおわすお方をどなたと心得るー！」	PRINTFORMW 「控えおろー！ここにおわすお方をどなたと心得るー！」
PRINTFORMW 「霊夢さん…？れ、霊夢さん！しっかりしてください！」	PRINTFORMW 「霊夢さん…？れ、霊夢さん！しっかりしてください！」
PRINTFORMW 「だ、大丈夫ですか！？咲夜さんっ！咲夜さんっっ！！」	PRINTFORMW 「だ、大丈夫ですか！？咲夜さんっ！咲夜さんっっ！！」
PRINTFORMW 「………えーと、もう一度最初からお願いできますか？」	PRINTFORMW 「………えーと、もう一度最初からお願いできますか？」
PRINTFORMW 「霊夢さんがいれば百人力ですね！頼りにしてますよ！」	PRINTFORMW 「霊夢さんがいれば百人力ですね！頼りにしてますよ！」
PRINTFORMW 「パチュリー様のような方がいるとありがたいですね！」	PRINTFORMW 「パチュリー様のような方がいるとありがたいですね！」
PRINTFORMW 「お嬢様が仲間なら何も心配する必要はなさそうですね」	PRINTFORMW 「お嬢様が仲間なら何も心配する必要はなさそうですね」
PRINTFORMW 「私は漢方以外は直感とか五感でしか分からないので…」	PRINTFORMW 「私は漢方以外は直感とか五感でしか分からないので…」
PRINTFORMW 「きた！蓬莱人きた！死なない人きた！これで勝つる！」	PRINTFORMW 「きた！蓬莱人きた！死なない人きた！これで勝つる！」
PRINTFORMW （いざとなれば帽子の桃が非常食になりそうですし……）	PRINTFORMW （いざとなれば帽子の桃が非常食になりそうですし……）
PRINTFORMW 「そ、そうですよ…お嬢様一人なら大丈夫…大丈夫……」	PRINTFORMW 「そ、そうですよ…お嬢様一人なら大丈夫…大丈夫……」
PRINTFORMW 「これは魔力を底上げできる道具…で良いんですよね？」	PRINTFORMW 「これは魔力を底上げできる道具…で良いんですよね？」
PRINTFORMW 「これがあるからと言って気を抜いてはいけませんね…」	PRINTFORMW 「これがあるからと言って気を抜いてはいけませんね…」
PRINTFORMDW 美鈴はつま先をピンと伸ばしだらしなく舌を出している	PRINTFORMDW 美鈴はつま先をピンと伸ばしだらしなく舌を出している
PRINTFORMDW 美鈴はその時のことを思い出したのか顔を赤くしている	PRINTFORMDW 美鈴はその時のことを思い出したのか顔を赤くしている
PRINTFORMDW 美鈴は自らの股間にある"ソレ"を憎らしそうに睨んだ	PRINTFORMDW 美鈴は自らの股間にある"ソレ"を憎らしそうに睨んだ
PRINTFORMDW 美鈴はいきなり体のけだるさが取れたことに驚いている	PRINTFORMDW 美鈴はいきなり体のけだるさが取れたことに驚いている
PRINTFORMW 「あ゛っ！あっ！あっ！ひゃっ！あああっ！あ゛っ！？」	PRINTFORMW 「あ゛っ！あっ！あっ！ひゃっ！あああっ！あ゛っ！？」
PRINTFORMW 「っくぁ！あ゛あ゛あ゛あ゛あ゛あ゛あ゛あ゛あ゛！！」	PRINTFORMW 「っくぁ！あ゛あ゛あ゛あ゛あ゛あ゛あ゛あ゛あ゛！！」
PRINTFORML 「んんーー！ぐんんんん！！んんんんんーーーー！！！」	PRINTFORML 「んんーー！ぐんんんん！！んんんんんーーーー！！！」
PRINTFORML 「お嬢様…漫画は出したら…きちんと…元に…むにゃ…」	PRINTFORML 「お嬢様…漫画は出したら…きちんと…元に…むにゃ…」
PRINTFORML 「パチュリー様…たまには…ストレッチでも…むにゃ…」	PRINTFORML 「パチュリー様…たまには…ストレッチでも…むにゃ…」
PRINTFORML 「好きな時にお昼寝できないのがここのつらい所ですね」	PRINTFORML 「好きな時にお昼寝できないのがここのつらい所ですね」
PRINTFORML 「ん～～っ、はぁ。たまにはストレッチしておかないと」	PRINTFORML 「ん～～っ、はぁ。たまにはストレッチしておかないと」
PRINTFORMW 「ほ、本当にいいんですか！？ありがとうございます！」	PRINTFORMW 「ほ、本当にいいんですか！？ありがとうございます！」
PRINTFORMW 「実はメイド妖精が一人帰ってきてないらしくてですね」	PRINTFORMW 「実はメイド妖精が一人帰ってきてないらしくてですね」
PRINTFORMW 「どこまで行けるか分かりませんが、まぁ行ってきます」	PRINTFORMW 「どこまで行けるか分かりませんが、まぁ行ってきます」
PRINTFORMDW ゆっくりと%ARGS:1%へ覆いかぶさっていった。	PRINTFORMDW ゆっくりと%ARGS:1%へ覆いかぶさっていった。
PRINTFORMDL そこには躊躇い、罪悪感、羞恥心、どれもが存在せず、	PRINTFORMDL そこには躊躇い、罪悪感、羞恥心、どれもが存在せず、
PRINTFORMW 「なっ！…て、敵の仕業ですか！？ならまだ近くに！？」	PRINTFORMW 「なっ！…て、敵の仕業ですか！？ならまだ近くに！？」
PRINTFORML 「はっはっはっは！それで避けているつもりですか！」	PRINTFORML 「はっはっはっは！それで避けているつもりですか！」
PRINTFORMW 「このエモノの恐ろしさを教えてさしあげましょう！」	PRINTFORMW 「このエモノの恐ろしさを教えてさしあげましょう！」
PRINTFORMDW 美鈴は逃げようと思いながらも体が上手く動かない！	PRINTFORMDW 美鈴は逃げようと思いながらも体が上手く動かない！
PRINTFORMW （私は？誰？どこに？なんで？どうして？いつから？）	PRINTFORMW （私は？誰？どこに？なんで？どうして？いつから？）
PRINTFORMW 「これじゃあお仕置きの意味がないじゃないですか♪」	PRINTFORMW 「これじゃあお仕置きの意味がないじゃないですか♪」
PRINTFORMW 「だ・れ・が、そんなことして良いって言いました？」	PRINTFORMW 「だ・れ・が、そんなことして良いって言いました？」
PRINTFORMDW 美鈴は男性器を模した触手の先端を指でつついている	PRINTFORMDW 美鈴は男性器を模した触手の先端を指でつついている
PRINTFORMW 「……！ゲホッ…！……はぁ、息つく暇もないですね」	PRINTFORMW 「……！ゲホッ…！……はぁ、息つく暇もないですね」
PRINTFORMDW 美鈴は官能的な笑顔を浮かべ、再び触手を咥え始めた	PRINTFORMDW 美鈴は官能的な笑顔を浮かべ、再び触手を咥え始めた
PRINTFORMDW 美鈴は眠りながら突然の快感に驚きの表情をしている	PRINTFORMDW 美鈴は眠りながら突然の快感に驚きの表情をしている
PRINTFORMW 「もっともっともっともっともっともっとぉぉぉぉぉぉ	PRINTFORMW 「もっともっともっともっともっともっとぉぉぉぉぉぉ
PRINTFORMDW オクトパスは構わず美鈴の陰核に快感を与えている！	PRINTFORMDW オクトパスは構わず美鈴の陰核に快感を与えている！
PRINTFORMW 「えへへぇ～ そんなにがっついちゃダメですよ～？」	PRINTFORMW 「えへへぇ～ そんなにがっついちゃダメですよ～？」
PRINTFORMDW 美鈴は体がびくびく震えているが抵抗は見られない…	PRINTFORMDW 美鈴は体がびくびく震えているが抵抗は見られない…
PRINTFORMW 「これくらいできなきゃ門番は務まらないんですよ！」	PRINTFORMW 「これくらいできなきゃ門番は務まらないんですよ！」
PRINTFORMDW 美鈴は腕を回した後に両手を前に突き出して構えた！	PRINTFORMDW 美鈴は腕を回した後に両手を前に突き出して構えた！
PRINTFORMW 「今は、戦いたく、んっ、ないんですけどね……ぅ…」	PRINTFORMW 「今は、戦いたく、んっ、ないんですけどね……ぅ…」
PRINTFORMW 「じゃあ霊夢さん！頑張ってくださ痛い痛い痛い！！」	PRINTFORMW 「じゃあ霊夢さん！頑張ってくださ痛い痛い痛い！！」
PRINTFORMW 「あえて言いましょう！その油断が命とりであると！」	PRINTFORMW 「あえて言いましょう！その油断が命とりであると！」
PRINTFORMDW 美鈴は出会った相手も見ず、小さく震え続けている…	PRINTFORMDW 美鈴は出会った相手も見ず、小さく震え続けている…
PRINTFORMDW その後、しばらくして美鈴はなんとか気を落ち着けた	PRINTFORMDW その後、しばらくして美鈴はなんとか気を落ち着けた
PRINTFORMW 「あ、大丈夫ですよ。ちゃんとメモを取ってあります」	PRINTFORMW 「あ、大丈夫ですよ。ちゃんとメモを取ってあります」
PRINTFORMW 「お、落ち着いてください！敵じゃありませんって！」	PRINTFORMW 「お、落ち着いてください！敵じゃありませんって！」
PRINTFORMW 「実は紅魔館にも「開かずの間」があってですね――」	PRINTFORMW 「実は紅魔館にも「開かずの間」があってですね――」
PRINTFORMW 「前に滝に打たれていたら変な鳥に会いましてね――」	PRINTFORMW 「前に滝に打たれていたら変な鳥に会いましてね――」
PRINTFORMW 「戦局を視ることができるのはすごい長所ですからね」	PRINTFORMW 「戦局を視ることができるのはすごい長所ですからね」
PRINTFORMW 「薬学に詳しい方がいてくれた方が心強いですからね」	PRINTFORMW 「薬学に詳しい方がいてくれた方が心強いですからね」
PRINTFORMW 「そう、粋。粋な格好です。風通しもよさそうですし」	PRINTFORMW 「そう、粋。粋な格好です。風通しもよさそうですし」
PRINTFORMW 「…………はぁ。仕方ないですね。今回だけですよ？」	PRINTFORMW 「…………はぁ。仕方ないですね。今回だけですよ？」
PRINTFORMW 「…おや、これは魔力が少ない私でも使えそうですね」	PRINTFORMW 「…おや、これは魔力が少ない私でも使えそうですね」
PRINTFORMW 「良い剣ですね。ありがたく使わせてもらいましょう」	PRINTFORMW 「良い剣ですね。ありがたく使わせてもらいましょう」
PRINTFORMW 美鈴は小さな触手に愛撫され喘ぎながらも眠りについた	PRINTFORMW 美鈴は小さな触手に愛撫され喘ぎながらも眠りについた
PRINTFORMW 「もっとぉぉ！もっとおかひくひてぇぇぇぇぇぇ！！」	PRINTFORMW 「もっとぉぉ！もっとおかひくひてぇぇぇぇぇぇ！！」
PRINTFORMW 「これは…使えそうにありませんね……あ、これとか」	PRINTFORMW 「これは…使えそうにありませんね……あ、これとか」
PRINTFORMW 「任せてください。お嬢様のためなら火の中水の中！」	PRINTFORMW 「任せてください。お嬢様のためなら火の中水の中！」
PRINTFORMDW 美鈴は素肌にスライムが纏わりつき、嫌悪感を示した	PRINTFORMDW 美鈴は素肌にスライムが纏わりつき、嫌悪感を示した
PRINTFORMDW 美鈴はガスを吸った後にいきなり自らを慰め始めた！	PRINTFORMDW 美鈴はガスを吸った後にいきなり自らを慰め始めた！
PRINTFORMDW 美鈴は草をしげしげと眺めながらその場を立ち去った	PRINTFORMDW 美鈴は草をしげしげと眺めながらその場を立ち去った
PRINTFORML 「がっ、あ゛あ゛あ゛あ゛あ゛あ゛ぁぁぁぁぁぁ！！」	PRINTFORML 「がっ、あ゛あ゛あ゛あ゛あ゛あ゛ぁぁぁぁぁぁ！！」
PRINTFORMW 「―――――――――――――――――――――ッ！」	PRINTFORMW 「―――――――――――――――――――――ッ！」
PRINTFORMDW 美鈴は性欲と羞恥心によって顔が真っ赤になっている	PRINTFORMDW 美鈴は性欲と羞恥心によって顔が真っ赤になっている
PRINTFORMW 「愛想が付きました！実家に帰らせていただきます！」	PRINTFORMW 「愛想が付きました！実家に帰らせていただきます！」
PRINTFORML 「……っはあ゛ぁっ！ハァーッ、ハァーッ、ハァッ…」	PRINTFORML 「……っはあ゛ぁっ！ハァーッ、ハァーッ、ハァッ…」
PRINTFORMW 「なっ！？ えっ！？……落ち着いて、落ち着いて…」	PRINTFORMW 「なっ！？ えっ！？……落ち着いて、落ち着いて…」
PRINTFORML 詳しい説明は付属のReadMeを読んでください。	PRINTFORML 詳しい説明は付属のReadMeを読んでください。
PRINTFORMW 「フラン様！私ごとふっ飛ばさないでくださいね！」	PRINTFORMW 「フラン様！私ごとふっ飛ばさないでくださいね！」
PRINTFORMDW 美鈴は頬を上気させながら敵から距離を取っていく	PRINTFORMDW 美鈴は頬を上気させながら敵から距離を取っていく
PRINTFORMDL 美鈴は欲望を打ち払って綺麗な虹色の弾幕を放った	PRINTFORMDL 美鈴は欲望を打ち払って綺麗な虹色の弾幕を放った
PRINTFORMW 「今ここでやたらと消費するのはマズそうですね…」	PRINTFORMW 「今ここでやたらと消費するのはマズそうですね…」
PRINTFORMDW 美鈴は気で筋力を増加させ、敵に攻撃を仕掛けた！	PRINTFORMDW 美鈴は気で筋力を増加させ、敵に攻撃を仕掛けた！
PRINTFORML 「将を射んと欲すればまず馬を射よ 名言ですね！」	PRINTFORML 「将を射んと欲すればまず馬を射よ 名言ですね！」
PRINTFORMDW 美鈴は敵の拘束から逃れようと必死に抵抗している	PRINTFORMDW 美鈴は敵の拘束から逃れようと必死に抵抗している
PRINTFORMW 「ちょっとハンカチ代わりにさせてもらいますね？」	PRINTFORMW 「ちょっとハンカチ代わりにさせてもらいますね？」
PRINTFORMW 「なるほど、ここのところが気持ちいいんですね？」	PRINTFORMW 「なるほど、ここのところが気持ちいいんですね？」
PRINTFORMW 「この先っぽのところ…随分弱いみたいですね～？」	PRINTFORMW 「この先っぽのところ…随分弱いみたいですね～？」
PRINTFORMW 「んっ、んっ、んっ、んんっ、んっ、んぐっ、んっ」	PRINTFORMW 「んっ、んっ、んっ、んんっ、んっ、んぐっ、んっ」
PRINTFORMW 「気持ち悪いです。とっとと終わらせてください…」	PRINTFORMW 「気持ち悪いです。とっとと終わらせてください…」
PRINTFORMDW 美鈴は侮蔑の目を向けるが触手は喜んでいるようだ	PRINTFORMDW 美鈴は侮蔑の目を向けるが触手は喜んでいるようだ
PRINTFORMW 「魔理沙さん！デカいの当てちゃってくださいな！」	PRINTFORMW 「魔理沙さん！デカいの当てちゃってくださいな！」
PRINTFORMDW 美鈴は殆ど無意識に傷口を抑えながら呻いている…	PRINTFORMDW 美鈴は殆ど無意識に傷口を抑えながら呻いている…
PRINTFORMDW 美鈴は敵の攻撃を受けてもピクリとも反応しない…	PRINTFORMDW 美鈴は敵の攻撃を受けてもピクリとも反応しない…
PRINTFORMDW 美鈴は必死に抵抗しているが、かなり厳しいようだ	PRINTFORMDW 美鈴は必死に抵抗しているが、かなり厳しいようだ
PRINTFORMW 「…っとと、危うくオーバーキルするところでした」	PRINTFORMW 「…っとと、危うくオーバーキルするところでした」
PRINTFORMW 「普通の魔法使いの腕前、是非見せてくださいな！」	PRINTFORMW 「普通の魔法使いの腕前、是非見せてくださいな！」
PRINTFORMW 「さっき打ち合わせしたとおりに動いてくださいね」	PRINTFORMW 「さっき打ち合わせしたとおりに動いてくださいね」
PRINTFORMW 「絶対に迎えに来ますから！待っていてください！」	PRINTFORMW 「絶対に迎えに来ますから！待っていてください！」
PRINTFORMW 「あ…待って下さい…置いて……行かないで………」	PRINTFORMW 「あ…待って下さい…置いて……行かないで………」
PRINTFORMW 「遅い！ぬるい！弱い！これがあなたの敗因です！」	PRINTFORMW 「遅い！ぬるい！弱い！これがあなたの敗因です！」
PRINTFORMDW 美鈴は出会った相手を悲しそうな目で見つめている	PRINTFORMDW 美鈴は出会った相手を悲しそうな目で見つめている
PRINTFORMW 「私はお嬢様に頼まれてですね…え？聞いてない？」	PRINTFORMW 「私はお嬢様に頼まれてですね…え？聞いてない？」
PRINTFORMW 「…内緒ですよ？実はここだけの話なんですが――」	PRINTFORMW 「…内緒ですよ？実はここだけの話なんですが――」
PRINTFORMW 「だって魔法を使えるじゃないですか！いいなぁ…」	PRINTFORMW 「だって魔法を使えるじゃないですか！いいなぁ…」
PRINTFORMW 「しかしここでもカメラは手放さないんですねぇ。」	PRINTFORMW 「しかしここでもカメラは手放さないんですねぇ。」
PRINTFORMW （………こんなにちょろくて大丈夫なんでしょうか）	PRINTFORMW （………こんなにちょろくて大丈夫なんでしょうか）
PRINTFORMW 「あ、あの失礼は承知なんですが、一つお願いが…」	PRINTFORMW 「あ、あの失礼は承知なんですが、一つお願いが…」
PRINTFORMW 「…やめて！そんな冷めた目で見ないでください！」	PRINTFORMW 「…やめて！そんな冷めた目で見ないでください！」
PRINTFORMW 「このセリフ、一回言ってみたかったんですよ～！」	PRINTFORMW 「このセリフ、一回言ってみたかったんですよ～！」
PRINTFORMW 「こういうのって、誰しも一度は憧れますよね～♪」	PRINTFORMW 「こういうのって、誰しも一度は憧れますよね～♪」
PRINTFORMW 「裸も嫌ですが、服を破られていくのも嫌ですから」	PRINTFORMW 「裸も嫌ですが、服を破られていくのも嫌ですから」
PRINTFORMDW 美鈴は最悪の状況を頭から振り払い、探索に戻った	PRINTFORMDW 美鈴は最悪の状況を頭から振り払い、探索に戻った
PRINTFORML 「止めてぇっ！くださぁっ！いぁぁぁぁぁぁぁ！！」	PRINTFORML 「止めてぇっ！くださぁっ！いぁぁぁぁぁぁぁ！！」
PRINTFORMW 「ふふふ、私の力が必要にあるときが来ましたか！」	PRINTFORMW 「ふふふ、私の力が必要にあるときが来ましたか！」
PRINTFORMW 「え？触手の中？……ちょっと遠慮しておきます…」	PRINTFORMW 「え？触手の中？……ちょっと遠慮しておきます…」
PRINTFORMDW 美鈴はビクビクと痙攣を起こしたように震えている	PRINTFORMDW 美鈴はビクビクと痙攣を起こしたように震えている
PRINTFORMDW 美鈴は荷物袋を開け、手際よくアイテムを回収した	PRINTFORMDW 美鈴は荷物袋を開け、手際よくアイテムを回収した
PRINTFORMW 「連れてきましたよ～…って！何する気ですか！？」	PRINTFORMW 「連れてきましたよ～…って！何する気ですか！？」
PRINTFORMW 「え？何こ…っひやぁぁあああああああああっ！」」	PRINTFORMW 「え？何こ…っひやぁぁあああああああああっ！」」
PRINTFORML 「げほっげほっ…ごほっ…っがは……はぁ、はぁ…」	PRINTFORML 「げほっげほっ…ごほっ…っがは……はぁ、はぁ…」
PRINTFORMW 「お、おひり…壊れちゃあぁっ！いますうぅぅっ！」	PRINTFORMW 「お、おひり…壊れちゃあぁっ！いますうぅぅっ！」
PRINTFORML (息っ！酸素！はやくはやくはやややや―――――)	PRINTFORML (息っ！酸素！はやくはやくはやややや―――――)
PRINTFORML 「何やら邪な気を感じますし、後回しにしましょう」	PRINTFORML 「何やら邪な気を感じますし、後回しにしましょう」
PRINTFORMW 「全く、ダメですよ？女の人を押し倒したりしては」	PRINTFORMW 「全く、ダメですよ？女の人を押し倒したりしては」
PRINTFORML 「咲夜さん…それは私の…鍋掴み…です…むにゃ…」	PRINTFORML 「咲夜さん…それは私の…鍋掴み…です…むにゃ…」
PRINTFORML 「ここの気の流れ、気持ち悪くてヤなんですよね…」	PRINTFORML 「ここの気の流れ、気持ち悪くてヤなんですよね…」
PRINTFORML 「はぁ…まだちょっとここの気に慣れませんね……」	PRINTFORML 「はぁ…まだちょっとここの気に慣れませんね……」
PRINTFORMDL さらに%ARGS:1%の口を再び蹂躙し始める。	PRINTFORMDL さらに%ARGS:1%の口を再び蹂躙し始める。
PRINTFORMDW しかし感覚を研ぎ澄ましても近くに敵の気配はない	PRINTFORMDW しかし感覚を研ぎ澄ましても近くに敵の気配はない
PRINTFORMDW 美鈴は気を使い敵の攻撃を防ぐため身構えている	PRINTFORMDW 美鈴は気を使い敵の攻撃を防ぐため身構えている
PRINTFORMW 「あ、本気で崩しにかからなくてもいいですから」	PRINTFORMW 「あ、本気で崩しにかからなくてもいいですから」
PRINTFORMDW 美鈴は震える手で%ARGS:1%を構え直した	PRINTFORMDW 美鈴は震える手で%ARGS:1%を構え直した
PRINTFORMW 「パチュリー様！魔法の準備はできてますかー！」	PRINTFORMW 「パチュリー様！魔法の準備はできてますかー！」
PRINTFORMW 「これ以上近づかれたら…欲望に呑まれる…っ！」	PRINTFORMW 「これ以上近づかれたら…欲望に呑まれる…っ！」
PRINTFORML 「ふふん、これでそのスピードは封じたも同然！」	PRINTFORML 「ふふん、これでそのスピードは封じたも同然！」
PRINTFORMDL 美鈴は頬を上気させながらも鋭い弾幕を放った！	PRINTFORMDL 美鈴は頬を上気させながらも鋭い弾幕を放った！
PRINTFORMDW 美鈴は余計な動きをせずに真っ直ぐ敵を狙った！	PRINTFORMDW 美鈴は余計な動きをせずに真っ直ぐ敵を狙った！
PRINTFORMW 「今離してくれたら許してあげても良いですよ？」	PRINTFORMW 「今離してくれたら許してあげても良いですよ？」
PRINTFORMW 「まぁそんな気さらさらないですけど…くぅっ！」	PRINTFORMW 「まぁそんな気さらさらないですけど…くぅっ！」
PRINTFORMW 「もう…我慢…したくな…い……ああぁぁあぁ♪」	PRINTFORMW 「もう…我慢…したくな…い……ああぁぁあぁ♪」
PRINTFORMDW 美鈴は虚ろな目をしたまま、自分を慰め始めた！	PRINTFORMDW 美鈴は虚ろな目をしたまま、自分を慰め始めた！
PRINTFORMW 「逃げなくちゃ…にげなくちゃ…ニゲナクチャ…」	PRINTFORMW 「逃げなくちゃ…にげなくちゃ…ニゲナクチャ…」
PRINTFORMW 「そんなにシコシコされたいんですか？この変態」	PRINTFORMW 「そんなにシコシコされたいんですか？この変態」
PRINTFORMW 「ケホッケホ……えへへ。いっぱい出ましたね♪」	PRINTFORMW 「ケホッケホ……えへへ。いっぱい出ましたね♪」
PRINTFORMDW 美鈴は敵の攻撃を受けても目を覚まそうとしない	PRINTFORMDW 美鈴は敵の攻撃を受けても目を覚まそうとしない
PRINTFORMDW 美鈴はガードを貫くほどの攻撃を受け呻いている	PRINTFORMDW 美鈴はガードを貫くほどの攻撃を受け呻いている
PRINTFORMDW 美鈴は目をトロンとさせて快楽を受け入れている	PRINTFORMDW 美鈴は目をトロンとさせて快楽を受け入れている
PRINTFORMDW 美鈴はろくに声も出せず口をパクパクさせている	PRINTFORMDW 美鈴はろくに声も出せず口をパクパクさせている
PRINTFORMW 「なぁっ…んぅ！っく、ふあぁぁあぁぁぁぁぁ！」	PRINTFORMW 「なぁっ…んぅ！っく、ふあぁぁあぁぁぁぁぁ！」
PRINTFORMDW 美鈴はサンドワームの砂により快感が加速した！	PRINTFORMDW 美鈴はサンドワームの砂により快感が加速した！
PRINTFORMW 「ひゃんっ！なっ、そ、そんなところまで…！？」	PRINTFORMW 「ひゃんっ！なっ、そ、そんなところまで…！？」
PRINTFORMDW 美鈴は何も無い空間を虚ろな目で見つめている…	PRINTFORMDW 美鈴は何も無い空間を虚ろな目で見つめている…
PRINTFORMW 「勝てましたね、魔理沙さん。あ、ケガとかは？」	PRINTFORMW 「勝てましたね、魔理沙さん。あ、ケガとかは？」
PRINTFORMW 「いきますよ魔女様。魔術の貯蔵は十分ですか？」	PRINTFORMW 「いきますよ魔女様。魔術の貯蔵は十分ですか？」
PRINTFORMDW 美鈴は眠りながら憎たらしい笑顔を浮かべている	PRINTFORMDW 美鈴は眠りながら憎たらしい笑顔を浮かべている
PRINTFORMDW 美鈴はお腹を大きくした咲夜を見た瞬間硬直した	PRINTFORMDW 美鈴はお腹を大きくした咲夜を見た瞬間硬直した
PRINTFORMW 「……………………………………………………！」	PRINTFORMW 「……………………………………………………！」
PRINTFORMDW 美鈴が咲夜を本気で心配しているのが見て取れる	PRINTFORMDW 美鈴が咲夜を本気で心配しているのが見て取れる
PRINTFORMDW 美鈴は礼をしながらもアイテムをもらっていった	PRINTFORMDW 美鈴は礼をしながらもアイテムをもらっていった
PRINTFORMW 「危なくなったらすぐ距離を取ってくださいね？」	PRINTFORMW 「危なくなったらすぐ距離を取ってくださいね？」
PRINTFORMW 「そんなに美味しいものなんですか？(じゅるり」	PRINTFORMW 「そんなに美味しいものなんですか？(じゅるり」
PRINTFORMW 「ゆ、幽香さん…いえ、まぁ、深くは聞きません」	PRINTFORMW 「ゆ、幽香さん…いえ、まぁ、深くは聞きません」
PRINTFORMW (これは豊作の合図なのか不作の合図なのか……)	PRINTFORMW (これは豊作の合図なのか不作の合図なのか……)
PRINTFORMW (しかし妖精にしてはなかなか強いみたいですね)	PRINTFORMW (しかし妖精にしてはなかなか強いみたいですね)
PRINTFORMW 「私が前に出ますから、援護射撃は任せましたよ」	PRINTFORMW 「私が前に出ますから、援護射撃は任せましたよ」
PRINTFORMW 「そんなこと言われても、見捨てたりしませんよ」	PRINTFORMW 「そんなこと言われても、見捨てたりしませんよ」
PRINTFORMDW 美鈴は気合を入れるように大きな声で挨拶をした	PRINTFORMDW 美鈴は気合を入れるように大きな声で挨拶をした
PRINTFORMW 　霊夢さんこそ、どうなっても知りませんから！」	PRINTFORMW 　霊夢さんこそ、どうなっても知りませんから！」
PRINTFORMW 「………分かり、ました…どうか…御無事で……」	PRINTFORMW 「………分かり、ました…どうか…御無事で……」
PRINTFORMW 「主の言葉だけで、従者は動けるものなんですよ」	PRINTFORMW 「主の言葉だけで、従者は動けるものなんですよ」
PRINTFORML 「いくッ！イっちゃうぅぅぅぅぁぁあああああ！」	PRINTFORML 「いくッ！イっちゃうぅぅぅぅぁぁあああああ！」
PRINTFORMW 「なんだか魔法が使えるようになった気分です！」	PRINTFORMW 「なんだか魔法が使えるようになった気分です！」
PRINTFORMDW 美鈴は涙をぽろぽろ零しながら助けを求めている	PRINTFORMDW 美鈴は涙をぽろぽろ零しながら助けを求めている
PRINTFORMW (ダメなのに…んっ！手が…止まらないぃぁっ！)	PRINTFORMW (ダメなのに…んっ！手が…止まらないぃぁっ！)
PRINTFORML 「どうやら触手の一部が寄生しているようですが…	PRINTFORML 「どうやら触手の一部が寄生しているようですが…
PRINTFORMW 「なっ！…えぇ～…た、確かに弱いですけど……」	PRINTFORMW 「なっ！…えぇ～…た、確かに弱いですけど……」
PRINTFORML 「ひぐぅ！…っくぁぁぁぁ！ああああああああ！」	PRINTFORML 「ひぐぅ！…っくぁぁぁぁ！ああああああああ！」
PRINTFORMW 「…失礼ですね、私だって怒るときは怒るんです」	PRINTFORMW 「…失礼ですね、私だって怒るときは怒るんです」
PRINTFORMW 「ですからこれは罰ゲームのようなものなんです」	PRINTFORMW 「ですからこれは罰ゲームのようなものなんです」
PRINTFORMDL 美鈴は時計で今現在の時間と日付を確認している	PRINTFORMDL 美鈴は時計で今現在の時間と日付を確認している
PRINTFORMW 「……できることなら遠慮したいんですけどね～」	PRINTFORMW 「……できることなら遠慮したいんですけどね～」
PRINTFORMDW ただ「犯す」という行動だけがそこにはあった。	PRINTFORMDW ただ「犯す」という行動だけがそこにはあった。
PRINTFORMDW 快感を貪っていた獣が唐突にピストンを止めた。	PRINTFORMDW 快感を貪っていた獣が唐突にピストンを止めた。
PRINTFORMDW 美鈴は何かに憑りつかれたように腰を振っている	PRINTFORMDW 美鈴は何かに憑りつかれたように腰を振っている
PRINTFORMW 「離脱します！準備はいいですか、咲夜さん！」	PRINTFORMW 「離脱します！準備はいいですか、咲夜さん！」
PRINTFORMDW 美鈴はフェイントをかけてから裏拳を放った！	PRINTFORMDW 美鈴はフェイントをかけてから裏拳を放った！
PRINTFORMDW 美鈴は気を纏った手刀を大きく振り下ろした！	PRINTFORMDW 美鈴は気を纏った手刀を大きく振り下ろした！
PRINTFORMW 「魔理沙さん！申し訳ないですが少し時間を！」	PRINTFORMW 「魔理沙さん！申し訳ないですが少し時間を！」
PRINTFORML 「無事では済みませんよ！極彩「彩光乱舞」！」	PRINTFORML 「無事では済みませんよ！極彩「彩光乱舞」！」
PRINTFORMDW 美鈴は発情して朦朧となりながらも敵を狙う！	PRINTFORMDW 美鈴は発情して朦朧となりながらも敵を狙う！
PRINTFORML 「舐めないでください！これでも妖怪ですよ！」	PRINTFORML 「舐めないでください！これでも妖怪ですよ！」
PRINTFORMDW 美鈴は短く息を吐き、敵に鋭い攻撃を放った！	PRINTFORMDW 美鈴は短く息を吐き、敵に鋭い攻撃を放った！
PRINTFORMDW 美鈴は尻に近づく触手を必死に押さえている！	PRINTFORMDW 美鈴は尻に近づく触手を必死に押さえている！
PRINTFORMW 「えへへ～ いいじゃないですか～キスぐらい」	PRINTFORMW 「えへへ～ いいじゃないですか～キスぐらい」
PRINTFORMW 「…………………あんまり美味しくないですね」	PRINTFORMW 「…………………あんまり美味しくないですね」
PRINTFORMW （もうちょっとあのままでも良かったかも……）	PRINTFORMW （もうちょっとあのままでも良かったかも……）
PRINTFORMW 「パチュリー様！私に当てないでくださいね！」	PRINTFORMW 「パチュリー様！私に当てないでくださいね！」
PRINTFORMDW 美鈴は胃液が逆流するのを必死に抑えている…	PRINTFORMDW 美鈴は胃液が逆流するのを必死に抑えている…
PRINTFORMW 「そんな攻撃、咲夜さんのナイフに比べれば！」	PRINTFORMW 「そんな攻撃、咲夜さんのナイフに比べれば！」
PRINTFORMDW 美鈴はだらしなく舌を突き出して痙攣している	PRINTFORMDW 美鈴はだらしなく舌を突き出して痙攣している
PRINTFORMDW サンドワームは美鈴を内側から蹂躙している！	PRINTFORMDW サンドワームは美鈴を内側から蹂躙している！
PRINTFORMW 「ひゃぅっ！そんなぁ…搾らないで…んくっ！」	PRINTFORMW 「ひゃぅっ！そんなぁ…搾らないで…んくっ！」
PRINTFORMDW 美鈴は敵の精を受け止めても何も反応しない…	PRINTFORMDW 美鈴は敵の精を受け止めても何も反応しない…
PRINTFORMW 「絶対に前に出たりしないようにしてください」	PRINTFORMW 「絶対に前に出たりしないようにしてください」
PRINTFORMW 「無茶して喘息が悪化しても知りませんよ～？」	PRINTFORMW 「無茶して喘息が悪化しても知りませんよ～？」
PRINTFORMDW 美鈴は涙をこぼしながら咲夜を抱きしめている	PRINTFORMDW 美鈴は涙をこぼしながら咲夜を抱きしめている
PRINTFORMW 「………………………………………………え？」	PRINTFORMW 「………………………………………………え？」
PRINTFORMW 「…ふふっ、その皮肉を聞くとホッとしますよ」	PRINTFORMW 「…ふふっ、その皮肉を聞くとホッとしますよ」
PRINTFORMW 「あ、咲夜さん！大丈夫ですか？ケガとかは？」	PRINTFORMW 「あ、咲夜さん！大丈夫ですか？ケガとかは？」
PRINTFORMDW 美鈴がレミリアを信頼しているのが見て取れる	PRINTFORMDW 美鈴がレミリアを信頼しているのが見て取れる
PRINTFORMW (でもサボったら絶対怒られるだろうなぁ……)	PRINTFORMW (でもサボったら絶対怒られるだろうなぁ……)
PRINTFORMW 「ですからそんな不安な顔しないでくださいよ」	PRINTFORMW 「ですからそんな不安な顔しないでくださいよ」
PRINTFORMW 「って言いきれないのが悲しいですね…はぁ…」	PRINTFORMW 「って言いきれないのが悲しいですね…はぁ…」
PRINTFORMW 「そ、そうですか…では、また次に機会にでも」	PRINTFORMW 「そ、そうですか…では、また次に機会にでも」
PRINTFORMW 「あ、あと…油断だけはしないでくださいね？」	PRINTFORMW 「あ、あと…油断だけはしないでくださいね？」
PRINTFORMW 　もう好きなところに行っちゃってください！」	PRINTFORMW 　もう好きなところに行っちゃってください！」
PRINTFORMW 「なかなかファンタジーな形をした弓ですね…」	PRINTFORMW 「なかなかファンタジーな形をした弓ですね…」
PRINTFORMW 「汚物は消毒しなくちゃいけませんね(ニコッ」	PRINTFORMW 「汚物は消毒しなくちゃいけませんね(ニコッ」
PRINTFORMW 「……？何かを呼び出す道具なんでしょうか？」	PRINTFORMW 「……？何かを呼び出す道具なんでしょうか？」
PRINTFORMW 「使うようなことにならないといいんですが…」	PRINTFORMW 「使うようなことにならないといいんですが…」
PRINTFORML 「ま、待って！これいじょうわぁぁああああ！」	PRINTFORML 「ま、待って！これいじょうわぁぁああああ！」
PRINTFORML 「お、おかひくなっちゃああああぁぁぁぁ！！」	PRINTFORML 「お、おかひくなっちゃああああぁぁぁぁ！！」
PRINTFORMW 「もう…げ、限界ですっぅあああああぁぁぁ！」	PRINTFORMW 「もう…げ、限界ですっぅあああああぁぁぁ！」
PRINTFORMW 「妖怪でもやっぱり痛いものなんですね…っく」	PRINTFORMW 「妖怪でもやっぱり痛いものなんですね…っく」
PRINTFORMW 「あなた…随分とおかしな気を持ってますね！」	PRINTFORMW 「あなた…随分とおかしな気を持ってますね！」
PRINTFORMW (もう誰も…助けてくれなかったり…して……)	PRINTFORMW (もう誰も…助けてくれなかったり…して……)
PRINTFORMW 「出たい…ここから…誰か……出し…て………」	PRINTFORMW 「出たい…ここから…誰か……出し…て………」
PRINTFORMDW 美鈴は周囲の気が濃くなっていくのを感じた！	PRINTFORMDW 美鈴は周囲の気が濃くなっていくのを感じた！
PRINTFORMW 「くぁ～…なんだか急に目の前が揺れてます…」	PRINTFORMW 「くぁ～…なんだか急に目の前が揺れてます…」
PRINTFORMW 「これがあれば昼寝せずに済むんですけどね…」	PRINTFORMW 「これがあれば昼寝せずに済むんですけどね…」
PRINTFORMDW 美鈴は"ソレ"に触れると小さな悲鳴を上げた	PRINTFORMDW 美鈴は"ソレ"に触れると小さな悲鳴を上げた
PRINTFORMW 「そんな…太っ…あっ！…ひゃ！…んんんぅ！」	PRINTFORMW 「そんな…太っ…あっ！…ひゃ！…んんんぅ！」
PRINTFORML 「この紅美鈴、全身全霊を尽くしてみせます！」	PRINTFORML 「この紅美鈴、全身全霊を尽くしてみせます！」
PRINTFORMW 「ん、っく……ま、守りを固めない…と……」	PRINTFORMW 「ん、っく……ま、守りを固めない…と……」
PRINTFORMW 「今はあまり前に出たくないんですけどね…」	PRINTFORMW 「今はあまり前に出たくないんですけどね…」
PRINTFORMDW 美鈴は体を少し引きずりながら敵の前に出た	PRINTFORMDW 美鈴は体を少し引きずりながら敵の前に出た
PRINTFORMDW 嫌な予感がした美鈴は敵から間合いを取った	PRINTFORMDW 嫌な予感がした美鈴は敵から間合いを取った
PRINTFORMDW 美鈴はアイコンタクトで霊夢に指示を出した	PRINTFORMDW 美鈴はアイコンタクトで霊夢に指示を出した
PRINTFORML 「これであなたは一歩負けに近づきました！」	PRINTFORML 「これであなたは一歩負けに近づきました！」
PRINTFORML 「まだまだ！これで終わりじゃないですよ！」	PRINTFORML 「まだまだ！これで終わりじゃないですよ！」
PRINTFORMDW 美鈴はゆっくり腕を回し、気を練っている！	PRINTFORMDW 美鈴はゆっくり腕を回し、気を練っている！
PRINTFORML 「これで敵も自由には動けなくなるはず…！」	PRINTFORML 「これで敵も自由には動けなくなるはず…！」
PRINTFORMDW 美鈴はすこし不安そうな顔で弾幕を放った！	PRINTFORMDW 美鈴はすこし不安そうな顔で弾幕を放った！
PRINTFORML (でも…少しくらい手を抜けば…きっと……)	PRINTFORML (でも…少しくらい手を抜けば…きっと……)
PRINTFORMDW 美鈴は軽口を叩きながら敵の隙を窺っている	PRINTFORMDW 美鈴は軽口を叩きながら敵の隙を窺っている
PRINTFORMW 「ストリップショーのはじまりはじまり～♪」	PRINTFORMW 「ストリップショーのはじまりはじまり～♪」
PRINTFORMW 「ほらほら、早く出しちゃってくださいよ～」	PRINTFORMW 「ほらほら、早く出しちゃってくださいよ～」
PRINTFORMW 「ダメですよ？弱いところは鍛えなくちゃ♪」	PRINTFORMW 「ダメですよ？弱いところは鍛えなくちゃ♪」
PRINTFORMW 「んっ！むっ！んっ！んぐっ！……ぷはぁっ」	PRINTFORMW 「んっ！むっ！んっ！んぐっ！……ぷはぁっ」
PRINTFORMW （もうちょっとあのままが良かったかな……）	PRINTFORMW （もうちょっとあのままが良かったかな……）
PRINTFORMDW 美鈴は攻撃の受けた場所を手で抑えている…	PRINTFORMDW 美鈴は攻撃の受けた場所を手で抑えている…
PRINTFORMDW 美鈴は白目をむいてガクガクと震えている…	PRINTFORMDW 美鈴は白目をむいてガクガクと震えている…
PRINTFORMW 「んくぅっ！うぁっ！あぁっ！あああぁっ！」	PRINTFORMW 「んくぅっ！うぁっ！あぁっ！あああぁっ！」
PRINTFORMDW 美鈴は息を荒げながらも敵の撃破を確認した	PRINTFORMDW 美鈴は息を荒げながらも敵の撃破を確認した
PRINTFORMDW 不利を悟り、ゆっくり隠していた手をどけた	PRINTFORMDW 不利を悟り、ゆっくり隠していた手をどけた
PRINTFORMW (もうちょっと捕まってても良かったかも…)	PRINTFORMW (もうちょっと捕まってても良かったかも…)
PRINTFORMW 「できればもう少し早く出たかったですね…」	PRINTFORMW 「できればもう少し早く出たかったですね…」
PRINTFORMDW 美鈴は衣類を身に着けない羞恥に耐えている	PRINTFORMDW 美鈴は衣類を身に着けない羞恥に耐えている
PRINTFORMW 「その体勢で、この攻撃を受けられますか？」	PRINTFORMW 「その体勢で、この攻撃を受けられますか？」
PRINTFORMW 「こうして肩を並べるのも、悪くないですね」	PRINTFORMW 「こうして肩を並べるのも、悪くないですね」
PRINTFORMW 「だ、だって…！お嬢様が！ねぇお嬢様！？」	PRINTFORMW 「だ、だって…！お嬢様が！ねぇお嬢様！？」
PRINTFORMDW その後、しばらくして美鈴は気を落ち着けた	PRINTFORMDW その後、しばらくして美鈴は気を落ち着けた
PRINTFORMW 「自棄にはならないようにしてくださいね？」	PRINTFORMW 「自棄にはならないようにしてくださいね？」
PRINTFORMW 「この帽子の生地って意外と頑丈でして――」	PRINTFORMW 「この帽子の生地って意外と頑丈でして――」
PRINTFORMW 「私が才能無いって、その話何回目ですか…」	PRINTFORMW 「私が才能無いって、その話何回目ですか…」
PRINTFORMW 「こっちはちゃんと信頼してるんだよ？相棒」	PRINTFORMW 「こっちはちゃんと信頼してるんだよ？相棒」
PRINTFORMW 「これでPTの火力もグッと上がりますね！」	PRINTFORMW 「これでPTの火力もグッと上がりますね！」
PRINTFORMW 「『鈴』の名どうし、仲良くしましょうね～」	PRINTFORMW 「『鈴』の名どうし、仲良くしましょうね～」
PRINTFORMW 「泣きついたりなんて……しません…………」	PRINTFORMW 「泣きついたりなんて……しません…………」
PRINTFORML 「ふ、ふん！もう妹様には愛想が付きました！	PRINTFORML 「ふ、ふん！もう妹様には愛想が付きました！
PRINTFORMW 「やめて…許してください…っぐぁぁぁぁ！」	PRINTFORMW 「やめて…許してください…っぐぁぁぁぁ！」
PRINTFORMW 「随分メカメカしいものが出てきましたね…」	PRINTFORMW 「随分メカメカしいものが出てきましたね…」
PRINTFORMDW 美鈴は伝説を目の当たりにし、興奮している	PRINTFORMDW 美鈴は伝説を目の当たりにし、興奮している
PRINTFORML 「もう…ダメ…あっ、あああぁぁぁぁぁ！！」	PRINTFORML 「もう…ダメ…あっ、あああぁぁぁぁぁ！！」
PRINTFORML 「だめですぅあっ！あひぃぃぃぃぃぃぃぃ！」	PRINTFORML 「だめですぅあっ！あひぃぃぃぃぃぃぃぃ！」
PRINTFORMDW 美鈴は鼻歌を歌いながら入浴を満喫している	PRINTFORMDW 美鈴は鼻歌を歌いながら入浴を満喫している
PRINTFORMDW 美鈴は何も言わず体がぴくぴくと震えている	PRINTFORMDW 美鈴は何も言わず体がぴくぴくと震えている
PRINTFORMW 「くあっぁああああ！うあああぁぁぁぁ…！」	PRINTFORMW 「くあっぁああああ！うあああぁぁぁぁ…！」
PRINTFORMW 「げほっげほっ…な、なんですか、これは…」	PRINTFORMW 「げほっげほっ…な、なんですか、これは…」
PRINTFORMDW 美鈴は予想外な展開についていけていない！	PRINTFORMDW 美鈴は予想外な展開についていけていない！
PRINTFORMW 「ひぁぁ！ま、待ってくださっ！んぁあっ！」	PRINTFORMW 「ひぁぁ！ま、待ってくださっ！んぁあっ！」
PRINTFORMW 「ひゃあっ！！ですから！ちょっと！待っ…」	PRINTFORMW 「ひゃあっ！！ですから！ちょっと！待っ…」
PRINTFORML 「しかし何度見ても、この壁は慣れませんね」	PRINTFORML 「しかし何度見ても、この壁は慣れませんね」
PRINTFORML 「ここって、ちゃんと出れるんですよね…？」	PRINTFORML 「ここって、ちゃんと出れるんですよね…？」
PRINTFORMW 「あの！これ、良かったら使ってください！」	PRINTFORMW 「あの！これ、良かったら使ってください！」
PRINTFORMW 「あぁ大丈夫ですよ。ちゃんと行きますから」	PRINTFORMW 「あぁ大丈夫ですよ。ちゃんと行きますから」
PRINTFORMW 「はぁっ、はぁっ…これで、仕留める…！」	PRINTFORMW 「はぁっ、はぁっ…これで、仕留める…！」
PRINTFORMW 「ちぃっ！大人しく逃がしてくださいよ！」	PRINTFORMW 「ちぃっ！大人しく逃がしてくださいよ！」
PRINTFORMW 「はぁ…はぁ…ま、まずいですね…はぁ…」	PRINTFORMW 「はぁ…はぁ…ま、まずいですね…はぁ…」
PRINTFORMDW 頬を染めながら美鈴は素早い弾幕を放った	PRINTFORMDW 頬を染めながら美鈴は素早い弾幕を放った
PRINTFORML 「これで倒れるってことはないですよね？」	PRINTFORML 「これで倒れるってことはないですよね？」
PRINTFORMDW 気を纏った美鈴の肘が敵に突き出される！	PRINTFORMDW 気を纏った美鈴の肘が敵に突き出される！
PRINTFORMW 「はぁ…はぁ…少しは休ませてください…」	PRINTFORMW 「はぁ…はぁ…少しは休ませてください…」
PRINTFORMDW 美鈴は欲望により少し涙目になっている！	PRINTFORMDW 美鈴は欲望により少し涙目になっている！
PRINTFORMDW 相手の次の行動を予測し、攻撃を放った！	PRINTFORMDW 相手の次の行動を予測し、攻撃を放った！
PRINTFORMW 「この程度で私は屈しませんからね…んっ」	PRINTFORMW 「この程度で私は屈しませんからね…んっ」
PRINTFORMW 「あ、あの……責任、取ってくださいね…」	PRINTFORMW 「あ、あの……責任、取ってくださいね…」
PRINTFORML 「私の攻撃にいつまで耐えられますかね？」	PRINTFORML 「私の攻撃にいつまで耐えられますかね？」
PRINTFORMW 「ひぐぅんっ！…っくぅああぁぁぁぁぁ！」	PRINTFORMW 「ひぐぅんっ！…っくぅああぁぁぁぁぁ！」
PRINTFORMW 「あ゛あ゛あ゛ッ！？んっぐぅ…ひぃっ！」	PRINTFORMW 「あ゛あ゛あ゛ッ！？んっぐぅ…ひぃっ！」
PRINTFORMW 「くぅっ！うぁっ！あぁっ！あああぁっ！」	PRINTFORMW 「くぅっ！うぁっ！あぁっ！あああぁっ！」
PRINTFORMDW 美鈴は敵に拘束されても何も反応しない…	PRINTFORMDW 美鈴は敵に拘束されても何も反応しない…
PRINTFORMW 「このままさくっといっちゃいましょう！」	PRINTFORMW 「このままさくっといっちゃいましょう！」
PRINTFORMW 「あの触手って、食べれるんですかね……」	PRINTFORMW 「あの触手って、食べれるんですかね……」
PRINTFORMW 「あ、咲夜さん！大丈夫です……か………」	PRINTFORMW 「あ、咲夜さん！大丈夫です……か………」
PRINTFORMDW どうやら美鈴なりに励まそうとしたようだ	PRINTFORMDW どうやら美鈴なりに励まそうとしたようだ
PRINTFORMW 「フラン様、ご機嫌いかが…です…………」	PRINTFORMW 「フラン様、ご機嫌いかが…です…………」
PRINTFORMW 「おや、霊夢さん。ここへは異変解決に？」	PRINTFORMW 「おや、霊夢さん。ここへは異変解決に？」
PRINTFORMDW 美鈴がフランの前でストレッチして見せる	PRINTFORMDW 美鈴がフランの前でストレッチして見せる
PRINTFORMW 「もちろん、あなた自身も十分素敵ですよ」	PRINTFORMW 「もちろん、あなた自身も十分素敵ですよ」
PRINTFORMW 「お世辞なんかじゃありませんってばー♪」	PRINTFORMW 「お世辞なんかじゃありませんってばー♪」
PRINTFORMW 「その能力、ここでは役に立ちそうですね」	PRINTFORMW 「その能力、ここでは役に立ちそうですね」
PRINTFORMDW 美鈴は夢美の研究の話を熱心に聞いている	PRINTFORMDW 美鈴は夢美の研究の話を熱心に聞いている
PRINTFORML 「なんとかする…って、どうするんですか！	PRINTFORML 「なんとかする…って、どうするんですか！
PRINTFORMW 　まぁ霊夢さんにも事情があるってことで」	PRINTFORMW 　まぁ霊夢さんにも事情があるってことで」
PRINTFORMW 「さて、っと。そろそろ陽動を始めますか」	PRINTFORMW 「さて、っと。そろそろ陽動を始めますか」
PRINTFORMW 「すんすん…間違いなくああいう薬ですね」	PRINTFORMW 「すんすん…間違いなくああいう薬ですね」
PRINTFORMW 「だからほら、もう少し寝ていてください」	PRINTFORMW 「だからほら、もう少し寝ていてください」
PRINTFORMDL 美鈴の視界がチカチカと明滅を繰り返す！	PRINTFORMDL 美鈴の視界がチカチカと明滅を繰り返す！
PRINTFORMW 「ひっ　あっ　ああああああああぁぁ…！」	PRINTFORMW 「ひっ　あっ　ああああああああぁぁ…！」
PRINTFORMW (私はこの後…どうなるんでしょうか……)	PRINTFORMW (私はこの後…どうなるんでしょうか……)
PRINTFORMDW 美鈴は目からぽろぽろと涙をこぼしている	PRINTFORMDW 美鈴は目からぽろぽろと涙をこぼしている
PRINTFORMDW 美鈴は叫び声に近い嬌声を上げ続けている	PRINTFORMDW 美鈴は叫び声に近い嬌声を上げ続けている
PRINTFORMW 「ひ、ひぇあああぁぁ！あっあっあっ…！」	PRINTFORMW 「ひ、ひぇあああぁぁ！あっあっあっ…！」
PRINTFORMW 「やめて…お…おねが…っ！あああぁぁ！」	PRINTFORMW 「やめて…お…おねが…っ！あああぁぁ！」
PRINTFORMW 「なんだか足が速くなった気がしますよ！」	PRINTFORMW 「なんだか足が速くなった気がしますよ！」
PRINTFORMDW 特に確証は無いが美鈴は自信に満ち溢れた	PRINTFORMDW 特に確証は無いが美鈴は自信に満ち溢れた
PRINTFORMDW 美鈴はすぐに気が付き、スライムを躱した	PRINTFORMDW 美鈴はすぐに気が付き、スライムを躱した
PRINTFORMDW 美鈴は一瞬何が起きたのかわからなかった	PRINTFORMDW 美鈴は一瞬何が起きたのかわからなかった
PRINTFORMDW 美鈴はすぐに気が付き、落とし穴を躱した	PRINTFORMDW 美鈴はすぐに気が付き、落とし穴を躱した
PRINTFORMW 「ひっ、ぐっ…あ゛あ゛あ゛あ゛あ゛ぁ！」	PRINTFORMW 「ひっ、ぐっ…あ゛あ゛あ゛あ゛あ゛ぁ！」
PRINTFORMW 「ひっ、くっ、ぅぐぅぅぅぅぅぅぅぅ！」」	PRINTFORMW 「ひっ、くっ、ぅぐぅぅぅぅぅぅぅぅ！」」
PRINTFORMW 「………これって確か…なんでしたっけ？」	PRINTFORMW 「………これって確か…なんでしたっけ？」
PRINTFORMW 「や、と、止まっ…！止まってぇぇぇ！！」	PRINTFORMW 「や、と、止まっ…！止まってぇぇぇ！！」
PRINTFORML 「花壇の花、枯れてないと良いんですが…」	PRINTFORML 「花壇の花、枯れてないと良いんですが…」
PRINTFORMW 「それでお嬢様、ご用件はなんでしょう？」	PRINTFORMW 「それでお嬢様、ご用件はなんでしょう？」
PRINTFORMDL そして獣はゆっくりと"ソレ"を引き抜く	PRINTFORMDL そして獣はゆっくりと"ソレ"を引き抜く
PRINTFORMDW 獣はニタリと笑い、そして蹂躙は続く……	PRINTFORMDW 獣はニタリと笑い、そして蹂躙は続く……
PRINTFORMW 「画面端でもないかぎり崩せませんよ！」	PRINTFORMW 「画面端でもないかぎり崩せませんよ！」
PRINTFORMW 「お嬢様！バックアップ任せましたよ！」	PRINTFORMW 「お嬢様！バックアップ任せましたよ！」
PRINTFORML 「私のターンはまだ終わっていません！」	PRINTFORML 「私のターンはまだ終わっていません！」
PRINTFORMDW 美鈴の華麗な回し蹴りが繰り出される！	PRINTFORMDW 美鈴の華麗な回し蹴りが繰り出される！
PRINTFORML 「アジの開きみたいにしてあげますよ！」	PRINTFORML 「アジの開きみたいにしてあげますよ！」
PRINTFORMW 美鈴は特殊な呼吸をし、気を練っている！	PRINTFORMW 美鈴は特殊な呼吸をし、気を練っている！
PRINTFORMDW 美鈴は目を閉じて集中力を高め始めた！	PRINTFORMDW 美鈴は目を閉じて集中力を高め始めた！
PRINTFORMW 「咲夜さん！もう少し待ってください！」	PRINTFORMW 「咲夜さん！もう少し待ってください！」
PRINTFORMW 「お嬢様！カバーしてもらえますか！？」	PRINTFORMW 「お嬢様！カバーしてもらえますか！？」
PRINTFORMDW 美鈴は腕に練った気を使い弾幕を放つ！	PRINTFORMDW 美鈴は腕に練った気を使い弾幕を放つ！
PRINTFORML 「し、心頭滅却すれば…この程度…っ！」	PRINTFORML 「し、心頭滅却すれば…この程度…っ！」
PRINTFORML 「食らいなさい！星気「星脈地転弾」！」	PRINTFORML 「食らいなさい！星気「星脈地転弾」！」
PRINTFORMDW 美鈴から雨を模った弾幕が発射される！	PRINTFORMDW 美鈴から雨を模った弾幕が発射される！
PRINTFORMDW 幾重にも広がる虹色の弾幕が放たれる！	PRINTFORMDW 幾重にも広がる虹色の弾幕が放たれる！
PRINTFORML 「あなた達なんて山にならない塵同然！」	PRINTFORML 「あなた達なんて山にならない塵同然！」
PRINTFORMDW 美鈴は腰を落とし、敵に攻撃を放った！	PRINTFORMDW 美鈴は腰を落とし、敵に攻撃を放った！
PRINTFORMW 「今ここで手加減すれば……って違う！」	PRINTFORMW 「今ここで手加減すれば……って違う！」
PRINTFORMDW 美鈴は隙の少ない素早い攻撃を放った！	PRINTFORMDW 美鈴は隙の少ない素早い攻撃を放った！
PRINTFORMDW 美鈴は体が疼き上手く脱出ができない！	PRINTFORMDW 美鈴は体が疼き上手く脱出ができない！
PRINTFORMDW 美鈴は必死に敵から離れようとしている	PRINTFORMDW 美鈴は必死に敵から離れようとしている
PRINTFORMW 「座布団…座布団…どこやったかな……」	PRINTFORMW 「座布団…座布団…どこやったかな……」
PRINTFORMW 「じゃあ…もっと強く踏んであげます♪」	PRINTFORMW 「じゃあ…もっと強く踏んであげます♪」
PRINTFORMDW 美鈴は次々と触手をしばき倒していく！	PRINTFORMDW 美鈴は次々と触手をしばき倒していく！
PRINTFORMW 「咲夜さん！このまま続けてください！」	PRINTFORMW 「咲夜さん！このまま続けてください！」
PRINTFORML (よし！この隙に距離を取らないと…！)	PRINTFORML (よし！この隙に距離を取らないと…！)
PRINTFORMDW 美鈴は眠りながら悲痛の表情をしている	PRINTFORMDW 美鈴は眠りながら悲痛の表情をしている
PRINTFORMDW 美鈴は傷口を抑えながら痛呻いている…	PRINTFORMDW 美鈴は傷口を抑えながら痛呻いている…
PRINTFORMW 「んっ…ああ……ひゃぅんっ……あっ！」	PRINTFORMW 「んっ…ああ……ひゃぅんっ……あっ！」
PRINTFORMW 「　～～～～ッ　～～～～～～～～～～ァ	PRINTFORMW 「　～～～～ッ　～～～～～～～～～～ァ
PRINTFORMDW ワームは美鈴を内側から蹂躙している！	PRINTFORMDW ワームは美鈴を内側から蹂躙している！
PRINTFORMW 「そんなに…吸わないでぇぇえぇぇ…！」	PRINTFORMW 「そんなに…吸わないでぇぇえぇぇ…！」
PRINTFORMW 「なぁっ…んぅ！っく、ふあぁぁぁぁ！」	PRINTFORMW 「なぁっ…んぅ！っく、ふあぁぁぁぁ！」
PRINTFORMDW 美鈴は歯を食いしばり快感を耐えている	PRINTFORMDW 美鈴は歯を食いしばり快感を耐えている
PRINTFORMDW 美鈴は眠りながら不快な表情をしている	PRINTFORMDW 美鈴は眠りながら不快な表情をしている
PRINTFORMDW 美鈴は華麗な足取りで敵の攻撃を流した	PRINTFORMDW 美鈴は華麗な足取りで敵の攻撃を流した
PRINTFORMW (気持ち悪いけど…気持ちいいような…)	PRINTFORMW (気持ち悪いけど…気持ちいいような…)
PRINTFORMDW 美鈴は発情のせいか倒錯的になっている	PRINTFORMDW 美鈴は発情のせいか倒錯的になっている
PRINTFORMW 「たまには先輩面しないといけませんね」	PRINTFORMW 「たまには先輩面しないといけませんね」
PRINTFORMDW 美鈴は俯きながら唇を噛みしめている…	PRINTFORMDW 美鈴は俯きながら唇を噛みしめている…
PRINTFORMDW 美鈴は肩で息をしながら傷の確認をした	PRINTFORMDW 美鈴は肩で息をしながら傷の確認をした
PRINTFORMDW 美鈴は呼吸を落ち着かせ、探索に戻った	PRINTFORMDW 美鈴は呼吸を落ち着かせ、探索に戻った
PRINTFORM 「おぉ！部屋の雰囲気が変わりましたね！」	PRINTFORM 「おぉ！部屋の雰囲気が変わりましたね！」
PRINTFORMDW 美鈴は記憶を辿って情報を提供している	PRINTFORMDW 美鈴は記憶を辿って情報を提供している
PRINTFORMW 「いやぁ、相変わらず綺麗な声ですね～」	PRINTFORMW 「いやぁ、相変わらず綺麗な声ですね～」
PRINTFORMW 「あ、私に噛みつかないでくださいね？」	PRINTFORMW 「あ、私に噛みつかないでくださいね？」
PRINTFORMW 「…………はぁ。相変わらず頑固ですね」	PRINTFORMW 「…………はぁ。相変わらず頑固ですね」
PRINTFORMW 「意地悪で構いません。ではさようなら」	PRINTFORMW 「意地悪で構いません。ではさようなら」
PRINTFORMW 「こ これは！懐かしきスペルカード！」	PRINTFORMW 「こ これは！懐かしきスペルカード！」
PRINTFORMW 「もしかして、触手でできてたり……？」	PRINTFORMW 「もしかして、触手でできてたり……？」
PRINTFORML 「んくぅ…あぁあぁぁぁぁぁぁぁぁ！！」	PRINTFORML 「んくぅ…あぁあぁぁぁぁぁぁぁぁ！！」
PRINTFORMW 「やっぱり雰囲気が変わりますねぇ～！」	PRINTFORMW 「やっぱり雰囲気が変わりますねぇ～！」
PRINTFORMDW 美鈴は苦笑いしながら目を反らしている	PRINTFORMDW 美鈴は苦笑いしながら目を反らしている
PRINTFORMW 「助かります！あ、後ろに気を付けて！」	PRINTFORMW 「助かります！あ、後ろに気を付けて！」
PRINTFORMW 「がはっ、があぁぅぅううううああ！！」	PRINTFORMW 「がはっ、があぁぅぅううううああ！！」
PRINTFORMW 「なんだか飲んだことのない味ですね…」	PRINTFORMW 「なんだか飲んだことのない味ですね…」
PRINTFORMW 「がぁっ！？…ぅうああぁぁあぁああ！」	PRINTFORMW 「がぁっ！？…ぅうああぁぁあぁああ！」
PRINTFORMDW 美鈴は触手に弄ばれ、嬌声を上げ続けた	PRINTFORMDW 美鈴は触手に弄ばれ、嬌声を上げ続けた
PRINTFORMW 「ありがく使わさせていただきましょう」	PRINTFORMW 「ありがく使わさせていただきましょう」
PRINTFORMDW 美鈴は目をこすりながら睡魔と闘った！	PRINTFORMDW 美鈴は目をこすりながら睡魔と闘った！
PRINTFORMW 「近道ですか。これは運がいいですね！」	PRINTFORMW 「近道ですか。これは運がいいですね！」
PRINTFORML 「ひっ…う、ああああああぁぁぁぁぁ…」	PRINTFORML 「ひっ…う、ああああああぁぁぁぁぁ…」
PRINTFORMW 「これは退いた方が良さそうですね…」	PRINTFORMW 「これは退いた方が良さそうですね…」
PRINTFORMW 「魔理沙さん！これ以上は危険です！」	PRINTFORMW 「魔理沙さん！これ以上は危険です！」
PRINTFORMW 「まずは確実に敵に当てれば…うぅ…」	PRINTFORMW 「まずは確実に敵に当てれば…うぅ…」
PRINTFORML 「はっはっはっは！隙だらけですよ！」	PRINTFORML 「はっはっはっは！隙だらけですよ！」
PRINTFORMW 「紅魔の門番を舐めないでください！」	PRINTFORMW 「紅魔の門番を舐めないでください！」
PRINTFORMDW 美鈴は欲望と戦いながら弾幕を放つ！	PRINTFORMDW 美鈴は欲望と戦いながら弾幕を放つ！
PRINTFORML 「吹きとべ！気符！「地龍天龍脚」！」	PRINTFORML 「吹きとべ！気符！「地龍天龍脚」！」
PRINTFORML 「斬れろ！斬れろ!!斬れろぉ～ッ！」	PRINTFORML 「斬れろ！斬れろ!!斬れろぉ～ッ！」
PRINTFORML 「ほらほら、動いてみてくださいよ！」	PRINTFORML 「ほらほら、動いてみてくださいよ！」
PRINTFORMW 「んくっ…はぁ…はぁ……そこだッ！」	PRINTFORMW 「んくっ…はぁ…はぁ……そこだッ！」
PRINTFORML 「下手な鉄砲何とやらですか…ねっ！」	PRINTFORML 「下手な鉄砲何とやらですか…ねっ！」
PRINTFORML (こんな状態で集中なんて…んんっ！)	PRINTFORML (こんな状態で集中なんて…んんっ！)
PRINTFORMW 「はぐぅ…ぁ！…ぁぁぁぁああああ！」	PRINTFORMW 「はぐぅ…ぁ！…ぁぁぁぁああああ！」
PRINTFORMW 「こんなことで…っぅああああああ！」	PRINTFORMW 「こんなことで…っぅああああああ！」
PRINTFORMDW 美鈴は喘ぎながらも気を練っている！	PRINTFORMDW 美鈴は喘ぎながらも気を練っている！
PRINTFORMDW 美鈴は深呼吸をし、精神力を高めた！	PRINTFORMDW 美鈴は深呼吸をし、精神力を高めた！
PRINTFORMW 「そこはダメです…ッ！く…ぅ……！」	PRINTFORMW 「そこはダメです…ッ！く…ぅ……！」
PRINTFORMW 「私、おっぱいに自信はあるんですよ？	PRINTFORMW 「私、おっぱいに自信はあるんですよ？
PRINTFORMDW 美鈴は目一杯、肺に空気を送っている	PRINTFORMDW 美鈴は目一杯、肺に空気を送っている
PRINTFORMW 「小悪魔さん！このタイミングです！」	PRINTFORMW 「小悪魔さん！このタイミングです！」
PRINTFORMDW 美鈴は肺の中にある空気を吐き出す…	PRINTFORMDW 美鈴は肺の中にある空気を吐き出す…
PRINTFORMW 「んあっ！んッ！も、もう…くうぅ！」	PRINTFORMW 「んあっ！んッ！も、もう…くうぅ！」
PRINTFORMDW 美鈴はもはや快楽しか見えていない！	PRINTFORMDW 美鈴はもはや快楽しか見えていない！
PRINTFORMW 「もっとぉ！狂うくらいして欲しいのぉ	PRINTFORMW 「もっとぉ！狂うくらいして欲しいのぉ
PRINTFORMW 「もっとキツくしてもいいんですよ♪」	PRINTFORMW 「もっとキツくしてもいいんですよ♪」
PRINTFORMW 「ひぐぅんっ！…っくぅぅぅぅぅぅ！」	PRINTFORMW 「ひぐぅんっ！…っくぅぅぅぅぅぅ！」
PRINTFORMDW 美鈴はいとも簡単に敵の攻撃を流した	PRINTFORMDW 美鈴はいとも簡単に敵の攻撃を流した
PRINTFORMDW 美鈴は手に付いた触手の粘液を掃った	PRINTFORMDW 美鈴は手に付いた触手の粘液を掃った
PRINTFORMW 「もう殆ど残ってないですよこれ……」	PRINTFORMW 「もう殆ど残ってないですよこれ……」
PRINTFORMW 「咲夜さん、ありがとうございます！」	PRINTFORMW 「咲夜さん、ありがとうございます！」
PRINTFORMW 「フラン様、ありがとうございます！」	PRINTFORMW 「フラン様、ありがとうございます！」
PRINTFORMW 「…ハッ！私は今…なんてことを……」	PRINTFORMW 「…ハッ！私は今…なんてことを……」
PRINTFORMW 「どうしたんです？来ないんですか？」	PRINTFORMW 「どうしたんです？来ないんですか？」
PRINTFORMW 「肩に力入れると転びますよ、お嬢様」	PRINTFORMW 「肩に力入れると転びますよ、お嬢様」
PRINTFORMW 「相手の隙を突く、兵法の基本です！」	PRINTFORMW 「相手の隙を突く、兵法の基本です！」
PRINTFORMDW 美鈴は涙を流しながら頭を下げている	PRINTFORMDW 美鈴は涙を流しながら頭を下げている
PRINTFORMW 「あの……なんといいますか…………」	PRINTFORMW 「あの……なんといいますか…………」
PRINTFORML 「咲夜さん、気を付つけてくださいね」	PRINTFORML 「咲夜さん、気を付つけてくださいね」
PRINTFORMW 「私の後ろでサポートをしてください」	PRINTFORMW 「私の後ろでサポートをしてください」
PRINTFORMW 「咲夜さんは私の後ろをお願いします」	PRINTFORMW 「咲夜さんは私の後ろをお願いします」
PRINTFORMW 「こちらこそ、よろしくお願いします」	PRINTFORMW 「こちらこそ、よろしくお願いします」
PRINTFORMW 「困ったときは持ちつ持たれつですよ」	PRINTFORMW 「困ったときは持ちつ持たれつですよ」
PRINTFORMW 「えっと、ではよろしくお願いします」	PRINTFORMW 「えっと、ではよろしくお願いします」
PRINTFORMW 「ありがたく使わせてもらいましょう」	PRINTFORMW 「ありがたく使わせてもらいましょう」
PRINTFORMW 「まぁ持っていても損はないでしょう」	PRINTFORMW 「まぁ持っていても損はないでしょう」
PRINTFORMW 「あ、大丈夫ですよ。慣れてますから」	PRINTFORMW 「あ、大丈夫ですよ。慣れてますから」
PRINTFORMW 「この恩はいつか必ずお返ししますね」	PRINTFORMW 「この恩はいつか必ずお返ししますね」
PRINTFORMDL 快楽によって美鈴は震え続けている！	PRINTFORMDL 快楽によって美鈴は震え続けている！
PRINTFORMDL 美鈴は体を弓のように反らしている！	PRINTFORMDL 美鈴は体を弓のように反らしている！
PRINTFORMW 「っと！敵ながら見事な作戦ですね…」	PRINTFORMW 「っと！敵ながら見事な作戦ですね…」
PRINTFORMW 「やっぱり温泉はいいものですね～♪」	PRINTFORMW 「やっぱり温泉はいいものですね～♪」
PRINTFORMW 「うあぁ…誰かぁ…たす、助けて……」	PRINTFORMW 「うあぁ…誰かぁ…たす、助けて……」
PRINTFORMW 「……あれ？私は確か……………！！」	PRINTFORMW 「……あれ？私は確か……………！！」
PRINTFORMDW 美鈴はすぐに気が付き、触手を躱した	PRINTFORMDW 美鈴はすぐに気が付き、触手を躱した
PRINTFORMDW 美鈴はすぐに気が付き、ガスを躱した	PRINTFORMDW 美鈴はすぐに気が付き、ガスを躱した
PRINTFORMDW 後に美鈴は紅茶を啜りながらこう語る	PRINTFORMDW 後に美鈴は紅茶を啜りながらこう語る
PRINTFORMW 「今ならなんだってできそうですよ！」	PRINTFORMW 「今ならなんだってできそうですよ！」
PRINTFORMDW 美鈴は火照った体を抑えようと必死だ	PRINTFORMDW 美鈴は火照った体を抑えようと必死だ
PRINTFORMW   そ、そのうち外れます…よね…？」	PRINTFORMW   そ、そのうち外れます…よね…？」
PRINTFORML 「お嬢様や咲夜さんたちのためにも！」	PRINTFORML 「お嬢様や咲夜さんたちのためにも！」
PRINTFORML 「なんだか、変な気分です…その……」	PRINTFORML 「なんだか、変な気分です…その……」
PRINTFORMW 「…よ……よかったぁーーーーー！！」	PRINTFORMW 「…よ……よかったぁーーーーー！！」
PRINTFORML 「あっ、あっ、あっ、あっ、あっ…！」	PRINTFORML 「あっ、あっ、あっ、あっ、あっ…！」
PRINTFORML 「じゅる…んむ……んんん……っはぁ」	PRINTFORML 「じゅる…んむ……んんん……っはぁ」
PRINTFORMW 「魔理沙さん！今がチャンスです！」	PRINTFORMW 「魔理沙さん！今がチャンスです！」
PRINTFORMW 「小悪魔さん！今のうちに体勢を！」	PRINTFORMW 「小悪魔さん！今のうちに体勢を！」
PRINTFORMW （霊夢さん、ここは一旦退きますよ）	PRINTFORMW （霊夢さん、ここは一旦退きますよ）
PRINTFORMW 「フラン様！逃げますよぉぉぉぉ！」	PRINTFORMW 「フラン様！逃げますよぉぉぉぉ！」
PRINTFORMDW 美鈴はテンションが上がっている！	PRINTFORMDW 美鈴はテンションが上がっている！
PRINTFORMW (うぅ…思うように気が練れない…)	PRINTFORMW (うぅ…思うように気が練れない…)
PRINTFORMDW 美鈴の気を纏った貫手が敵を狙う！	PRINTFORMDW 美鈴の気を纏った貫手が敵を狙う！
PRINTFORML 「それで防御してるつもりですか！」	PRINTFORML 「それで防御してるつもりですか！」
PRINTFORML 「今の私は誰にも止められません！」	PRINTFORML 「今の私は誰にも止められません！」
PRINTFORMDW 美鈴は敵に対して溜めた気を放つ！	PRINTFORMDW 美鈴は敵に対して溜めた気を放つ！
PRINTFORML 「動けるものなら動いてみなさい！」	PRINTFORML 「動けるものなら動いてみなさい！」
PRINTFORMDW 美鈴はエモノを横一文字に薙いだ！	PRINTFORMDW 美鈴はエモノを横一文字に薙いだ！
PRINTFORML 「んくっ…はぁ…はぁ……だぁッ！」	PRINTFORML 「んくっ…はぁ…はぁ……だぁッ！」
PRINTFORMDW 美鈴は屈服し、全てを受け入れた…	PRINTFORMDW 美鈴は屈服し、全てを受け入れた…
PRINTFORMW 「言ってませんよね？だ！れ！も！」	PRINTFORMW 「言ってませんよね？だ！れ！も！」
PRINTFORMW 「あっ！ひゃんっ！んっ！んぁっ！」	PRINTFORMW 「あっ！ひゃんっ！んっ！んぁっ！」
PRINTFORMW 「だめですっ…ぁっ！…んぅ…っ！」	PRINTFORMW 「だめですっ…ぁっ！…んぅ…っ！」
PRINTFORMW (気を使えばこれくらいなら…ッ！)	PRINTFORMW (気を使えばこれくらいなら…ッ！)
PRINTFORMW 「そんなもので私は倒れませんよ！」	PRINTFORMW 「そんなもので私は倒れませんよ！」
PRINTFORMW 「ッ！あ゛あ゛あ゛あ゛ぉあ゛ぁぁ」	PRINTFORMW 「ッ！あ゛あ゛あ゛あ゛ぉあ゛ぁぁ」
PRINTFORMW 「ダメ…これ以上はああああっっ！」	PRINTFORMW 「ダメ…これ以上はああああっっ！」
PRINTFORMW 「んんんぅ！胸は！ダメなのっぁ！」	PRINTFORMW 「んんんぅ！胸は！ダメなのっぁ！」
PRINTFORMW 「食べてっ♪食べてっ♪食べてっ♪」	PRINTFORMW 「食べてっ♪食べてっ♪食べてっ♪」
PRINTFORMW 「お嬢様、衰えていないようですね」	PRINTFORMW 「お嬢様、衰えていないようですね」
PRINTFORMDW 美鈴はすぐに秘所と胸を隠したが…	PRINTFORMDW 美鈴はすぐに秘所と胸を隠したが…
PRINTFORMW 「お嬢様、ありがとうございます！」	PRINTFORMW 「お嬢様、ありがとうございます！」
PRINTFORMW 「さて…行きましょうか、フラン様」	PRINTFORMW 「さて…行きましょうか、フラン様」
PRINTFORMW 「あなたには、地獄すら生ぬるい！」	PRINTFORMW 「あなたには、地獄すら生ぬるい！」
PRINTFORMDW 美鈴は呆れるほどぐっすり寝ていた	PRINTFORMDW 美鈴は呆れるほどぐっすり寝ていた
PRINTFORMW 「おや、おじょうさ……………は？」	PRINTFORMW 「おや、おじょうさ……………は？」
PRINTFORMW 「これで大分戦闘が楽になりますね」	PRINTFORMW 「これで大分戦闘が楽になりますね」
PRINTFORMW 「はぃ？刺激が強すぎるからダメ？」	PRINTFORMW 「はぃ？刺激が強すぎるからダメ？」
PRINTFORMW 「えーと、豊穣の神様ですよね…？」	PRINTFORMW 「えーと、豊穣の神様ですよね…？」
PRINTFORMW 「現人神が居れば、百人力ですね！」	PRINTFORMW 「現人神が居れば、百人力ですね！」
PRINTFORMW 「仲間は多いほど心強いものですよ」	PRINTFORMW 「仲間は多いほど心強いものですよ」
PRINTFORMW 「よろしくお願いします(ﾄﾞﾔｧ」	PRINTFORMW 「よろしくお願いします(ﾄﾞﾔｧ」
PRINTFORMW 「へ？何かまずいこと言いました？」	PRINTFORMW 「へ？何かまずいこと言いました？」
PRINTFORMW 「私がいるからには百人力ですよ！」	PRINTFORMW 「私がいるからには百人力ですよ！」
PRINTFORMW 「お嬢様の加護とはありがたいです」	PRINTFORMW 「お嬢様の加護とはありがたいです」
PRINTFORMW 「はは…我ながら、不器用ですねぇ」	PRINTFORMW 「はは…我ながら、不器用ですねぇ」
PRINTFORMW 「油断だけはしないでくださいね？」	PRINTFORMW 「油断だけはしないでくださいね？」
PRINTFORMW 「くれぐれもお気をつけて下さいね」	PRINTFORMW 「くれぐれもお気をつけて下さいね」
PRINTFORMW 「…どこかから流れてきたのかな？」	PRINTFORMW 「…どこかから流れてきたのかな？」
PRINTFORMW 「これ、アイツらに効くんですか？」	PRINTFORMW 「これ、アイツらに効くんですか？」
PRINTFORMW 「いつ使えばいいんですか、これ…」	PRINTFORMW 「いつ使えばいいんですか、これ…」
PRINTFORMW （どうか見つかりませんように……）	PRINTFORMW （どうか見つかりませんように……）
PRINTFORML 「が、あぁぁっ！？…っはぁん！！」	PRINTFORML 「が、あぁぁっ！？…っはぁん！！」
PRINTFORMDW 美鈴は眠気からか大きな欠伸をした	PRINTFORMDW 美鈴は眠気からか大きな欠伸をした
PRINTFORMDW 美鈴は息を殺して気配を消している	PRINTFORMDW 美鈴は息を殺して気配を消している
PRINTFORMW 「あっ、あっ、あっ、あっ、あっ…」	PRINTFORMW 「あっ、あっ、あっ、あっ、あっ…」
PRINTFORMW 「ひゃぁあぁああぁぁぁ！あぁ…！」	PRINTFORMW 「ひゃぁあぁああぁぁぁ！あぁ…！」
PRINTFORMW 「気…私の…気…が…吸われ……！」	PRINTFORMW 「気…私の…気…が…吸われ……！」
PRINTFORMW (なんだか…頭……ふわーって……)	PRINTFORMW (なんだか…頭……ふわーって……)
PRINTFORMW 「なっ！こ、これは！あぐぅっ！？」	PRINTFORMW 「なっ！こ、これは！あぐぅっ！？」
PRINTFORMDW 美鈴は寄生された自覚がないようだ	PRINTFORMDW 美鈴は寄生された自覚がないようだ
PRINTFORMW 「しばらくじっとしていたいです…」	PRINTFORMW 「しばらくじっとしていたいです…」
PRINTFORMW 「んー！んんー！ごっ！んんんん！」	PRINTFORMW 「んー！んんー！ごっ！んんんん！」
PRINTFORML 「はぁーっ、はぁーっ、はぁーっ…」	PRINTFORML 「はぁーっ、はぁーっ、はぁーっ…」
PRINTFORMW 「あ゛ぁぁぁぁぁぁぁぁ！…ぁっ！」	PRINTFORMW 「あ゛ぁぁぁぁぁぁぁぁ！…ぁっ！」
PRINTFORMDW 美鈴は前に大きく一歩踏み出した	PRINTFORMDW 美鈴は前に大きく一歩踏み出した
PRINTFORMW 「お嬢様、ここは退きましょう！」	PRINTFORMW 「お嬢様、ここは退きましょう！」
PRINTFORMW 「確実に当てていけば勝てます！」	PRINTFORMW 「確実に当てていけば勝てます！」
PRINTFORMDW 美鈴の空中から蹴りを繰り出す！	PRINTFORMDW 美鈴の空中から蹴りを繰り出す！
PRINTFORMW 「霊夢さん！分かってますよね！」	PRINTFORMW 「霊夢さん！分かってますよね！」
PRINTFORMW 「動かないで…ください……っ！」	PRINTFORMW 「動かないで…ください……っ！」
PRINTFORML 「これで敵の動きを止めないと！」	PRINTFORML 「これで敵の動きを止めないと！」
PRINTFORMW (逃げなくちゃいけないのに…ッ)	PRINTFORMW (逃げなくちゃいけないのに…ッ)
PRINTFORMW （せめて自由に呼吸が出来れば…）	PRINTFORMW （せめて自由に呼吸が出来れば…）
PRINTFORMW 「気を練る余裕なんて…っぁあ！」	PRINTFORMW 「気を練る余裕なんて…っぁあ！」
PRINTFORMW 「んふふ、気持ちいいですよね？」	PRINTFORMW 「んふふ、気持ちいいですよね？」
PRINTFORMW 「って何考えてるんですか私は！」	PRINTFORMW 「って何考えてるんですか私は！」
PRINTFORML 「このまま畳み掛けられればッ！」	PRINTFORML 「このまま畳み掛けられればッ！」
PRINTFORMW 「げほっ…げほっ…！うぅぐ……」	PRINTFORMW 「げほっ…げほっ…！うぅぐ……」
PRINTFORMW 「あッ…！？　ッ！…ぅぅぅ……」	PRINTFORMW 「あッ…！？　ッ！…ぅぅぅ……」
PRINTFORMW 「　～～～～ッ　～～～～ァ！！」	PRINTFORMW 「　～～～～ッ　～～～～ァ！！」
PRINTFORMW 「んぁぁああああああああああああ	PRINTFORMW 「んぁぁああああああああああああ
PRINTFORMW 「ダメダメぇ！もっと激しくぅ！」	PRINTFORMW 「ダメダメぇ！もっと激しくぅ！」
PRINTFORMW 「吸盤が…ッ！うぁ…あ゛っ！！」	PRINTFORMW 「吸盤が…ッ！うぁ…あ゛っ！！」
PRINTFORMDW 美鈴は内側から蹂躙されている！	PRINTFORMDW 美鈴は内側から蹂躙されている！
PRINTFORMW 「ひゃっ！そんなぁ……んくっ！」	PRINTFORMW 「ひゃっ！そんなぁ……んくっ！」
PRINTFORMW 「そんなに…吸わないでぇっ…！」	PRINTFORMW 「そんなに…吸わないでぇっ…！」
PRINTFORMDW 美鈴は小刻みに震え続けている！	PRINTFORMDW 美鈴は小刻みに震え続けている！
PRINTFORMW 「まだまだ修行が足りませんね！」	PRINTFORMW 「まだまだ修行が足りませんね！」
PRINTFORMW 「スロー過ぎてあくびが出ますよ」	PRINTFORMW 「スロー過ぎてあくびが出ますよ」
PRINTFORMW 「見事な活躍でしたよ、フラン様」	PRINTFORMW 「見事な活躍でしたよ、フラン様」
PRINTFORMW 「行きますよ！博麗の巫女様っ！」	PRINTFORMW 「行きますよ！博麗の巫女様っ！」
PRINTFORMW （敵より味方からの攻撃が怖い…）	PRINTFORMW （敵より味方からの攻撃が怖い…）
PRINTFORMW 「ここまでくれば大丈夫でしょう」	PRINTFORMW 「ここまでくれば大丈夫でしょう」
PRINTFORMW 「私が……一緒にいれば…………」	PRINTFORMW 「私が……一緒にいれば…………」
PRINTFORMW 「フラン様……フラン様ぁ……！」	PRINTFORMW 「フラン様……フラン様ぁ……！」
PRINTFORMW 「何か新しい情報はありますか？」	PRINTFORMW 「何か新しい情報はありますか？」
PRINTFORMW 「…え？使い方間違ってました？」	PRINTFORMW 「…え？使い方間違ってました？」
PRINTFORMW 「必ずここから脱出しましょうね」	PRINTFORMW 「必ずここから脱出しましょうね」
PRINTFORML 「泣きついたりなんてしませんよ！	PRINTFORML 「泣きついたりなんてしませんよ！
PRINTFORMW 　ここがどれだけ危険か……ッ！」	PRINTFORMW 　ここがどれだけ危険か……ッ！」
PRINTFORMW 「まぎれもなく咲夜さんの時計！」	PRINTFORMW 「まぎれもなく咲夜さんの時計！」
PRINTFORMW 「もうコメントしたくないです…」	PRINTFORMW 「もうコメントしたくないです…」
PRINTFORML 「ん…んぁっ！ひゃ…う…ん……」	PRINTFORML 「ん…んぁっ！ひゃ…う…ん……」
PRINTFORMW それ、正真正銘、私の処女ですよぉ	PRINTFORMW それ、正真正銘、私の処女ですよぉ
PRINTFORMW 「あ！援軍ですか？感謝します！」	PRINTFORMW 「あ！援軍ですか？感謝します！」
PRINTFORMW 「もう…ダメっ…だ、誰かぁ……」	PRINTFORMW 「もう…ダメっ…だ、誰かぁ……」
PRINTFORMW 「また後で詳しく調べましょうか」	PRINTFORMW 「また後で詳しく調べましょうか」
PRINTFORMDW 美鈴は慌てて戦闘態勢に入った！	PRINTFORMDW 美鈴は慌てて戦闘態勢に入った！
PRINTFORMDW 美鈴は当然のように落石を避けた	PRINTFORMDW 美鈴は当然のように落石を避けた
PRINTFORMDW 美鈴は快楽に今にも屈しそうだ！	PRINTFORMDW 美鈴は快楽に今にも屈しそうだ！
PRINTFORMW 「うぅ…こんなものあっても……」	PRINTFORMW 「うぅ…こんなものあっても……」
PRINTFORMW 「例の噂の洞窟？調査を？私が？」	PRINTFORMW 「例の噂の洞窟？調査を？私が？」
PRINTFORML 「…なんて…美味しそう…ふふっ」	PRINTFORML 「…なんて…美味しそう…ふふっ」
PRINTFORMW 「咲夜さん！そこから援護を！」	PRINTFORMW 「咲夜さん！そこから援護を！」
PRINTFORMW 「小悪魔さん！走れますね！？」	PRINTFORMW 「小悪魔さん！走れますね！？」
PRINTFORMDW 美鈴の鋭い蹴りが相手を狙う！	PRINTFORMDW 美鈴の鋭い蹴りが相手を狙う！
PRINTFORMW 「何事もバランスが大事ですよ」	PRINTFORMW 「何事もバランスが大事ですよ」
PRINTFORML 「幻想を抱いて溺死なさい！ 」	PRINTFORML 「幻想を抱いて溺死なさい！ 」
PRINTFORML 「下手に動くと危ないですよ？」	PRINTFORML 「下手に動くと危ないですよ？」
PRINTFORML 「んっ…来ないでくださいっ！」	PRINTFORML 「んっ…来ないでくださいっ！」
PRINTFORMW 「目を覚ましてくださいよー！」	PRINTFORMW 「目を覚ましてくださいよー！」
PRINTFORMW 「お嬢様！追撃お願いします！」	PRINTFORMW 「お嬢様！追撃お願いします！」
PRINTFORMDW 美鈴は眉間にしわを寄せている	PRINTFORMDW 美鈴は眉間にしわを寄せている
PRINTFORMW 「ぅ…っくあぁ！っぐぅぅ…！」	PRINTFORMW 「ぅ…っくあぁ！っぐぅぅ…！」
PRINTFORMDW 美鈴は快楽に身を震わせている	PRINTFORMDW 美鈴は快楽に身を震わせている
PRINTFORMW 「ひぅぅぅぅぅぅぅんぁっっ！」	PRINTFORMW 「ひぅぅぅぅぅぅぅんぁっっ！」
PRINTFORMW 「お、お尻にッぁああああ！？」	PRINTFORMW 「お、お尻にッぁああああ！？」
PRINTFORMW 「ダメ…これ以上はああっっ！」	PRINTFORMW 「ダメ…これ以上はああっっ！」
PRINTFORMDW 美鈴は快楽にじっと耐えている	PRINTFORMDW 美鈴は快楽にじっと耐えている
PRINTFORMDW 美鈴は未だ眠りについたままだ	PRINTFORMDW 美鈴は未だ眠りについたままだ
PRINTFORMW 「咲夜さん！大丈夫ですか！？」	PRINTFORMW 「咲夜さん！大丈夫ですか！？」
PRINTFORMW (もっと…もっと…もっと……)	PRINTFORMW (もっと…もっと…もっと……)
PRINTFORMDW 美鈴は眠りながら眉をひそめる	PRINTFORMDW 美鈴は眠りながら眉をひそめる
PRINTFORMW 「作戦は…分かってますよね？」	PRINTFORMW 「作戦は…分かってますよね？」
PRINTFORMDW 美鈴は呆れるほど熟睡している	PRINTFORMDW 美鈴は呆れるほど熟睡している
PRINTFORMW 「ちょっときつかったですね…」	PRINTFORMW 「ちょっときつかったですね…」
PRINTFORMW 「不意打ち！？なんて卑怯な！」	PRINTFORMW 「不意打ち！？なんて卑怯な！」
PRINTFORMW 「卑怯？何とでも言いなさい！」	PRINTFORMW 「卑怯？何とでも言いなさい！」
PRINTFORMW 「…………………あ、あぁぁ！」	PRINTFORMW 「…………………あ、あぁぁ！」
PRINTFORMW 「あら魔理沙さん。奇遇ですね」	PRINTFORMW 「あら魔理沙さん。奇遇ですね」
PRINTFORMW 「そちらの探索はどうですか？」	PRINTFORMW 「そちらの探索はどうですか？」
PRINTFORML 「パチュリー様、お気をつけて」	PRINTFORML 「パチュリー様、お気をつけて」
PRINTFORMDW 美鈴は情報を熱心に聞いている	PRINTFORMDW 美鈴は情報を熱心に聞いている
PRINTFORMW 「そんなこと言わないでよ～～」	PRINTFORMW 「そんなこと言わないでよ～～」
PRINTFORMW 「……気取ってもダメ？むむむ」	PRINTFORMW 「……気取ってもダメ？むむむ」
PRINTFORMW 「頼りにさせていただきます！」	PRINTFORMW 「頼りにさせていただきます！」
PRINTFORMW 「う、うぁぁああああああ！！」	PRINTFORMW 「う、うぁぁああああああ！！」
PRINTFORMDW 美鈴は怪しげな笑みを浮かべた	PRINTFORMDW 美鈴は怪しげな笑みを浮かべた
PRINTFORMW 「う～ん、清々しくてグッド！」	PRINTFORMW 「う～ん、清々しくてグッド！」
PRINTFORMW (じわじわ…溶けて…いく……)	PRINTFORMW (じわじわ…溶けて…いく……)
PRINTFORMW (感じたく…ないのにッ！……)	PRINTFORMW (感じたく…ないのにッ！……)
PRINTFORMW 「…！？っぐ、げほ、げっほ！」	PRINTFORMW 「…！？っぐ、げほ、げっほ！」
PRINTFORMW 「げほげほっ……はぁ…ふぅ…」	PRINTFORMW 「げほげほっ……はぁ…ふぅ…」
PRINTFORMW 「な…なんなんですか…これ…」	PRINTFORMW 「な…なんなんですか…これ…」
PRINTFORMW 「ひっ！？……なっ、えっ？！」	PRINTFORMW 「ひっ！？……なっ、えっ？！」
PRINTFORML 「うぅ…ぁ！……っく、ひぅ…」	PRINTFORML 「うぅ…ぁ！……っく、ひぅ…」
PRINTFORMW 「……で、ではお先にどうぞ…」	PRINTFORMW 「……で、ではお先にどうぞ…」
PRINTFORMW 「…うぅ……分かりました……」	PRINTFORMW 「…うぅ……分かりました……」
PRINTFORMW 「…ふふ…ふふふ……ふふふふ」	PRINTFORMW 「…ふふ…ふふふ……ふふふふ」
PRINTFORMW 「さぁ、かかってきなさい！」	PRINTFORMW 「さぁ、かかってきなさい！」
PRINTFORMW 「ここは逃げるが勝ちです！」	PRINTFORMW 「ここは逃げるが勝ちです！」
PRINTFORML 「どこを見ているんですか？」	PRINTFORML 「どこを見ているんですか？」
PRINTFORMW 「じゃ、邪魔なんですよぉ！」	PRINTFORMW 「じゃ、邪魔なんですよぉ！」
PRINTFORMW 「上手く力が入らない…ッ！」	PRINTFORMW 「上手く力が入らない…ッ！」
PRINTFORML 「この突きがかわせますか！」	PRINTFORML 「この突きがかわせますか！」
PRINTFORML 「これでも！食らいなさい！」	PRINTFORML 「これでも！食らいなさい！」
PRINTFORML 「ぐっ…おおおぉぉぉぉぉ！」	PRINTFORML 「ぐっ…おおおぉぉぉぉぉ！」
PRINTFORML 「これで…相手も少しは……」	PRINTFORML 「これで…相手も少しは……」
PRINTFORMW 「手が汚れちゃいました……」	PRINTFORMW 「手が汚れちゃいました……」
PRINTFORMW 「あ、そこの あ・な・た♪」	PRINTFORMW 「あ、そこの あ・な・た♪」
PRINTFORMW 「おいたはいけませんねぇ？」	PRINTFORMW 「おいたはいけませんねぇ？」
PRINTFORMW 「はぁ……はぁ……はぁ……」	PRINTFORMW 「はぁ……はぁ……はぁ……」
PRINTFORMW 「おぼッ！…う…おえぇ……」	PRINTFORMW 「おぼッ！…う…おえぇ……」
PRINTFORMW (これくらいならなんとか…)	PRINTFORMW (これくらいならなんとか…)
PRINTFORMW 「んあっ！んッ！…くぅっ！」	PRINTFORMW 「んあっ！んッ！…くぅっ！」
PRINTFORMW 「ひゃあぁぁぁあぁぁぁ…！」	PRINTFORMW 「ひゃあぁぁぁあぁぁぁ…！」
PRINTFORMW 「く…うぅ……　こんな…ッ」	PRINTFORMW 「く…うぅ……　こんな…ッ」
PRINTFORMW 「なっ！脱出できないっ！？」	PRINTFORMW 「なっ！脱出できないっ！？」
PRINTFORMW 「あかちゃんできちゃうのぉ…	PRINTFORMW 「あかちゃんできちゃうのぉ…
PRINTFORML 「はぁー…はぁー…はぁー…」	PRINTFORML 「はぁー…はぁー…はぁー…」
PRINTFORMW (マズい…気が練れない…！)	PRINTFORMW (マズい…気が練れない…！)
PRINTFORMW (もっと…欲しいィ…ぃぃ♪)	PRINTFORMW (もっと…欲しいィ…ぃぃ♪)
PRINTFORMDW 美鈴は未だに眠りこけている	PRINTFORMDW 美鈴は未だに眠りこけている
PRINTFORMW 「んんっ…っはぁ、はぁ……」	PRINTFORMW 「んんっ…っはぁ、はぁ……」
PRINTFORMW 「小悪魔さん！私の後ろに！」	PRINTFORMW 「小悪魔さん！私の後ろに！」
PRINTFORMW (はっ…、私は…今何を！？)	PRINTFORMW (はっ…、私は…今何を！？)
PRINTFORMW 「次こそは倒して見せる…！」	PRINTFORMW 「次こそは倒して見せる…！」
PRINTFORMW             死刑	PRINTFORMW             死刑
PRINTFORMW 「飛んで火にいる夏の虫っ！」	PRINTFORMW 「飛んで火にいる夏の虫っ！」
PRINTFORMW 「あ、あの…大丈夫ですか？」	PRINTFORMW 「あ、あの…大丈夫ですか？」
PRINTFORMW 「あ、またお会いしましたね」	PRINTFORMW 「あ、またお会いしましたね」
PRINTFORML 「フラン様、お気をつけて…」	PRINTFORML 「フラン様、お気をつけて…」
PRINTFORMDW 美鈴は話の花を咲かせている	PRINTFORMDW 美鈴は話の花を咲かせている
PRINTFORMDW 美鈴は咲夜に注意をしている	PRINTFORMDW 美鈴は咲夜に注意をしている
PRINTFORMW 「はいよろしくお願いします」	PRINTFORMW 「はいよろしくお願いします」
PRINTFORMW 「ふふっ、任せてください。」	PRINTFORMW 「ふふっ、任せてください。」
PRINTFORMDW 美鈴は明羅の服に興味津々だ	PRINTFORMDW 美鈴は明羅の服に興味津々だ
PRINTFORMDW 美鈴は少し苦笑いをしている	PRINTFORMDW 美鈴は少し苦笑いをしている
PRINTFORMW 「よろしくお願いしますね！」	PRINTFORMW 「よろしくお願いしますね！」
PRINTFORML 「んああああぁぁぁぁぁっ！」	PRINTFORML 「んああああぁぁぁぁぁっ！」
PRINTFORMDW 美鈴は虚ろな目を続けている	PRINTFORMDW 美鈴は虚ろな目を続けている
PRINTFORMW 「ご助力、感謝いたします！」	PRINTFORMW 「ご助力、感謝いたします！」
PRINTFORMW 「ちゃんと愉しませますから」	PRINTFORMW 「ちゃんと愉しませますから」
PRINTFORMW 「……んっ……くぅ！………」	PRINTFORMW 「……んっ……くぅ！………」
PRINTFORMW 「ふぅ…心が落ち着きますね」	PRINTFORMW 「ふぅ…心が落ち着きますね」
PRINTFORMW 「気になるんですけどねぇ…」	PRINTFORMW 「気になるんですけどねぇ…」
PRINTFORMW 「……！？何か、今悪寒が…」	PRINTFORMW 「……！？何か、今悪寒が…」
PRINTFORMW 「この守りを崩せますか？」	PRINTFORMW 「この守りを崩せますか？」
PRINTFORMW 「武器は投げ捨てるもの！」	PRINTFORMW 「武器は投げ捨てるもの！」
PRINTFORMW 「霊夢さん！今のうちに！」	PRINTFORMW 「霊夢さん！今のうちに！」
PRINTFORMW 「これなら当たるはず…！」	PRINTFORMW 「これなら当たるはず…！」
PRINTFORMW 「貫け！光符「華光玉」！」	PRINTFORMW 「貫け！光符「華光玉」！」
PRINTFORML 「くぅ…どいてください！」	PRINTFORML 「くぅ…どいてください！」
PRINTFORMDW 美鈴は敵に狙いを定めた！	PRINTFORMDW 美鈴は敵に狙いを定めた！
PRINTFORML 「そこを…どきな、さい！」	PRINTFORML 「そこを…どきな、さい！」
PRINTFORMW 「―――――――――ッ！」	PRINTFORMW 「―――――――――ッ！」
PRINTFORMW 「ん、んぐぅぅぅっっ！！」	PRINTFORMW 「ん、んぐぅぅぅっっ！！」
PRINTFORMW 「霊夢さん！頼みますよ！」	PRINTFORMW 「霊夢さん！頼みますよ！」
PRINTFORMW 「フラン様！今のうちに！」	PRINTFORMW 「フラン様！今のうちに！」
PRINTFORMW 「っっっっ！！っっんぅ♪」	PRINTFORMW 「っっっっ！！っっんぅ♪」
PRINTFORMW 「ふぁっ♪あぁぁぁぁぁ♪」	PRINTFORMW 「ふぁっ♪あぁぁぁぁぁ♪」
PRINTFORMW 「ぇああああぁぁぁぁぁ…」	PRINTFORMW 「ぇああああぁぁぁぁぁ…」
PRINTFORMW 「やりましたね、霊夢さん」	PRINTFORMW 「やりましたね、霊夢さん」
PRINTFORMW 「このまま…では…くっ！」	PRINTFORMW 「このまま…では…くっ！」
PRINTFORMW 「はー…　あぁ…ん…　…」	PRINTFORMW 「はー…　あぁ…ん…　…」
PRINTFORMW 「あー！何するんですか！」	PRINTFORMW 「あー！何するんですか！」
PRINTFORMW 「もう二度とゴメンです…」	PRINTFORMW 「もう二度とゴメンです…」
PRINTFORMW 「うぅ、べとべとします…」	PRINTFORMW 「うぅ、べとべとします…」
PRINTFORMW 「始まりますよ、メイド長」	PRINTFORMW 「始まりますよ、メイド長」
PRINTFORML 「お嬢様、お気をつけて…」	PRINTFORML 「お嬢様、お気をつけて…」
PRINTFORMW 「ふむふむ、なるほど……」	PRINTFORMW 「ふむふむ、なるほど……」
PRINTFORMW 「一緒に頑張りましょう！」	PRINTFORMW 「一緒に頑張りましょう！」
PRINTFORMW 「ふぁぁぁぁぁぁぁああああ	PRINTFORMW 「ふぁぁぁぁぁぁぁああああ
PRINTFORMW 「ごふっ…ぅ…っぐぅあ！」	PRINTFORMW 「ごふっ…ぅ…っぐぅあ！」
PRINTFORMW 「よろしくお願いします！」	PRINTFORMW 「よろしくお願いします！」
PRINTFORMW 「あなたの気をください♪」	PRINTFORMW 「あなたの気をください♪」
PRINTFORMW 「んんぅ！ぐっんんんん！」	PRINTFORMW 「んんぅ！ぐっんんんん！」
PRINTFORMW 「…ぅ…気持ち…悪い……」	PRINTFORMW 「…ぅ…気持ち…悪い……」
PRINTFORMW 「かっ…ぁ―――――――」	PRINTFORMW 「かっ…ぁ―――――――」
PRINTFORMW 「ひゃぁっ！？ふ、服が！」	PRINTFORMW 「ひゃぁっ！？ふ、服が！」
PRINTFORMW 「……かっ…っ…がはっ…」	PRINTFORMW 「……かっ…っ…がはっ…」
PRINTFORMDW 美鈴は苦しそうにしている	PRINTFORMDW 美鈴は苦しそうにしている
PRINTFORMW 「すいません、また後で…」	PRINTFORMW 「すいません、また後で…」
PRINTFORMDW 美鈴は息を荒くしている！	PRINTFORMDW 美鈴は息を荒くしている！
PRINTFORML 「ああぁぁっ！？っくぅ！」	PRINTFORML 「ああぁぁっ！？っくぅ！」
PRINTFORML 「――――ッ！ッッ！！！」	PRINTFORML 「――――ッ！ッッ！！！」
PRINTFORMW 「こんな時こそこれを！」	PRINTFORMW 「こんな時こそこれを！」
PRINTFORMDW 美鈴の裏拳が放たれる！	PRINTFORMDW 美鈴の裏拳が放たれる！
PRINTFORMW 「頑張れ…私の理性…！」	PRINTFORMW 「頑張れ…私の理性…！」
PRINTFORML 「貧弱！貧弱過ぎます！」	PRINTFORML 「貧弱！貧弱過ぎます！」
PRINTFORML 「速さが足りませんね！」	PRINTFORML 「速さが足りませんね！」
PRINTFORMW 「んっくああぁぁぁぁ…」	PRINTFORMW 「んっくああぁぁぁぁ…」
PRINTFORMW 「あぁっ……ひゃっ……」	PRINTFORMW 「あぁっ……ひゃっ……」
PRINTFORMW 「あっ…んぅうぅぅぅぅぅ	PRINTFORMW 「あっ…んぅうぅぅぅぅぅ
PRINTFORMW 「吸盤が…はぁんっ…！」	PRINTFORMW 「吸盤が…はぁんっ…！」
PRINTFORMW 「うううぅぅぅぅぅぅ！」	PRINTFORMW 「うううぅぅぅぅぅぅ！」
PRINTFORMW 「…いっ…、うっ　んッ」	PRINTFORMW 「…いっ…、うっ　んッ」
PRINTFORMW 「離しなさいっ！くっ！」	PRINTFORMW 「離しなさいっ！くっ！」
PRINTFORMW 「ぅ…さむ……むにゃ…」	PRINTFORMW 「ぅ…さむ……むにゃ…」
PRINTFORMW 「……！てっ、敵襲！？」	PRINTFORMW 「……！てっ、敵襲！？」
PRINTFORMW 「私の太極拳は無敵です」	PRINTFORMW 「私の太極拳は無敵です」
PRINTFORMW 「さて、進みましょうか」	PRINTFORMW 「さて、進みましょうか」
PRINTFORMW 「れ、霊夢…さん……？」	PRINTFORMW 「れ、霊夢…さん……？」
PRINTFORML 「さ、咲夜さん……！？」	PRINTFORML 「さ、咲夜さん……！？」
PRINTFORMW 「またお会いしましょう」	PRINTFORMW 「またお会いしましょう」
PRINTFORMW 「ありがとうございます」	PRINTFORMW 「ありがとうございます」
PRINTFORML 「え、あ、分かりました。	PRINTFORML 「え、あ、分かりました。
PRINTFORML 「っ…っっ！……ぁっ！」	PRINTFORML 「っ…っっ！……ぁっ！」
PRINTFORML 「ひぐっ…うっ…あっ！」	PRINTFORML 「ひぐっ…うっ…あっ！」
PRINTFORMW 「ああ、あぁぁぁぁ……」	PRINTFORMW 「ああ、あぁぁぁぁ……」
PRINTFORMW 「うあ…っくぅぅぅ……」	PRINTFORMW 「うあ…っくぅぅぅ……」
PRINTFORMW 「やめて…そん…な……」	PRINTFORMW 「やめて…そん…な……」
PRINTFORMW (もう…これ以上は……)	PRINTFORMW (もう…これ以上は……)
PRINTFORMW (お願い…外…外に……)	PRINTFORMW (お願い…外…外に……)
PRINTFORMW 「や…あ　んぁ…　あ…」	PRINTFORMW 「や…あ　んぁ…　あ…」
PRINTFORMW 「こ、これは…もしや…」	PRINTFORMW 「こ、これは…もしや…」
PRINTFORMW 「う…気持ち悪いです…」	PRINTFORMW 「う…気持ち悪いです…」
PRINTFORMW 「大きい代償でした……」	PRINTFORMW 「大きい代償でした……」
PRINTFORMW 「げほげほっ……むぅ…」	PRINTFORMW 「げほげほっ……むぅ…」
PRINTFORMDW 美鈴は壁に弄ばれている	PRINTFORMDW 美鈴は壁に弄ばれている
PRINTFORMW 「…まさか……ひゃ！？」	PRINTFORMW 「…まさか……ひゃ！？」
PRINTFORMW 「…！？ま、まさか…！」	PRINTFORMW 「…！？ま、まさか…！」
PRINTFORMW 「ふ、不束者ですが……」	PRINTFORMW 「ふ、不束者ですが……」
PRINTFORMW 「ふふっ…オイシソウ…」	PRINTFORMW 「ふふっ…オイシソウ…」
PRINTFORML 「ぬ、布が擦れて…んっ」	PRINTFORML 「ぬ、布が擦れて…んっ」
PRINTFORML 「えっと、今は大体……」	PRINTFORML 「えっと、今は大体……」
PRINTFORML 「紅魔館、大丈夫かなぁ」	PRINTFORML 「紅魔館、大丈夫かなぁ」
PRINTFORMW 「私は、今まで何を……」	PRINTFORMW 「私は、今まで何を……」
PRINTFORML 「―――――――ッッ！」	PRINTFORML 「―――――――ッッ！」
PRINTFORML 「と、取れ……た……？」	PRINTFORML 「と、取れ……た……？」
PRINTFORMW 「おかわり行きまーす」	PRINTFORMW 「おかわり行きまーす」
PRINTFORML 「コォォォォォォ……」	PRINTFORML 「コォォォォォォ……」
PRINTFORMDW …寝ていないか不安だ	PRINTFORMDW …寝ていないか不安だ
PRINTFORML 「当たれ！当たれぇ！」	PRINTFORML 「当たれ！当たれぇ！」
PRINTFORML 「でやぁぁぁぁぁぁ！」	PRINTFORML 「でやぁぁぁぁぁぁ！」
PRINTFORMW 「うぐぐっ！ぐぅっ！」	PRINTFORMW 「うぐぐっ！ぐぅっ！」
PRINTFORMW 「うー…っ！うぁッ！」	PRINTFORMW 「うー…っ！うぁッ！」
PRINTFORMW 「れろれろ～、ちゅっ」	PRINTFORMW 「れろれろ～、ちゅっ」
PRINTFORMW 「ほ～ら、ぐりぐりー」	PRINTFORMW 「ほ～ら、ぐりぐりー」
PRINTFORML 「吹っ飛びなさいっ！」	PRINTFORML 「吹っ飛びなさいっ！」
PRINTFORMW 「…んっ…んぁっ…！」	PRINTFORMW 「…んっ…んぁっ…！」
PRINTFORMW 「…ふっ…くぁっ…！」	PRINTFORMW 「…ふっ…くぁっ…！」
PRINTFORMW 「は、あっ！…ぁ……」	PRINTFORMW 「は、あっ！…ぁ……」
PRINTFORMW 「んくっ…ふぁっ…！」	PRINTFORMW 「んくっ…ふぁっ…！」
PRINTFORMW 「くっ…油断した！？」	PRINTFORMW 「くっ…油断した！？」
PRINTFORMW 「かかってきなさい！」	PRINTFORMW 「かかってきなさい！」
PRINTFORMW 「まぁ、冗談ですけど」	PRINTFORMW 「まぁ、冗談ですけど」
PRINTFORMW 「………………………」	PRINTFORMW 「………………………」
PRINTFORMW 「あの部屋には確か…」	PRINTFORMW 「あの部屋には確か…」
PRINTFORMW 「でーた？…ふむふむ」	PRINTFORMW 「でーた？…ふむふむ」
PRINTFORMDW 美鈴はため息をついた	PRINTFORMDW 美鈴はため息をついた
PRINTFORMW 「…………これって…」	PRINTFORMW 「…………これって…」
PRINTFORMW 「…ひゃ………ん……」	PRINTFORMW 「…ひゃ………ん……」
PRINTFORMW 「させません…よッ！」	PRINTFORMW 「させません…よッ！」
PRINTFORML 「ふぃ～、極楽極楽♪」	PRINTFORML 「ふぃ～、極楽極楽♪」
PRINTFORMW 「いっそ一思いに……」	PRINTFORMW 「いっそ一思いに……」
PRINTFORMW 「……っ！今のは！？」	PRINTFORMW 「……っ！今のは！？」
PRINTFORMW 「凄く美味しいです！」	PRINTFORMW 「凄く美味しいです！」
PRINTFORMW 「ああ～、極楽極楽♪」	PRINTFORMW 「ああ～、極楽極楽♪」
PRINTFORMW 「……ぅ……ぁっ……」	PRINTFORMW 「……ぅ……ぁっ……」
PRINTFORMW 「び、びっくりした…」	PRINTFORMW 「び、びっくりした…」
PRINTFORMW 「イタダキマース…！」	PRINTFORMW 「イタダキマース…！」
PRINTFORML 「う……げほっげほ！」	PRINTFORML 「う……げほっげほ！」
PRINTFORMW 「…ん………あ、れ？」	PRINTFORMW 「…ん………あ、れ？」
PRINTFORML 「んっ…んちゅっ……」	PRINTFORML 「んっ…んちゅっ……」
PRINTFORMW 「あっ、そういえば！」	PRINTFORMW 「あっ、そういえば！」
﻿PRINTFORML つくった人　やーこふ	PRINTFORML つくった人　やーこふ
PRINTFORMW 「戦略的撤退です！」	PRINTFORMW 「戦略的撤退です！」
PRINTFORML 「吹っ飛びなさい！」	PRINTFORML 「吹っ飛びなさい！」
PRINTFORML 「消えてください！」	PRINTFORML 「消えてください！」
PRINTFORML 「でやぁぁぁぁぁ！」	PRINTFORML 「でやぁぁぁぁぁ！」
PRINTFORMW 「大体このへんっ！」	PRINTFORMW 「大体このへんっ！」
PRINTFORMW 「んっ…っくあぁ…」	PRINTFORMW 「んっ…っくあぁ…」
PRINTFORMW 「くっ、このぉっ!」	PRINTFORMW 「くっ、このぉっ!」
PRINTFORMW 「…う…おえぇ……」	PRINTFORMW 「…う…おえぇ……」
PRINTFORMW 「ま、まだまだっ！」	PRINTFORMW 「ま、まだまだっ！」
PRINTFORMW 「ぐッ！…ぁっ！…」	PRINTFORMW 「ぐッ！…ぁっ！…」
PRINTFORMW 「あ…ぁあっ…！？」	PRINTFORMW 「あ…ぁあっ…！？」
PRINTFORMW 「くぅっ、んっ…！」	PRINTFORMW 「くぅっ、んっ…！」
PRINTFORMW 「くぅん！…っあ！」	PRINTFORMW 「くぅん！…っあ！」
PRINTFORMW 「この程度で…ッ！」	PRINTFORMW 「この程度で…ッ！」
PRINTFORMW 「ひっ…、うんっ…」	PRINTFORMW 「ひっ…、うんっ…」
PRINTFORMW 「うぅ…っくぅ……」	PRINTFORMW 「うぅ…っくぅ……」
PRINTFORMW 「ふふっ、幸せぇ…」	PRINTFORMW 「ふふっ、幸せぇ…」
PRINTFORMW 「んんっ…っはぁぁ…	PRINTFORMW 「んんっ…っはぁぁ…
PRINTFORMW 「…………ふふっ♪」	PRINTFORMW 「…………ふふっ♪」
PRINTFORMW 「う…くぁッ…！？」	PRINTFORMW 「う…くぁッ…！？」
PRINTFORMW 「あ……ぁ…………」	PRINTFORMW 「あ……ぁ…………」
PRINTFORMW 「ふぅ……よしっ！」	PRINTFORMW 「ふぅ……よしっ！」
PRINTFORMW 「な…あ……え…？」	PRINTFORMW 「な…あ……え…？」
PRINTFORMW 「…………私が……」	PRINTFORMW 「…………私が……」
PRINTFORMW 「応援してますよ！」	PRINTFORMW 「応援してますよ！」
PRINTFORMW 「これは…魔方陣？」	PRINTFORMW 「これは…魔方陣？」
PRINTFORMW 「……………………」	PRINTFORMW 「……………………」
PRINTFORMW 「アイテムゲット！」	PRINTFORMW 「アイテムゲット！」
PRINTFORMW 「う、ううぅ………」	PRINTFORMW 「う、ううぅ………」
PRINTFORMW 「誰かいますか～？」	PRINTFORMW 「誰かいますか～？」
PRINTFORMW 「おじゃましまーす」	PRINTFORMW 「おじゃましまーす」
PRINTFORMW 「…………っ…！…」	PRINTFORMW 「…………っ…！…」
PRINTFORMW 「っ！罠でしたか！」	PRINTFORMW 「っ！罠でしたか！」
PRINTFORML 「…………ぁぁぁぁ」	PRINTFORML 「…………ぁぁぁぁ」
PRINTFORMW 「ん…っは…ぁ……」	PRINTFORMW 「ん…っは…ぁ……」
PRINTFORMW 「…ん………はっ！」	PRINTFORMW 「…ん………はっ！」
PRINTFORMW 「小手調べです！」	PRINTFORMW 「小手調べです！」
PRINTFORMW 「…ッ！食らえ！」	PRINTFORMW 「…ッ！食らえ！」
PRINTFORML 「食らいなさい！」	PRINTFORML 「食らいなさい！」
PRINTFORML 「うくっ…うぅ…」	PRINTFORML 「うくっ…うぅ…」
PRINTFORMDW そうでもなかった	PRINTFORMDW そうでもなかった
PRINTFORMW 「ひぅん！…っく」	PRINTFORMW 「ひぅん！…っく」
PRINTFORMW 「くぁぁ～～……」	PRINTFORMW 「くぁぁ～～……」
PRINTFORMW 「…ぐ、ごほっ…」	PRINTFORMW 「…ぐ、ごほっ…」
PRINTFORMW 「ん゛っ………！」	PRINTFORMW 「ん゛っ………！」
PRINTFORMW 「ぐ…い゛っ！？」	PRINTFORMW 「ぐ…い゛っ！？」
PRINTFORMW 「…う…ぇ………」	PRINTFORMW 「…う…ぇ………」
PRINTFORMW 「ひッ…んッ…！」	PRINTFORMW 「ひッ…んッ…！」
PRINTFORMW 「むにゃむにゃ…」	PRINTFORMW 「むにゃむにゃ…」
PRINTFORMW 「ひゃうんっ！？」	PRINTFORMW 「ひゃうんっ！？」
PRINTFORMW 「敵機撃墜です！」	PRINTFORMW 「敵機撃墜です！」
PRINTFORMW 「むぐ…んむ……」	PRINTFORMW 「むぐ…んむ……」
PRINTFORMW 「やれやれですね」	PRINTFORMW 「やれやれですね」
PRINTFORMW 「さ、咲夜さん…」	PRINTFORMW 「さ、咲夜さん…」
PRINTFORMW 「中々の腕でした」	PRINTFORMW 「中々の腕でした」
PRINTFORMW 「やりましたね！」	PRINTFORMW 「やりましたね！」
PRINTFORMW 「先手必勝です！」	PRINTFORMW 「先手必勝です！」
PRINTFORMW …春が来たんですか	PRINTFORMW …春が来たんですか
PRINTFORMW 「別行動ですか？」	PRINTFORMW 「別行動ですか？」
PRINTFORMW 「あっ……ぅ……」	PRINTFORMW 「あっ……ぅ……」
PRINTFORMW 「うぐぅっ……！」	PRINTFORMW 「うぐぅっ……！」
PRINTFORMW 「ふあぁ～～っ…」	PRINTFORMW 「ふあぁ～～っ…」
PRINTFORMW 「美鈴一番乗り！」	PRINTFORMW 「美鈴一番乗り！」
PRINTFORMW 「っ！…ううぅ…」	PRINTFORMW 「っ！…ううぅ…」
PRINTFORMW 「大丈夫ですよ…」	PRINTFORMW 「大丈夫ですよ…」
PRINTFORMW (もう…だめ……)	PRINTFORMW (もう…だめ……)
PRINTFORMW 「………ん……？」	PRINTFORMW 「………ん……？」
PRINTFORMW 「体が…熱い…ッ」	PRINTFORMW 「体が…熱い…ッ」
PRINTFORMW 「よみよみですっ」	PRINTFORMW 「よみよみですっ」
PRINTFORML 「…………………」	PRINTFORML 「…………………」
PRINTFORMW 「では、これで…」	PRINTFORMW 「では、これで…」
PRINTFORMW 「………ふ………」	PRINTFORMW 「………ふ………」
PRINTFORMDW 　じ　ゅ　る　り	PRINTFORMDW 　じ　ゅ　る　り
PRINTFORMW 「はぁ…はぁ…」	PRINTFORMW 「はぁ…はぁ…」
PRINTFORMW 「受けなさい！」	PRINTFORMW 「受けなさい！」
PRINTFORMW 「でやぁぁぁ！」	PRINTFORMW 「でやぁぁぁ！」
PRINTFORMW (あぁ…もう…)	PRINTFORMW (あぁ…もう…)
PRINTFORMW 「んっ…………」	PRINTFORMW 「んっ…………」
PRINTFORML 「この調子で！」	PRINTFORML 「この調子で！」
PRINTFORMW 「んふふふ……」	PRINTFORMW 「んふふふ……」
PRINTFORMW 「ぎ…う…ぁ！」	PRINTFORMW 「ぎ…う…ぁ！」
PRINTFORMW 「ひゃっ…！？」	PRINTFORMW 「ひゃっ…！？」
PRINTFORMW 「……ぇ………」	PRINTFORMW 「……ぇ………」
PRINTFORMW 「ひゃ――！？」	PRINTFORMW 「ひゃ――！？」
PRINTFORMW 「……ぁ………」	PRINTFORMW 「……ぁ………」
PRINTFORMW 「勝てば官軍！」	PRINTFORMW 「勝てば官軍！」
PRINTFORMW 「がぁっ…っ！」	PRINTFORMW 「がぁっ…っ！」
PRINTFORMW 「…………ぅ…」	PRINTFORMW 「…………ぅ…」
PRINTFORMDW を浮かべている	PRINTFORMDW を浮かべている
PRINTFORMW 「ああうっ…！」	PRINTFORMW 「ああうっ…！」
PRINTFORMW 「うへへへー♪」	PRINTFORMW 「うへへへー♪」
PRINTFORMW 「むにゃ………」	PRINTFORMW 「むにゃ………」
PRINTFORMW 「こんにちは！」	PRINTFORMW 「こんにちは！」
PRINTFORMW 「こちらこそ！」	PRINTFORMW 「こちらこそ！」
PRINTFORMW 「こ、これは！」	PRINTFORMW 「こ、これは！」
PRINTFORMW (………………)	PRINTFORMW (………………)
PRINTFORMW 「…あ、ぁははっ	PRINTFORMW 「…あ、ぁははっ
PRINTFORMW 「あ、お嬢様！」	PRINTFORMW 「あ、お嬢様！」
PRINTFORMW 「………………」	PRINTFORMW 「………………」
PRINTFORMW 「危ない！っと」	PRINTFORMW 「危ない！っと」
PRINTFORMW 「…ふ…………」	PRINTFORMW 「…ふ…………」
PRINTFORML 「それじゃぁ…」	PRINTFORML 「それじゃぁ…」
PRINTFORMW 「あ……あはっ」	PRINTFORMW 「あ……あはっ」
PRINTFORMW 「ていやっ！」	PRINTFORMW 「ていやっ！」
PRINTFORML 「チェスト！」	PRINTFORML 「チェスト！」
PRINTFORML 「吹きとべ！」	PRINTFORML 「吹きとべ！」
PRINTFORMW 「はいやー！」	PRINTFORMW 「はいやー！」
PRINTFORML 「どりゃあ！」	PRINTFORML 「どりゃあ！」
PRINTFORML 「このぉっ！」	PRINTFORML 「このぉっ！」
PRINTFORML 「どうです！」	PRINTFORML 「どうです！」
PRINTFORMW 「んぐぅっ！」	PRINTFORMW 「んぐぅっ！」
PRINTFORMW 「がは…ッ…」	PRINTFORMW 「がは…ッ…」
PRINTFORMW 「ぐぁッ！！」	PRINTFORMW 「ぐぁッ！！」
PRINTFORMW 「…ッ………」	PRINTFORMW 「…ッ………」
PRINTFORMW 「んんっ…♪」	PRINTFORMW 「んんっ…♪」
PRINTFORMW 「ん゛っ！？」	PRINTFORMW 「ん゛っ！？」
PRINTFORMW 「おやどうも」	PRINTFORMW 「おやどうも」
PRINTFORMW 「あぁぁぁ…」	PRINTFORMW 「あぁぁぁ…」
PRINTFORMW 「ぅ…ぅ……」	PRINTFORMW 「ぅ…ぅ……」
PRINTFORMW 「…えっ！？」	PRINTFORMW 「…えっ！？」
PRINTFORMW 「へぇっ？！」	PRINTFORMW 「へぇっ？！」
PRINTFORML 「ううぅ……」	PRINTFORML 「ううぅ……」
PRINTFORMW 「当たれ！」	PRINTFORMW 「当たれ！」
PRINTFORML 「でやぁ！」	PRINTFORML 「でやぁ！」
PRINTFORMW 「だぁっ！」	PRINTFORMW 「だぁっ！」
PRINTFORML 「甘いっ！」	PRINTFORML 「甘いっ！」
PRINTFORML 「そこっ！」	PRINTFORML 「そこっ！」
PRINTFORML 「食らえ！」	PRINTFORML 「食らえ！」
PRINTFORML 「んぅ……」	PRINTFORML 「んぅ……」
PRINTFORML 「ズェア！」	PRINTFORML 「ズェア！」
PRINTFORMW 「がっ……」	PRINTFORMW 「がっ……」
PRINTFORMW 「くッ！！」	PRINTFORMW 「くッ！！」
PRINTFORMW 「ぐぅッ！」	PRINTFORMW 「ぐぅッ！」
PRINTFORMW 「っ………」	PRINTFORMW 「っ………」
PRINTFORMW 「んんっ…」	PRINTFORMW 「んんっ…」
PRINTFORMW 「んっ……」	PRINTFORMW 「んっ……」
PRINTFORMW 「うぅ……」	PRINTFORMW 「うぅ……」
PRINTFORMDW 美鈴は瞳に	PRINTFORMDW 美鈴は瞳に
PRINTFORMW 「いけずぅ…	PRINTFORMW 「いけずぅ…
PRINTFORMW 「お嬢様…」	PRINTFORMW 「お嬢様…」
PRINTFORMW 「すかぴー」	PRINTFORMW 「すかぴー」
PRINTFORMW ﾒｲﾘｰﾝ!	PRINTFORMW ﾒｲﾘｰﾝ!
PRINTFORMW 「ッ……！」	PRINTFORMW 「ッ……！」
PRINTFORMW 「これは…」	PRINTFORMW 「これは…」
PRINTFORMW 「……！！」	PRINTFORMW 「……！！」
PRINTFORMW 「いっ！？」	PRINTFORMW 「いっ！？」
PRINTFORML 「はっ！」	PRINTFORML 「はっ！」
PRINTFORML 「ふん！」	PRINTFORML 「ふん！」
PRINTFORML 「むん！」	PRINTFORML 「むん！」
PRINTFORML 「うぅ…」	PRINTFORML 「うぅ…」
PRINTFORML 「ふっ！」	PRINTFORML 「ふっ！」
PRINTFORMW 「っ……」	PRINTFORMW 「っ……」
PRINTFORMW 「ふぅ…」	PRINTFORMW 「ふぅ…」
PRINTFORMW 「ん～…」	PRINTFORMW 「ん～…」
PRINTFORMW 春ですかー	PRINTFORMW 春ですかー
PRINTFORMW 「………」	PRINTFORMW 「………」
PRINTFORMW 「えっ？」	PRINTFORMW 「えっ？」
PRINTFORMDW 惜しい！	PRINTFORMDW 惜しい！
PRINTFORMW 「ッ！」	PRINTFORMW 「ッ！」
PRINTFORMW 「ほっ」	PRINTFORMW 「ほっ」
PRINTFORMDW 」	PRINTFORMDW 」
PRINTFORMW 判決	PRINTFORMW 判決
