//口上:

PRINTFORMDL [0] ちょっ…やっやめなさ……～～～～～ッッ%UNICODE(0x2665)%%UNICODE(0x2665)%%UNICODE(0x2665)%%UNICODE(0x2665)%	PRINTFORMDL [0] ちょっ…やっやめなさ……～～～～～ッッ%UNICODE(0x2665)%%UNICODE(0x2665)%%UNICODE(0x2665)%%UNICODE(0x2665)%
PRINTFORMW 「という事は…私が%CALLNAME_7_0(GET_ID_FROM_NO(CFLAG:114))%の身体で、そこの私は%CALLNAME_7_0(LOCAL:0)%で…」	PRINTFORMW 「という事は…私が%CALLNAME_7_0(GET_ID_FROM_NO(CFLAG:114))%の身体で、そこの私は%CALLNAME_7_0(LOCAL:0)%で…」
PRINTFORMDW 断続的に続く%CALLNAME:(TARGET)%の射精に合わせ、全て飲み干すかの様に%SAVESTR:(CFLAG:902)%は膣内を脈動させていた…	PRINTFORMDW 断続的に続く%CALLNAME:(TARGET)%の射精に合わせ、全て飲み干すかの様に%SAVESTR:(CFLAG:902)%は膣内を脈動させていた…
PRINTFORMDW トドメとばかりに激しく腰を突き落とした%SAVESTR:(CFLAG:902)%の最奥で、%CALLNAME:(TARGET)%の熱い滾りが迸る…！	PRINTFORMDW トドメとばかりに激しく腰を突き落とした%SAVESTR:(CFLAG:902)%の最奥で、%CALLNAME:(TARGET)%の熱い滾りが迸る…！
PRINTFORMDW %CALLNAME:(ARG:3)%は、仰向けになり天を向いた%CALLNAME:(TARGET)%の剛直をその胸で抑えつつ身体を揺すらせている…	PRINTFORMDW %CALLNAME:(ARG:3)%は、仰向けになり天を向いた%CALLNAME:(TARGET)%の剛直をその胸で抑えつつ身体を揺すらせている…
PRINTFORMDW 目の前でゆっくりと尻を振る%CALLNAME:(ARG:3)%の姿に、%CALLNAME:(TARGET)%はよりいっそうその剛直を固くさせた…	PRINTFORMDW 目の前でゆっくりと尻を振る%CALLNAME:(ARG:3)%の姿に、%CALLNAME:(TARGET)%はよりいっそうその剛直を固くさせた…
PRINTFORMDW %CALLNAME:(TARGET)%の限界を察した%SAVESTR:(CFLAG:902)%は射精に備え子宮口をピタリと鈴口に吸い付けた…	PRINTFORMDW %CALLNAME:(TARGET)%の限界を察した%SAVESTR:(CFLAG:902)%は射精に備え子宮口をピタリと鈴口に吸い付けた…
PRINTFORMDW %SAVESTR:(CFLAG:902)%の淫肉が、一滴残らず搾り取ろうと%CALLNAME:(TARGET)%のペニスに絡みついている…	PRINTFORMDW %SAVESTR:(CFLAG:902)%の淫肉が、一滴残らず搾り取ろうと%CALLNAME:(TARGET)%のペニスに絡みついている…
PRINTFORM 「いつもの身体と違った感覚…たっぷり愉しませて頂きますよ、%CALLNAME_7_0(GET_ID_FROM_NO(CFLAG:114))%	PRINTFORM 「いつもの身体と違った感覚…たっぷり愉しませて頂きますよ、%CALLNAME_7_0(GET_ID_FROM_NO(CFLAG:114))%
PRINTFORMDW %CALLNAME:(TARGET)%は%CALLNAME:(ARG:3)%の腰をぐっと掴み、最奥へ欲望を放とうと自らの腰を密着させた…	PRINTFORMDW %CALLNAME:(TARGET)%は%CALLNAME:(ARG:3)%の腰をぐっと掴み、最奥へ欲望を放とうと自らの腰を密着させた…
PRINTFORMDW %CALLNAME:(TARGET)%の助言を受けながら、%CALLNAME:(ARG:3)%は奉仕しているペニスを絶頂へと導いていく…	PRINTFORMDW %CALLNAME:(TARGET)%の助言を受けながら、%CALLNAME:(ARG:3)%は奉仕しているペニスを絶頂へと導いていく…
PRINTFORMDW %CALLNAME:(ARG:1)%は%CALLNAME:(ARG:0)%を抱きしめると、脚を絡めて自らヴァギナにペニスを器用に導いた…	PRINTFORMDW %CALLNAME:(ARG:1)%は%CALLNAME:(ARG:0)%を抱きしめると、脚を絡めて自らヴァギナにペニスを器用に導いた…
PRINTFORMDW 触手も絡んでいるが%CALLNAME:(ARG:1)%の両手両脚も%CALLNAME:(ARG:0)%の身体に、がっしりと絡められている	PRINTFORMDW 触手も絡んでいるが%CALLNAME:(ARG:1)%の両手両脚も%CALLNAME:(ARG:0)%の身体に、がっしりと絡められている
PRINTFORMDW %CALLNAME:(ARG:3)%を四つんばいにさせた%CALLNAME:(TARGET)%は、ゆっくりと慣らす様に抽挿させている…	PRINTFORMDW %CALLNAME:(ARG:3)%を四つんばいにさせた%CALLNAME:(TARGET)%は、ゆっくりと慣らす様に抽挿させている…
PRINTFORMW 「なるほど…（ふにふに）…これが%CALLNAME_7_0(GET_ID_FROM_NO(CFLAG:114))%の身体…（ごくり）」	PRINTFORMW 「なるほど…（ふにふに）…これが%CALLNAME_7_0(GET_ID_FROM_NO(CFLAG:114))%の身体…（ごくり）」
PRINTFORMDW %CALLNAME:(ARG:0)%が目を覚ますと、そこには今にも襲い掛かろうとしている%CALLNAME:(ARG:1)%が居た！	PRINTFORMDW %CALLNAME:(ARG:0)%が目を覚ますと、そこには今にも襲い掛かろうとしている%CALLNAME:(ARG:1)%が居た！
PRINTFORMDW %CALLNAME:(TARGET)%はクスクスと妖しい笑みを浮かべながら%CALLNAME:(ARG:2)%へと、にじり寄った…	PRINTFORMDW %CALLNAME:(TARGET)%はクスクスと妖しい笑みを浮かべながら%CALLNAME:(ARG:2)%へと、にじり寄った…
PRINTFORMW 「一見、%CALLNAME_7_0(GET_ID_FROM_NO(NO:(ARG:1)))%に見えますが…あ、きっと娘さんですよね」	PRINTFORMW 「一見、%CALLNAME_7_0(GET_ID_FROM_NO(NO:(ARG:1)))%に見えますが…あ、きっと娘さんですよね」
PRINTFORMDW %CALLNAME:(ARG:3)%の身体を抱き寄せた%CALLNAME:(TARGET)%は、腰をくねらせ快楽を送り込んでいる…	PRINTFORMDW %CALLNAME:(ARG:3)%の身体を抱き寄せた%CALLNAME:(TARGET)%は、腰をくねらせ快楽を送り込んでいる…
PRINTFORMDW %CALLNAME:(ARG:3)%の乳房の間に男根を挟み込み、%CALLNAME:(TARGET)%は腰を激しく前後させている…	PRINTFORMDW %CALLNAME:(ARG:3)%の乳房の間に男根を挟み込み、%CALLNAME:(TARGET)%は腰を激しく前後させている…
PRINTFORMDW %CALLNAME:(ARG:1)%は心底残念そうにしながら、%CALLNAME:(ARG:0)%に深くお辞儀をして去っていった…	PRINTFORMDW %CALLNAME:(ARG:1)%は心底残念そうにしながら、%CALLNAME:(ARG:0)%に深くお辞儀をして去っていった…
PRINTFORMDW %CALLNAME:(TARGET)%が喋る間もなく、使い魔はその触手を%CALLNAME:(TARGET)%の双丘へと絡ませる！	PRINTFORMDW %CALLNAME:(TARGET)%が喋る間もなく、使い魔はその触手を%CALLNAME:(TARGET)%の双丘へと絡ませる！
PRINTFORMW 「という事は…%CALLNAME_7_0(GET_ID_FROM_NO(CFLAG:114))%と私、入れ替わっちゃってます！？」	PRINTFORMW 「という事は…%CALLNAME_7_0(GET_ID_FROM_NO(CFLAG:114))%と私、入れ替わっちゃってます！？」
PRINTFORMDW 上に乗せた%CALLNAME:(ARG:3)%の動きに合わせ、%CALLNAME:(TARGET)%は巧みに腰を突き上げている…	PRINTFORMDW 上に乗せた%CALLNAME:(ARG:3)%の動きに合わせ、%CALLNAME:(TARGET)%は巧みに腰を突き上げている…
PRINTFORMDW %CALLNAME:(TARGET)%による的確な刺激によって、早くも%CALLNAME:(ARG:2)%のマグマは噴火寸前だ…	PRINTFORMDW %CALLNAME:(TARGET)%による的確な刺激によって、早くも%CALLNAME:(ARG:2)%のマグマは噴火寸前だ…
PRINTFORMDW 射精の快感に腰砕けになっている%CALLNAME:(ARG:0)%の身体を%CALLNAME:(ARG:1)%は優しく抱きしめた	PRINTFORMDW 射精の快感に腰砕けになっている%CALLNAME:(ARG:0)%の身体を%CALLNAME:(ARG:1)%は優しく抱きしめた
PRINTFORMDW キラキラと糸を引かせながらゆっくりと口を離した%CALLNAME:(TARGET)%は、ご馳走様と言わんばかりに舌で唇を舐めた	PRINTFORMDW キラキラと糸を引かせながらゆっくりと口を離した%CALLNAME:(TARGET)%は、ご馳走様と言わんばかりに舌で唇を舐めた
PRINTFORMDL 張り詰め膨らみあがった%CALLNAME:(TARGET)%のペニスを、%ARGS:1%は吐息と共に自身の中に飲み込んでいく…	PRINTFORMDL 張り詰め膨らみあがった%CALLNAME:(TARGET)%のペニスを、%ARGS:1%は吐息と共に自身の中に飲み込んでいく…
PRINTFORMDW %CALLNAME:(ARG:1)%は心底残念そうにしながら、%CALLNAME:(ARG:0)%にお辞儀をして去っていった…	PRINTFORMDW %CALLNAME:(ARG:1)%は心底残念そうにしながら、%CALLNAME:(ARG:0)%にお辞儀をして去っていった…
PRINTFORMDL %CALLNAME:(ARG:0)%の身体を優しく抱きしめた%CALLNAME:(ARG:1)%は、膣内を蠢かせ射精を促した…	PRINTFORMDL %CALLNAME:(ARG:0)%の身体を優しく抱きしめた%CALLNAME:(ARG:1)%は、膣内を蠢かせ射精を促した…
PRINTFORMW 「%SAVESTR:(TFLAG:53)%さん…%CALLNAME_7_0(LOCAL:0)%は私の……ずるいですっっ！！！」	PRINTFORMW 「%SAVESTR:(TFLAG:53)%さん…%CALLNAME_7_0(LOCAL:0)%は私の……ずるいですっっ！！！」
PRINTFORMDW そう言って微笑むと、%CALLNAME:(TARGET)%は綺麗にし終えた%CALLNAME:(1)%のペニスにキスをした…	PRINTFORMDW そう言って微笑むと、%CALLNAME:(TARGET)%は綺麗にし終えた%CALLNAME:(1)%のペニスにキスをした…
PRINTFORMDW %CALLNAME:(ARG:3)%は、その大きな胸で%CALLNAME:(TARGET)%のペニスを包み込み、擦りあげた…	PRINTFORMDW %CALLNAME:(ARG:3)%は、その大きな胸で%CALLNAME:(TARGET)%のペニスを包み込み、擦りあげた…
PRINTFORMDL 目の前に差し出された、%CALLNAME:(ARG:1)%の精液と%CALLNAME:(ARG:0)%の愛液に塗れたペニスに	PRINTFORMDL 目の前に差し出された、%CALLNAME:(ARG:1)%の精液と%CALLNAME:(ARG:0)%の愛液に塗れたペニスに
PRINTFORMDW %CALLNAME:(TARGET)%は%CALLNAME:(ARG:2)%に口づけをすると、情熱的に見つめながら囁いた…	PRINTFORMDW %CALLNAME:(TARGET)%は%CALLNAME:(ARG:2)%に口づけをすると、情熱的に見つめながら囁いた…
PRINTFORMW （%SAVESTR:(TFLAG:53)%のあの激しい攻め…%CALLNAME_7_0(LOCAL:0)%も役得ですよね…）	PRINTFORMW （%SAVESTR:(TFLAG:53)%のあの激しい攻め…%CALLNAME_7_0(LOCAL:0)%も役得ですよね…）
PRINTFORMDW 両手を交差させ魔力を溜めていた%CALLNAME:(TARGET)%が、大きく手を開くと同時に凄まじい熱光線を放つッッ！！	PRINTFORMDW 両手を交差させ魔力を溜めていた%CALLNAME:(TARGET)%が、大きく手を開くと同時に凄まじい熱光線を放つッッ！！
PRINTFORMDW %CALLNAME:(ARG:1)%は脚を強く絡めて%CALLNAME:(ARG:0)%を抱きしめ、その瞬間を待ち構えた…	PRINTFORMDW %CALLNAME:(ARG:1)%は脚を強く絡めて%CALLNAME:(ARG:0)%を抱きしめ、その瞬間を待ち構えた…
PRINTFORMDW %CALLNAME:(ARG:3)%が激しく腰を落とすたび、%CALLNAME:(TARGET)%は大きな嬌声を上げる…	PRINTFORMDW %CALLNAME:(ARG:3)%が激しく腰を落とすたび、%CALLNAME:(TARGET)%は大きな嬌声を上げる…
PRINTFORMDW 頬を真っ赤に染めたパチュリーは無言で%CALLNAME:(TARGET)%から大人の玩具をひったくって、道具袋に収めた。	PRINTFORMDW 頬を真っ赤に染めたパチュリーは無言で%CALLNAME:(TARGET)%から大人の玩具をひったくって、道具袋に収めた。
PRINTFORMDW %CALLNAME:(ARG:2)%の上に跨った%CALLNAME:(TARGET)%は、艶かしく上下に腰を揺らした…	PRINTFORMDW %CALLNAME:(ARG:2)%の上に跨った%CALLNAME:(TARGET)%は、艶かしく上下に腰を揺らした…
PRINTFORMDW %CALLNAME:(TARGET)%は%CALLNAME:(ARG:2)%の上に跨り…ずぶずぶとアヌスで飲み込んだ…	PRINTFORMDW %CALLNAME:(TARGET)%は%CALLNAME:(ARG:2)%の上に跨り…ずぶずぶとアヌスで飲み込んだ…
PRINTFORMDW 上半身をスライムに包まれた%CALLNAME:(TARGET)%は声も出せないまま、尻を高く上げた状態でもがいている…	PRINTFORMDW 上半身をスライムに包まれた%CALLNAME:(TARGET)%は声も出せないまま、尻を高く上げた状態でもがいている…
PRINTFORMDW 部屋に蠢く触手達は%CALLNAME:(TARGET)%の下着の隙間から次々と入り込み、中の敏感な突起に群がっている…	PRINTFORMDW 部屋に蠢く触手達は%CALLNAME:(TARGET)%の下着の隙間から次々と入り込み、中の敏感な突起に群がっている…
PRINTFORM 「ずちゅずちゅ抜き挿しするたびに…%CALLNAME_7_0(ARG:2)%の膣内…ヒダヒダが纏わりついてきて…ああんっ	PRINTFORM 「ずちゅずちゅ抜き挿しするたびに…%CALLNAME_7_0(ARG:2)%の膣内…ヒダヒダが纏わりついてきて…ああんっ
PRINTFORMDW 妖艶な笑みを浮かべた%CALLNAME:(TARGET)%…その秘所は獲物を見つけた獣の様に口から涎を滴らせている…	PRINTFORMDW 妖艶な笑みを浮かべた%CALLNAME:(TARGET)%…その秘所は獲物を見つけた獣の様に口から涎を滴らせている…
PRINTFORMDW %CALLNAME:(TARGET)%は、今まさにヴァギナを犯さんとしている剛直に、ねっとりとした視線を送っている…	PRINTFORMDW %CALLNAME:(TARGET)%は、今まさにヴァギナを犯さんとしている剛直に、ねっとりとした視線を送っている…
PRINTFORMDL %SAVESTR:(LOCAL:0)%は%CALLNAME:(TARGET)%を拘束したまま、両脚を大きく開脚させた	PRINTFORMDL %SAVESTR:(LOCAL:0)%は%CALLNAME:(TARGET)%を拘束したまま、両脚を大きく開脚させた
PRINTFORMDW %CALLNAME:(TARGET)%は物欲しそうに熱い眼差しで%CALLNAME:(ARG:2)%を見つめている…	PRINTFORMDW %CALLNAME:(TARGET)%は物欲しそうに熱い眼差しで%CALLNAME:(ARG:2)%を見つめている…
PRINTFORMDW 部屋に蠢く触手達は%CALLNAME:(TARGET)%の尻穴の疼きを察知したのか、その身をうねらせながら殺到した…	PRINTFORMDW 部屋に蠢く触手達は%CALLNAME:(TARGET)%の尻穴の疼きを察知したのか、その身をうねらせながら殺到した…
PRINTFORMDW 子宮を求める気配を敏感に察知した%CALLNAME:(TARGET)%は、獲物を誘い込む様に両脚を扇情的に開いた…	PRINTFORMDW 子宮を求める気配を敏感に察知した%CALLNAME:(TARGET)%は、獲物を誘い込む様に両脚を扇情的に開いた…
PRINTFORMDW %CALLNAME:(TARGET)%は%CALLNAME:(ARG:3)%が何かいつもと違う事に気が付いた様だ…	PRINTFORMDW %CALLNAME:(TARGET)%は%CALLNAME:(ARG:3)%が何かいつもと違う事に気が付いた様だ…
PRINTFORMDW %CALLNAME:(TARGET)%は%CALLNAME:(ARG:3)%の胸板に、自らの欲望を擦りつけている…	PRINTFORMDW %CALLNAME:(TARGET)%は%CALLNAME:(ARG:3)%の胸板に、自らの欲望を擦りつけている…
PRINTFORMDW お腹の中の子について気遣われた%CALLNAME:(TARGET)%は、心配をかけぬよう、笑顔を作って言葉を返した	PRINTFORMDW お腹の中の子について気遣われた%CALLNAME:(TARGET)%は、心配をかけぬよう、笑顔を作って言葉を返した
PRINTFORMDW お腹の中の子について気遣われた%CALLNAME:(TARGET)%は、精を受けた時の快感を思い返し目を細めた…	PRINTFORMDW お腹の中の子について気遣われた%CALLNAME:(TARGET)%は、精を受けた時の快感を思い返し目を細めた…
PRINTFORMDW %CALLNAME:(TARGET)%は%CALLNAME:(ARG:2)%の腰にゆっくりと手を回し引き寄せる…	PRINTFORMDW %CALLNAME:(TARGET)%は%CALLNAME:(ARG:2)%の腰にゆっくりと手を回し引き寄せる…
PRINTFORMDW %CALLNAME:(TARGET)%に流れる淫魔の血が騒ぐ…たとえ魔物といえども狩りの対象に変わりはなかった…	PRINTFORMDW %CALLNAME:(TARGET)%に流れる淫魔の血が騒ぐ…たとえ魔物といえども狩りの対象に変わりはなかった…
PRINTFORMDW 目の前に無防備に曝け出された尻を見て、%CALLNAME:(TARGET)%は湧き上がる痴情を抑え切れなかった…	PRINTFORMDW 目の前に無防備に曝け出された尻を見て、%CALLNAME:(TARGET)%は湧き上がる痴情を抑え切れなかった…
PRINTFORMW 「%CALLNAME_7_0(ARG:3)%…顔にかけるのがいいですか？　それともこのまま…お胸に擦りこみます？」	PRINTFORMW 「%CALLNAME_7_0(ARG:3)%…顔にかけるのがいいですか？　それともこのまま…お胸に擦りこみます？」
PRINTFORMW 「……すみません、%CALLNAME_7_0(ARG:0)%が寝ている間に済ましてしまおうと思っていたのですが…」	PRINTFORMW 「……すみません、%CALLNAME_7_0(ARG:0)%が寝ている間に済ましてしまおうと思っていたのですが…」
PRINTFORMDW いまだ%CALLNAME:(ARG:1)%の膣内では緩やかな射精が断続的に続いている…全てを搾り尽くすかの様に…	PRINTFORMDW いまだ%CALLNAME:(ARG:1)%の膣内では緩やかな射精が断続的に続いている…全てを搾り尽くすかの様に…
PRINTFORMDW %CALLNAME:(TARGET)%は腰を激しくくねらせ、%CALLNAME:(ARG:2)%を攻め立てる…	PRINTFORMDW %CALLNAME:(TARGET)%は腰を激しくくねらせ、%CALLNAME:(ARG:2)%を攻め立てる…
PRINTFORMDW %CALLNAME:(TARGET)%は性器に舌を這わせ、次から次へと溢れ出る粘着性の分泌液を舐め取っている…	PRINTFORMDW %CALLNAME:(TARGET)%は性器に舌を這わせ、次から次へと溢れ出る粘着性の分泌液を舐め取っている…
PRINTFORMDW たくましい生命力に満ちた精の匂い…%CALLNAME:(TARGET)%はサキュバスの本性を抑えきれずにいた…	PRINTFORMDW たくましい生命力に満ちた精の匂い…%CALLNAME:(TARGET)%はサキュバスの本性を抑えきれずにいた…
PRINTFORMDW 荒々しく喉奥に吐き出された白濁液を、なんなく飲み干した%CALLNAME:(TARGET)%は、妖しく微笑んだ	PRINTFORMDW 荒々しく喉奥に吐き出された白濁液を、なんなく飲み干した%CALLNAME:(TARGET)%は、妖しく微笑んだ
PRINTFORMDW {CFLAG:110} {CFLAG:(FLAG:10):114} {CFLAG:(FLAG:11):114}	PRINTFORMDW {CFLAG:110} {CFLAG:(FLAG:10):114} {CFLAG:(FLAG:11):114}
PRINTFORMDW そう言って%CALLNAME:(TARGET)%は口を大きく開き、限界まで膨張したペニスを根元まで咥え込んだ…	PRINTFORMDW そう言って%CALLNAME:(TARGET)%は口を大きく開き、限界まで膨張したペニスを根元まで咥え込んだ…
PRINTFORMDW %CALLNAME:(ARG:1)%は優しく%CALLNAME:(ARG:0)%を抱きしめながら耳元で囁いた…	PRINTFORMDW %CALLNAME:(ARG:1)%は優しく%CALLNAME:(ARG:0)%を抱きしめながら耳元で囁いた…
PRINTFORMDL ハートマークを撒き散らして駆け寄る%CALLNAME:(TARGET)%からパチュリーは即座に距離を取った。	PRINTFORMDL ハートマークを撒き散らして駆け寄る%CALLNAME:(TARGET)%からパチュリーは即座に距離を取った。
PRINTFORMDW 腰をくねらせながら近づいてくる%CALLNAME:(TARGET)%を避けるようにパチュリーが後ずさった瞬間	PRINTFORMDW 腰をくねらせながら近づいてくる%CALLNAME:(TARGET)%を避けるようにパチュリーが後ずさった瞬間
PRINTFORM （これが%SAVESTR:(TFLAG:53)%……%CALLNAME_7_0(LOCAL:0)%の次は…私が…	PRINTFORM （これが%SAVESTR:(TFLAG:53)%……%CALLNAME_7_0(LOCAL:0)%の次は…私が…
PRINTFORMDW %CALLNAME:(TARGET)%は口の周りを粘液だらけにしながら触手とのディープキスを繰り返している…	PRINTFORMDW %CALLNAME:(TARGET)%は口の周りを粘液だらけにしながら触手とのディープキスを繰り返している…
PRINTFORMDW %CALLNAME:(TARGET)%は天に向けてそそり勃つ剛直を見せ付けながら、妖しい笑みを浮かべている…	PRINTFORMDW %CALLNAME:(TARGET)%は天に向けてそそり勃つ剛直を見せ付けながら、妖しい笑みを浮かべている…
PRINTFORM 「分かりました、%CALLNAME_7_0(ARG:3)%のエッチな腰つきを存分に披露して下さい…期待してますよ	PRINTFORM 「分かりました、%CALLNAME_7_0(ARG:3)%のエッチな腰つきを存分に披露して下さい…期待してますよ
PRINTFORMDW %CALLNAME:(TARGET)%はそう呟くと、そっと%CALLNAME:(ARG:3)%を引き寄せた…	PRINTFORMDW %CALLNAME:(TARGET)%はそう呟くと、そっと%CALLNAME:(ARG:3)%を引き寄せた…
PRINTFORM 「……もう…ひどいです…%CALLNAME_7_0(ARG:0)%。　お願いですから次は膣内で射精して下さいよぉ	PRINTFORM 「……もう…ひどいです…%CALLNAME_7_0(ARG:0)%。　お願いですから次は膣内で射精して下さいよぉ
PRINTFORMDW 顔に身体にぶちまけられた精液を指で拭い舐め取りながら、%CALLNAME:(ARG:1)%は妖艶に微笑んだ…	PRINTFORMDW 顔に身体にぶちまけられた精液を指で拭い舐め取りながら、%CALLNAME:(ARG:1)%は妖艶に微笑んだ…
PRINTFORMDW %CALLNAME:(TARGET)%の肉壷には無数の触手達が群がり、次から次へと快楽の波を送り込んでいる…	PRINTFORMDW %CALLNAME:(TARGET)%の肉壷には無数の触手達が群がり、次から次へと快楽の波を送り込んでいる…
PRINTFORMW 「徐々に%CALLNAME_7_0(LOCAL:0)%の魔力が弱まって行くのが判る……早く……しないと……」	PRINTFORMW 「徐々に%CALLNAME_7_0(LOCAL:0)%の魔力が弱まって行くのが判る……早く……しないと……」
PRINTFORMW 「あれ…%CALLNAME_7_0(RESULT)%？　%CALLNAME_7_0(RESULT)%！！！」	PRINTFORMW 「あれ…%CALLNAME_7_0(RESULT)%？　%CALLNAME_7_0(RESULT)%！！！」
PRINTFORM 「私のせーえき…%CALLNAME_7_0(ARG:0)%の赤ちゃんのお部屋…たぷたぷになるまで注いじゃいます	PRINTFORM 「私のせーえき…%CALLNAME_7_0(ARG:0)%の赤ちゃんのお部屋…たぷたぷになるまで注いじゃいます
PRINTFORMDW その傍ら、色々な体液の水溜りに息も絶え絶え倒れこんでいる%CALLNAME:(ARG:0)%の姿があった…	PRINTFORMDW その傍ら、色々な体液の水溜りに息も絶え絶え倒れこんでいる%CALLNAME:(ARG:0)%の姿があった…
PRINTFORMDW パチュリーは%CALLNAME:(TARGET)%から大人の玩具をひったくると、いそいそと道具袋に収めた。	PRINTFORMDW パチュリーは%CALLNAME:(TARGET)%から大人の玩具をひったくると、いそいそと道具袋に収めた。
PRINTFORMDW 下着の隙間から入り込んだ触手達は、先を争って%CALLNAME:(TARGET)%の美肉を押し拡げている…	PRINTFORMDW 下着の隙間から入り込んだ触手達は、先を争って%CALLNAME:(TARGET)%の美肉を押し拡げている…
PRINTFORMDW %CALLNAME:(TARGET)%は豊満な乳房でペニスを包み込み…両手で大きく揺らして刺激を与える…	PRINTFORMDW %CALLNAME:(TARGET)%は豊満な乳房でペニスを包み込み…両手で大きく揺らして刺激を与える…
PRINTFORMW 　見て下さいよ…%CALLNAME_7_0(ARG:2)%のテラテラ光って…とってもイヤらしいでしょう？」	PRINTFORMW 　見て下さいよ…%CALLNAME_7_0(ARG:2)%のテラテラ光って…とってもイヤらしいでしょう？」
PRINTFORM 「触手が…脚に……これは…私に%CALLNAME_7_0(ARG:2)%のお相手をしろというサインですかねぇ	PRINTFORM 「触手が…脚に……これは…私に%CALLNAME_7_0(ARG:2)%のお相手をしろというサインですかねぇ
PRINTFORMDL %CALLNAME:(TARGET)%のかけ声を瞬時に理解したパチュリーは、即座に魔物から距離を取った。	PRINTFORMDL %CALLNAME:(TARGET)%のかけ声を瞬時に理解したパチュリーは、即座に魔物から距離を取った。
PRINTFORMW 「あ、あの…%CALLNAME_7_0(ARG:2)%…　大変嬉しいのですが、そういう状況でもない様な…」	PRINTFORMW 「あ、あの…%CALLNAME_7_0(ARG:2)%…　大変嬉しいのですが、そういう状況でもない様な…」
PRINTFORM 　%CALLNAME_7_0(ARG:2)%のアソコと私のアソコが…見て下さい、ぐちゅぐちゅ絡み合ってますよ	PRINTFORM 　%CALLNAME_7_0(ARG:2)%のアソコと私のアソコが…見て下さい、ぐちゅぐちゅ絡み合ってますよ
PRINTFORMDW %CALLNAME:(TARGET)%が自らの指で開いたそこは、テラテラと妖しく輝き見た者を吸い寄せる…	PRINTFORMDW %CALLNAME:(TARGET)%が自らの指で開いたそこは、テラテラと妖しく輝き見た者を吸い寄せる…
PRINTFORMDL %CALLNAME:(TARGET)%は下半身に群がる小さな触手達を片手間に振り払いながら戦っているが、	PRINTFORMDL %CALLNAME:(TARGET)%は下半身に群がる小さな触手達を片手間に振り払いながら戦っているが、
PRINTFORMDW %CALLNAME:(TARGET)%はしなやかな指使いで男根をしごきあげるが、いささか不満気な表情だ…	PRINTFORMDW %CALLNAME:(TARGET)%はしなやかな指使いで男根をしごきあげるが、いささか不満気な表情だ…
PRINTFORM 「え…%CALLNAME_7_0(ARG:0)%自身もとっても気持ちよくなれるのに？　淫魔の私が保証しますよ	PRINTFORM 「え…%CALLNAME_7_0(ARG:0)%自身もとっても気持ちよくなれるのに？　淫魔の私が保証しますよ
PRINTFORMDL %CALLNAME:(ARG:0)%の服が普通でない事に気づいた%CALLNAME:(ARG:1)%は、	PRINTFORMDL %CALLNAME:(ARG:0)%の服が普通でない事に気づいた%CALLNAME:(ARG:1)%は、
PRINTFORMW 　なんでしょう…私を愛撫して…早く%CALLNAME_7_0(ARG:0)%に注ぎ込めって事でしょうか…」	PRINTFORMW 　なんでしょう…私を愛撫して…早く%CALLNAME_7_0(ARG:0)%に注ぎ込めって事でしょうか…」
PRINTFORM 「そう…ですね…%CALLNAME_7_0(ARG:0)%のお顔を見てたらなんだか…穢したくなっちゃいました	PRINTFORM 「そう…ですね…%CALLNAME_7_0(ARG:0)%のお顔を見てたらなんだか…穢したくなっちゃいました
PRINTFORM 「せーえきぴゅっぴゅしながら、ふるふる震えてる今の%CALLNAME_7_0(ARG:0)%…凄く可愛いです	PRINTFORM 「せーえきぴゅっぴゅしながら、ふるふる震えてる今の%CALLNAME_7_0(ARG:0)%…凄く可愛いです
PRINTFORMDW %CALLNAME:(TARGET)%はゆっくり奥まで飲み込んだペニスを子宮口でぐりぐりと攻め立てる…	PRINTFORMDW %CALLNAME:(TARGET)%はゆっくり奥まで飲み込んだペニスを子宮口でぐりぐりと攻め立てる…
PRINTFORMDW 乳房の間から覗く亀頭に%CALLNAME:(TARGET)%は舌を這わせた後、おもむろにかぶりついた…	PRINTFORMDW 乳房の間から覗く亀頭に%CALLNAME:(TARGET)%は舌を這わせた後、おもむろにかぶりついた…
PRINTFORM 「凄くエラが張ってて…口をすぼめてたら咥えられないほどですよ、%CALLNAME_7_0(ARG:2)%の	PRINTFORM 「凄くエラが張ってて…口をすぼめてたら咥えられないほどですよ、%CALLNAME_7_0(ARG:2)%の
PRINTFORMDW %CALLNAME:(TARGET)%は乳房に性器を挟み、両手で適度な圧迫をしながら身体を擦り付けた…	PRINTFORMDW %CALLNAME:(TARGET)%は乳房に性器を挟み、両手で適度な圧迫をしながら身体を擦り付けた…
PRINTFORMDW 淫魔の血が%CALLNAME:(TARGET)%の身体を駆け巡る！　MPが{LOCAL:0}回復した！	PRINTFORMDW 淫魔の血が%CALLNAME:(TARGET)%の身体を駆け巡る！　MPが{LOCAL:0}回復した！
PRINTFORMDW 俯く%CALLNAME:(TARGET)%の羽耳から、とろ～りと粘液が滴り落ち床に水溜りを作っている…	PRINTFORMDW 俯く%CALLNAME:(TARGET)%の羽耳から、とろ～りと粘液が滴り落ち床に水溜りを作っている…
PRINTFORMDW %CALLNAME:(TARGET)%も慣れない射精の快楽には抗えず、そのまま全ての力を放出しきった…	PRINTFORMDW %CALLNAME:(TARGET)%も慣れない射精の快楽には抗えず、そのまま全ての力を放出しきった…
PRINTFORM 「鼻息荒いですよ、%CALLNAME_7_0(ARG:2)%……分かりました、私で宜しければ、お相手します	PRINTFORM 「鼻息荒いですよ、%CALLNAME_7_0(ARG:2)%……分かりました、私で宜しければ、お相手します
PRINTFORMDW ぐったりとしたパチュリーを抱きかかえながら、%CALLNAME:(TARGET)%はレミリアに呟いた…	PRINTFORMDW ぐったりとしたパチュリーを抱きかかえながら、%CALLNAME:(TARGET)%はレミリアに呟いた…
PRINTFORM 「ふふっ…%CALLNAME_7_0(RESULT)%…私たちの情事…マスターに見せ付けてあげましょうよ	PRINTFORM 「ふふっ…%CALLNAME_7_0(RESULT)%…私たちの情事…マスターに見せ付けてあげましょうよ
PRINTFORMW 「ほら…%CALLNAME_7_0(ARG:2)%？　敵が近づいて来ますよ…私は別にいいんですけど…」	PRINTFORMW 「ほら…%CALLNAME_7_0(ARG:2)%？　敵が近づいて来ますよ…私は別にいいんですけど…」
PRINTFORM 「これは早く…%CALLNAME_7_0(ARG:2)%の膣内に射精して、落ち着けないといけませんよね…	PRINTFORM 「これは早く…%CALLNAME_7_0(ARG:2)%の膣内に射精して、落ち着けないといけませんよね…
PRINTFORMDW %CALLNAME:(TARGET)%はなんとか射精感を堪えながら、下から激しく腰を突き上げ返した…	PRINTFORMDW %CALLNAME:(TARGET)%はなんとか射精感を堪えながら、下から激しく腰を突き上げ返した…
PRINTFORMDW %ARGS:1%の舌が%CALLNAME:(TARGET)%の口内を撫で回し、絶えず唾液を送り込む！	PRINTFORMDW %ARGS:1%の舌が%CALLNAME:(TARGET)%の口内を撫で回し、絶えず唾液を送り込む！
PRINTFORMDW %CALLNAME:(TARGET)%のエナジードレインが発動！　HPが{LOCAL:0}回復した！	PRINTFORMDW %CALLNAME:(TARGET)%のエナジードレインが発動！　HPが{LOCAL:0}回復した！
PRINTFORMDW %CALLNAME:(TARGET)%の乳房に群がっていた触手達は、徐々にその快楽を引き出していく…	PRINTFORMDW %CALLNAME:(TARGET)%の乳房に群がっていた触手達は、徐々にその快楽を引き出していく…
PRINTFORMW 「あ…%CALLNAME_7_0(FLAG:10)%は……姿が見えないですね。さてどうしましょうか…」	PRINTFORMW 「あ…%CALLNAME_7_0(FLAG:10)%は……姿が見えないですね。さてどうしましょうか…」
PRINTFORM 「お願いしますね…。%CALLNAME_7_0(ARG:3)%の、その綺麗な肌で…ご奉仕して頂けるなんて	PRINTFORM 「お願いしますね…。%CALLNAME_7_0(ARG:3)%の、その綺麗な肌で…ご奉仕して頂けるなんて
PRINTFORM 「%CALLNAME_7_0(ARG:2)%のおちんちん…すっごく元気ですね♪　涎で私の手がべとべとです	PRINTFORM 「%CALLNAME_7_0(ARG:2)%のおちんちん…すっごく元気ですね♪　涎で私の手がべとべとです
PRINTFORMW 「あーあ…まるでレイプされたみたいな格好になりましたね、%CALLNAME_7_0(ARG:0)%…」	PRINTFORMW 「あーあ…まるでレイプされたみたいな格好になりましたね、%CALLNAME_7_0(ARG:0)%…」
PRINTFORMDW ぐったりとしたパチュリーを抱きかかえながら、%CALLNAME:(TARGET)%は魔理沙に呟いた…	PRINTFORMDW ぐったりとしたパチュリーを抱きかかえながら、%CALLNAME:(TARGET)%は魔理沙に呟いた…
PRINTFORMDL 部屋に蠢く触手達に、その下腹部からそそり立つ剛直を責められた%CALLNAME:(TARGET)%は	PRINTFORMDL 部屋に蠢く触手達に、その下腹部からそそり立つ剛直を責められた%CALLNAME:(TARGET)%は
PRINTFORM 「私のおちんぽ…%CALLNAME_7_0(1)%のアソコをぐぽぐぽしたくて、こんなになっちゃってます	PRINTFORM 「私のおちんぽ…%CALLNAME_7_0(1)%のアソコをぐぽぐぽしたくて、こんなになっちゃってます
PRINTFORMW 「せっかくお会いできたのに…せめて一回してから…あぁ、ごめんなさいごめんなさい、行ってきます！！！」	PRINTFORMW 「せっかくお会いできたのに…せめて一回してから…あぁ、ごめんなさいごめんなさい、行ってきます！！！」
PRINTFORM 「%CALLNAME_7_0(ARG:2)%はこっちも一緒に弄られると…ほんとすぐイっちゃうんですよね	PRINTFORM 「%CALLNAME_7_0(ARG:2)%はこっちも一緒に弄られると…ほんとすぐイっちゃうんですよね
PRINTFORM 「私の膣内に射精したいんですよね…そう顔に書いてありますよ、%CALLNAME_7_0(ARG:2)%	PRINTFORM 「私の膣内に射精したいんですよね…そう顔に書いてありますよ、%CALLNAME_7_0(ARG:2)%
PRINTFORMDW %CALLNAME:(TARGET)%は自らの指先を胸の先端に当て円を書きながら、おねだりをした…	PRINTFORMDW %CALLNAME:(TARGET)%は自らの指先を胸の先端に当て円を書きながら、おねだりをした…
PRINTFORMDW そう言って%CALLNAME:(TARGET)%は粘液を絡めた手で、改めて相手の性器を擦り始めた…	PRINTFORMDW そう言って%CALLNAME:(TARGET)%は粘液を絡めた手で、改めて相手の性器を擦り始めた…
PRINTFORMDW %CALLNAME:(TARGET)%は%ARGS:1%を後ろから抱きしめ、ゆっくりと開脚させる…	PRINTFORMDW %CALLNAME:(TARGET)%は%ARGS:1%を後ろから抱きしめ、ゆっくりと開脚させる…
PRINTFORMDW 下着が丸見えになっている事にも構わず、%CALLNAME:(TARGET)%は足での奉仕を始めた…	PRINTFORMDW 下着が丸見えになっている事にも構わず、%CALLNAME:(TARGET)%は足での奉仕を始めた…
PRINTFORMDW 少し縮んだとはいえそれでも十分な存在感を誇る%CALLNAME:(TARGET)%のバストだった…	PRINTFORMDW 少し縮んだとはいえそれでも十分な存在感を誇る%CALLNAME:(TARGET)%のバストだった…
PRINTFORMDL %SAVESTR:(LOCAL:0)%は%CALLNAME:(TARGET)%をきつく拘束しながら	PRINTFORMDL %SAVESTR:(LOCAL:0)%は%CALLNAME:(TARGET)%をきつく拘束しながら
PRINTFORMDW 不意に床から這い伸びた触手に尻穴を征服され%CALLNAME:(TARGET)%は熱く息を吐いた…	PRINTFORMDW 不意に床から這い伸びた触手に尻穴を征服され%CALLNAME:(TARGET)%は熱く息を吐いた…
PRINTFORMDW 妖しい香りを放つ液体に浸かった%CALLNAME:(TARGET)%は、みるみる顔が紅潮していく…	PRINTFORMDW 妖しい香りを放つ液体に浸かった%CALLNAME:(TARGET)%は、みるみる顔が紅潮していく…
PRINTFORMDW そう言って%ARGS:1%は%ARGS:0%の双丘に優しく手をやり、その間にペニスを潜り込ませた！	PRINTFORMDW そう言って%ARGS:1%は%ARGS:0%の双丘に優しく手をやり、その間にペニスを潜り込ませた！
PRINTFORMW 「…………ん？　えっ……%CALLNAME_7_0(ARG:0)%…もしかして私が寝ている間に！？」	PRINTFORMW 「…………ん？　えっ……%CALLNAME_7_0(ARG:0)%…もしかして私が寝ている間に！？」
PRINTFORMDW %CALLNAME:(TARGET)%は、朦朧とした意識の中、本能的に快楽を求め、自ら慰め始めた…	PRINTFORMDW %CALLNAME:(TARGET)%は、朦朧とした意識の中、本能的に快楽を求め、自ら慰め始めた…
PRINTFORMDW そう言って%CALLNAME:(TARGET)%はペニスを咥え込み、頭を激しくグラインドさせた…	PRINTFORMDW そう言って%CALLNAME:(TARGET)%はペニスを咥え込み、頭を激しくグラインドさせた…
PRINTFORMDW %CALLNAME:(TARGET)%は淫らな手つきで男根をしごきながら、己の秘部に手をやった…	PRINTFORMDW %CALLNAME:(TARGET)%は淫らな手つきで男根をしごきながら、己の秘部に手をやった…
PRINTFORMW 「そうですねぇ…このおちんぽで%CALLNAME_7_0(1)%を攻め立てるのは簡単なのですが…」	PRINTFORMW 「そうですねぇ…このおちんぽで%CALLNAME_7_0(1)%を攻め立てるのは簡単なのですが…」
PRINTFORMDW 大きなおなかを優しく擦りながら、%CALLNAME:(TARGET)%は少々バツが悪そうに答えた	PRINTFORMDW 大きなおなかを優しく擦りながら、%CALLNAME:(TARGET)%は少々バツが悪そうに答えた
PRINTFORMW 「%CALLNAME_7_0(LOCAL:0)%ッッ！！！　私の声っ！　聞こえたら返事を…！！！」	PRINTFORMW 「%CALLNAME_7_0(LOCAL:0)%ッッ！！！　私の声っ！　聞こえたら返事を…！！！」
PRINTFORMDW %CALLNAME:(TARGET)%はそのしなやかな指先を、ゆっくりとクレバスに沈めていった…	PRINTFORMDW %CALLNAME:(TARGET)%はそのしなやかな指先を、ゆっくりとクレバスに沈めていった…
PRINTFORMDW そう言うと%CALLNAME:(TARGET)%は、ゆっくりと見せつける様に両脚を開いていった…	PRINTFORMDW そう言うと%CALLNAME:(TARGET)%は、ゆっくりと見せつける様に両脚を開いていった…
PRINTFORMDL %CALLNAME:(TARGET)%は%ARGS:1%の姿をした何者かに、そっと手を伸ばすと、	PRINTFORMDL %CALLNAME:(TARGET)%は%ARGS:1%の姿をした何者かに、そっと手を伸ばすと、
PRINTFORMDW %CALLNAME:(TARGET)%は%ARGS:1%を抱き寄せ、負けじと舌を入れ絡め返した…	PRINTFORMDW %CALLNAME:(TARGET)%は%ARGS:1%を抱き寄せ、負けじと舌を入れ絡め返した…
PRINTFORMDW %CALLNAME:(TARGET)%は攻撃を受けボロボロになった触手スーツを一気に引き剥がした	PRINTFORMDW %CALLNAME:(TARGET)%は攻撃を受けボロボロになった触手スーツを一気に引き剥がした
PRINTFORMDL %CALLNAME:(TARGET)%は床から伸びる触手達にヴァギナを蹂躙されたまま戦っているが	PRINTFORMDL %CALLNAME:(TARGET)%は床から伸びる触手達にヴァギナを蹂躙されたまま戦っているが
PRINTFORMDW %CALLNAME:(TARGET)%は息も絶え絶えなパチュリーに対して一歩ずつ近づいて行った…	PRINTFORMDW %CALLNAME:(TARGET)%は息も絶え絶えなパチュリーに対して一歩ずつ近づいて行った…
PRINTFORMW 「もう…我慢できそうにないんです…だから……すみません%CALLNAME_7_0(1)%っっ！！」	PRINTFORMW 「もう…我慢できそうにないんです…だから……すみません%CALLNAME_7_0(1)%っっ！！」
PRINTFORMW 　%CALLNAME_7_0(ARG:0)%の膣内気持ち良過ぎて…我慢できずに射精ちゃいました…」	PRINTFORMW 　%CALLNAME_7_0(ARG:0)%の膣内気持ち良過ぎて…我慢できずに射精ちゃいました…」
PRINTFORMDW %CALLNAME:(ARG:1)%の剛直は依然衰えぬまま、びゅるびゅると欲望を撒き散らしていた	PRINTFORMDW %CALLNAME:(ARG:1)%の剛直は依然衰えぬまま、びゅるびゅると欲望を撒き散らしていた
PRINTFORMDL 他人が見ても判るくらい大きくなったお腹を擦りながら%CALLNAME:(TARGET)%は呟いた	PRINTFORMDL 他人が見ても判るくらい大きくなったお腹を擦りながら%CALLNAME:(TARGET)%は呟いた
PRINTFORMDW %CALLNAME:(TARGET)%は子宮に満ちた精液の感覚を味わいながら、妖しく微笑んだ…	PRINTFORMDW %CALLNAME:(TARGET)%は子宮に満ちた精液の感覚を味わいながら、妖しく微笑んだ…
PRINTFORM 「敏感な%CALLNAME_7_0(ARG:2)%ですもの、キスだけでイける様にして差し上げますよ	PRINTFORM 「敏感な%CALLNAME_7_0(ARG:2)%ですもの、キスだけでイける様にして差し上げますよ
PRINTFORMW 「大丈夫ですか？　%CALLNAME_7_0(LOCAL:0)%っ！　すぐに…助けますからっ！」	PRINTFORMW 「大丈夫ですか？　%CALLNAME_7_0(LOCAL:0)%っ！　すぐに…助けますからっ！」
PRINTFORMW 「あぁ…%CALLNAME_7_0(LOCAL:0)%が…あんなにテラテラと艶やかに輝いて……」	PRINTFORMW 「あぁ…%CALLNAME_7_0(LOCAL:0)%が…あんなにテラテラと艶やかに輝いて……」
PRINTFORMDW %CALLNAME:(TARGET)%は性器をしっかりと口に含み、頭を大きくグラインドさせた…	PRINTFORMDW %CALLNAME:(TARGET)%は性器をしっかりと口に含み、頭を大きくグラインドさせた…
PRINTFORMDW %CALLNAME:(TARGET)%は悩ましげな表情を浮かべ、%ARGS:1%に抱きついた…	PRINTFORMDW %CALLNAME:(TARGET)%は悩ましげな表情を浮かべ、%ARGS:1%に抱きついた…
PRINTFORMW 「申し訳ありません、%CALLNAME_7_0(ARG:2)%。今は目の前の敵に集中する時かと」	PRINTFORMW 「申し訳ありません、%CALLNAME_7_0(ARG:2)%。今は目の前の敵に集中する時かと」
PRINTFORMDL 滴り落ちる白濁液を手で拭い取りペロリと舌で舐め取る%CALLNAME:(TARGET)%の顔は	PRINTFORMDL 滴り落ちる白濁液を手で拭い取りペロリと舌で舐め取る%CALLNAME:(TARGET)%の顔は
PRINTFORMDW %CALLNAME:(TARGET)%は小さくなった手のひらで全身をペタペタ確認しながら呟いた	PRINTFORMDW %CALLNAME:(TARGET)%は小さくなった手のひらで全身をペタペタ確認しながら呟いた
PRINTFORMW 　私のおちんちん…%CALLNAME_7_0(ARG:3)%を気持ち良くしてあげられてますか？」	PRINTFORMW 　私のおちんちん…%CALLNAME_7_0(ARG:3)%を気持ち良くしてあげられてますか？」
PRINTFORMDW そう言って%ARGS:1%は馬乗りになり%ARGS:0%の胸に己の固くなったモノを擦り付ける！	PRINTFORMDW そう言って%ARGS:1%は馬乗りになり%ARGS:0%の胸に己の固くなったモノを擦り付ける！
PRINTFORM 「次こそは…絶頂で震える%CALLNAME_7_0(ARG:0)%の子宮に注ぎ込んでみせますから…	PRINTFORM 「次こそは…絶頂で震える%CALLNAME_7_0(ARG:0)%の子宮に注ぎ込んでみせますから…
PRINTFORMW 「この薬は……%CALLNAME_7_0(LOCAL:0)%に飲ませてあげるのが良さそうですね」	PRINTFORMW 「この薬は……%CALLNAME_7_0(LOCAL:0)%に飲ませてあげるのが良さそうですね」
PRINTFORMDW 部屋に蠢く触手達が%CALLNAME:(TARGET)%の二つの乳首を代わる代わる吸い立てる…	PRINTFORMDW 部屋に蠢く触手達が%CALLNAME:(TARGET)%の二つの乳首を代わる代わる吸い立てる…
PRINTFORM 「%CALLNAME_7_0(GET_ID_FROM_NO(8))%の手が…勝手に動くんですよぉ…	PRINTFORM 「%CALLNAME_7_0(GET_ID_FROM_NO(8))%の手が…勝手に動くんですよぉ…
PRINTFORMW 「仕方ないですよね。いくら妊娠すると解っていても、淫魔が膣内射精を嫌がる事なんて出来るわけが…」	PRINTFORMW 「仕方ないですよね。いくら妊娠すると解っていても、淫魔が膣内射精を嫌がる事なんて出来るわけが…」
PRINTFORMDW たらふく母乳を吸って満足した使い魔は、ようやく%CALLNAME:(TARGET)%を解放した	PRINTFORMDW たらふく母乳を吸って満足した使い魔は、ようやく%CALLNAME:(TARGET)%を解放した
PRINTFORMDW %CALLNAME:(TARGET)%は唯一自由になる両脚を絡め、ピストン運動を促している…	PRINTFORMDW %CALLNAME:(TARGET)%は唯一自由になる両脚を絡め、ピストン運動を促している…
PRINTFORM 「ふふ…流石の%CALLNAME_7_0(ARG:1)%もここで一人というのは心細いみたいですね	PRINTFORM 「ふふ…流石の%CALLNAME_7_0(ARG:1)%もここで一人というのは心細いみたいですね
PRINTFORMDW パチュリーが気づく前に、%CALLNAME:(TARGET)%は媚薬を素早く懐に仕舞い込んだ	PRINTFORMDW パチュリーが気づく前に、%CALLNAME:(TARGET)%は媚薬を素早く懐に仕舞い込んだ
PRINTFORMW 　私の乳首と%CALLNAME_7_0(ARG:2)%の乳首…一緒に気持ちよくなりましょう…」	PRINTFORMW 　私の乳首と%CALLNAME_7_0(ARG:2)%の乳首…一緒に気持ちよくなりましょう…」
PRINTFORMDW %CALLNAME:(TARGET)%は片手で奉仕を続けたまま、もう片方の手で自らを慰めた…	PRINTFORMDW %CALLNAME:(TARGET)%は片手で奉仕を続けたまま、もう片方の手で自らを慰めた…
PRINTFORMDW ぐちゅぐちゅと激しい音を立て、%CALLNAME:(TARGET)%は触手を擦りあげている…	PRINTFORMDW ぐちゅぐちゅと激しい音を立て、%CALLNAME:(TARGET)%は触手を擦りあげている…
PRINTFORMDW 触手への奉仕を一旦止め口を離した%CALLNAME:(TARGET)%は、触手にキスをした…	PRINTFORMDW 触手への奉仕を一旦止め口を離した%CALLNAME:(TARGET)%は、触手にキスをした…
PRINTFORMW 「…あ、%CALLNAME_7_0(ARG:2)%が離れたと思ったら…横取りしないで下さいよ」	PRINTFORMW 「…あ、%CALLNAME_7_0(ARG:2)%が離れたと思ったら…横取りしないで下さいよ」
PRINTFORMDW 淫魔の血が%CALLNAME:(TARGET)%の身体を駆け巡る！　MPが最大まで回復した！	PRINTFORMDW 淫魔の血が%CALLNAME:(TARGET)%の身体を駆け巡る！　MPが最大まで回復した！
PRINTFORMDW %CALLNAME:(TARGET)%は、ぐっすり眠ったパチュリーに一歩ずつ近づいて行った…	PRINTFORMDW %CALLNAME:(TARGET)%は、ぐっすり眠ったパチュリーに一歩ずつ近づいて行った…
PRINTFORM 「%CALLNAME_7_0(ARG:3)%ったら、そんな顔をして…その唇…欲しくなっちゃいます	PRINTFORM 「%CALLNAME_7_0(ARG:3)%ったら、そんな顔をして…その唇…欲しくなっちゃいます
PRINTFORMW 「…あ…これ…勝手に絡まって……どうしましょう、%CALLNAME_7_0(ARG:0)%？」	PRINTFORMW 「…あ…これ…勝手に絡まって……どうしましょう、%CALLNAME_7_0(ARG:0)%？」
PRINTFORM 「%CALLNAME_7_0(ARG:0, 1)%…ひと突きごとにビクってしちゃって…くすくすっ	PRINTFORM 「%CALLNAME_7_0(ARG:0, 1)%…ひと突きごとにビクってしちゃって…くすくすっ
PRINTFORMDW パチュリーはうつむき加減でブツブツ呟き続けている。が、その顔はどことなく嬉しそうでもあった。	PRINTFORMDW パチュリーはうつむき加減でブツブツ呟き続けている。が、その顔はどことなく嬉しそうでもあった。
PRINTFORMW 「あ……%CALLNAME_7_0(LOCAL:0)%！　この薬さえあればもう大丈夫ですよ！」	PRINTFORMW 「あ……%CALLNAME_7_0(LOCAL:0)%！　この薬さえあればもう大丈夫ですよ！」
PRINTFORMDW 頬を真っ赤に染めたパチュリーが物凄い勢いで%CALLNAME:(TARGET)%の口を塞ぐ。	PRINTFORMDW 頬を真っ赤に染めたパチュリーが物凄い勢いで%CALLNAME:(TARGET)%の口を塞ぐ。
PRINTFORMDW %CALLNAME:(TARGET)%は熱く湿ったクレバスに向けて、しなやかに指を這わせた…	PRINTFORMDW %CALLNAME:(TARGET)%は熱く湿ったクレバスに向けて、しなやかに指を這わせた…
PRINTFORMDW 目の前の%CALLNAME:(TARGET)%の頭に、上から落ちてきた大きな岩が直撃した。	PRINTFORMDW 目の前の%CALLNAME:(TARGET)%の頭に、上から落ちてきた大きな岩が直撃した。
PRINTFORMDW 挿入された瞬間、%CALLNAME:(TARGET)%は魔族特有の冷たく淫靡な視線を向けた	PRINTFORMDW 挿入された瞬間、%CALLNAME:(TARGET)%は魔族特有の冷たく淫靡な視線を向けた
PRINTFORM 「%CALLNAME_7_0(ARG:2)%のせーえきたっぷり詰まったおちんぽ…いただきまーす	PRINTFORM 「%CALLNAME_7_0(ARG:2)%のせーえきたっぷり詰まったおちんぽ…いただきまーす
PRINTFORMW 「%CALLNAME_7_0(LOCAL:0)%…息も絶え絶えに……でも…なんだか凄く……」	PRINTFORMW 「%CALLNAME_7_0(LOCAL:0)%…息も絶え絶えに……でも…なんだか凄く……」
PRINTFORMDW %CALLNAME:(TARGET)%は相手の性器を優しく握り…焦らす様に手を上下させた…	PRINTFORMDW %CALLNAME:(TARGET)%は相手の性器を優しく握り…焦らす様に手を上下させた…
PRINTFORMDW 丸見えの秘部を見せつける様に、%CALLNAME:(TARGET)%は足での奉仕を始めた…	PRINTFORMDW 丸見えの秘部を見せつける様に、%CALLNAME:(TARGET)%は足での奉仕を始めた…
PRINTFORMDW %CALLNAME:(TARGET)%は両手で乳房を押さえ、触手を挟み込んで揺すっている…	PRINTFORMDW %CALLNAME:(TARGET)%は両手で乳房を押さえ、触手を挟み込んで揺すっている…
PRINTFORM 　%CALLNAME_7_0(ARG:2)%…%CALLNAME_7_0(ARG:2,1)%…	PRINTFORM 　%CALLNAME_7_0(ARG:2)%…%CALLNAME_7_0(ARG:2,1)%…
PRINTFORMDW %CALLNAME:(TARGET)%のエナジードレインが発動！　HPが最大まで回復した！	PRINTFORMDW %CALLNAME:(TARGET)%のエナジードレインが発動！　HPが最大まで回復した！
PRINTFORMDW %CALLNAME:(TARGET)%はそれを指で掬い取り、両手で双丘に馴染ませていった…	PRINTFORMDW %CALLNAME:(TARGET)%はそれを指で掬い取り、両手で双丘に馴染ませていった…
PRINTFORMW 「どなたかの荷物ですね。後で取りに戻られるかもしれませんし、そのままにしておきましょうか。」	PRINTFORMW 「どなたかの荷物ですね。後で取りに戻られるかもしれませんし、そのままにしておきましょうか。」
PRINTFORMW 「すみません…貴女が私%TACHI()%を襲わないという話…信じないわけではないのですが…」	PRINTFORMW 「すみません…貴女が私%TACHI()%を襲わないという話…信じないわけではないのですが…」
PRINTFORMDW 追い込まれているはずなのに、どこか嬉しそうな%CALLNAME:(TARGET)%だった…	PRINTFORMDW 追い込まれているはずなのに、どこか嬉しそうな%CALLNAME:(TARGET)%だった…
PRINTFORMDW お腹をさすった%CALLNAME:(ARG:1)%の中に、新たな生命が誕生した瞬間だった…	PRINTFORMDW お腹をさすった%CALLNAME:(ARG:1)%の中に、新たな生命が誕生した瞬間だった…
PRINTFORM 「貴女の身体と引き換え…というのはいかがでしょう？　%CALLNAME_7_0(ARG:0)%	PRINTFORM 「貴女の身体と引き換え…というのはいかがでしょう？　%CALLNAME_7_0(ARG:0)%
PRINTFORMW 「今この状況でその要求を受け入れてしまうと…パチュリー様に危険が及ぶ可能性もありますので…」	PRINTFORMW 「今この状況でその要求を受け入れてしまうと…パチュリー様に危険が及ぶ可能性もありますので…」
PRINTFORMW 　申し訳ありません、%CALLNAME_7_0(ARG:0)%…一人で先にイってしまって…」	PRINTFORMW 　申し訳ありません、%CALLNAME_7_0(ARG:0)%…一人で先にイってしまって…」
PRINTFORM 「……ほ、ほら！　実は私がパチュリー様に当たらない様に誘導したんですよ！　御褒美…頂けません	PRINTFORM 「……ほ、ほら！　実は私がパチュリー様に当たらない様に誘導したんですよ！　御褒美…頂けません
PRINTFORMDW 妖艶な笑みを浮かべた%CALLNAME:(TARGET)%が…滑らかに腰を動かし始めた…	PRINTFORMDW 妖艶な笑みを浮かべた%CALLNAME:(TARGET)%が…滑らかに腰を動かし始めた…
PRINTFORMDW %CALLNAME:(TARGET)%は淫靡な顔で見つめながら、再び口での奉仕を始める…	PRINTFORMDW %CALLNAME:(TARGET)%は淫靡な顔で見つめながら、再び口での奉仕を始める…
PRINTFORMW 「そろそろ…%CALLNAME_7_0(LOCAL:0)%を解放してくれないでしょうか…」	PRINTFORMW 「そろそろ…%CALLNAME_7_0(LOCAL:0)%を解放してくれないでしょうか…」
PRINTFORM 「%CALLNAME_7_0(RESULT, 1)%…肩の力を抜いて…もっと愉しみましょう…	PRINTFORM 「%CALLNAME_7_0(RESULT, 1)%…肩の力を抜いて…もっと愉しみましょう…
PRINTFORMDW 言われるがままに%CALLNAME:(TARGET)%は触手に力を込めて折り曲げている…	PRINTFORMDW 言われるがままに%CALLNAME:(TARGET)%は触手に力を込めて折り曲げている…
PRINTFORMDW %CALLNAME:(TARGET)%は身体に纏わり付く粘液を嬉しそうに擦り付けている…	PRINTFORMDW %CALLNAME:(TARGET)%は身体に纏わり付く粘液を嬉しそうに擦り付けている…
PRINTFORMDL %CALLNAME:(TARGET)%は顔にへばり付く白濁液をペロリと舌で舐め取りながら	PRINTFORMDL %CALLNAME:(TARGET)%は顔にへばり付く白濁液をペロリと舌で舐め取りながら
PRINTFORMW 「あれは…この辺りの怪物を産み出しているんですね。なんとかして止める必要がありそうです。」	PRINTFORMW 「あれは…この辺りの怪物を産み出しているんですね。なんとかして止める必要がありそうです。」
PRINTFORMDW 初めて味わう射精の感覚に%CALLNAME:(TARGET)%は、しばらく放心状態で居た	PRINTFORMDW 初めて味わう射精の感覚に%CALLNAME:(TARGET)%は、しばらく放心状態で居た
PRINTFORM 「ほら…その証拠に…私の…涎垂らしてるでしょう？　その胸でイクところ…ちゃんと見てて下さいね	PRINTFORM 「ほら…その証拠に…私の…涎垂らしてるでしょう？　その胸でイクところ…ちゃんと見てて下さいね
PRINTFORM 　%CALLNAME_7_0(ARG:0)%の膣内…吸い込まれる様に挿入って行っちゃいます…	PRINTFORM 　%CALLNAME_7_0(ARG:0)%の膣内…吸い込まれる様に挿入って行っちゃいます…
PRINTFORMDW %CALLNAME:(ARG:1)%は妖しく舌舐めずりしながら、二つ返事で要求を快諾した	PRINTFORMDW %CALLNAME:(ARG:1)%は妖しく舌舐めずりしながら、二つ返事で要求を快諾した
PRINTFORMW 「…パ、パチュリー様っ？！　すぐに気付け薬を探してきますっ！　それまで…どうぞご無事で…」	PRINTFORMW 「…パ、パチュリー様っ？！　すぐに気付け薬を探してきますっ！　それまで…どうぞご無事で…」
PRINTFORMDL 本来は望まぬ妊娠をするわけのないサキュバスである%CALLNAME:(TARGET)%は	PRINTFORMDL 本来は望まぬ妊娠をするわけのないサキュバスである%CALLNAME:(TARGET)%は
PRINTFORMW 「…んっ……これ…子宮口が…こじ開け…あ、あ…ぁ……ずりゅっ…って……ああぁぁっっ！！！」	PRINTFORMW 「…んっ……これ…子宮口が…こじ開け…あ、あ…ぁ……ずりゅっ…って……ああぁぁっっ！！！」
PRINTFORMDL 目を覚ました%CALLNAME:(TARGET)%の視界には触手を展開した使い魔が居た。	PRINTFORMDL 目を覚ました%CALLNAME:(TARGET)%の視界には触手を展開した使い魔が居た。
PRINTFORMDW 掛け声と共に%CALLNAME:(TARGET)%は大きな光弾を次々と周囲に撃ち出した	PRINTFORMDW 掛け声と共に%CALLNAME:(TARGET)%は大きな光弾を次々と周囲に撃ち出した
PRINTFORMW 「お尻で抜いて欲しいだなんて…%CALLNAME_7_0(ARG:2)%は変態さんですね	PRINTFORMW 「お尻で抜いて欲しいだなんて…%CALLNAME_7_0(ARG:2)%は変態さんですね
PRINTFORM 「コレ…咥えてみたいんでしょう？　解りますよ、そういう気分になっちゃう事があるの…くすくす	PRINTFORM 「コレ…咥えてみたいんでしょう？　解りますよ、そういう気分になっちゃう事があるの…くすくす
PRINTFORM 「%CALLNAME_7_0(ARG:2)%のおちんぽ…こんなにだらだら涎を垂らしちゃって	PRINTFORM 「%CALLNAME_7_0(ARG:2)%のおちんぽ…こんなにだらだら涎を垂らしちゃって
PRINTFORMW 「……このお腹ですか？　本来なら淫魔が意図せず孕むなんて事はありえないんですけどねぇ…」	PRINTFORMW 「……このお腹ですか？　本来なら淫魔が意図せず孕むなんて事はありえないんですけどねぇ…」
PRINTFORM 「お礼と言うわけではないですが…別に少しくらいでしたら、私で欲求不満を解消してもいいですよ	PRINTFORM 「お礼と言うわけではないですが…別に少しくらいでしたら、私で欲求不満を解消してもいいですよ
PRINTFORM 「はぁ…%CALLNAME_7_0(LOCAL:0)%…あんな気持ち良さそうに…羨ましい…	PRINTFORM 「はぁ…%CALLNAME_7_0(LOCAL:0)%…あんな気持ち良さそうに…羨ましい…
PRINTFORMDW %CALLNAME:(TARGET)%は白く細い指先で自らのクレバスを開き誘っている…	PRINTFORMDW %CALLNAME:(TARGET)%は白く細い指先で自らのクレバスを開き誘っている…
PRINTFORMDW %CALLNAME:(TARGET)%は汁が溢れ出る先端の口に、舌で刺激を与えている…	PRINTFORMDW %CALLNAME:(TARGET)%は汁が溢れ出る先端の口に、舌で刺激を与えている…
PRINTFORMDW %CALLNAME:(TARGET)%は悩まし気に腰をくねらせ、挿入を待ちわびている…	PRINTFORMDW %CALLNAME:(TARGET)%は悩まし気に腰をくねらせ、挿入を待ちわびている…
PRINTFORMDW 触手スーツを傷つけられ、%CALLNAME:(TARGET)%はショックを受けている…	PRINTFORMDW 触手スーツを傷つけられ、%CALLNAME:(TARGET)%はショックを受けている…
PRINTFORMDW 耳元で甘く囁きながら%CALLNAME:(TARGET)%は子宮口を鈴口に押し付けた…	PRINTFORMDW 耳元で甘く囁きながら%CALLNAME:(TARGET)%は子宮口を鈴口に押し付けた…
PRINTFORMDW 子宮にたっぷり精を受け、%CALLNAME:(TARGET)%は多幸感に包まれている…	PRINTFORMDW 子宮にたっぷり精を受け、%CALLNAME:(TARGET)%は多幸感に包まれている…
PRINTFORMDW 口内を蹂躙されたにも関わらず%CALLNAME:(TARGET)%に動じた様子はない…	PRINTFORMDW 口内を蹂躙されたにも関わらず%CALLNAME:(TARGET)%に動じた様子はない…
PRINTFORMW 「近くには居ないですか…早く%CALLNAME_7_0(RESULT)%を探さないと…」	PRINTFORMW 「近くには居ないですか…早く%CALLNAME_7_0(RESULT)%を探さないと…」
PRINTFORMDW %CALLNAME:(TARGET)%は両手で白濁液をすくい上げ、うっとりとしている…	PRINTFORMDW %CALLNAME:(TARGET)%は両手で白濁液をすくい上げ、うっとりとしている…
PRINTFORMW 「……あの、よく考えたんですが。　動ける者を優先した方が助かる確率が高くなりますよね？」	PRINTFORMW 「……あの、よく考えたんですが。　動ける者を優先した方が助かる確率が高くなりますよね？」
PRINTFORM 「私…これがあると困ってしまうんです…なので、申し訳ないのですが…解消のご協力お願いします	PRINTFORM 「私…これがあると困ってしまうんです…なので、申し訳ないのですが…解消のご協力お願いします
PRINTFORMW 「えーと…%CALLNAME_7_0(1)%にシコシコして頂けたら…多分治ると思います」	PRINTFORMW 「えーと…%CALLNAME_7_0(1)%にシコシコして頂けたら…多分治ると思います」
PRINTFORM 「ぜーんぶ…私のナカに注ぎ込んで下さいね、%CALLNAME_7_0(ARG:2, 1)%	PRINTFORM 「ぜーんぶ…私のナカに注ぎ込んで下さいね、%CALLNAME_7_0(ARG:2, 1)%
PRINTFORM 　%CALLNAME_7_0(ARG:0)%の…気持ち良くよがる顔…間近で見させて下さいね	PRINTFORM 　%CALLNAME_7_0(ARG:0)%の…気持ち良くよがる顔…間近で見させて下さいね
PRINTFORMDW %CALLNAME:(ARG:1)%は妖艶な視線で見つめながら見返りに身体を要求した…	PRINTFORMDW %CALLNAME:(ARG:1)%は妖艶な視線で見つめながら見返りに身体を要求した…
PRINTFORMDW 少しでも子宮内に入る様にと%CALLNAME:(ARG:0)%の身体を優しく揺すった…	PRINTFORMDW 少しでも子宮内に入る様にと%CALLNAME:(ARG:0)%の身体を優しく揺すった…
PRINTFORM 「次はきっと…%CALLNAME_7_0(ARG:0)%がイってる時に合わせてみせますから	PRINTFORM 「次はきっと…%CALLNAME_7_0(ARG:0)%がイってる時に合わせてみせますから
PRINTFORMDL 部屋に蠢く触手達は%CALLNAME:(TARGET)%の肉芽だけを執拗に攻めている。	PRINTFORMDL 部屋に蠢く触手達は%CALLNAME:(TARGET)%の肉芽だけを執拗に攻めている。
PRINTFORMDW %CALLNAME:(TARGET)%は腰をくねらせながら自らの身体をまさぐり始める…	PRINTFORMDW %CALLNAME:(TARGET)%は腰をくねらせながら自らの身体をまさぐり始める…
PRINTFORMDW 新たな生命の脈動を感じる己の下腹部を擦りながら、いまだ信じられないといった様子である…	PRINTFORMDW 新たな生命の脈動を感じる己の下腹部を擦りながら、いまだ信じられないといった様子である…
PRINTFORMDW むしろどこか懐かしい様な雰囲気に浸りつつ、小悪魔は周囲の気配を少し集中して探ってみる。	PRINTFORMDW むしろどこか懐かしい様な雰囲気に浸りつつ、小悪魔は周囲の気配を少し集中して探ってみる。
PRINTFORMW 「ん…そこ…ずっと纏わり付かれてると…なんだか…おトイレ行きたくなってきちゃいますね…」	PRINTFORMW 「ん…そこ…ずっと纏わり付かれてると…なんだか…おトイレ行きたくなってきちゃいますね…」
PRINTFORMDW 目の前の%CALLNAME:(TARGET)%との間に、上から大きな岩が落ちてきた。	PRINTFORMDW 目の前の%CALLNAME:(TARGET)%との間に、上から大きな岩が落ちてきた。
PRINTFORM 「そうですねぇ…それじゃあ…%CALLNAME_7_0(1)%の足でコスコスして下さいな	PRINTFORM 「そうですねぇ…それじゃあ…%CALLNAME_7_0(1)%の足でコスコスして下さいな
PRINTFORMW 「…えっ！？　脚に触手が…？　そうですか…遠慮しておこうと思いましたけど、それなら…」	PRINTFORMW 「…えっ！？　脚に触手が…？　そうですか…遠慮しておこうと思いましたけど、それなら…」
PRINTFORMDW 両手を組んで胸元を強調しながら%CALLNAME:(TARGET)%は妖艶に囁いた…	PRINTFORMDW 両手を組んで胸元を強調しながら%CALLNAME:(TARGET)%は妖艶に囁いた…
PRINTFORMDW %CALLNAME:(TARGET)%は尻を突き出し振り返りながら熱い視線を送った…	PRINTFORMDW %CALLNAME:(TARGET)%は尻を突き出し振り返りながら熱い視線を送った…
PRINTFORMDW %CALLNAME:(TARGET)%は妖艶な笑みを浮かべながら、触手を叩いている…	PRINTFORMDW %CALLNAME:(TARGET)%は妖艶な笑みを浮かべながら、触手を叩いている…
PRINTFORM 「%CALLNAME_7_0(ARG:2)%がお望みなのでしたら、後ほど改めて……くすっ	PRINTFORM 「%CALLNAME_7_0(ARG:2)%がお望みなのでしたら、後ほど改めて……くすっ
PRINTFORM 　%CALLNAME_7_0(ARG:2,1)%…こういう風に腰を動かすともっと…くぅん	PRINTFORM 　%CALLNAME_7_0(ARG:2,1)%…こういう風に腰を動かすともっと…くぅん
PRINTFORMDL %CALLNAME:(TARGET)%の身体に不釣合いなほど醜悪に反り返った剛直が、	PRINTFORMDL %CALLNAME:(TARGET)%の身体に不釣合いなほど醜悪に反り返った剛直が、
PRINTFORMDL 慣れない男根への刺激になんとか耐えていた%CALLNAME:(TARGET)%だが、	PRINTFORMDL 慣れない男根への刺激になんとか耐えていた%CALLNAME:(TARGET)%だが、
PRINTFORMDW %CALLNAME:(TARGET)%はパチュリーを庇おうとして落石の直撃を受けた…	PRINTFORMDW %CALLNAME:(TARGET)%はパチュリーを庇おうとして落石の直撃を受けた…
PRINTFORMDW %CALLNAME:(TARGET)%は身動きの取れないまま、露出した尻を犯される…	PRINTFORMDW %CALLNAME:(TARGET)%は身動きの取れないまま、露出した尻を犯される…
PRINTFORMDW %CALLNAME:(TARGET)%は一心不乱に、しかし丁寧に口での奉仕を続ける…	PRINTFORMDW %CALLNAME:(TARGET)%は一心不乱に、しかし丁寧に口での奉仕を続ける…
PRINTFORMW 「もう…仕方ないですね。触手さんに捕まってしまったという事で…大義名分はできました♪」	PRINTFORMW 「もう…仕方ないですね。触手さんに捕まってしまったという事で…大義名分はできました♪」
PRINTFORM 「おや…%CALLNAME_7_0(ARG:0)%の服って、もしかして……うふふふふふ…	PRINTFORM 「おや…%CALLNAME_7_0(ARG:0)%の服って、もしかして……うふふふふふ…
PRINTFORM 「どうです？　この大きいモノが今から%CALLNAME_7_0(ARG:0)%の…ふふっ	PRINTFORM 「どうです？　この大きいモノが今から%CALLNAME_7_0(ARG:0)%の…ふふっ
PRINTFORMW 「%CALLNAME_7_0(ARG:0)%…気持ち良過ぎて腰が抜けちゃいましたか？」	PRINTFORMW 「%CALLNAME_7_0(ARG:0)%…気持ち良過ぎて腰が抜けちゃいましたか？」
PRINTFORMDW %CALLNAME:(ARG:0)%のペニスが抽挿を始めた水音がいやらしく響き渡る…	PRINTFORMDW %CALLNAME:(ARG:0)%のペニスが抽挿を始めた水音がいやらしく響き渡る…
PRINTFORM 　もっと…もっと%CALLNAME_7_0(ARG:0)%の胎内に子種を注ぎ込めってぇ…	PRINTFORM 　もっと…もっと%CALLNAME_7_0(ARG:0)%の胎内に子種を注ぎ込めってぇ…
PRINTFORM 　とても具合が良いですよ、%CALLNAME_7_0(ARG:0)%の膣肉が絡みついて…	PRINTFORM 　とても具合が良いですよ、%CALLNAME_7_0(ARG:0)%の膣肉が絡みついて…
PRINTFORM 　さぁ…%CALLNAME_7_0(ARG:0)%の膣内に…注ぎ込んであげます…ねっっっ	PRINTFORM 　さぁ…%CALLNAME_7_0(ARG:0)%の膣内に…注ぎ込んであげます…ねっっっ
PRINTFORMW 　%CALLNAME_7_0(ARG:0)%の膣内がピクピク悦んでるのが伝わってきて…	PRINTFORMW 　%CALLNAME_7_0(ARG:0)%の膣内がピクピク悦んでるのが伝わってきて…
PRINTFORM 　%CALLNAME_7_0(ARG:0)%…顔にも胸にも…たくさんかかっちゃいましたね	PRINTFORM 　%CALLNAME_7_0(ARG:0)%…顔にも胸にも…たくさんかかっちゃいましたね
PRINTFORMW 「……%CALLNAME_7_0(ARG:1)%……すぐに、助けてさしあげますから…」	PRINTFORMW 「……%CALLNAME_7_0(ARG:1)%……すぐに、助けてさしあげますから…」
PRINTFORM 　%CALLNAME_7_0(GET_ID_FROM_NO(8))%の身体…敏感過ぎです	PRINTFORM 　%CALLNAME_7_0(GET_ID_FROM_NO(8))%の身体…敏感過ぎです
PRINTFORMDW %CALLNAME:(TARGET)%は多数のクナイ型の弾幕を広範囲に撒き散らした	PRINTFORMDW %CALLNAME:(TARGET)%は多数のクナイ型の弾幕を広範囲に撒き散らした
PRINTFORMW 「動けもせず産むだけの存在…快楽ではなく生殖が存在意義とは…間違いなく私の敵です！」	PRINTFORMW 「動けもせず産むだけの存在…快楽ではなく生殖が存在意義とは…間違いなく私の敵です！」
PRINTFORM 　我慢するのもここまでにして…%CALLNAME_7_0(1)%を頂く事にしましょうか	PRINTFORM 　我慢するのもここまでにして…%CALLNAME_7_0(1)%を頂く事にしましょうか
PRINTFORM 「じっくり…ねっとり…可愛がってあげますよ、%CALLNAME_7_0(ARG:2)%	PRINTFORM 「じっくり…ねっとり…可愛がってあげますよ、%CALLNAME_7_0(ARG:2)%
PRINTFORM 「フタナリおちんぽ狂いの%CALLNAME_7_0(ARG:2)%くらいじゃないですか	PRINTFORM 「フタナリおちんぽ狂いの%CALLNAME_7_0(ARG:2)%くらいじゃないですか
PRINTFORMW 「お願いです…%CALLNAME_7_0(LOCAL:0)%の代わりに私の身体を…」	PRINTFORMW 「お願いです…%CALLNAME_7_0(LOCAL:0)%の代わりに私の身体を…」
PRINTFORMW 「%CALLNAME_7_0(LOCAL:0)%に…何をしてるんですか…ッッ！！！」	PRINTFORMW 「%CALLNAME_7_0(LOCAL:0)%に…何をしてるんですか…ッッ！！！」
PRINTFORMDW %CALLNAME:(TARGET)%は弱点を露にして敵を引きつけようとしている…	PRINTFORMDW %CALLNAME:(TARGET)%は弱点を露にして敵を引きつけようとしている…
PRINTFORMDW %CALLNAME:(TARGET)%は指を巧みに絡めながら相手の性器を刺激した…	PRINTFORMDW %CALLNAME:(TARGET)%は指を巧みに絡めながら相手の性器を刺激した…
PRINTFORMDW %CALLNAME:(TARGET)%は口での奉仕を続けたまま、自らを慰めている…	PRINTFORMDW %CALLNAME:(TARGET)%は口での奉仕を続けたまま、自らを慰めている…
PRINTFORMW 「こんな事をして…痛くないんですか？　え？気持ちいい？　それでしたらいいのですが…」	PRINTFORMW 「こんな事をして…痛くないんですか？　え？気持ちいい？　それでしたらいいのですが…」
PRINTFORM 　まるで本物の%CALLNAME_7_0(RESULT)%が私を求めているみたいですよ	PRINTFORM 　まるで本物の%CALLNAME_7_0(RESULT)%が私を求めているみたいですよ
PRINTFORMDW %CALLNAME:(TARGET)%は全ての精を放出して、ぐったりと倒れこんだ…	PRINTFORMDW %CALLNAME:(TARGET)%は全ての精を放出して、ぐったりと倒れこんだ…
PRINTFORMDW %CALLNAME:(TARGET)%は頭の羽を震わせながら、しゃがみ込んでいる…	PRINTFORMDW %CALLNAME:(TARGET)%は頭の羽を震わせながら、しゃがみ込んでいる…
PRINTFORMDW 突如、大量の白濁した液体をかけられ始めた小悪魔は、一瞬驚いた顔を見せたのも束の間…	PRINTFORMDW 突如、大量の白濁した液体をかけられ始めた小悪魔は、一瞬驚いた顔を見せたのも束の間…
PRINTFORMDW %CALLNAME:(TARGET)%は尻尾をぴこぴこと揺らしながら戸惑っている…	PRINTFORMDW %CALLNAME:(TARGET)%は尻尾をぴこぴこと揺らしながら戸惑っている…
PRINTFORM 「%CALLNAME_7_0(ARG:3)%のお尻が私のを飲み込んで…また顔を出して…	PRINTFORM 「%CALLNAME_7_0(ARG:3)%のお尻が私のを飲み込んで…また顔を出して…
PRINTFORMW 「あ……いえ、私が搾り取ってあげたいなぁとか、その事だけ考えていたわけでもなくて…」	PRINTFORMW 「あ……いえ、私が搾り取ってあげたいなぁとか、その事だけ考えていたわけでもなくて…」
PRINTFORMDW %CALLNAME:(TARGET)%は言い訳がましく腰をくねらせ射精を促した……	PRINTFORMDW %CALLNAME:(TARGET)%は言い訳がましく腰をくねらせ射精を促した……
PRINTFORM 「早く…待ちきれません……来て下さい…%CALLNAME_7_0(ARG:0, 1)%	PRINTFORM 「早く…待ちきれません……来て下さい…%CALLNAME_7_0(ARG:0, 1)%
PRINTFORM 　%CALLNAME_7_0(ARG:0)%の逞しいものが…私のナカに挿入ってきます…	PRINTFORM 　%CALLNAME_7_0(ARG:0)%の逞しいものが…私のナカに挿入ってきます…
PRINTFORM 　全部注ぎ込むまで…じっとしていて下さいね、%CALLNAME_7_0(ARG:0)%	PRINTFORM 　全部注ぎ込むまで…じっとしていて下さいね、%CALLNAME_7_0(ARG:0)%
PRINTFORM 「ふぅ、助かりました♪　ではおやすみなさい、%CALLNAME_7_0(ARG:0)%	PRINTFORM 「ふぅ、助かりました♪　ではおやすみなさい、%CALLNAME_7_0(ARG:0)%
PRINTFORMW 「……あ、大丈夫です、私が最初に見張りをしますから…皆さんはお休みになって下さい。」	PRINTFORMW 「……あ、大丈夫です、私が最初に見張りをしますから…皆さんはお休みになって下さい。」
PRINTFORMDL 眠れずにいた%CALLNAME:(TARGET)%は、周囲が寝静まっているのを見て	PRINTFORMDL 眠れずにいた%CALLNAME:(TARGET)%は、周囲が寝静まっているのを見て
PRINTFORMDL 意外と順応が早く、あっさり割り切る%CALLNAME:(TARGET)%であった…	PRINTFORMDL 意外と順応が早く、あっさり割り切る%CALLNAME:(TARGET)%であった…
PRINTFORMDW 自分は本の整理をしていたはずだが、いつのまにかうたた寝でもしてしまったのだろうか？	PRINTFORMDW 自分は本の整理をしていたはずだが、いつのまにかうたた寝でもしてしまったのだろうか？
PRINTFORMDL 触手による強制自慰から、ようやく解放された%CALLNAME:(TARGET)%は	PRINTFORMDL 触手による強制自慰から、ようやく解放された%CALLNAME:(TARGET)%は
PRINTFORMDW 退避を確認すると%CALLNAME:(TARGET)%は周囲に弾幕を展開する！！	PRINTFORMDW 退避を確認すると%CALLNAME:(TARGET)%は周囲に弾幕を展開する！！
PRINTFORMDW 我慢しろと言いつつも%CALLNAME:(TARGET)%は攻めの手を緩めない…	PRINTFORMDW 我慢しろと言いつつも%CALLNAME:(TARGET)%は攻めの手を緩めない…
PRINTFORM 「変態マゾ奴隷の%CALLNAME_7_0(ARG:2)%のためですものね…くすくす	PRINTFORM 「変態マゾ奴隷の%CALLNAME_7_0(ARG:2)%のためですものね…くすくす
PRINTFORM 「触手に捕まったまま犯される…たまにはこういうシチュエーションもイイかもしれませんね	PRINTFORM 「触手に捕まったまま犯される…たまにはこういうシチュエーションもイイかもしれませんね
PRINTFORM 「魔理沙さんっ？！　いつも元気な魔理沙さんが…そんな格好していたら襲われちゃいますよ	PRINTFORM 「魔理沙さんっ？！　いつも元気な魔理沙さんが…そんな格好していたら襲われちゃいますよ
PRINTFORM 「ちゃんと見張りをしますって…もう、なんでそんな疑いの目で見るんですか、パチュリー様	PRINTFORM 「ちゃんと見張りをしますって…もう、なんでそんな疑いの目で見るんですか、パチュリー様
PRINTFORMW 「これ…私のここに…挿入るかしら……って、違います、違いますっ！　攻撃しないと！」	PRINTFORMW 「これ…私のここに…挿入るかしら……って、違います、違いますっ！　攻撃しないと！」
PRINTFORM 「残念…%CALLNAME_7_0(ARG:2)%ったらおちんちん付いてないんですね	PRINTFORM 「残念…%CALLNAME_7_0(ARG:2)%ったらおちんちん付いてないんですね
PRINTFORMW 「魔理沙さんとの弾幕ごっこのために開発した秘密の技ですが…ここで使っちゃいます！」	PRINTFORMW 「魔理沙さんとの弾幕ごっこのために開発した秘密の技ですが…ここで使っちゃいます！」
PRINTFORMW 「戦闘中に魔力を込めて準備するのは少々危険ですが…仕方ないですね、やってみます！」	PRINTFORMW 「戦闘中に魔力を込めて準備するのは少々危険ですが…仕方ないですね、やってみます！」
PRINTFORMDW %CALLNAME:(TARGET)%は大きく張った乳房を無防備にさらけ出した…	PRINTFORMDW %CALLNAME:(TARGET)%は大きく張った乳房を無防備にさらけ出した…
PRINTFORMDW %CALLNAME:(TARGET)%は両手で乳房を抱え、正面からの挿入を誘った	PRINTFORMDW %CALLNAME:(TARGET)%は両手で乳房を抱え、正面からの挿入を誘った
PRINTFORMDW %CALLNAME:(TARGET)%は胸に挟むと同時に口での奉仕も行っている…	PRINTFORMDW %CALLNAME:(TARGET)%は胸に挟むと同時に口での奉仕も行っている…
PRINTFORMDW %CALLNAME:(TARGET)%は腰をくねらせながら、敵に近づいていった…	PRINTFORMDW %CALLNAME:(TARGET)%は腰をくねらせながら、敵に近づいていった…
PRINTFORMDW %CALLNAME:(TARGET)%は胸の谷間から顔を出す触手に口淫を始めた…	PRINTFORMDW %CALLNAME:(TARGET)%は胸の谷間から顔を出す触手に口淫を始めた…
PRINTFORM 「もっと脚を開いて下さい…はい、それで結構です。こうすればより密着できて…くぅ…ぅん	PRINTFORM 「もっと脚を開いて下さい…はい、それで結構です。こうすればより密着できて…くぅ…ぅん
PRINTFORM 「それ…私のここに…下さい……たっぷり…濃い精液で…種付けして…欲しいんです…ぅぅん	PRINTFORM 「それ…私のここに…下さい……たっぷり…濃い精液で…種付けして…欲しいんです…ぅぅん
PRINTFORMDL 触手で口を塞がれたまま呼吸もままならない%CALLNAME:(TARGET)%は	PRINTFORMDL 触手で口を塞がれたまま呼吸もままならない%CALLNAME:(TARGET)%は
PRINTFORMW 「…ぁぅ……加減を…間違えました…射精って思ったより…力を消費…するんですね……」	PRINTFORMW 「…ぁぅ……加減を…間違えました…射精って思ったより…力を消費…するんですね……」
PRINTFORMDW 両手でカップサイズを確かめながら%CALLNAME:(TARGET)%は呟いた…	PRINTFORMDW 両手でカップサイズを確かめながら%CALLNAME:(TARGET)%は呟いた…
PRINTFORMW 「んー……すみませんが私の知る限りでは、そこまで開発された方はここには居ません…」	PRINTFORMW 「んー……すみませんが私の知る限りでは、そこまで開発された方はここには居ません…」
PRINTFORMW 「えーと…%CALLNAME_7_0(ARG:3)%？　宜しければ、今から私と…」	PRINTFORMW 「えーと…%CALLNAME_7_0(ARG:3)%？　宜しければ、今から私と…」
PRINTFORM 　%CALLNAME_7_0(ARG:3)%…おっぱいに出し入れされて…感じてます？	PRINTFORM 　%CALLNAME_7_0(ARG:3)%…おっぱいに出し入れされて…感じてます？
PRINTFORMW 「……解りました、一回だけですよ？　あんまり頑張ると明日に差し支えありますからね」	PRINTFORMW 「……解りました、一回だけですよ？　あんまり頑張ると明日に差し支えありますからね」
PRINTFORM 　%CALLNAME_7_0(ARG:0)%に…受精して頂く必要があるという事ですね	PRINTFORM 　%CALLNAME_7_0(ARG:0)%に…受精して頂く必要があるという事ですね
PRINTFORMW 「あ、パチュリー様。アイテムですか？　もちろん、差し上げるのは構わないのですが…」	PRINTFORMW 「あ、パチュリー様。アイテムですか？　もちろん、差し上げるのは構わないのですが…」
PRINTFORMW 「申し訳ありません。要求の内容自体は、むしろ凄く魅力的なのですが…今はちょっと…」	PRINTFORMW 「申し訳ありません。要求の内容自体は、むしろ凄く魅力的なのですが…今はちょっと…」
PRINTFORM 　%CALLNAME_7_0(ARG:0,1)%…そろそろ…私の方も限界みたいです…	PRINTFORM 　%CALLNAME_7_0(ARG:0,1)%…そろそろ…私の方も限界みたいです…
PRINTFORM 　%CALLNAME_7_0(ARG:0)%の綺麗なお顔が…私の精液でドロドロです…	PRINTFORM 　%CALLNAME_7_0(ARG:0)%の綺麗なお顔が…私の精液でドロドロです…
PRINTFORMW 「……あ、大丈夫です、私が最初に見張りをしますから…どうぞパチュリー様がお先に。」	PRINTFORMW 「……あ、大丈夫です、私が最初に見張りをしますから…どうぞパチュリー様がお先に。」
PRINTFORMW 「パチュリー様、どうぞお先にお休みになられて下さい。私が見張りをいたしますので。」	PRINTFORMW 「パチュリー様、どうぞお先にお休みになられて下さい。私が見張りをいたしますので。」
PRINTFORMW 「大丈夫でしょうか、眠っても……この触手たち、普段は特に何もしてこない様ですが…」	PRINTFORMW 「大丈夫でしょうか、眠っても……この触手たち、普段は特に何もしてこない様ですが…」
PRINTFORMW 「道具を使うのはいささか不本意ではありますが…自分でするのにも限界がありますし…」	PRINTFORMW 「道具を使うのはいささか不本意ではありますが…自分でするのにも限界がありますし…」
PRINTFORMW 「ぁ…行っちゃう…の？　そう…ですよね…私は…繁殖のために使われたんですものね…」	PRINTFORMW 「ぁ…行っちゃう…の？　そう…ですよね…私は…繁殖のために使われたんですものね…」
PRINTFORMW 「…パチュリーさまも見当たりませんし…少しくらい羽を伸ばしてみてもいいですよね…」	PRINTFORMW 「…パチュリーさまも見当たりませんし…少しくらい羽を伸ばしてみてもいいですよね…」
PRINTFORMW 「…ひとまず諦めましょう。下手に刺激しても、暴れられて、こちらが疲れるだけです…」	PRINTFORMW 「…ひとまず諦めましょう。下手に刺激しても、暴れられて、こちらが疲れるだけです…」
PRINTFORMDW %CALLNAME:(TARGET)%は身を震わせながら恍惚の笑みを浮かべている	PRINTFORMDW %CALLNAME:(TARGET)%は身を震わせながら恍惚の笑みを浮かべている
PRINTFORMW 「せっかく美味しいお酒を頂いたのに…私の舌技は味わえてもらえてないのは残念です…」	PRINTFORMW 「せっかく美味しいお酒を頂いたのに…私の舌技は味わえてもらえてないのは残念です…」
PRINTFORMW 「これ以上…我慢できない…申し訳ありません、%CALLNAME_7_0(1)%…」	PRINTFORMW 「これ以上…我慢できない…申し訳ありません、%CALLNAME_7_0(1)%…」
PRINTFORMW 「まずは、%CALLNAME_7_0(1)%自ら、手で御奉仕して頂きましょうか」	PRINTFORMW 「まずは、%CALLNAME_7_0(1)%自ら、手で御奉仕して頂きましょうか」
PRINTFORM 「ほら…私と一緒に…快楽に溺れましょうよ、%CALLNAME_7_0(1, 1)%	PRINTFORM 「ほら…私と一緒に…快楽に溺れましょうよ、%CALLNAME_7_0(1, 1)%
PRINTFORMW 「もう…上のお口でも下のお口でも使っていいんですよ？　それを手がイイだなんて…」	PRINTFORMW 「もう…上のお口でも下のお口でも使っていいんですよ？　それを手がイイだなんて…」
PRINTFORMW 「%CALLNAME_7_0(ARG:2)%に気を使ったつもりだったんですが…」	PRINTFORMW 「%CALLNAME_7_0(ARG:2)%に気を使ったつもりだったんですが…」
PRINTFORM 　迫ってきたのは%CALLNAME_7_0(ARG:2)%の方ですからね…くすくす	PRINTFORM 　迫ってきたのは%CALLNAME_7_0(ARG:2)%の方ですからね…くすくす
PRINTFORMDW 舌舐めずりをして、%CALLNAME:(TARGET)%は魔性の瞳を光らせた…	PRINTFORMDW 舌舐めずりをして、%CALLNAME:(TARGET)%は魔性の瞳を光らせた…
PRINTFORMDW 間髪入れず、%CALLNAME:(TARGET)%の放った射撃が着弾して行く！	PRINTFORMDW 間髪入れず、%CALLNAME:(TARGET)%の放った射撃が着弾して行く！
PRINTFORMW （すみませんパチュリー様……でも、こんな気持ち良くされたら耐えられませんよ……）	PRINTFORMW （すみませんパチュリー様……でも、こんな気持ち良くされたら耐えられませんよ……）
PRINTFORM 「着替えるんですか？　えぇ、マスターのお好きな服装を致しますから少々お待ち下さい…	PRINTFORM 「着替えるんですか？　えぇ、マスターのお好きな服装を致しますから少々お待ち下さい…
PRINTFORM 「%CALLNAME_7_0(ARG:2)%ったら…濡れ過ぎてテラテラ光ってますよ	PRINTFORM 「%CALLNAME_7_0(ARG:2)%ったら…濡れ過ぎてテラテラ光ってますよ
PRINTFORMDW %CALLNAME:(TARGET)%の金色の瞳が妖しく輝き、膣内が蠢きだす！	PRINTFORMDW %CALLNAME:(TARGET)%の金色の瞳が妖しく輝き、膣内が蠢きだす！
PRINTFORMDL %CALLNAME:(TARGET)%の不浄の穴を拡げる様に尻肉を引っ張った…	PRINTFORMDL %CALLNAME:(TARGET)%の不浄の穴を拡げる様に尻肉を引っ張った…
PRINTFORM 「…えっ？　…この…服っ？！　いやいやいや、確かに服の形をしてはいますが…くぅん…	PRINTFORM 「…えっ？　…この…服っ？！　いやいやいや、確かに服の形をしてはいますが…くぅん…
PRINTFORM 「…ずるいですよ…私だって我慢しているのに…そんなわけで引き続き、私とお願いします	PRINTFORM 「…ずるいですよ…私だって我慢しているのに…そんなわけで引き続き、私とお願いします
PRINTFORM 「おやおや？　%CALLNAME_7_0(ARG:3)%が自ら動いてくれるんですか	PRINTFORM 「おやおや？　%CALLNAME_7_0(ARG:3)%が自ら動いてくれるんですか
PRINTFORMDW そう言って%ARGS:1%は焦らす様にゆっくりと%ARGS:0%の尻穴を犯す…	PRINTFORMDW そう言って%ARGS:1%は焦らす様にゆっくりと%ARGS:0%の尻穴を犯す…
PRINTFORM 　我慢できるわけないじゃないですか…そんなに美味しそうな精液の匂いを嗅がせられたら	PRINTFORM 　我慢できるわけないじゃないですか…そんなに美味しそうな精液の匂いを嗅がせられたら
PRINTFORMDW 言い終わる前に、すでに挿入していた%CALLNAME:(TARGET)%だった	PRINTFORMDW 言い終わる前に、すでに挿入していた%CALLNAME:(TARGET)%だった
PRINTFORMW 「んー…その…%CALLNAME_7_0(1)%のお口で舐めて頂けたらな、と…」	PRINTFORMW 「んー…その…%CALLNAME_7_0(1)%のお口で舐めて頂けたらな、と…」
PRINTFORMDW 寝起き直後で意味も分からず%CALLNAME:(ARG:0)%は押し倒された…	PRINTFORMDW 寝起き直後で意味も分からず%CALLNAME:(ARG:0)%は押し倒された…
PRINTFORMDL ゆっくりとスカートをたくし上げた%CALLNAME:(ARG:1)%のそこには	PRINTFORMDL ゆっくりとスカートをたくし上げた%CALLNAME:(ARG:1)%のそこには
PRINTFORMW 「すみません、できれば助けてさしあげたいのですが、こちらもいっぱいいっぱいで…」	PRINTFORMW 「すみません、できれば助けてさしあげたいのですが、こちらもいっぱいいっぱいで…」
PRINTFORMW 「では、私が最初に見張りをしますね。交代時間になった時はよろしくお願いします。」	PRINTFORMW 「では、私が最初に見張りをしますね。交代時間になった時はよろしくお願いします。」
PRINTFORMW 「ちょっとの辛抱です。幸いここの魔物さんの場合、成長が早くて短期間で済みますし」	PRINTFORMW 「ちょっとの辛抱です。幸いここの魔物さんの場合、成長が早くて短期間で済みますし」
PRINTFORM 「こんな場所に誰の荷物でしょう？　おや、これは…随分と際どい下着が出てきましたよ	PRINTFORM 「こんな場所に誰の荷物でしょう？　おや、これは…随分と際どい下着が出てきましたよ
PRINTFORMDW そう呟いて%CALLNAME:(TARGET)%は、股間の剛直をあてがった…	PRINTFORMDW そう呟いて%CALLNAME:(TARGET)%は、股間の剛直をあてがった…
PRINTFORM 「では、一緒に行きましょうか。　触手…使えるんですよね？　いえ、興味がありまして	PRINTFORM 「では、一緒に行きましょうか。　触手…使えるんですよね？　いえ、興味がありまして
PRINTFORM 「このまま…ぐっぽぐっぽってして…膣内でいっぱいびゅくびゅくしてもらっちゃいます	PRINTFORM 「このまま…ぐっぽぐっぽってして…膣内でいっぱいびゅくびゅくしてもらっちゃいます
PRINTFORMDW 身動きできない%ARGS:0%は、ただ快感に満ちた声を上げる事しかできない…	PRINTFORMDW 身動きできない%ARGS:0%は、ただ快感に満ちた声を上げる事しかできない…
PRINTFORM 「あの…ペットに対しておねだりするのもはしたない事ですが…身体が疼いてしまって…	PRINTFORM 「あの…ペットに対しておねだりするのもはしたない事ですが…身体が疼いてしまって…
PRINTFORMDW %CALLNAME:(TARGET)%は妖しげにウインクをして手招いている…	PRINTFORMDW %CALLNAME:(TARGET)%は妖しげにウインクをして手招いている…
PRINTFORMDW %CALLNAME:(TARGET)%は誘い込む様に両脚を大きく開いていく…	PRINTFORMDW %CALLNAME:(TARGET)%は誘い込む様に両脚を大きく開いていく…
PRINTFORMDW %CALLNAME:(TARGET)%はボロボロになった布切れを放り捨てた。	PRINTFORMDW %CALLNAME:(TARGET)%はボロボロになった布切れを放り捨てた。
PRINTFORMDW %CALLNAME:(TARGET)%は物珍しそうに自分の胸部を見下ろした…	PRINTFORMDW %CALLNAME:(TARGET)%は物珍しそうに自分の胸部を見下ろした…
PRINTFORMW 「戦う気ですか…わかりました。どちらの技が優れているか、決着を付けましょうか」	PRINTFORMW 「戦う気ですか…わかりました。どちらの技が優れているか、決着を付けましょうか」
PRINTFORMW 「ごめんなさい、一旦引かせて頂きますね。このままでは全滅してしまいますので…」	PRINTFORMW 「ごめんなさい、一旦引かせて頂きますね。このままでは全滅してしまいますので…」
PRINTFORMW 「はぁ…やっと出れました…けど……これ、入り込まれちゃいましたね、子宮の中…」	PRINTFORMW 「はぁ…やっと出れました…けど……これ、入り込まれちゃいましたね、子宮の中…」
PRINTFORMW 「パチュリー様……その、流石に全員で夢中になってしまいますと…危険ですので…」	PRINTFORMW 「パチュリー様……その、流石に全員で夢中になってしまいますと…危険ですので…」
PRINTFORMW 「んー……深く眠ってるみたいですね。これはちょっとやそっとじゃ起きませんか…」	PRINTFORMW 「んー……深く眠ってるみたいですね。これはちょっとやそっとじゃ起きませんか…」
PRINTFORMW 　%CALLNAME_7_0(ARG:3)%って大きなおっぱいしてますよね…」	PRINTFORMW 　%CALLNAME_7_0(ARG:3)%って大きなおっぱいしてますよね…」
PRINTFORM 「%CALLNAME_7_0(ARG:3)%の膣内に…放出しちゃいますからっっっ	PRINTFORM 「%CALLNAME_7_0(ARG:3)%の膣内に…放出しちゃいますからっっっ
PRINTFORMW 「お困りの様子ですね。仕方ないですよ、恥ずかしがらず処理した方が宜しいかと…」	PRINTFORMW 「お困りの様子ですね。仕方ないですよ、恥ずかしがらず処理した方が宜しいかと…」
PRINTFORMDW %CALLNAME:(TARGET)%は半ば強引に後ろの穴の方へと導いた……	PRINTFORMDW %CALLNAME:(TARGET)%は半ば強引に後ろの穴の方へと導いた……
PRINTFORMW 「これで…宜しいですか？　私の方は別にお口でも他の場所でも構わないのですが…」	PRINTFORMW 「これで…宜しいですか？　私の方は別にお口でも他の場所でも構わないのですが…」
PRINTFORM 「仕方ありません…%CALLNAME_7_0(ARG:0)%、続き…しましょうか	PRINTFORM 「仕方ありません…%CALLNAME_7_0(ARG:0)%、続き…しましょうか
PRINTFORMDL 下着姿の%CALLNAME:(ARG:1)%のショーツに目をやると、そこには	PRINTFORMDL 下着姿の%CALLNAME:(ARG:1)%のショーツに目をやると、そこには
PRINTFORMDL 一糸纏わぬ%CALLNAME:(ARG:1)%の下腹部に目をやると、そこには	PRINTFORMDL 一糸纏わぬ%CALLNAME:(ARG:1)%の下腹部に目をやると、そこには
PRINTFORMDL %CALLNAME:(ARG:1)%は子宮口にぴったりと亀頭を密着させたまま	PRINTFORMDL %CALLNAME:(ARG:1)%は子宮口にぴったりと亀頭を密着させたまま
PRINTFORMDW %CALLNAME:(ARG:0)%は朦朧としたままおずおずと舌を伸ばした…	PRINTFORMDW %CALLNAME:(ARG:0)%は朦朧としたままおずおずと舌を伸ばした…
PRINTFORMW 「……%CALLNAME_7_0(ARG:1)%……すぐに、助けてさしあげ…」	PRINTFORMW 「……%CALLNAME_7_0(ARG:1)%……すぐに、助けてさしあげ…」
PRINTFORMW 「あ、えーと…すぐ行ってしまわれたから名前も付けられなかったですけど、私の…」	PRINTFORMW 「あ、えーと…すぐ行ってしまわれたから名前も付けられなかったですけど、私の…」
PRINTFORMW 「この種…確か基礎能力を上げてくれると、パチュリー様が言っていた物ですよね。」	PRINTFORMW 「この種…確か基礎能力を上げてくれると、パチュリー様が言っていた物ですよね。」
PRINTFORM 　だって%CALLNAME_7_0(GET_ID_FROM_NO(8),1)%…	PRINTFORM 　だって%CALLNAME_7_0(GET_ID_FROM_NO(8),1)%…
PRINTFORMW 「いや、そんなはずは…淫魔の私が…解呪もしていないのに…………妊娠だなんて…」	PRINTFORMW 「いや、そんなはずは…淫魔の私が…解呪もしていないのに…………妊娠だなんて…」
PRINTFORMDL %CALLNAME:(TARGET)%は妊娠した事実自体は受け入れているが、	PRINTFORMDL %CALLNAME:(TARGET)%は妊娠した事実自体は受け入れているが、
PRINTFORMW 「…ふぅ。このお腹…ここ数日の体調不良は、やっぱり妊娠が原因だったんですね…」	PRINTFORMW 「…ふぅ。このお腹…ここ数日の体調不良は、やっぱり妊娠が原因だったんですね…」
PRINTFORMW 「…えーと、パチュリー様のお気遣いはありがたいのですが、だ、大丈夫ですので！」	PRINTFORMW 「…えーと、パチュリー様のお気遣いはありがたいのですが、だ、大丈夫ですので！」
PRINTFORMW 「…まぁ、サキュバスの武器として考えれば有効な面も多々ありますし、いいですか」	PRINTFORMW 「…まぁ、サキュバスの武器として考えれば有効な面も多々ありますし、いいですか」
PRINTFORM 「…ッッ？！　こっ…これ…クリトリス…擦ってる？　あ、脚が…ガクガクしちゃ…ぅ…	PRINTFORM 「…ッッ？！　こっ…これ…クリトリス…擦ってる？　あ、脚が…ガクガクしちゃ…ぅ…
PRINTFORM 「うぅ……パチュリー様…実は私が身を挺して庇ったんですよ？　御褒美…頂けません	PRINTFORM 「うぅ……パチュリー様…実は私が身を挺して庇ったんですよ？　御褒美…頂けません
PRINTFORM 「これからよろしくお願いします。　こんな場所ですし…親睦を深めて行きましょうね	PRINTFORM 「これからよろしくお願いします。　こんな場所ですし…親睦を深めて行きましょうね
PRINTFORM 「ほら…%CALLNAME_7_0(ARG:2)%のおちんちん…飲み込んじゃう	PRINTFORM 「ほら…%CALLNAME_7_0(ARG:2)%のおちんちん…飲み込んじゃう
PRINTFORMW 「あぁ……%CALLNAME_7_0(LOCAL:0)%が…このままじゃ…」	PRINTFORMW 「あぁ……%CALLNAME_7_0(LOCAL:0)%が…このままじゃ…」
PRINTFORMW 「駄目ですよ、おまんこは……本当は私も…欲しいんですけど……駄目なんです！」	PRINTFORMW 「駄目ですよ、おまんこは……本当は私も…欲しいんですけど……駄目なんです！」
PRINTFORMDW %CALLNAME:(TARGET)%は科を作りながら敵に寄りそっている…	PRINTFORMDW %CALLNAME:(TARGET)%は科を作りながら敵に寄りそっている…
PRINTFORMDW %CALLNAME:(TARGET)%は触手に対して甘い口づけを繰り返す…	PRINTFORMDW %CALLNAME:(TARGET)%は触手に対して甘い口づけを繰り返す…
PRINTFORMW 「ふぅ…あの服からも解放されましたけど…いざ無くなるとちょっと寂しいですね」	PRINTFORMW 「ふぅ…あの服からも解放されましたけど…いざ無くなるとちょっと寂しいですね」
PRINTFORMW 「…でもどうやら、ここから出るにはあのゴツいのを倒さないといけない様ですね」	PRINTFORMW 「…でもどうやら、ここから出るにはあのゴツいのを倒さないといけない様ですね」
PRINTFORMW 「また…おちんちんが…搾取する側なのに精液を放出してしまうのは、ちょっと…」	PRINTFORMW 「また…おちんちんが…搾取する側なのに精液を放出してしまうのは、ちょっと…」
PRINTFORM 　とてもイイ…ですよ…続けて下さい…%CALLNAME_7_0(ARG:3)%	PRINTFORM 　とてもイイ…ですよ…続けて下さい…%CALLNAME_7_0(ARG:3)%
PRINTFORM 「ふふっ、精気が足りなかったんですよね。少し分けてあげますよ。方法はもちろん…	PRINTFORM 「ふふっ、精気が足りなかったんですよね。少し分けてあげますよ。方法はもちろん…
PRINTFORM 「これで準備もＯＫです…行きますよ、%CALLNAME_7_0(ARG:0)%	PRINTFORM 「これで準備もＯＫです…行きますよ、%CALLNAME_7_0(ARG:0)%
PRINTFORMDW 本来あるわけのない、ガチガチに勃起した男のシンボルがビクビクと戦慄いていた	PRINTFORMDW 本来あるわけのない、ガチガチに勃起した男のシンボルがビクビクと戦慄いていた
PRINTFORM 「これが…%CALLNAME_7_0(ARG:0)%の膣内に入っていたんですよ	PRINTFORM 「これが…%CALLNAME_7_0(ARG:0)%の膣内に入っていたんですよ
PRINTFORMW 「言われなくても見ればわかるわよ。お久しぶりね魔理沙、と言っておくわ、一応」	PRINTFORMW 「言われなくても見ればわかるわよ。お久しぶりね魔理沙、と言っておくわ、一応」
PRINTFORMW 「……え？　服ですか？　それがボロボロになってしまって、生憎、替えの服も…」	PRINTFORMW 「……え？　服ですか？　それがボロボロになってしまって、生憎、替えの服も…」
PRINTFORMW 「んっ…！　今…お腹の中を蹴って……もう少し…大人しくしていて欲しいです…」	PRINTFORMW 「んっ…！　今…お腹の中を蹴って……もう少し…大人しくしていて欲しいです…」
PRINTFORMW 「……すみません、ちょっと今はあなた方のお相手をしている余裕が無いもので…」	PRINTFORMW 「……すみません、ちょっと今はあなた方のお相手をしている余裕が無いもので…」
PRINTFORMW 「……周囲に敵の気配を感じます。この部屋に入って来た所に奇襲をかけましょう」	PRINTFORMW 「……周囲に敵の気配を感じます。この部屋に入って来た所に奇襲をかけましょう」
PRINTFORMW 「こういう時は、まず自分の居る場所の状態を、しっかり理解するのが肝心ですね」	PRINTFORMW 「こういう時は、まず自分の居る場所の状態を、しっかり理解するのが肝心ですね」
PRINTFORMW 「あー…初期の性格設定を『超強気なセクシーギャル』に変えてしまいましたか…」	PRINTFORMW 「あー…初期の性格設定を『超強気なセクシーギャル』に変えてしまいましたか…」
PRINTFORMW 「パチュリーさまもどこかに居るかもしれないですし、少し探索してみましょうか」	PRINTFORMW 「パチュリーさまもどこかに居るかもしれないですし、少し探索してみましょうか」
PRINTFORMW 「この胸の大きさは…流石にこれほどだと、戦闘などでの機動力は落ちそうですね」	PRINTFORMW 「この胸の大きさは…流石にこれほどだと、戦闘などでの機動力は落ちそうですね」
PRINTFORMW 「っ…まだ…やらなきゃいけないんですか……一人でするのは勿体無いのに…んんっ	PRINTFORMW 「っ…まだ…やらなきゃいけないんですか……一人でするのは勿体無いのに…んんっ
PRINTFORMDL ひゅーひゅーと微かに息の漏れる音を発しながら、指一本動かせず横たわっていた	PRINTFORMDL ひゅーひゅーと微かに息の漏れる音を発しながら、指一本動かせず横たわっていた
PRINTFORMDW 満足した使い魔は、ようやく%CALLNAME:(TARGET)%を解放した	PRINTFORMDW 満足した使い魔は、ようやく%CALLNAME:(TARGET)%を解放した
PRINTFORM 　魔導書で囲んじゃいました♪　じゃあ一斉に…びゅびゅーーってしちゃいましょう	PRINTFORM 　魔導書で囲んじゃいました♪　じゃあ一斉に…びゅびゅーーってしちゃいましょう
PRINTFORMW 「……はぁ。　こういう重い気分の時は…誰でもいいからヤるしかないですね…」	PRINTFORMW 「……はぁ。　こういう重い気分の時は…誰でもいいからヤるしかないですね…」
PRINTFORMDW そう言って%CALLNAME:(TARGET)%は誘う様な目線を向けた…	PRINTFORMDW そう言って%CALLNAME:(TARGET)%は誘う様な目線を向けた…
PRINTFORM 　そんなに私と…シたいんですか？　%CALLNAME_7_0(ARG:2)%	PRINTFORM 　そんなに私と…シたいんですか？　%CALLNAME_7_0(ARG:2)%
PRINTFORMW 「……ふぅ、失礼致しました。魔物が近づいてきたのかと勘違いしてしまって…」	PRINTFORMW 「……ふぅ、失礼致しました。魔物が近づいてきたのかと勘違いしてしまって…」
PRINTFORM 「動きづらくて困っちゃいますね。孕まされた時は…とても気持ち良かったのですが	PRINTFORM 「動きづらくて困っちゃいますね。孕まされた時は…とても気持ち良かったのですが
PRINTFORM 「何か情報を聞かせて欲しい？　そうですねぇ…代わりに貴女の身体を…冗談ですよ	PRINTFORM 「何か情報を聞かせて欲しい？　そうですねぇ…代わりに貴女の身体を…冗談ですよ
PRINTFORMW 「付いて行ってもよろしいのですね、パチュリー様！　ありがとうございます！」	PRINTFORMW 「付いて行ってもよろしいのですね、パチュリー様！　ありがとうございます！」
PRINTFORMW 「あの…失礼なのは重々承知ですが……えぇ、見張っていて頂けると助かります」	PRINTFORMW 「あの…失礼なのは重々承知ですが……えぇ、見張っていて頂けると助かります」
PRINTFORMW 「そうですか…せっかく濃厚なお礼をして差し上げたかったのですが…残念です」	PRINTFORMW 「そうですか…せっかく濃厚なお礼をして差し上げたかったのですが…残念です」
PRINTFORM 　%CALLNAME_7_0(ARG:2)%ったら、おちんぽ勃起させちゃって	PRINTFORM 　%CALLNAME_7_0(ARG:2)%ったら、おちんぽ勃起させちゃって
PRINTFORM 「解ってますよ、%CALLNAME_7_0(ARG:2)%の弱いところは全部	PRINTFORM 「解ってますよ、%CALLNAME_7_0(ARG:2)%の弱いところは全部
PRINTFORM 「今…たーっぷりと…熱くて…どろぉっと濃い元気な子種で満たしてあげますからね	PRINTFORM 「今…たーっぷりと…熱くて…どろぉっと濃い元気な子種で満たしてあげますからね
PRINTFORM 「ほぉんと、全身敏感なんですから、%CALLNAME_7_0(ARG:2)%	PRINTFORM 「ほぉんと、全身敏感なんですから、%CALLNAME_7_0(ARG:2)%
PRINTFORMW 「%CALLNAME_7_0(LOCAL:0)%…すぐに助けますからね…」	PRINTFORMW 「%CALLNAME_7_0(LOCAL:0)%…すぐに助けますからね…」
PRINTFORMW 「うぅ…吐息が漏れて……攻撃の前口上じゃないみたいですけど…集中…集中…」	PRINTFORMW 「うぅ…吐息が漏れて……攻撃の前口上じゃないみたいですけど…集中…集中…」
PRINTFORMDW %CALLNAME:(TARGET)%は口内に舌を這わして刺激を与えた…	PRINTFORMDW %CALLNAME:(TARGET)%は口内に舌を這わして刺激を与えた…
PRINTFORMDW %CALLNAME:(TARGET)%は触手を舐め上げ、先を責めている…	PRINTFORMDW %CALLNAME:(TARGET)%は触手を舐め上げ、先を責めている…
PRINTFORMW 「あら…この服もだいぶほつれて…お裁縫道具でも持ってくれば良かったですね」	PRINTFORMW 「あら…この服もだいぶほつれて…お裁縫道具でも持ってくれば良かったですね」
PRINTFORMW 「うう…全身ぬとぬとです…この辺、身体を洗う場所も、そうは無いんですよ…」	PRINTFORMW 「うう…全身ぬとぬとです…この辺、身体を洗う場所も、そうは無いんですよ…」
PRINTFORMDW 両手で自らの胸を愛撫する様に、ぬるりとした液体を満遍なく塗りつけている…	PRINTFORMDW 両手で自らの胸を愛撫する様に、ぬるりとした液体を満遍なく塗りつけている…
PRINTFORMW 「この押し潰される様な雰囲気…今の私%TACHI()%で勝てるかどうか…」	PRINTFORMW 「この押し潰される様な雰囲気…今の私%TACHI()%で勝てるかどうか…」
PRINTFORMW 「これは確かパチュリー様が言っていた眠気覚ましの…でも今は必要ないですね」	PRINTFORMW 「これは確かパチュリー様が言っていた眠気覚ましの…でも今は必要ないですね」
PRINTFORMDW 喉奥に注ぎ込まれる液体が何か理解した小悪魔は、落ち着いて飲み干している…	PRINTFORMDW 喉奥に注ぎ込まれる液体が何か理解した小悪魔は、落ち着いて飲み干している…
PRINTFORM 「%CALLNAME_7_0(1)%、もしかして…鎮めて頂けるんですか、これ	PRINTFORM 「%CALLNAME_7_0(1)%、もしかして…鎮めて頂けるんですか、これ
PRINTFORM 「おちんちん…生えちゃってると色々と困りますよね？　私を…使ってもいいですよ	PRINTFORM 「おちんちん…生えちゃってると色々と困りますよね？　私を…使ってもいいですよ
PRINTFORM 「いっ……ぱぁい射精しないと、このおちんちん、いつまでも生えたままですからね	PRINTFORM 「いっ……ぱぁい射精しないと、このおちんちん、いつまでも生えたままですからね
PRINTFORMW 「エナジードレインの能力を持っているサキュバスと交わるのは怖い…ですか？」	PRINTFORMW 「エナジードレインの能力を持っているサキュバスと交わるのは怖い…ですか？」
PRINTFORMW 「あら、どこへ行こうというんですか…%CALLNAME_7_0(1)%…」	PRINTFORMW 「あら、どこへ行こうというんですか…%CALLNAME_7_0(1)%…」
PRINTFORMW 「や…触手が…脚に…だ、だめですってばぁ…そんなに左右に大きく開いたら…」	PRINTFORMW 「や…触手が…脚に…だ、だめですってばぁ…そんなに左右に大きく開いたら…」
PRINTFORM 「なんでそんな事するんですかっ！　こっそりするくらいなら…起こして下さいよぉ	PRINTFORM 「なんでそんな事するんですかっ！　こっそりするくらいなら…起こして下さいよぉ
PRINTFORMW 「あ、あの…私としては嬉しいんですが…今は体力を回復させないとこの後が…」	PRINTFORMW 「あ、あの…私としては嬉しいんですが…今は体力を回復させないとこの後が…」
PRINTFORM 「その…濡れほそぼったところに…ずぷずぷずぷぅ…って、挿入っていくんですよ…	PRINTFORM 「その…濡れほそぼったところに…ずぷずぷずぷぅ…って、挿入っていくんですよ…
PRINTFORMW （って、ダメダメ、こんな時こそ気をしっかり持って！　…でも、少しくらい…）	PRINTFORMW （って、ダメダメ、こんな時こそ気をしっかり持って！　…でも、少しくらい…）
PRINTFORML 「付いて行ってもよろしいのですね、パチュリー様！　ありがとうございます！」	PRINTFORML 「付いて行ってもよろしいのですね、パチュリー様！　ありがとうございます！」
PRINTFORMW 「な、なっ、何やってるのっ！！？？　私の身体を勝手に使わないでよ！！！！」	PRINTFORMW 「な、なっ、何やってるのっ！！？？　私の身体を勝手に使わないでよ！！！！」
PRINTFORMW 「…ちょっ！　やめなさいよ小悪魔！！！　その身体は私のでしょっっっ！！！」	PRINTFORMW 「…ちょっ！　やめなさいよ小悪魔！！！　その身体は私のでしょっっっ！！！」
PRINTFORMW 「えぇ…お申し出はありがたいのですが、これくらいは一人で処理できますので」	PRINTFORMW 「えぇ…お申し出はありがたいのですが、これくらいは一人で処理できますので」
PRINTFORMW 「あー…初期の性格設定を『強気なセクシーギャル』に変えてしまいましたか…」	PRINTFORMW 「あー…初期の性格設定を『強気なセクシーギャル』に変えてしまいましたか…」
PRINTFORM 「では、今回のプレイは最初から『淫魔覚醒モード小悪魔』でお相手させて頂きます	PRINTFORM 「では、今回のプレイは最初から『淫魔覚醒モード小悪魔』でお相手させて頂きます
PRINTFORMDW ボソリと呟いた瞬間、小悪魔の身体から淫魔特有の甘いオーラが湧き上がる…！	PRINTFORMDW ボソリと呟いた瞬間、小悪魔の身体から淫魔特有の甘いオーラが湧き上がる…！
PRINTFORMW 「…人が…居ますね。それとこの…強い瘴気………ちょっとまずい事になりそう」	PRINTFORMW 「…人が…居ますね。それとこの…強い瘴気………ちょっとまずい事になりそう」
PRINTFORMW 「…っく？！　えっ…服の中で…おしりっ！！　なんか入って…来てるっっ？！」	PRINTFORMW 「…っく？！　えっ…服の中で…おしりっ！！　なんか入って…来てるっっ？！」
PRINTFORMW 「こんな場所に誰の荷物でしょう？　放っておくのがいいかもしれませんね。」	PRINTFORMW 「こんな場所に誰の荷物でしょう？　放っておくのがいいかもしれませんね。」
PRINTFORM 　そんなに恥ずかしがらなくても…口で抜いてあげるくらい、いつでもいいですよ	PRINTFORM 　そんなに恥ずかしがらなくても…口で抜いてあげるくらい、いつでもいいですよ
PRINTFORMDW %CALLNAME:(TARGET)%は、大きく脚を開いて誘っている…	PRINTFORMDW %CALLNAME:(TARGET)%は、大きく脚を開いて誘っている…
PRINTFORM 「ちょっと名残惜しいですけど……今は他のコトに集中したいので…ごめんなさい	PRINTFORM 「ちょっと名残惜しいですけど……今は他のコトに集中したいので…ごめんなさい
PRINTFORM 「%CALLNAME_7_0(ARG:2)%のおっぱい…大きくて柔らかい…	PRINTFORM 「%CALLNAME_7_0(ARG:2)%のおっぱい…大きくて柔らかい…
PRINTFORM 「ほんと好きモノなんですから、%CALLNAME_7_0(ARG:2)%は	PRINTFORM 「ほんと好きモノなんですから、%CALLNAME_7_0(ARG:2)%は
PRINTFORMW 「あらあら、こんなに愛液を垂れ流して…そんなにおちんぽ欲しいんですか？」	PRINTFORMW 「あらあら、こんなに愛液を垂れ流して…そんなにおちんぽ欲しいんですか？」
PRINTFORM 「%CALLNAME_7_0(ARG:2)%の子宮が…せーえき欲しがってる	PRINTFORM 「%CALLNAME_7_0(ARG:2)%の子宮が…せーえき欲しがってる
PRINTFORM 「もう…乳首…こんなにピンと硬くなってるのに…弄っていただけないんですか？	PRINTFORM 「もう…乳首…こんなにピンと硬くなってるのに…弄っていただけないんですか？
PRINTFORM 　もっと…激しくして下さい…%CALLNAME_7_0(ARG:2,1)%	PRINTFORM 　もっと…激しくして下さい…%CALLNAME_7_0(ARG:2,1)%
PRINTFORMW 「あ……もう…あんまり服の消耗が激しいとパチュリー様に叱られるんですよ」	PRINTFORMW 「あ……もう…あんまり服の消耗が激しいとパチュリー様に叱られるんですよ」
PRINTFORMW 「あれ…身体が動かない…いや、正確には自分の意思で動かせない、ですね…」	PRINTFORMW 「あれ…身体が動かない…いや、正確には自分の意思で動かせない、ですね…」
PRINTFORM 「え…この霧…どうなってるんですか？　なんだか…凄く精で満たされた気分に…	PRINTFORM 「え…この霧…どうなってるんですか？　なんだか…凄く精で満たされた気分に…
PRINTFORMW 「パチュリーさま…すみま…せん……この辺りが…私の…限界…でし…た……」	PRINTFORMW 「パチュリーさま…すみま…せん……この辺りが…私の…限界…でし…た……」
PRINTFORMDW %CALLNAME:(TARGET)%は軽く身体を動かしながら呟いた…	PRINTFORMDW %CALLNAME:(TARGET)%は軽く身体を動かしながら呟いた…
PRINTFORMW 「はぁ……ここの空気に染まってすっかり理性を失っちゃってる様ですね……」	PRINTFORMW 「はぁ……ここの空気に染まってすっかり理性を失っちゃってる様ですね……」
PRINTFORMW 「…………（ふぅ…こんな場所のガス…何の効果があるか判りませんからね）」	PRINTFORMW 「…………（ふぅ…こんな場所のガス…何の効果があるか判りませんからね）」
PRINTFORMW 「…でも……男性側の気持ち良さを身を持って知るのも大事かもしれませんね」	PRINTFORMW 「…でも……男性側の気持ち良さを身を持って知るのも大事かもしれませんね」
PRINTFORM 「早速使って…ぶびゅびゅびゅーーー…っっってザーメン注ぎ込んじゃいましょう	PRINTFORM 「早速使って…ぶびゅびゅびゅーーー…っっってザーメン注ぎ込んじゃいましょう
PRINTFORM 「そんなエッチなおっぱいを使わないのは…勿体無いと思いません？　くすくすっ	PRINTFORM 「そんなエッチなおっぱいを使わないのは…勿体無いと思いません？　くすくすっ
PRINTFORM 「もう…見ていて待ちきれなくて、おちんぽ…我慢汁だらだらだったんですから…	PRINTFORM 「もう…見ていて待ちきれなくて、おちんぽ…我慢汁だらだらだったんですから…
PRINTFORMW 　その状態でしたら…ナニをシても元に戻れば綺麗さっぱり忘れられますよね」	PRINTFORMW 　その状態でしたら…ナニをシても元に戻れば綺麗さっぱり忘れられますよね」
PRINTFORM 「それでは…%CALLNAME_7_0(ARG:3)%が上で…お願いします	PRINTFORM 「それでは…%CALLNAME_7_0(ARG:3)%が上で…お願いします
PRINTFORM 　私…%CALLNAME_7_0(ARG:3)%のおっぱいに包まれたいです	PRINTFORM 　私…%CALLNAME_7_0(ARG:3)%のおっぱいに包まれたいです
PRINTFORMDW そう言って%ARGS:1%は%ARGS:0%の秘所をペニスでかき回す！	PRINTFORMDW そう言って%ARGS:1%は%ARGS:0%の秘所をペニスでかき回す！
PRINTFORM 　見つめてもらいながらシコシコされると…恥ずかしいけど気持ちいいでしょう？	PRINTFORM 　見つめてもらいながらシコシコされると…恥ずかしいけど気持ちいいでしょう？
PRINTFORMW 「見て下さい…私のおちんぽ…こんなにギンギンになっちゃってるんですよ…」	PRINTFORMW 「見て下さい…私のおちんぽ…こんなにギンギンになっちゃってるんですよ…」
PRINTFORMW 「……ふぅ……仕方ないですね、一回だけしたら大人しく寝る。約束ですよ？」	PRINTFORMW 「……ふぅ……仕方ないですね、一回だけしたら大人しく寝る。約束ですよ？」
PRINTFORMW 「ありがとうございます！　%CALLNAME_7_0(ARG:0)%！」	PRINTFORMW 「ありがとうございます！　%CALLNAME_7_0(ARG:0)%！」
PRINTFORM 「%CALLNAME_7_0(ARG:0)%の膣内…ひだの一つ一つが…んぅ	PRINTFORM 「%CALLNAME_7_0(ARG:0)%の膣内…ひだの一つ一つが…んぅ
PRINTFORM 　快楽を…味あわせてあげますよ、%CALLNAME_7_0(ARG:0)%	PRINTFORM 　快楽を…味あわせてあげますよ、%CALLNAME_7_0(ARG:0)%
PRINTFORMW 「え？　困りましたね…こちらもアイテムが余っているわけではないですし…」	PRINTFORMW 「え？　困りましたね…こちらもアイテムが余っているわけではないですし…」
PRINTFORM 「もう少し我慢ができないと…これからイキ過ぎて倒れてしまうかもしれませんよ	PRINTFORM 「もう少し我慢ができないと…これからイキ過ぎて倒れてしまうかもしれませんよ
PRINTFORMW 「貴女…パチュリー様ではないですね？　正体を偽っても私には判りますよ！」	PRINTFORMW 「貴女…パチュリー様ではないですね？　正体を偽っても私には判りますよ！」
PRINTFORMW 「うふふっ、それは危ないところでしたね。でも無事逃げ切れて良かったです」	PRINTFORMW 「うふふっ、それは危ないところでしたね。でも無事逃げ切れて良かったです」
PRINTFORM （パチュリー様に、この手の薬を使ってさしあげると……とても可愛いんですよね	PRINTFORM （パチュリー様に、この手の薬を使ってさしあげると……とても可愛いんですよね
PRINTFORMW 「あ、胸が少し大きく…やっぱり、これくらいの大きさが一番しっくりきます」	PRINTFORMW 「あ、胸が少し大きく…やっぱり、これくらいの大きさが一番しっくりきます」
PRINTFORM 「私が動ける状態でしたら、むしろもっと…存分にお口で愉しませてあげましたよ	PRINTFORM 「私が動ける状態でしたら、むしろもっと…存分にお口で愉しませてあげましたよ
PRINTFORMDW 妖艶な笑みを浮かべながら、%ARGS:0%は漆黒の翼を広げ飛び去った…	PRINTFORMDW 妖艶な笑みを浮かべながら、%ARGS:0%は漆黒の翼を広げ飛び去った…
PRINTFORM 　こんな無防備にお尻を突き出して…犯してくれって言ってる様なものですよね	PRINTFORM 　こんな無防備にお尻を突き出して…犯してくれって言ってる様なものですよね
PRINTFORM 　サキュバスの前にそんな立派なモノを出したら…どうなるか、わかりますよね	PRINTFORM 　サキュバスの前にそんな立派なモノを出したら…どうなるか、わかりますよね
PRINTFORM 　%CALLNAME_7_0(ARG:2)%も生意気に腰を使っちゃってぇ	PRINTFORM 　%CALLNAME_7_0(ARG:2)%も生意気に腰を使っちゃってぇ
PRINTFORMW 「あぁ、私のおちんちんが気になって仕方ないんですね。…舐めてみます？」	PRINTFORMW 「あぁ、私のおちんちんが気になって仕方ないんですね。…舐めてみます？」
PRINTFORMDW %CALLNAME:(TARGET)%は脚を絡めながら耳元で囁いた…	PRINTFORMDW %CALLNAME:(TARGET)%は脚を絡めながら耳元で囁いた…
PRINTFORM 「%CALLNAME_7_0(ARG:1)%じゃないですか。その格好…ん	PRINTFORM 「%CALLNAME_7_0(ARG:1)%じゃないですか。その格好…ん
PRINTFORM 　あぁ…おちんちん…想像しただけでガチガチに硬く勃起してきちゃってます…	PRINTFORM 　あぁ…おちんちん…想像しただけでガチガチに硬く勃起してきちゃってます…
PRINTFORM （私のおちんちんで突き上げたら、どれだけ淫らに堕ちた顔を見せてくれるか…	PRINTFORM （私のおちんちんで突き上げたら、どれだけ淫らに堕ちた顔を見せてくれるか…
PRINTFORMW 「…なるほど。　確かに二手に分かれて探索した方が効率がいいですよね…」	PRINTFORMW 「…なるほど。　確かに二手に分かれて探索した方が効率がいいですよね…」
PRINTFORM 「徐々に…徐々に…%CALLNAME_7_0(ARG:2)%の肌が露に…	PRINTFORM 「徐々に…徐々に…%CALLNAME_7_0(ARG:2)%の肌が露に…
PRINTFORM 「乳首をこんなにしこらせちゃって…そんなに一緒に弄って欲しかったんですか	PRINTFORM 「乳首をこんなにしこらせちゃって…そんなに一緒に弄って欲しかったんですか
PRINTFORMW 「%CALLNAME_7_0(LOCAL:0)%を…離して下さいっ！」	PRINTFORMW 「%CALLNAME_7_0(LOCAL:0)%を…離して下さいっ！」
PRINTFORMW 「もう少しの辛抱です…%CALLNAME_7_0(LOCAL:0)%」	PRINTFORMW 「もう少しの辛抱です…%CALLNAME_7_0(LOCAL:0)%」
PRINTFORMW 「大事なところを狙うのは私としても忍びないのですが…すみませんっ！！」	PRINTFORMW 「大事なところを狙うのは私としても忍びないのですが…すみませんっ！！」
PRINTFORM 「そろそろ精気を分け与えないとですよね、はい、どうぞ私から吸収して下さい	PRINTFORM 「そろそろ精気を分け与えないとですよね、はい、どうぞ私から吸収して下さい
PRINTFORM 「どうです…このたわわに実った胸…見ているだけで吸い付きたくなりません？	PRINTFORM 「どうです…このたわわに実った胸…見ているだけで吸い付きたくなりません？
PRINTFORMDW %CALLNAME:(TARGET)%は柔らかなその唇を押し付けた…	PRINTFORMDW %CALLNAME:(TARGET)%は柔らかなその唇を押し付けた…
PRINTFORMDW %CALLNAME:(TARGET)%は触手を愛おしげに擦っている…	PRINTFORMDW %CALLNAME:(TARGET)%は触手を愛おしげに擦っている…
PRINTFORM 　まぁ…私は種族的に望まぬ妊娠はしないんですが…たっぷり…精液貰いますよ	PRINTFORM 　まぁ…私は種族的に望まぬ妊娠はしないんですが…たっぷり…精液貰いますよ
PRINTFORMDW 上半身一帯に吐き出された白濁液が流れ落ち、豊かな谷間に溜まっていく。	PRINTFORMDW 上半身一帯に吐き出された白濁液が流れ落ち、豊かな谷間に溜まっていく。
PRINTFORMDW 間髪入れず周囲の触手達が、その物欲しそうにヒクつく尻穴に襲い掛かる！	PRINTFORMDW 間髪入れず周囲の触手達が、その物欲しそうにヒクつく尻穴に襲い掛かる！
PRINTFORMW 「うーん、白く濁っていて魅力的ですが…近づくのはやめておきましょうか」	PRINTFORMW 「うーん、白く濁っていて魅力的ですが…近づくのはやめておきましょうか」
PRINTFORMW 「今のスライムは……確かパチュリー様が言っていた服だけ溶かすタイプ…」	PRINTFORMW 「今のスライムは……確かパチュリー様が言っていた服だけ溶かすタイプ…」
PRINTFORMDW 小悪魔はパチュリーの方に向き直って、怪しく蠢く触手スーツを見せつけた	PRINTFORMDW 小悪魔はパチュリーの方に向き直って、怪しく蠢く触手スーツを見せつけた
PRINTFORMW 「あ、私、見張りをしていますから。どうぞ、お一人でなさっていて下さい」	PRINTFORMW 「あ、私、見張りをしていますから。どうぞ、お一人でなさっていて下さい」
PRINTFORM 「…ごめんなさい。ちょっと…限界…みたいで…絶対…悪い様にはしませんから	PRINTFORM 「…ごめんなさい。ちょっと…限界…みたいで…絶対…悪い様にはしませんから
PRINTFORMW 　はぁー…パチュリー…さま……私…抑えられなかったら…ごめんなさい…」	PRINTFORMW 　はぁー…パチュリー…さま……私…抑えられなかったら…ごめんなさい…」
PRINTFORM 「もう…射精した時の気持ち良さを想像しただけで…先っぽから溢れて来ちゃう	PRINTFORM 「もう…射精した時の気持ち良さを想像しただけで…先っぽから溢れて来ちゃう
PRINTFORML 「また…おちんちんが……射精って…結構体力消耗してしまうんですよね…」	PRINTFORML 「また…おちんちんが……射精って…結構体力消耗してしまうんですよね…」
PRINTFORM 　熱いザーメン…びゅくびゅくってたくさん……射精しちゃい…ますッッッッッ	PRINTFORM 　熱いザーメン…びゅくびゅくってたくさん……射精しちゃい…ますッッッッッ
PRINTFORM 「だって、これからは好きなだけ…おまんこにびゅくびゅく射精できるんですよ	PRINTFORM 「だって、これからは好きなだけ…おまんこにびゅくびゅく射精できるんですよ
PRINTFORM 「では、申し訳ないのですが…私のコレ…解消するためにご協力お願いしますね	PRINTFORM 「では、申し訳ないのですが…私のコレ…解消するためにご協力お願いしますね
PRINTFORM 　一番奥まで突き入れると同時に…いっぱいせーえき射精しちゃいますぅッッッ	PRINTFORM 　一番奥まで突き入れると同時に…いっぱいせーえき射精しちゃいますぅッッッ
PRINTFORM 「…でも、エナジードレインって別に膣への挿入時以外でも可能なんですけどね	PRINTFORM 「…でも、エナジードレインって別に膣への挿入時以外でも可能なんですけどね
PRINTFORMW 「では…申し訳ありませんが%CALLNAME_7_0(1)%の足で…」	PRINTFORMW 「では…申し訳ありませんが%CALLNAME_7_0(1)%の足で…」
PRINTFORMW 「いたたた…何かにつまづいたと思ったら…足首に触手が絡まってますね…」	PRINTFORMW 「いたたた…何かにつまづいたと思ったら…足首に触手が絡まってますね…」
PRINTFORMW 「じっとしていて下さい、%CALLNAME_7_0(ARG:3)%…」	PRINTFORMW 「じっとしていて下さい、%CALLNAME_7_0(ARG:3)%…」
PRINTFORMW 「アイテムが必要なんですか？　うーん…差し上げても別にいいのですが…」	PRINTFORMW 「アイテムが必要なんですか？　うーん…差し上げても別にいいのですが…」
PRINTFORMW 「パチュリー様、お体の方は大丈夫ですか？　少しお休みになられた方が…」	PRINTFORMW 「パチュリー様、お体の方は大丈夫ですか？　少しお休みになられた方が…」
PRINTFORMW 「よろしくお願い致します、%CALLNAME_7_0(ARG:1)%」	PRINTFORMW 「よろしくお願い致します、%CALLNAME_7_0(ARG:1)%」
PRINTFORMDW 延々と続く甘い刺激に、こらえ切れず、熱いマグマを噴出そうとしていた…	PRINTFORMDW 延々と続く甘い刺激に、こらえ切れず、熱いマグマを噴出そうとしていた…
PRINTFORMDW パチュリーは自分の身体での痴態を見せられて、たまらずツっこみを入れる	PRINTFORMDW パチュリーは自分の身体での痴態を見せられて、たまらずツっこみを入れる
PRINTFORM 「%CALLNAME_7_0(GET_ID_FROM_NO(8),1)%	PRINTFORM 「%CALLNAME_7_0(GET_ID_FROM_NO(8),1)%
PRINTFORMW 「このお腹の子も相変わらず成長が速いですね…そろそろ動くのに支障が…」	PRINTFORMW 「このお腹の子も相変わらず成長が速いですね…そろそろ動くのに支障が…」
PRINTFORMW 「まずいですね…皆さん疲労が溜まってきてます…早く休養を取らないと…」	PRINTFORMW 「まずいですね…皆さん疲労が溜まってきてます…早く休養を取らないと…」
PRINTFORMW 「あの…パチュリー様…よろしければご一緒させていただきたいのですが…」	PRINTFORMW 「あの…パチュリー様…よろしければご一緒させていただきたいのですが…」
PRINTFORMDW むしろどこか懐かしい様な雰囲気に、小悪魔の中で種族の本能が疼きだす…	PRINTFORMDW むしろどこか懐かしい様な雰囲気に、小悪魔の中で種族の本能が疼きだす…
PRINTFORMW 　はぁ……ここは諦めましょう…せっかく大人しくなってくれたんですし…」	PRINTFORMW 　はぁ……ここは諦めましょう…せっかく大人しくなってくれたんですし…」
PRINTFORMW 「…うわ…新しい服とひとつに？　いったいどういう生き物なんでしょう…」	PRINTFORMW 「…うわ…新しい服とひとつに？　いったいどういう生き物なんでしょう…」
PRINTFORM 「くー…　くー…　………？　…あら…貴方…その触手は…もしかして…んんっ	PRINTFORM 「くー…　くー…　………？　…あら…貴方…その触手は…もしかして…んんっ
PRINTFORMW 「この押し潰される様な雰囲気…覚醒した私とはいえ荷が重そうですよ…」	PRINTFORMW 「この押し潰される様な雰囲気…覚醒した私とはいえ荷が重そうですよ…」
PRINTFORM 「%CALLNAME_7_0(1)%ってば、ぽかーんと口を開けちゃって	PRINTFORM 「%CALLNAME_7_0(1)%ってば、ぽかーんと口を開けちゃって
PRINTFORM 「これがそんなに気になります…？　なんだったら触ってみてもいいんですよ	PRINTFORM 「これがそんなに気になります…？　なんだったら触ってみてもいいんですよ
PRINTFORM 「ふっふっふっ…%CALLNAME_7_0(1)%…逃げても無駄ですよ	PRINTFORM 「ふっふっふっ…%CALLNAME_7_0(1)%…逃げても無駄ですよ
PRINTFORM 　それは危ないところでしたね。でも…捕まっていてもそれはそれで…きっと	PRINTFORM 　それは危ないところでしたね。でも…捕まっていてもそれはそれで…きっと
PRINTFORM 「大丈夫ですよ、魔物には襲われない様に私が見張りをしますから…くすくす	PRINTFORM 「大丈夫ですよ、魔物には襲われない様に私が見張りをしますから…くすくす
PRINTFORMDW %CALLNAME:(TARGET)%は腰を妖艶にくねらせている…	PRINTFORMDW %CALLNAME:(TARGET)%は腰を妖艶にくねらせている…
PRINTFORM 「それなら…もっと寄り添って、もっと凄いコト…してあげちゃいましょうか	PRINTFORM 「それなら…もっと寄り添って、もっと凄いコト…してあげちゃいましょうか
PRINTFORM 「あらあら…こんなにおちんぽギンギンにさせてる女の子なんて居ませんよぉ	PRINTFORM 「あらあら…こんなにおちんぽギンギンにさせてる女の子なんて居ませんよぉ
PRINTFORMDW %ARGS:0%は時折り痙攣しながら、声にならない声をあげている…	PRINTFORMDW %ARGS:0%は時折り痙攣しながら、声にならない声をあげている…
PRINTFORM 　マスターのが…私のおっぱいの間から…顔を出してて…なんだか可愛いです	PRINTFORM 　マスターのが…私のおっぱいの間から…顔を出してて…なんだか可愛いです
PRINTFORM 「…吸うの…止めて…下さ…い……これじゃ……イっ…ちゃうんんんんっっっ	PRINTFORM 「…吸うの…止めて…下さ…い……これじゃ……イっ…ちゃうんんんんっっっ
PRINTFORMDW すでに完熟して芳醇な蜜が溢れている秘穴に、触手達が次々と入り込む…	PRINTFORMDW すでに完熟して芳醇な蜜が溢れている秘穴に、触手達が次々と入り込む…
PRINTFORM 「ははっ……これじゃサキュバス失格かもしれません…でも…別にいいんです	PRINTFORM 「ははっ……これじゃサキュバス失格かもしれません…でも…別にいいんです
PRINTFORM 「わかりました…私のおちんぽで種付けして…元気な赤ちゃん作りましょうか	PRINTFORM 「わかりました…私のおちんぽで種付けして…元気な赤ちゃん作りましょうか
PRINTFORMW 「あれ……%CALLNAME_7_0(ARG:3)%…その目……？」	PRINTFORMW 「あれ……%CALLNAME_7_0(ARG:3)%…その目……？」
PRINTFORMW 　どうですか…？　身体の奥から…気持ちイイのが溢れて来るでしょう？」	PRINTFORMW 　どうですか…？　身体の奥から…気持ちイイのが溢れて来るでしょう？」
PRINTFORM 「それ…私だったら気持ちよく解消させられますけれど…任せて頂けません？	PRINTFORM 「それ…私だったら気持ちよく解消させられますけれど…任せて頂けません？
PRINTFORM 「はぁ…私…我慢できなく…お困りの様ですし…いいですよね、挿入れてもっ	PRINTFORM 「はぁ…私…我慢できなく…お困りの様ですし…いいですよね、挿入れてもっ
PRINTFORMW 「あれ？　あれれっ！？　いつの間にこんな…うっ動けませんよ、これ…」	PRINTFORMW 「あれ？　あれれっ！？　いつの間にこんな…うっ動けませんよ、これ…」
PRINTFORMW 「ちょっ！？　や、やめて下さいよ！！！　服なら脱ぎますからっ！！！」	PRINTFORMW 「ちょっ！？　や、やめて下さいよ！！！　服なら脱ぎますからっ！！！」
PRINTFORM 　%CALLNAME_7_0(ARG:0)%ったら膣内に欲しいんですね	PRINTFORM 　%CALLNAME_7_0(ARG:0)%ったら膣内に欲しいんですね
PRINTFORMW （……助けるにしても、その前に私の方も色々解消させてもらったって…）	PRINTFORMW （……助けるにしても、その前に私の方も色々解消させてもらったって…）
PRINTFORM （…淫魔としての成長を確認するのも、親である私の勤めかもしれませんね…	PRINTFORM （…淫魔としての成長を確認するのも、親である私の勤めかもしれませんね…
PRINTFORM 　駄目…鎮まって…あぁ…ますますガチガチに硬く勃起してきちゃってます…	PRINTFORM 　駄目…鎮まって…あぁ…ますますガチガチに硬く勃起してきちゃってます…
PRINTFORMW 「よろしくお願い致します。私一人の力ではどうにも困っていたもので…」	PRINTFORMW 「よろしくお願い致します。私一人の力ではどうにも困っていたもので…」
PRINTFORMW 「武器…ですか。取っておいてもパチュリー様には必要なさそうですが…」	PRINTFORMW 「武器…ですか。取っておいてもパチュリー様には必要なさそうですが…」
PRINTFORMDW %CALLNAME:(TARGET)%は玩具を丁寧に仕舞い込んだ。	PRINTFORMDW %CALLNAME:(TARGET)%は玩具を丁寧に仕舞い込んだ。
PRINTFORMW 「それにしても…あの姿は、まるで私の小さな頃を見ている様でしたね…」	PRINTFORMW 「それにしても…あの姿は、まるで私の小さな頃を見ている様でしたね…」
PRINTFORMW 「ありがとうございます…え？　お酒も頂けるんですか？　ご馳走様です」	PRINTFORMW 「ありがとうございます…え？　お酒も頂けるんですか？　ご馳走様です」
PRINTFORMW 「ひうぅっ！？　気のせいじゃないですね…スライムがお尻に……んぅ…」	PRINTFORMW 「ひうぅっ！？　気のせいじゃないですね…スライムがお尻に……んぅ…」
PRINTFORM 「私の淫魔の力…攻撃のために魔力集中させるコトも…できちゃうんですよ	PRINTFORM 「私の淫魔の力…攻撃のために魔力集中させるコトも…できちゃうんですよ
PRINTFORM 「焦らして…焦らして…その後に、とびきり強烈なアクメを味わせてあげる	PRINTFORM 「焦らして…焦らして…その後に、とびきり強烈なアクメを味わせてあげる
PRINTFORM 「なんでしたら…たくさんミルクが出せる様に私が種付けしてあげますから	PRINTFORM 「なんでしたら…たくさんミルクが出せる様に私が種付けしてあげますから
PRINTFORMDW %ARGS:0%は大きな快楽に身を震わせながら嬌声を発している…	PRINTFORMDW %ARGS:0%は大きな快楽に身を震わせながら嬌声を発している…
PRINTFORMW （隙を突いて乳首にしゃぶり付くつもりですね…そうは行かないですよ）	PRINTFORMW （隙を突いて乳首にしゃぶり付くつもりですね…そうは行かないですよ）
PRINTFORM 　私…そろそろ我慢できなくなっちゃいます…マスターのが…欲しいんです	PRINTFORM 　私…そろそろ我慢できなくなっちゃいます…マスターのが…欲しいんです
PRINTFORM 「マスター、なんなりとご命令を…もちろん…エッチな事をお願いしますよ	PRINTFORM 「マスター、なんなりとご命令を…もちろん…エッチな事をお願いしますよ
PRINTFORMDL %CALLNAME:(TARGET)%は伏せた顔を真っ赤に染め、	PRINTFORMDL %CALLNAME:(TARGET)%は伏せた顔を真っ赤に染め、
PRINTFORMW 「あの…よろしければ…私のこちらを使っていただけないでしょうか？」	PRINTFORMW 「あの…よろしければ…私のこちらを使っていただけないでしょうか？」
PRINTFORM 「マスター…手を出してくれないのでしたら私の方から…襲っちゃいますよ	PRINTFORM 「マスター…手を出してくれないのでしたら私の方から…襲っちゃいますよ
PRINTFORM 「ほら…サキュバスの癖におちんちん…ギンギンに勃起しちゃってるんです	PRINTFORM 「ほら…サキュバスの癖におちんちん…ギンギンに勃起しちゃってるんです
PRINTFORMW 「その…拘束するだけじゃなくて……いや、だ、駄目ですよ、駄目です」	PRINTFORMW 「その…拘束するだけじゃなくて……いや、だ、駄目ですよ、駄目です」
PRINTFORMDW 白濁液を浴びせかけられた%CALLNAME:(TARGET)%は	PRINTFORMDW 白濁液を浴びせかけられた%CALLNAME:(TARGET)%は
PRINTFORMDW 触手達も負けずに次から次へと肉芽に纏わり、快感を蓄積させていく…	PRINTFORMDW 触手達も負けずに次から次へと肉芽に纏わり、快感を蓄積させていく…
PRINTFORM 「もう…抜け出すのは…無理…でしょうかね……それなら…身を委ねても…	PRINTFORM 「もう…抜け出すのは…無理…でしょうかね……それなら…身を委ねても…
PRINTFORM 「…え？！　あ…パチュリー様……分かりました、お気の済むまで…どうぞ	PRINTFORM 「…え？！　あ…パチュリー様……分かりました、お気の済むまで…どうぞ
PRINTFORM 「…え？！　何を……もう…こんなところで…どうなっても知らないですよ	PRINTFORM 「…え？！　何を……もう…こんなところで…どうなっても知らないですよ
PRINTFORMW 「……はぁ、びっくりしました…………あれ？　なんだか声が違って…」	PRINTFORMW 「……はぁ、びっくりしました…………あれ？　なんだか声が違って…」
PRINTFORMW 「ちょっと小悪魔？　私の身体なんだから変な事するの止めなさいよ？」	PRINTFORMW 「ちょっと小悪魔？　私の身体なんだから変な事するの止めなさいよ？」
PRINTFORMW 「ちょ…ちょっと？！　おちんちんそのものは嫌いではないというか…」	PRINTFORMW 「ちょ…ちょっと？！　おちんちんそのものは嫌いではないというか…」
PRINTFORM 「%CALLNAME_7_0(ARG:3)%のおっぱい…とても温かい	PRINTFORM 「%CALLNAME_7_0(ARG:3)%のおっぱい…とても温かい
PRINTFORM 「私のおちんちん…凄く熱くなってるでしょう？　もう…限界が近いです…	PRINTFORM 「私のおちんちん…凄く熱くなってるでしょう？　もう…限界が近いです…
PRINTFORMW 「もう…ここの空気が魔界に近いからって、何をやっているんですか…」	PRINTFORMW 「もう…ここの空気が魔界に近いからって、何をやっているんですか…」
PRINTFORMDW そう言って%ARGS:1%は%ARGS:0%の触手を引き寄せた…	PRINTFORMDW そう言って%ARGS:1%は%ARGS:0%の触手を引き寄せた…
PRINTFORM 「ふふ…おっぱいで包んだだけで…みんな大人しくなっちゃうんですよねぇ	PRINTFORM 「ふふ…おっぱいで包んだだけで…みんな大人しくなっちゃうんですよねぇ
PRINTFORM 　今回はこっちを…使ってみます？　膣とはまた違った快感が味わえますよ	PRINTFORM 　今回はこっちを…使ってみます？　膣とはまた違った快感が味わえますよ
PRINTFORMW 「それと…今射精されたので…なんだか…子宮の中に…違和感の様な…」	PRINTFORMW 「それと…今射精されたので…なんだか…子宮の中に…違和感の様な…」
PRINTFORM 「いくら私のおまんこが淫魔のそれだからって…流石に射精し過ぎですよぉ	PRINTFORM 「いくら私のおまんこが淫魔のそれだからって…流石に射精し過ぎですよぉ
PRINTFORMW 「あの…意識はあります？　あ、良かった。ちょっと待って下さいね…」	PRINTFORMW 「あの…意識はあります？　あ、良かった。ちょっと待って下さいね…」
PRINTFORMW 「戦闘の時に邪魔になりますし、使ってみるのもいいかもしれませんね」	PRINTFORMW 「戦闘の時に邪魔になりますし、使ってみるのもいいかもしれませんね」
PRINTFORMDW 男性の精を己の糧とするサキュバスとして、これは相当な屈辱である…	PRINTFORMDW 男性の精を己の糧とするサキュバスとして、これは相当な屈辱である…
PRINTFORMW 「では、私はまた探索してきますので。また後ほど、調査が進んだ頃に」	PRINTFORMW 「では、私はまた探索してきますので。また後ほど、調査が進んだ頃に」
PRINTFORMW 　うふふ…そんなに私のミルクが飲みたかったんですか、パチュリー様」	PRINTFORMW 　うふふ…そんなに私のミルクが飲みたかったんですか、パチュリー様」
PRINTFORMW 「ありがとうございます！助かりました！　このご恩は、いずれ必ず！」	PRINTFORMW 「ありがとうございます！助かりました！　このご恩は、いずれ必ず！」
PRINTFORM 　せっかく着れたのですし、どうしても激しい刺激が欲しくなっちゃいます	PRINTFORM 　せっかく着れたのですし、どうしても激しい刺激が欲しくなっちゃいます
PRINTFORM 　おちんちんミルク…欲しいんですか？　いいですよ…そのまま…搾ってっ	PRINTFORM 　おちんちんミルク…欲しいんですか？　いいですよ…そのまま…搾ってっ
PRINTFORMW 「…あら？　スライムが身体に纏わり付いてきて…なんなんですこれ…」	PRINTFORMW 「…あら？　スライムが身体に纏わり付いてきて…なんなんですこれ…」
PRINTFORMW 「ん…　このスライム…なんだかおっぱいをマッサージしてるような…」	PRINTFORMW 「ん…　このスライム…なんだかおっぱいをマッサージしてるような…」
PRINTFORMW 「スライムプレイは別に構わないんですが…常時というのはちょっと…」	PRINTFORMW 「スライムプレイは別に構わないんですが…常時というのはちょっと…」
PRINTFORMW 「こんな何が潜んでいるか判らない泉…無視するのが一番ですよね…」	PRINTFORMW 「こんな何が潜んでいるか判らない泉…無視するのが一番ですよね…」
PRINTFORMW 「…ぁ…パチュリーさまの…寝込みを襲う…チャンスなのに…不覚…」	PRINTFORMW 「…ぁ…パチュリーさまの…寝込みを襲う…チャンスなのに…不覚…」
PRINTFORM 「あ、パチュリー様もいかがですか？　なかなか…気持ち良かったですよ	PRINTFORM 「あ、パチュリー様もいかがですか？　なかなか…気持ち良かったですよ
PRINTFORM 「ほら…舌を伸ばして、%CALLNAME_7_0(ARG:2)%…	PRINTFORM 「ほら…舌を伸ばして、%CALLNAME_7_0(ARG:2)%…
PRINTFORM 「一緒にクリちゃんも…おっぱいの方も…いーっぱい弄ってあげますから	PRINTFORM 「一緒にクリちゃんも…おっぱいの方も…いーっぱい弄ってあげますから
PRINTFORMW 「…って、見惚れちゃいました、ごめんなさい。今なんとかします…」	PRINTFORMW 「…って、見惚れちゃいました、ごめんなさい。今なんとかします…」
PRINTFORM 「乳首からも精気を吸えるんですよね…私もよくやりますから分かります	PRINTFORM 「乳首からも精気を吸えるんですよね…私もよくやりますから分かります
PRINTFORMDW %CALLNAME:(TARGET)%は甘い口づけを繰り返す…	PRINTFORMDW %CALLNAME:(TARGET)%は甘い口づけを繰り返す…
PRINTFORMW 「…っっ？！　す、すみませんパチュリー様、捕まっちゃいました…」	PRINTFORMW 「…っっ？！　す、すみませんパチュリー様、捕まっちゃいました…」
PRINTFORMDW 微弱な刺激と言えども延々と続くその快楽に屈さざるを得ない様だ…	PRINTFORMDW 微弱な刺激と言えども延々と続くその快楽に屈さざるを得ない様だ…
PRINTFORMW 「こんな場所にある泉ですし、何が潜んでいるか判らないですよね…」	PRINTFORMW 「こんな場所にある泉ですし、何が潜んでいるか判らないですよね…」
PRINTFORM 　敏感かどうか調べるためとはいえ…あんなにクリちゃんイジるなんて…	PRINTFORM 　敏感かどうか調べるためとはいえ…あんなにクリちゃんイジるなんて…
PRINTFORMW 「…なんでしょう？　色々ボタンらしき物が付いてるみたいですが…」	PRINTFORMW 「…なんでしょう？　色々ボタンらしき物が付いてるみたいですが…」
PRINTFORM 「ご、ごめんなさいパチュリー様……私…その……ご、ごめんなさいっっ	PRINTFORM 「ご、ごめんなさいパチュリー様……私…その……ご、ごめんなさいっっ
PRINTFORMW 「食べるのは止めておいた方がいいですよね、毒かもしれないですし」	PRINTFORMW 「食べるのは止めておいた方がいいですよね、毒かもしれないですし」
PRINTFORMW 「そんな事をおっしゃられても…今のこの身体の持ち主は私ですし…」	PRINTFORMW 「そんな事をおっしゃられても…今のこの身体の持ち主は私ですし…」
PRINTFORMW 「クリちゃん…気持ちよくして欲しくてヒクヒクしてる…なのに……」	PRINTFORMW 「クリちゃん…気持ちよくして欲しくてヒクヒクしてる…なのに……」
PRINTFORM 「そして膣の中の一番奥目掛けて…溢れるほど子種汁注いであげちゃうっ	PRINTFORM 「そして膣の中の一番奥目掛けて…溢れるほど子種汁注いであげちゃうっ
PRINTFORM 「……あ…おちんぽ…完全に根付いてしまった様ですね…………ふふふふ	PRINTFORM 「……あ…おちんぽ…完全に根付いてしまった様ですね…………ふふふふ
PRINTFORM 「ぐっすり眠ってますね…では、今の内に元気を注入しておいてあげます	PRINTFORM 「ぐっすり眠ってますね…では、今の内に元気を注入しておいてあげます
PRINTFORMW 「私がおちんちんで突き上げる側というのも…気持ちイイでしょう？」	PRINTFORMW 「私がおちんちんで突き上げる側というのも…気持ちイイでしょう？」
PRINTFORMW 「このまま収まりませんよね…その股間を見れば分かりますよ…はい」	PRINTFORMW 「このまま収まりませんよね…その股間を見れば分かりますよ…はい」
PRINTFORM 　素敵です…%CALLNAME_7_0(LOCAL:0, 1)%…	PRINTFORM 　素敵です…%CALLNAME_7_0(LOCAL:0, 1)%…
PRINTFORM 「一回だけ…すっごく気持ちいいのをして…すっきり眠りにつきましょう	PRINTFORM 「一回だけ…すっごく気持ちいいのをして…すっきり眠りにつきましょう
PRINTFORMDL %CALLNAME:(ARG:1)%が腰をくねらせる事により、	PRINTFORMDL %CALLNAME:(ARG:1)%が腰をくねらせる事により、
PRINTFORMW 「……え？　あれだけ強引に絡んでた触手が、放してくれましたね…」	PRINTFORMW 「……え？　あれだけ強引に絡んでた触手が、放してくれましたね…」
PRINTFORM 「それを見せ付けられていて…むしろこちらからお願いしたいくらいで…	PRINTFORM 「それを見せ付けられていて…むしろこちらからお願いしたいくらいで…
PRINTFORM 　ありがとうございます、%CALLNAME_7_0(ARG:0)%	PRINTFORM 　ありがとうございます、%CALLNAME_7_0(ARG:0)%
PRINTFORM 　一緒に…イキましたね、%CALLNAME_7_0(ARG:0)%	PRINTFORM 　一緒に…イキましたね、%CALLNAME_7_0(ARG:0)%
PRINTFORM 　おちんちんが…この娘にずぷずぷってハメたがってビクビクしてます…	PRINTFORM 　おちんちんが…この娘にずぷずぷってハメたがってビクビクしてます…
PRINTFORMW 「パチュリー様っ？！　どうされたんですか…今、助けますからっ！」	PRINTFORMW 「パチュリー様っ？！　どうされたんですか…今、助けますからっ！」
PRINTFORMW 「……このお腹ですか？　ちょっと動くのに不自由ですがなんとか…」	PRINTFORMW 「……このお腹ですか？　ちょっと動くのに不自由ですがなんとか…」
PRINTFORM 「そもそも、夢なら私がとても良い夢を見せてさしあげられますけどね…	PRINTFORM 「そもそも、夢なら私がとても良い夢を見せてさしあげられますけどね…
PRINTFORMW 「パチュリー様…あ、よろしいのですか？　お手数をおかけします…」	PRINTFORMW 「パチュリー様…あ、よろしいのですか？　お手数をおかけします…」
PRINTFORM 　やめて…下さいよぉ…そんなにされると…で、射精ちゃいます…よぉ…	PRINTFORM 　やめて…下さいよぉ…そんなにされると…で、射精ちゃいます…よぉ…
PRINTFORMW 「……駄目ですね…このままでは眠る事すらできそうにありません…」	PRINTFORMW 「……駄目ですね…このままでは眠る事すらできそうにありません…」
PRINTFORMW 「ううっ…やっぱり…これ…本当に……陣…痛？…なんでしょうか…」	PRINTFORMW 「ううっ…やっぱり…これ…本当に……陣…痛？…なんでしょうか…」
PRINTFORMW 「んぅ…痛みが一段と……私また…赤ちゃん…産んじゃうんですね…」	PRINTFORMW 「んぅ…痛みが一段と……私また…赤ちゃん…産んじゃうんですね…」
PRINTFORMW 「まずいですね…疲労が溜まってきてます…早く休養を取らないと…」	PRINTFORMW 「まずいですね…疲労が溜まってきてます…早く休養を取らないと…」
PRINTFORMW 「…あ。　確かに二手に分かれて探索した方が効率がいいですよね…」	PRINTFORMW 「…あ。　確かに二手に分かれて探索した方が効率がいいですよね…」
PRINTFORMW 「あ、パチュリー様はご好意で下さったのですから、気にしなくても」	PRINTFORMW 「あ、パチュリー様はご好意で下さったのですから、気にしなくても」
PRINTFORMDW その瞬間、小悪魔の身体から淫魔特有の甘いオーラが湧き上がる…！	PRINTFORMDW その瞬間、小悪魔の身体から淫魔特有の甘いオーラが湧き上がる…！
PRINTFORMW 「はぁ……これくらいの瘴気で理性を失うとは情けないですね……」	PRINTFORMW 「はぁ……これくらいの瘴気で理性を失うとは情けないですね……」
PRINTFORMW 「こんな場所に誰の荷物でしょう？　中身は………えっ？敵っ！？」	PRINTFORMW 「こんな場所に誰の荷物でしょう？　中身は………えっ？敵っ！？」
PRINTFORM 　どうしたんですか？　%CALLNAME_7_0(ARG:2)%	PRINTFORM 　どうしたんですか？　%CALLNAME_7_0(ARG:2)%
PRINTFORM 「足なんかで…いいんですか？　それじゃあ…おちんちん出して下さい	PRINTFORM 「足なんかで…いいんですか？　それじゃあ…おちんちん出して下さい
PRINTFORM 「あ、私が産んだ…あの時の娘…ですよね？　私にそっくりに育って…	PRINTFORM 「あ、私が産んだ…あの時の娘…ですよね？　私にそっくりに育って…
PRINTFORM 「こちらも、ちょっと先を急いでいて…また、別の機会に…ゆっくりと	PRINTFORM 「こちらも、ちょっと先を急いでいて…また、別の機会に…ゆっくりと
PRINTFORM 「これからよろしくお願いします。　きっとお役に立てますよ…色々と	PRINTFORM 「これからよろしくお願いします。　きっとお役に立てますよ…色々と
PRINTFORM 「んー…ちょっと今は…おっぱい触られちゃうと感じ過ぎてしまうので	PRINTFORM 「んー…ちょっと今は…おっぱい触られちゃうと感じ過ぎてしまうので
PRINTFORM 　まだまだですよ…もぉっといっぱい…膣内に射精してもらいますから	PRINTFORM 　まだまだですよ…もぉっといっぱい…膣内に射精してもらいますから
PRINTFORM 「でも…ちゃぁんと感じて…えっちな気分にならないとダメですからね	PRINTFORM 「でも…ちゃぁんと感じて…えっちな気分にならないとダメですからね
PRINTFORMW 「パチュリー様、私が動きを止めておきますから、お願いします！」	PRINTFORMW 「パチュリー様、私が動きを止めておきますから、お願いします！」
PRINTFORM 　そんなに求められたら…ダメだって解っていても応えちゃいますよぉ	PRINTFORM 　そんなに求められたら…ダメだって解っていても応えちゃいますよぉ
PRINTFORMW 「服…まだ脱がせたいんですか？　もう…待ち切れないのですが…」	PRINTFORMW 「服…まだ脱がせたいんですか？　もう…待ち切れないのですが…」
PRINTFORMW 　だめ…淫魔が孕むなんて…屈辱なのに……でも…この気持ちは…」	PRINTFORMW 　だめ…淫魔が孕むなんて…屈辱なのに……でも…この気持ちは…」
PRINTFORMW 「生憎ですが…私の子宮内は、もう赤ちゃん住んでるんですよ……」	PRINTFORMW 「生憎ですが…私の子宮内は、もう赤ちゃん住んでるんですよ……」
PRINTFORM 　子宮の中…入りきらなくて…ハメられてる隙間から…溢れてきてる…	PRINTFORM 　子宮の中…入りきらなくて…ハメられてる隙間から…溢れてきてる…
PRINTFORM 「…ぅ……駄目……パチュリー様にご迷惑をかけるのだけは……ぅぅん	PRINTFORM 「…ぅ……駄目……パチュリー様にご迷惑をかけるのだけは……ぅぅん
PRINTFORMW 「はぅ…これは…流石にシャワーも無い今は勘弁して欲しいです…」	PRINTFORMW 「はぅ…これは…流石にシャワーも無い今は勘弁して欲しいです…」
PRINTFORMW 「……っ！！　…ふぅ、そう簡単に捕まるわけにはいかないんです」	PRINTFORMW 「……っ！！　…ふぅ、そう簡単に捕まるわけにはいかないんです」
PRINTFORMW 「パチュリー様っ、私の力では…すぐに助けを呼んできますっ！！」	PRINTFORMW 「パチュリー様っ、私の力では…すぐに助けを呼んできますっ！！」
PRINTFORMW 「……ただの水？　気のせいか少し体が軽くなった気はしますが…」	PRINTFORMW 「……ただの水？　気のせいか少し体が軽くなった気はしますが…」
PRINTFORM 「ちょっ？　蟲の大群が？！　や、やだ、なんで下半身ばかり…んんっ	PRINTFORM 「ちょっ？　蟲の大群が？！　や、やだ、なんで下半身ばかり…んんっ
PRINTFORM 　この蟲の舌の動き…カリ首に纏わり付いて…癖になっちゃいそうです	PRINTFORM 　この蟲の舌の動き…カリ首に纏わり付いて…癖になっちゃいそうです
PRINTFORMW 「…パチュリー様……お気を確かに。無事帰ったら、いくらでも…」	PRINTFORMW 「…パチュリー様……お気を確かに。無事帰ったら、いくらでも…」
PRINTFORM 「そうですね。すぐにでも、びゅくびゅく射精しきってしまわないと…	PRINTFORM 「そうですね。すぐにでも、びゅくびゅく射精しきってしまわないと…
PRINTFORMDW 口から涎を垂れ流し惚けた顔で、凄まじい勢いの射精を繰り返す…	PRINTFORMDW 口から涎を垂れ流し惚けた顔で、凄まじい勢いの射精を繰り返す…
PRINTFORM 　%CALLNAME_7_0(ARG:3)%、ビクっとしちゃって	PRINTFORM 　%CALLNAME_7_0(ARG:3)%、ビクっとしちゃって
PRINTFORMW 「な…なにをするんですか…%CALLNAME_7_0(1)%」	PRINTFORMW 「な…なにをするんですか…%CALLNAME_7_0(1)%」
PRINTFORMDW そう言って%ARGS:1%は%ARGS:0%に口淫を促した…	PRINTFORMDW そう言って%ARGS:1%は%ARGS:0%に口淫を促した…
PRINTFORM 「どうすれば良いかですか？　そうですねぇ…手でコスって頂ければと	PRINTFORM 「どうすれば良いかですか？　そうですねぇ…手でコスって頂ければと
PRINTFORM 「ねぇ…お願いしますよ、%CALLNAME_7_0(1, 1)%	PRINTFORM 「ねぇ…お願いしますよ、%CALLNAME_7_0(1, 1)%
PRINTFORM 　これ、下手に刺激しちゃほんと危ないですって…んふぅぅぅんんんッ	PRINTFORM 　これ、下手に刺激しちゃほんと危ないですって…んふぅぅぅんんんッ
PRINTFORMW 「…これは…服同士が……まだ離れさせてもらえないみたいですね」	PRINTFORMW 「…これは…服同士が……まだ離れさせてもらえないみたいですね」
PRINTFORMW 「たぶん…私たちを使って子孫を孕ませるのが目的みたいですし…」	PRINTFORMW 「たぶん…私たちを使って子孫を孕ませるのが目的みたいですし…」
PRINTFORM 「%CALLNAME_7_0(ARG:0)%が、おめでた…きゃっ	PRINTFORM 「%CALLNAME_7_0(ARG:0)%が、おめでた…きゃっ
PRINTFORM 　イっ…ちゃう……%CALLNAME_7_0(ARG:0)%もっ	PRINTFORM 　イっ…ちゃう……%CALLNAME_7_0(ARG:0)%もっ
PRINTFORM 　膣内射精されて一緒にイクと…より美味しい精気が味わえるんです…	PRINTFORM 　膣内射精されて一緒にイクと…より美味しい精気が味わえるんです…
PRINTFORMW （……私の母親…という事は同じ淫魔ですよね。つまり…極上の…）	PRINTFORMW （……私の母親…という事は同じ淫魔ですよね。つまり…極上の…）
PRINTFORMW 「ありがとうございます、早くここを出られる様に頑張りましょう」	PRINTFORMW 「ありがとうございます、早くここを出られる様に頑張りましょう」
PRINTFORMW 「…子宮に寄生だなんて…これ…このままで大丈夫なんですかね…」	PRINTFORMW 「…子宮に寄生だなんて…これ…このままで大丈夫なんですかね…」
PRINTFORMW 「この間たっぷり膣内射精された時に、孕まされたみたい…ですね」	PRINTFORMW 「この間たっぷり膣内射精された時に、孕まされたみたい…ですね」
PRINTFORMW 「…あっ…破水……うっ…産まれちゃっ……ううううぅッッ！！！」	PRINTFORMW 「…あっ…破水……うっ…産まれちゃっ……ううううぅッッ！！！」
PRINTFORMW 「ぁ…行っちゃう…の？　でも…きっとまたいつか…会える日が…」	PRINTFORMW 「ぁ…行っちゃう…の？　でも…きっとまたいつか…会える日が…」
PRINTFORMW …やっと…落ち着いたみたいですね。しかしなんでお酒が魔物に…」	PRINTFORMW …やっと…落ち着いたみたいですね。しかしなんでお酒が魔物に…」
PRINTFORM 「こういう性格にしたという事は…そういうコトですよね…クスクスっ	PRINTFORM 「こういう性格にしたという事は…そういうコトですよね…クスクスっ
PRINTFORMDW 『小悪魔』と言うだけあって、この手の異界の風景に抵抗は無い。	PRINTFORMDW 『小悪魔』と言うだけあって、この手の異界の風景に抵抗は無い。
PRINTFORM 「おちんちん気持ち良過ぎて……ずっと、しゃせー止まらないのぉ……	PRINTFORM 「おちんちん気持ち良過ぎて……ずっと、しゃせー止まらないのぉ……
PRINTFORM 　私のおまんこ…まだもっと気持ち良くなれる余地があったんですね…	PRINTFORM 　私のおまんこ…まだもっと気持ち良くなれる余地があったんですね…
PRINTFORMW 「はう……普通に濡れてるのと違ってずっとぐちょぐちょですね…」	PRINTFORMW 「はう……普通に濡れてるのと違ってずっとぐちょぐちょですね…」
PRINTFORMW 　この触手さん…随分美味しいお酒をご馳走してくれるんですね♪」	PRINTFORMW 　この触手さん…随分美味しいお酒をご馳走してくれるんですね♪」
PRINTFORM 「でも…こんなものを使ってたら寝込みを襲ったりできないですよね	PRINTFORM 「でも…こんなものを使ってたら寝込みを襲ったりできないですよね
PRINTFORM 「もうすぐ…先っぽからくっさいザーメン…吐き出しちゃうんですよ	PRINTFORM 「もうすぐ…先っぽからくっさいザーメン…吐き出しちゃうんですよ
PRINTFORM 「どうしたんですか…くすくす…私のココ…そんな真剣に見ちゃって	PRINTFORM 「どうしたんですか…くすくす…私のココ…そんな真剣に見ちゃって
PRINTFORM 「おくちで…シて欲しいんですか？　仕方がありませんねぇ…ふふっ	PRINTFORM 「おくちで…シて欲しいんですか？　仕方がありませんねぇ…ふふっ
PRINTFORM 「……誰かこの部屋に…近づいてきてる？　可愛いコだといいですね	PRINTFORM 「……誰かこの部屋に…近づいてきてる？　可愛いコだといいですね
PRINTFORMW 「気にしてます？　大丈夫ですよ…じきに大きくなりますから♪」	PRINTFORMW 「気にしてます？　大丈夫ですよ…じきに大きくなりますから♪」
PRINTFORM 「少し堪えて下さいね%CALLNAME_7_0(ARG:2)%	PRINTFORM 「少し堪えて下さいね%CALLNAME_7_0(ARG:2)%
PRINTFORM 「あらあら…クリちゃんこんなに勃起させちゃって…おちんぽみたい	PRINTFORM 「あらあら…クリちゃんこんなに勃起させちゃって…おちんぽみたい
PRINTFORMW 「全魔導書展開……ターゲット捕捉……攻撃…開始ッッッ！！！」	PRINTFORMW 「全魔導書展開……ターゲット捕捉……攻撃…開始ッッッ！！！」
PRINTFORMW 「だめ…です…イっちゃった直後じゃ…力なんて…入りません…」	PRINTFORMW 「だめ…です…イっちゃった直後じゃ…力なんて…入りません…」
PRINTFORM 「おなかが空いているんですね、いいですよ…一緒に愉しみましょう	PRINTFORM 「おなかが空いているんですね、いいですよ…一緒に愉しみましょう
PRINTFORMW 「ふふ…どうです、力強く脈打ってて凄く美味しそうでしょう？」	PRINTFORMW 「ふふ…どうです、力強く脈打ってて凄く美味しそうでしょう？」
PRINTFORM 　仕方ないですよね…欲求不満を解消しないと集中できませんもんね	PRINTFORM 　仕方ないですよね…欲求不満を解消しないと集中できませんもんね
PRINTFORM 「覚悟…して下さいね……たっっっぷりと…搾り取ってあげますから	PRINTFORM 「覚悟…して下さいね……たっっっぷりと…搾り取ってあげますから
PRINTFORMW 「はうぅ……パチュリー様ぁ…倒れてしまったら…すみません…」	PRINTFORMW 「はうぅ……パチュリー様ぁ…倒れてしまったら…すみません…」
PRINTFORM 　いくら他のところが切なくても…やっぱり…ここだけは特別です…	PRINTFORM 　いくら他のところが切なくても…やっぱり…ここだけは特別です…
PRINTFORM 「いやいや…必死に防御をしたけれど手薄を攻められただけですよね	PRINTFORM 「いやいや…必死に防御をしたけれど手薄を攻められただけですよね
PRINTFORM 「でも…欲しいんです…お願いですから…私の身体…犯して下さい…	PRINTFORM 「でも…欲しいんです…お願いですから…私の身体…犯して下さい…
PRINTFORMW 　申し訳ありませんマスター…これ以上は…無理みたいです……」	PRINTFORMW 　申し訳ありませんマスター…これ以上は…無理みたいです……」
PRINTFORMW 「あ…この服…ダメージを受けてますね…ちょっと可哀相かも…」	PRINTFORMW 「あ…この服…ダメージを受けてますね…ちょっと可哀相かも…」
PRINTFORML 「はぁ…流石にこうボロボロだと…むしろ邪魔ですね（ぽいっ）」	PRINTFORML 「はぁ…流石にこうボロボロだと…むしろ邪魔ですね（ぽいっ）」
PRINTFORM 　乳首が…熱い…この触手…案外気持ち良い動き…できるんですね…	PRINTFORM 　乳首が…熱い…この触手…案外気持ち良い動き…できるんですね…
PRINTFORMW 「あっ！！　こ、このままだと…抜け出せなくなっちゃいます…」	PRINTFORMW 「あっ！！　こ、このままだと…抜け出せなくなっちゃいます…」
PRINTFORMW 「…く…こ、こんなところで捕まってるわけには行かないのに…」	PRINTFORMW 「…く…こ、こんなところで捕まってるわけには行かないのに…」
PRINTFORMW 「……ん…ここは……どこかに飛ばされちゃったみたいですね…」	PRINTFORMW 「……ん…ここは……どこかに飛ばされちゃったみたいですね…」
PRINTFORMW 「大丈夫ですかね……あ、美味しいですよこれ、見た目通りに♪」	PRINTFORMW 「大丈夫ですかね……あ、美味しいですよこれ、見た目通りに♪」
PRINTFORMW 「…はぁ。　やめておきましょう、ここでは少々危険過ぎます…」	PRINTFORMW 「…はぁ。　やめておきましょう、ここでは少々危険過ぎます…」
PRINTFORMW （えっ？　ええっ？？？　なんですこれ…スライムが…んんっ！）	PRINTFORMW （えっ？　ええっ？？？　なんですこれ…スライムが…んんっ！）
PRINTFORMW 「おっぱい…揉みしだいて欲しくてドキドキしてるんですよ……」	PRINTFORMW 「おっぱい…揉みしだいて欲しくてドキドキしてるんですよ……」
PRINTFORMW 「…おまんこ…欲しいんですよ…疼いて疼いて仕方ないのに……」	PRINTFORMW 「…おまんこ…欲しいんですよ…疼いて疼いて仕方ないのに……」
PRINTFORMDL ぶびゅるっ！！！ぶびっ！！どびゅるるるるるっっっっ！！！！	PRINTFORMDL ぶびゅるっ！！！ぶびっ！！どびゅるるるるるっっっっ！！！！
PRINTFORM 「そう…誰とでも…パチュリー様にだって…種付けできちゃうんです	PRINTFORM 「そう…誰とでも…パチュリー様にだって…種付けできちゃうんです
PRINTFORMW 「……あの…私も…便乗させてもらっても構わないでしょうか…」	PRINTFORMW 「……あの…私も…便乗させてもらっても構わないでしょうか…」
PRINTFORM 「%CALLNAME_7_0(ARG:3)%…覚悟して下さいね	PRINTFORM 「%CALLNAME_7_0(ARG:3)%…覚悟して下さいね
PRINTFORM 　おっぱいの隙間から…おちんちんが顔を出してとてもいやらしい…	PRINTFORM 　おっぱいの隙間から…おちんちんが顔を出してとてもいやらしい…
PRINTFORMW 「え…ちょ、ちょっと…%CALLNAME_7_0(1)%…」	PRINTFORMW 「え…ちょ、ちょっと…%CALLNAME_7_0(1)%…」
PRINTFORM 「そう…けして乱暴にしないで…お互い気持ちよく…うぅぅんんんッ	PRINTFORM 「そう…けして乱暴にしないで…お互い気持ちよく…うぅぅんんんッ
PRINTFORMW 「暴れないで下さいっ。　ほら、服が肌蹴ちゃってますってば…」	PRINTFORMW 「暴れないで下さいっ。　ほら、服が肌蹴ちゃってますってば…」
PRINTFORM 　そう…%CALLNAME_7_0(ARG:0)%って…上手…	PRINTFORM 　そう…%CALLNAME_7_0(ARG:0)%って…上手…
PRINTFORM 　アイテムなんてどうでもよくなる位…夢見心地にして差し上げます	PRINTFORM 　アイテムなんてどうでもよくなる位…夢見心地にして差し上げます
PRINTFORM 　満足げな顔ですね、%CALLNAME_7_0(ARG:0)%	PRINTFORM 　満足げな顔ですね、%CALLNAME_7_0(ARG:0)%
PRINTFORMW 「いかがでした？　これで心地良く…眠りにつけるでしょうか？」	PRINTFORMW 「いかがでした？　これで心地良く…眠りにつけるでしょうか？」
PRINTFORMW （……私の娘…という事は同じ淫魔ですよね。つまり…極上の…）	PRINTFORMW （……私の娘…という事は同じ淫魔ですよね。つまり…極上の…）
PRINTFORMW 「……はい…大丈夫です。たまにやんちゃして動かれますけど…」	PRINTFORMW 「……はい…大丈夫です。たまにやんちゃして動かれますけど…」
PRINTFORMW 「魔力を増幅するアイテム…是非パチュリー様にお渡ししないと」	PRINTFORMW 「魔力を増幅するアイテム…是非パチュリー様にお渡ししないと」
PRINTFORMW 「この丸薬は…以前パチュリー様が使って…あの時は大変でした」	PRINTFORMW 「この丸薬は…以前パチュリー様が使って…あの時は大変でした」
PRINTFORML 「今のサイズも私本来の役割を発揮するには魅力的なのですが…」	PRINTFORML 「今のサイズも私本来の役割を発揮するには魅力的なのですが…」
PRINTFORMW 「ちょっと危険ですけど見張り無しでぐっすり眠りましょうか…」	PRINTFORMW 「ちょっと危険ですけど見張り無しでぐっすり眠りましょうか…」
PRINTFORMW 　身体が…精気を求めてる……でも今は…一人で我慢しないと…」	PRINTFORMW 　身体が…精気を求めてる……でも今は…一人で我慢しないと…」
PRINTFORMW 　あ…おっぱい…欲しいんですよね？　ん…ほら…ここですよ…」	PRINTFORMW 　あ…おっぱい…欲しいんですよね？　ん…ほら…ここですよ…」
PRINTFORMW 「ぁ…ミルクを吸い終わったばかりなのに、もう行くんですね…」	PRINTFORMW 「ぁ…ミルクを吸い終わったばかりなのに、もう行くんですね…」
PRINTFORM 「ふふ…そうですね…まだもう少し愉しんでいても…大丈夫ですよね	PRINTFORM 「ふふ…そうですね…まだもう少し愉しんでいても…大丈夫ですよね
PRINTFORM 　もう…気持ちいいコト…我慢するのもバカらしくなっちゃいました	PRINTFORM 　もう…気持ちいいコト…我慢するのもバカらしくなっちゃいました
PRINTFORM 　おちんちん…パンパンに膨れ上がっちゃって…早く…射精したい…	PRINTFORM 　おちんちん…パンパンに膨れ上がっちゃって…早く…射精したい…
PRINTFORM 「お酒…飲んでたんでしたっけ…口の中…まだ甘い感じが残ってます	PRINTFORM 「お酒…飲んでたんでしたっけ…口の中…まだ甘い感じが残ってます
PRINTFORM 「いいですよ…こっちだって…ちゃぁんと搾り取ってあげますから	PRINTFORM 「いいですよ…こっちだって…ちゃぁんと搾り取ってあげますから
PRINTFORM 「覚悟して下さい、%CALLNAME_7_0(ARG:2)%	PRINTFORM 「覚悟して下さい、%CALLNAME_7_0(ARG:2)%
PRINTFORM 「あ…こんにちは、%CALLNAME_7_0(ARG:1)%	PRINTFORM 「あ…こんにちは、%CALLNAME_7_0(ARG:1)%
PRINTFORMW 　あ、冗談ですって！一割くらい　…待って！パチュリー様！」	PRINTFORMW 　あ、冗談ですって！一割くらい　…待って！パチュリー様！」
PRINTFORMW 「はぁぁぁぁ……ビィィィィィィィィィムっっっ！！！！！！」	PRINTFORMW 「はぁぁぁぁ……ビィィィィィィィィィムっっっ！！！！！！」
PRINTFORM 「とろっとろに熟した淫魔の極上ヴァギナ…是非味わって下さいよ	PRINTFORM 「とろっとろに熟した淫魔の極上ヴァギナ…是非味わって下さいよ
PRINTFORM 「私を快楽に堕としたいのでしょう？　やってみて下さい、存分に	PRINTFORM 「私を快楽に堕としたいのでしょう？　やってみて下さい、存分に
PRINTFORMW 「ぅ…おちんちんはち切れそう…これ…どうにかして下さい…」	PRINTFORMW 「ぅ…おちんちんはち切れそう…これ…どうにかして下さい…」
PRINTFORM 「ふーん…マスターったら、叩かれて悦ぶんですね、この変態さん	PRINTFORM 「ふーん…マスターったら、叩かれて悦ぶんですね、この変態さん
PRINTFORMW 「服なら着たままでも…そんな事より…ねぇ…お願いします…」	PRINTFORMW 「服なら着たままでも…そんな事より…ねぇ…お願いします…」
PRINTFORM 　こう強烈な臭いを間近で嗅がされてしまうと…疼いちゃいます…	PRINTFORM 　こう強烈な臭いを間近で嗅がされてしまうと…疼いちゃいます…
PRINTFORM 「でも…孕んじゃうのは…淫魔のプライドが……まぁ、いいですか	PRINTFORM 「でも…孕んじゃうのは…淫魔のプライドが……まぁ、いいですか
PRINTFORMW 「あ…だ…駄目…いつものつもりで膣内射精させちゃうと……」	PRINTFORMW 「あ…だ…駄目…いつものつもりで膣内射精させちゃうと……」
PRINTFORM 　焦らさないで…下さい…イキたいんです……ねぇ…お願いです…	PRINTFORM 　焦らさないで…下さい…イキたいんです……ねぇ…お願いです…
PRINTFORMW 「んんっ？！　…んく…ふはぁ……もう…出し終わりました？」	PRINTFORMW 「んんっ？！　…んく…ふはぁ……もう…出し終わりました？」
PRINTFORMW 　私とも…あろう者が……逆に…搾り尽くされる…なんて……」	PRINTFORMW 　私とも…あろう者が……逆に…搾り尽くされる…なんて……」
PRINTFORMW 「身体を覆っているこの触手…だいぶ小さくなって来ましたね」	PRINTFORMW 「身体を覆っているこの触手…だいぶ小さくなって来ましたね」
PRINTFORMW 「…これくらいが普通でしょうか……ギリギリ挟めるのかな？」	PRINTFORMW 「…これくらいが普通でしょうか……ギリギリ挟めるのかな？」
PRINTFORM 　そんなに…クリちゃん刺激されたら……戦ってるのに…手元がっ	PRINTFORM 　そんなに…クリちゃん刺激されたら……戦ってるのに…手元がっ
PRINTFORM 「…んんんっ？！　泉の中…何かが…だ…ダメ…そこ入っちゃ…ぁ	PRINTFORM 「…んんんっ？！　泉の中…何かが…だ…ダメ…そこ入っちゃ…ぁ
PRINTFORMW 「…ぁ…パチュリーさま…お先に失礼…させていただきます…」	PRINTFORMW 「…ぁ…パチュリーさま…お先に失礼…させていただきます…」
PRINTFORMW 「おちんちん…こんなにしてるんだから弄ってくれたって……」	PRINTFORMW 「おちんちん…こんなにしてるんだから弄ってくれたって……」
PRINTFORM 「…あそこに…その太いのが…欲しくて…我慢…できないんです…	PRINTFORM 「…あそこに…その太いのが…欲しくて…我慢…できないんです…
PRINTFORMW 　こんな…の……精を…自分の方から…出してしまうなんて…」	PRINTFORMW 　こんな…の……精を…自分の方から…出してしまうなんて…」
PRINTFORM 「誰でもいいですから…早く…このおちんぽ味合わせてあげたい…	PRINTFORM 「誰でもいいですから…早く…このおちんぽ味合わせてあげたい…
PRINTFORM 「動けなくなってしまいましたか…では、元気を注入してあげます	PRINTFORM 「動けなくなってしまいましたか…では、元気を注入してあげます
PRINTFORM 「%CALLNAME_7_0(ARG:3,1)%…イかせてぇ	PRINTFORM 「%CALLNAME_7_0(ARG:3,1)%…イかせてぇ
PRINTFORM いいですよね、%CALLNAME_7_0(ARG:3,1)%	PRINTFORM いいですよね、%CALLNAME_7_0(ARG:3,1)%
PRINTFORM 「こうやって…おちんちんを胸に擦り付けているだけでも…んんぅ	PRINTFORM 「こうやって…おちんちんを胸に擦り付けているだけでも…んんぅ
PRINTFORM 「せつないです…ねぇ…%CALLNAME_7_0(1,1)%	PRINTFORM 「せつないです…ねぇ…%CALLNAME_7_0(1,1)%
PRINTFORM 　こんなに気持ち良くできるんですから…平和的に使いましょうよ	PRINTFORM 　こんなに気持ち良くできるんですから…平和的に使いましょうよ
PRINTFORM 「だめ…そのおちんぽ見てるだけで…身体が疼いて来ちゃうんです	PRINTFORM 「だめ…そのおちんぽ見てるだけで…身体が疼いて来ちゃうんです
PRINTFORMW 「手で…いいんですか？　せめて口くらい使わせてくれても？」	PRINTFORMW 「手で…いいんですか？　せめて口くらい使わせてくれても？」
PRINTFORM 　射精したくなったら、いつでも私の顔にかけていいですからね…	PRINTFORM 　射精したくなったら、いつでも私の顔にかけていいですからね…
PRINTFORM 　こんなコトされたら…私の方も我慢が…できなくなっちゃいます	PRINTFORM 　こんなコトされたら…私の方も我慢が…できなくなっちゃいます
PRINTFORM 「覚悟して下さい…%CALLNAME_7_0(ARG:0)%	PRINTFORM 「覚悟して下さい…%CALLNAME_7_0(ARG:0)%
PRINTFORMW 「せっかくこちらが要求できる機会ですし……解りますよね？」	PRINTFORMW 「せっかくこちらが要求できる機会ですし……解りますよね？」
PRINTFORMW 「魔理沙さんっ？！　いつもあんなに元気な魔理沙さんが……」	PRINTFORMW 「魔理沙さんっ？！　いつもあんなに元気な魔理沙さんが……」
PRINTFORMW （……私の親…ですか…やっぱり素敵な身体をしていますね…）	PRINTFORMW （……私の親…ですか…やっぱり素敵な身体をしていますね…）
PRINTFORML 「これはパチュリー様のために、大事に取っておきましょうか」	PRINTFORML 「これはパチュリー様のために、大事に取っておきましょうか」
PRINTFORMW 「不死鳥の羽…？　どうしてこんなところにあるんでしょう…」	PRINTFORMW 「不死鳥の羽…？　どうしてこんなところにあるんでしょう…」
PRINTFORMW 「この辺りだったら、見張りを置かないで寝ても大丈夫…かも」	PRINTFORMW 「この辺りだったら、見張りを置かないで寝ても大丈夫…かも」
PRINTFORM 　膣内で…蠢いて…あ…また一本…挿入って…イくぅぅぅッッッッ	PRINTFORM 　膣内で…蠢いて…あ…また一本…挿入って…イくぅぅぅッッッッ
PRINTFORMW 　襲うと後が怖いし…今回は一人で我慢しておきましょうか…」	PRINTFORMW 　襲うと後が怖いし…今回は一人で我慢しておきましょうか…」
PRINTFORML 「妊娠…してますよね。それにしても数日でこんなに大きく…」	PRINTFORML 「妊娠…してますよね。それにしても数日でこんなに大きく…」
PRINTFORM この子…乳首吸うの上手…お母さんミルク…たくさん出ちゃうっっ	PRINTFORM この子…乳首吸うの上手…お母さんミルク…たくさん出ちゃうっっ
PRINTFORMW 「……ん…疲れてますね…けど…先にこの部屋を調べてから…」	PRINTFORMW 「……ん…疲れてますね…けど…先にこの部屋を調べてから…」
PRINTFORMW ……………あれ？　静かになって…もうおしまいなんですか？」	PRINTFORMW ……………あれ？　静かになって…もうおしまいなんですか？」
PRINTFORM 　ありがとうございました、おっぱいマッサージ…良かったですよ	PRINTFORM 　ありがとうございました、おっぱいマッサージ…良かったですよ
PRINTFORM 　もう…終わりですか……クリくらいでしたら、いっそ常時でも…	PRINTFORM 　もう…終わりですか……クリくらいでしたら、いっそ常時でも…
PRINTFORMW 　どうです？サキュバスの膣の中は…たまらないでしょう？」	PRINTFORMW 　どうです？サキュバスの膣の中は…たまらないでしょう？」
PRINTFORM 　これから、いぃっ……ぱぁい、ぴゅっぴゅして貰うんですから	PRINTFORM 　これから、いぃっ……ぱぁい、ぴゅっぴゅして貰うんですから
PRINTFORM 「もう…手でさせるなんて…私は…こっちに欲しいのに…んんっ	PRINTFORM 「もう…手でさせるなんて…私は…こっちに欲しいのに…んんっ
PRINTFORM 「できれば…その手でシコシコシコって擦って頂けると…くすっ	PRINTFORM 「できれば…その手でシコシコシコって擦って頂けると…くすっ
PRINTFORMW 「…あれ？　うっ…動けない？　なんですかこの触手達は…」	PRINTFORMW 「…あれ？　うっ…動けない？　なんですかこの触手達は…」
PRINTFORMW 「こんにちは。他の人に会えると、なんだかほっとしますね」	PRINTFORMW 「こんにちは。他の人に会えると、なんだかほっとしますね」
PRINTFORM 「早く出口を見つけて戻りたい…ですか？　ここはここで…ふふ	PRINTFORM 「早く出口を見つけて戻りたい…ですか？　ここはここで…ふふ
PRINTFORM 「では…ご一緒させて頂きます、パチュリー様♪　うふふふ……	PRINTFORM 「では…ご一緒させて頂きます、パチュリー様♪　うふふふ……
PRINTFORM 「少しでも強くなれれば…それだけ組み伏せ易いというものです	PRINTFORM 「少しでも強くなれれば…それだけ組み伏せ易いというものです
PRINTFORMW 「ありがとうございます、パチュリー様…え？お酒ですか？」	PRINTFORMW 「ありがとうございます、パチュリー様…え？お酒ですか？」
PRINTFORM 「抵抗するなら仕方ないですね…こちらも力づくでシちゃいます	PRINTFORM 「抵抗するなら仕方ないですね…こちらも力づくでシちゃいます
PRINTFORMW 「じっとりと湿って…もう少しほぐした方が良さそうですね」	PRINTFORMW 「じっとりと湿って…もう少しほぐした方が良さそうですね」
PRINTFORM 　%CALLNAME_7_0(ARG:2)%の乳首固過ぎぃ	PRINTFORM 　%CALLNAME_7_0(ARG:2)%の乳首固過ぎぃ
PRINTFORM 「思う存分膣内をかきまわして…いーっぱい種付けしてあげます	PRINTFORM 「思う存分膣内をかきまわして…いーっぱい種付けしてあげます
PRINTFORMW 「私だって…一応悪魔族なんですよ…魔力を集中させれば…」	PRINTFORMW 「私だって…一応悪魔族なんですよ…魔力を集中させれば…」
PRINTFORMW 　クリちゃん…自分で弄っていれば手出しできませんよね…」	PRINTFORMW 　クリちゃん…自分で弄っていれば手出しできませんよね…」
PRINTFORMW 　しかしなんで魔物さんでもおっぱいは好きなんですかね…」	PRINTFORMW 　しかしなんで魔物さんでもおっぱいは好きなんですかね…」
PRINTFORM 　どうしたんですか？　いいんですよ…マスターの好きにしても	PRINTFORM 　どうしたんですか？　いいんですよ…マスターの好きにしても
PRINTFORMW 　このままでは戦えませんから…少しだけ…いいですよね？」	PRINTFORMW 　このままでは戦えませんから…少しだけ…いいですよね？」
PRINTFORMW 「ぐ……これは…不味いです…自分で動けなくなっちゃう…」	PRINTFORMW 「ぐ……これは…不味いです…自分で動けなくなっちゃう…」
PRINTFORMW 「んぅ…いいんですよ？別に脱がさないでしてしまっても…」	PRINTFORMW 「んぅ…いいんですよ？別に脱がさないでしてしまっても…」
PRINTFORM 「お尻の穴でしたら…マスターの太くて長いおちんちんでも…ん	PRINTFORM 「お尻の穴でしたら…マスターの太くて長いおちんちんでも…ん
PRINTFORM 「こ、このままだと…もう…何もかもどうでも良く…はぁんっっ	PRINTFORM 「こ、このままだと…もう…何もかもどうでも良く…はぁんっっ
PRINTFORMDW やがて観念して口内を埋め尽くす多量の粘液の飲み下した…	PRINTFORMDW やがて観念して口内を埋め尽くす多量の粘液の飲み下した…
PRINTFORM 「やっぱりこれだけ注ぎ込まれたら……妊娠………でも……はぁ	PRINTFORM 「やっぱりこれだけ注ぎ込まれたら……妊娠………でも……はぁ
PRINTFORM 「…ぅ……こんな…事で……手が……我慢できない…………はぁ	PRINTFORM 「…ぅ……こんな…事で……手が……我慢できない…………はぁ
PRINTFORM 　これ以上はやめておきましょう…次からは…加減して下さいね	PRINTFORM 　これ以上はやめておきましょう…次からは…加減して下さいね
PRINTFORMW 「あ…下着が丸見え……いやまぁ、別に構わないのですが…」	PRINTFORMW 「あ…下着が丸見え……いやまぁ、別に構わないのですが…」
PRINTFORM 「…ん？　この体勢…もしかして…あ…この子達……ううんっっ	PRINTFORM 「…ん？　この体勢…もしかして…あ…この子達……ううんっっ
PRINTFORMDW 意識はすでに、甘美な快感を生み出す下半身に向いている…	PRINTFORMDW 意識はすでに、甘美な快感を生み出す下半身に向いている…
PRINTFORM 「……あ…しまった…泉の水に何か…だめ…抑えなきゃ…んんっ	PRINTFORM 「……あ…しまった…泉の水に何か…だめ…抑えなきゃ…んんっ
PRINTFORMW 「……私が裸だったので何もできずに帰って行ったんですね」	PRINTFORMW 「……私が裸だったので何もできずに帰って行ったんですね」
PRINTFORMW 「…仕方ないですよね。ちょっと気持ちいいのは我慢我慢…」	PRINTFORMW 「…仕方ないですよね。ちょっと気持ちいいのは我慢我慢…」
PRINTFORM 「ほら真新しくて元気いっぱい♪　見て下さいよ、パチュリー様	PRINTFORM 「ほら真新しくて元気いっぱい♪　見て下さいよ、パチュリー様
PRINTFORM 　そんな焦って激しくしなくても…これからしばらく一緒ですよ	PRINTFORM 　そんな焦って激しくしなくても…これからしばらく一緒ですよ
PRINTFORM 「お願いします…疼いてしまって……欲しいんです、たっぷりと	PRINTFORM 「お願いします…疼いてしまって……欲しいんです、たっぷりと
PRINTFORMW 「お手を煩わせて申し訳ありませんが、お願いいたします。」	PRINTFORMW 「お手を煩わせて申し訳ありませんが、お願いいたします。」
PRINTFORMW 「ごめんなさい、お相手してあげたいのは山々なのですが…」	PRINTFORMW 「ごめんなさい、お相手してあげたいのは山々なのですが…」
PRINTFORMW 「尻尾にも毛が生えてるし形も変わっちゃってますけど…？」	PRINTFORMW 「尻尾にも毛が生えてるし形も変わっちゃってますけど…？」
PRINTFORMW 「私の…こんなに硬くはち切れそうになってるんですから…」	PRINTFORMW 「私の…こんなに硬くはち切れそうになってるんですから…」
PRINTFORMDL びゅくっ！びゅくるるッッ！！！びゅくっ！びゅくっ！！！	PRINTFORMDL びゅくっ！びゅくるるッッ！！！びゅくっ！びゅくっ！！！
PRINTFORM 　ふふ…膣内で震えてますね、いいですよ、すぐイっちゃっても	PRINTFORM 　ふふ…膣内で震えてますね、いいですよ、すぐイっちゃっても
PRINTFORMW 「分かりました、おくちで抜いて差し上げればいいんですね」	PRINTFORMW 「分かりました、おくちで抜いて差し上げればいいんですね」
PRINTFORM 　ちょっとシコシコしちゃっただけで、ビクって反応してますよ	PRINTFORM 　ちょっとシコシコしちゃっただけで、ビクって反応してますよ
PRINTFORMW 「えーと…%CALLNAME_7_0(ARG:2)%？」	PRINTFORMW 「えーと…%CALLNAME_7_0(ARG:2)%？」
PRINTFORM 「この…おちんちんから来る衝動に、どうしても抗えないんです	PRINTFORM 「この…おちんちんから来る衝動に、どうしても抗えないんです
PRINTFORM 　いい…ですよ、%CALLNAME_7_0(ARG:0)%	PRINTFORM 　いい…ですよ、%CALLNAME_7_0(ARG:0)%
PRINTFORM 　もっと…溢れるまで…溢れてもまだ…注ぎ込んであげますから	PRINTFORM 　もっと…溢れるまで…溢れてもまだ…注ぎ込んであげますから
PRINTFORMW 「セックスくらい…好きにさせて欲しいですよ、やっぱり…」	PRINTFORMW 「セックスくらい…好きにさせて欲しいですよ、やっぱり…」
PRINTFORM 　おちんちんが…ずぷずぷってハメたがってビクビクしてます…	PRINTFORM 　おちんちんが…ずぷずぷってハメたがってビクビクしてます…
PRINTFORMW 「アリス様じゃないですか。どうです、そちらのご様子は…」	PRINTFORMW 「アリス様じゃないですか。どうです、そちらのご様子は…」
PRINTFORMW 「……ふぅ…ここ最近微熱が続いている様な気がしますね…」	PRINTFORMW 「……ふぅ…ここ最近微熱が続いている様な気がしますね…」
PRINTFORMW 「避妊の呪術は有効なままなのに…ここの魔物はいったい…」	PRINTFORMW 「避妊の呪術は有効なままなのに…ここの魔物はいったい…」
PRINTFORM 　んもうっ…産まれた時から…乳首を吸うのが上手過ぎますっっ	PRINTFORM 　んもうっ…産まれた時から…乳首を吸うのが上手過ぎますっっ
PRINTFORMW 「今度は…どんな子が………あ、ああぁぁぁっっっ！！！！」	PRINTFORMW 「今度は…どんな子が………あ、ああぁぁぁっっっ！！！！」
PRINTFORMW 「何事も慎重に…パチュリー様にいつも言われてますからね」	PRINTFORMW 「何事も慎重に…パチュリー様にいつも言われてますからね」
PRINTFORML 「ありがとうございます、パチュリー様…え？お酒ですか？」	PRINTFORML 「ありがとうございます、パチュリー様…え？お酒ですか？」
PRINTFORML 「あ、いえいえ、こちらこそ勝手を言ってすみませんでした」	PRINTFORML 「あ、いえいえ、こちらこそ勝手を言ってすみませんでした」
PRINTFORMDW しかし図書館にしては周りの風景が些か禍々しい感がある…	PRINTFORMDW しかし図書館にしては周りの風景が些か禍々しい感がある…
PRINTFORM 　触手さんも元気いっぱいですね♪　またよろしくお願いします	PRINTFORM 　触手さんも元気いっぱいですね♪　またよろしくお願いします
PRINTFORM 　もう…突然お尻にズブリってされたら…驚くじゃないですか…	PRINTFORM 　もう…突然お尻にズブリってされたら…驚くじゃないですか…
PRINTFORM 「…んぅぅっ？！　や…やだ…服の中で…ぐぽぐぽされて…んっ	PRINTFORM 「…んぅぅっ？！　や…やだ…服の中で…ぐぽぐぽされて…んっ
PRINTFORM 　こんなすっごく濃いのは…やっぱりおまんこで頂きたいですね	PRINTFORM 　こんなすっごく濃いのは…やっぱりおまんこで頂きたいですね
PRINTFORM 「…あれ？　スライムが乳首に集まってきてる様な……んくぅっ	PRINTFORM 「…あれ？　スライムが乳首に集まってきてる様な……んくぅっ
PRINTFORM 　%CALLNAME_7_0(1)%の精気…凄く美味しそう	PRINTFORM 　%CALLNAME_7_0(1)%の精気…凄く美味しそう
PRINTFORM …ちゃんと集中できるか…わかりません…が…ヤっちゃいます	PRINTFORM …ちゃんと集中できるか…わかりません…が…ヤっちゃいます
PRINTFORMW 　色々しちゃうために開発した秘密の技…使っちゃいます」	PRINTFORMW 　色々しちゃうために開発した秘密の技…使っちゃいます」
PRINTFORMW 「あ、パチュリー様！　見て下さい、出口らしきものが！」	PRINTFORMW 「あ、パチュリー様！　見て下さい、出口らしきものが！」
PRINTFORMW 「…ぁ…絶頂したわけでもないのに…意識…が…トぶ……」	PRINTFORMW 「…ぁ…絶頂したわけでもないのに…意識…が…トぶ……」
PRINTFORMW 「…あ、こんにちは。貴女もこの迷宮から抜け出せずに？」	PRINTFORMW 「…あ、こんにちは。貴女もこの迷宮から抜け出せずに？」
PRINTFORM （見た感じは普通ですけど…えっちな触手が使えるんですよね	PRINTFORM （見た感じは普通ですけど…えっちな触手が使えるんですよね
PRINTFORM 　早く…どこか…ゆっくり『ご休憩』できる場所を見つけて…	PRINTFORM 　早く…どこか…ゆっくり『ご休憩』できる場所を見つけて…
PRINTFORMW 「ありがとうございます…え？　お酒も頂けるんですか？」	PRINTFORMW 「ありがとうございます…え？　お酒も頂けるんですか？」
PRINTFORMW 「しっかり狙って…だめ、身体が求めちゃう…けど今は…」	PRINTFORMW 「しっかり狙って…だめ、身体が求めちゃう…けど今は…」
PRINTFORM 　どうしたんですか？　物欲しそうにおっぱい震わせちゃって	PRINTFORM 　どうしたんですか？　物欲しそうにおっぱい震わせちゃって
PRINTFORM 「いいです…こうして擦りあっても…魔力は吸い取れますから	PRINTFORM 「いいです…こうして擦りあっても…魔力は吸い取れますから
PRINTFORMW 「すみません、パチュリー様。やっぱり私も下がります…」	PRINTFORMW 「すみません、パチュリー様。やっぱり私も下がります…」
PRINTFORMW 「とっておきの特大魔弾…当たって下さいっっっ！！！！」	PRINTFORMW 「とっておきの特大魔弾…当たって下さいっっっ！！！！」
PRINTFORM 　戦闘中だというのに…こんな事シていていいんですかねぇ…	PRINTFORM 　戦闘中だというのに…こんな事シていていいんですかねぇ…
PRINTFORML 「もうっ…この服にも慣れて具合がよくなってきたのに…」	PRINTFORML 「もうっ…この服にも慣れて具合がよくなってきたのに…」
PRINTFORMW 「あっ…脱げないと思ったこの服も戦闘で弱らせれば…！」	PRINTFORMW 「あっ…脱げないと思ったこの服も戦闘で弱らせれば…！」
PRINTFORMW 「これは…服を狙って…？　足止めのつもりでしょうか…」	PRINTFORMW 「これは…服を狙って…？　足止めのつもりでしょうか…」
PRINTFORM 　いい…おっぱいぎゅぅって締め付けられて…凄く感じちゃう	PRINTFORM 　いい…おっぱいぎゅぅって締め付けられて…凄く感じちゃう
PRINTFORM 　ふはぁ…クリ…そんなに弄られたら…シビれちゃいますっっ	PRINTFORM 　ふはぁ…クリ…そんなに弄られたら…シビれちゃいますっっ
PRINTFORM 　他を抑えていればきっとここを攻めてくれると信じてました	PRINTFORM 　他を抑えていればきっとここを攻めてくれると信じてました
PRINTFORM 「…え…う…嘘…私がこんなに感じさせられちゃうなんて……	PRINTFORM 「…え…う…嘘…私がこんなに感じさせられちゃうなんて……
PRINTFORM 「やりました…！　マスターと私の…赤ちゃんできたんですよ	PRINTFORM 「やりました…！　マスターと私の…赤ちゃんできたんですよ
PRINTFORM 　子宮に居る子も…きっと精液大好きですよね…私と一緒です	PRINTFORM 　子宮に居る子も…きっと精液大好きですよね…私と一緒です
PRINTFORMW 「もしかして…また…孕まされちゃってるんでしょうか…」	PRINTFORMW 「もしかして…また…孕まされちゃってるんでしょうか…」
PRINTFORM 「…ぅ……駄目……皆さんにご迷惑をかけない様に……ぅぅん	PRINTFORM 「…ぅ……駄目……皆さんにご迷惑をかけない様に……ぅぅん
PRINTFORMW 「…えっ？！　なんです、これ…服が…溶けてるっ？？？」	PRINTFORMW 「…えっ？！　なんです、これ…服が…溶けてるっ？？？」
PRINTFORM 「やぁん…また壁から触手…だめ…正気を保たないと…んんぅ	PRINTFORM 「やぁん…また壁から触手…だめ…正気を保たないと…んんぅ
PRINTFORM 「きゃっ？！　壁から触手が…こらっ…やめて下さいっ…んっ	PRINTFORM 「きゃっ？！　壁から触手が…こらっ…やめて下さいっ…んっ
PRINTFORM 　こんな触手だらけだなんて…そこ…入って来ちゃだめ…んぅ	PRINTFORM 　こんな触手だらけだなんて…そこ…入って来ちゃだめ…んぅ
PRINTFORMW 「下っ！　崩れますよっ！　皆さん気を付けて下さいっ！」	PRINTFORMW 「下っ！　崩れますよっ！　皆さん気を付けて下さいっ！」
PRINTFORMW 　はぁ……私のお尻…こんなに敏感になっていたなんて…」	PRINTFORMW 　はぁ……私のお尻…こんなに敏感になっていたなんて…」
PRINTFORMW 　どうでした？　私のおっぱい…お眼鏡に適いましたか？」	PRINTFORMW 　どうでした？　私のおっぱい…お眼鏡に適いましたか？」
PRINTFORMW 「えーと…今の私では多分だめですね。出直してきます。」	PRINTFORMW 「えーと…今の私では多分だめですね。出直してきます。」
PRINTFORM 　いいですよ…今たっぷり…ザーメン射精してあげますからね	PRINTFORM 　いいですよ…今たっぷり…ザーメン射精してあげますからね
PRINTFORMW 「あ…これ…やっ…えぇぇーーーーーーーーーーー………」	PRINTFORMW 「あ…これ…やっ…えぇぇーーーーーーーーーーー………」
PRINTFORMW 　…ミルクが染み出してこなくなりましたね、良かった。」	PRINTFORMW 　…ミルクが染み出してこなくなりましたね、良かった。」
PRINTFORM 「くす…身体が火照って我慢できないのでしょう？　私もです	PRINTFORM 「くす…身体が火照って我慢できないのでしょう？　私もです
PRINTFORMW 「あっ、尻尾が元に戻りました！　頭の耳も消えてますね」	PRINTFORMW 「あっ、尻尾が元に戻りました！　頭の耳も消えてますね」
PRINTFORM 　我慢した分だけ………あぁぁんんっイイのぉぉぉぉぉぉっっ	PRINTFORM 　我慢した分だけ………あぁぁんんっイイのぉぉぉぉぉぉっっ
PRINTFORM 　いかかでした…？　%CALLNAME_7_0(1)%…	PRINTFORM 　いかかでした…？　%CALLNAME_7_0(1)%…
PRINTFORM 　そんなところで横になってしまって…誘っているんですか？	PRINTFORM 　そんなところで横になってしまって…誘っているんですか？
PRINTFORM 「%CALLNAME_7_0(LOCAL:0)%…んぅ…	PRINTFORM 「%CALLNAME_7_0(LOCAL:0)%…んぅ…
PRINTFORM 　触手さんに責められて…大人しくなって頂けたみたいですね	PRINTFORM 　触手さんに責められて…大人しくなって頂けたみたいですね
PRINTFORM 　%CALLNAME_7_0(ARG:0, 1)%…んふ	PRINTFORM 　%CALLNAME_7_0(ARG:0, 1)%…んふ
PRINTFORM 　いいですよ…%CALLNAME_7_0(ARG:0)%	PRINTFORM 　いいですよ…%CALLNAME_7_0(ARG:0)%
PRINTFORM 　膣内…ぢゅぽぢゅぽされながら…触手が全身を…ふぁぅぅぅ	PRINTFORM 　膣内…ぢゅぽぢゅぽされながら…触手が全身を…ふぁぅぅぅ
PRINTFORM 「ぶびゅびゅびゅぅぅぅぅぅっって流れ込んできてますッッッ	PRINTFORM 「ぶびゅびゅびゅぅぅぅぅぅっって流れ込んできてますッッッ
PRINTFORM 　%CALLNAME_7_0(ARG:0)%が…くすくす	PRINTFORM 　%CALLNAME_7_0(ARG:0)%が…くすくす
PRINTFORMW 「パチュリー様っ？！　どうされたんですか…今、助け…」	PRINTFORMW 「パチュリー様っ？！　どうされたんですか…今、助け…」
PRINTFORMW 「あら、レミィ。…流石の貴女もだいぶ苦戦している様ね」	PRINTFORMW 「あら、レミィ。…流石の貴女もだいぶ苦戦している様ね」
PRINTFORMW 「えーっと、まずは何からお話すればいいでしょうか……」	PRINTFORMW 「えーっと、まずは何からお話すればいいでしょうか……」
PRINTFORMW 「武器の…弾ですね。補充して使うためのものみたいです」	PRINTFORMW 「武器の…弾ですね。補充して使うためのものみたいです」
PRINTFORMW 　この疼きを自分で治めるのは…不本意ではありますが…」	PRINTFORMW 　この疼きを自分で治めるのは…不本意ではありますが…」
PRINTFORMW 「ここの魔物で受精した場合、成長が速いのでしょうか…」	PRINTFORMW 「ここの魔物で受精した場合、成長が速いのでしょうか…」
PRINTFORMW 「…はぁ…っはぁ…　この…子が…私の…初めての………」	PRINTFORMW 「…はぁ…っはぁ…　この…子が…私の…初めての………」
PRINTFORMW 「これは…お掃除しないと休むのにも不自由しそうですね」	PRINTFORMW 「これは…お掃除しないと休むのにも不自由しそうですね」
PRINTFORMW 　早く…どこか一人になれる所を見つけて…鎮めないと…」	PRINTFORMW 　早く…どこか一人になれる所を見つけて…鎮めないと…」
PRINTFORMW 「迂闊に動くのは危険ですね…待ち構えて撃退しましょう」	PRINTFORMW 「迂闊に動くのは危険ですね…待ち構えて撃退しましょう」
PRINTFORMW 「ここにも何かアイテムがありそうですね、調べましょう」	PRINTFORMW 「ここにも何かアイテムがありそうですね、調べましょう」
PRINTFORMW 「助けていただいただけでも、ありがとうございました。」	PRINTFORMW 「助けていただいただけでも、ありがとうございました。」
PRINTFORMW 　胸が張って苦しかったところでしたので、助かりました」	PRINTFORMW 　胸が張って苦しかったところでしたので、助かりました」
PRINTFORM 「暴れなければ普通の服と同じ…でも…激しくしてくれた方が	PRINTFORM 「暴れなければ普通の服と同じ…でも…激しくしてくれた方が
PRINTFORM 　胸のところが…んっ……も…揉まれてるみたいに…んふぅ…	PRINTFORM 　胸のところが…んっ……も…揉まれてるみたいに…んふぅ…
PRINTFORMW 「……あ、これもしかして…母乳が染み出してきてます？」	PRINTFORMW 「……あ、これもしかして…母乳が染み出してきてます？」
PRINTFORML 「……もう…別に無理やりでなくても良かったんですよ…」	PRINTFORML 「……もう…別に無理やりでなくても良かったんですよ…」
PRINTFORM 「えぇ、イニシアチブを渡すのは…あまり好きじゃないので	PRINTFORM 「えぇ、イニシアチブを渡すのは…あまり好きじゃないので
PRINTFORM 「…でもどうやら、ここから出るにはあのゴツいのを…んふ	PRINTFORM 「…でもどうやら、ここから出るにはあのゴツいのを…んふ
PRINTFORMW 「あれは…この辺りの怪物を産み出しているんですね。」	PRINTFORMW 「あれは…この辺りの怪物を産み出しているんですね。」
PRINTFORM 　身体が火照って…なんだかいい気分になってきましたよ…	PRINTFORM 　身体が火照って…なんだかいい気分になってきましたよ…
PRINTFORMW 「これは確かパチュリー様が言っていた眠気覚ましの…」	PRINTFORMW 「これは確かパチュリー様が言っていた眠気覚ましの…」
PRINTFORM 「そうやって、たぁっぷり射精した方が…絶対イイですから	PRINTFORM 「そうやって、たぁっぷり射精した方が…絶対イイですから
PRINTFORM 「これ…誰かを拘束しておくためのものですよね…くすくす	PRINTFORM 「これ…誰かを拘束しておくためのものですよね…くすくす
PRINTFORM 「たまにアクセントとして使うには…いいかもしれませんね	PRINTFORM 「たまにアクセントとして使うには…いいかもしれませんね
PRINTFORMW 「安心して下さい、指の後はぁ…もぉっと太いのでぇ…」	PRINTFORMW 「安心して下さい、指の後はぁ…もぉっと太いのでぇ…」
PRINTFORM 「挿入れられてるというのに、おちんぽこんなにしちゃって	PRINTFORM 「挿入れられてるというのに、おちんぽこんなにしちゃって
PRINTFORM 　そう、大人しくしていて下さい、抵抗するだけ無駄ですよ	PRINTFORM 　そう、大人しくしていて下さい、抵抗するだけ無駄ですよ
PRINTFORM …ちゃんと集中できるか…わかりません…が…ヤってみます	PRINTFORM …ちゃんと集中できるか…わかりません…が…ヤってみます
PRINTFORMW 「勿体無いですけど、とりあえず撃てるだけ…っ！！！」	PRINTFORMW 「勿体無いですけど、とりあえず撃てるだけ…っ！！！」
PRINTFORMW 「ちょっと強く振るので…痛いかもしれませんよっ！！」	PRINTFORMW 「ちょっと強く振るので…痛いかもしれませんよっ！！」
PRINTFORMW （すぐ下半身に纏わり付いてくるから気をつけないと…）	PRINTFORMW （すぐ下半身に纏わり付いてくるから気をつけないと…）
PRINTFORMDW 自らの下腹部で欲望に震える男根を突き出し懇願した…	PRINTFORMDW 自らの下腹部で欲望に震える男根を突き出し懇願した…
PRINTFORM 　お願いします…私のあそこ…こんなになっちゃってますよ	PRINTFORM 　お願いします…私のあそこ…こんなになっちゃってますよ
PRINTFORMDW ゆっくりと自らの胸元に引き寄せ、耳元で甘く囁いた…	PRINTFORMDW ゆっくりと自らの胸元に引き寄せ、耳元で甘く囁いた…
PRINTFORM 　…もちろんここはいつでも欲しいんですけど……んぅぅぅ	PRINTFORM 　…もちろんここはいつでも欲しいんですけど……んぅぅぅ
PRINTFORM 「お尻…確かに今、他を攻められるよりはマシですが…くっ	PRINTFORM 「お尻…確かに今、他を攻められるよりはマシですが…くっ
PRINTFORM 「しまった？！　今の私、おちんちんがあったの忘れ…てっ	PRINTFORM 「しまった？！　今の私、おちんちんがあったの忘れ…てっ
PRINTFORM 「これでは…逃げられませんよね……仕方…ないですよねっ	PRINTFORM 「これでは…逃げられませんよね……仕方…ないですよねっ
PRINTFORMW 「あっ…！！！　んんっ！　は…放して下さい…っ！！」	PRINTFORMW 「あっ…！！！　んんっ！　は…放して下さい…っ！！」
PRINTFORMW 「……おっぱいから…ミルク…出てますよね、これ…？」	PRINTFORMW 「……おっぱいから…ミルク…出てますよね、これ…？」
PRINTFORM 　結構な量のスペルマを頂きましたね。お味も…濃いですし	PRINTFORM 　結構な量のスペルマを頂きましたね。お味も…濃いですし
PRINTFORMW 　ほんとは…私が精を吸い取らなきゃいけないのに……」	PRINTFORMW 　ほんとは…私が精を吸い取らなきゃいけないのに……」
PRINTFORM 　わざわざ脱がせてくれるなんて、見かけによらないですね	PRINTFORM 　わざわざ脱がせてくれるなんて、見かけによらないですね
PRINTFORMW 「これくらいだと…流石に動きやすいものなんですね♪」	PRINTFORMW 「これくらいだと…流石に動きやすいものなんですね♪」
PRINTFORM 　キツい…ですけど……もっと良くしてくれるのでしたら…	PRINTFORM 　キツい…ですけど……もっと良くしてくれるのでしたら…
PRINTFORMW 「ちょっと痛いかもしれませんけど…我慢して下さい！」	PRINTFORMW 「ちょっと痛いかもしれませんけど…我慢して下さい！」
PRINTFORMW 「あ、そんな……行っちゃいましたか……このまま私…」	PRINTFORMW 「あ、そんな……行っちゃいましたか……このまま私…」
PRINTFORM 　この泉…まるでザーメンみたい…だとしたら凄い量ですね	PRINTFORM 　この泉…まるでザーメンみたい…だとしたら凄い量ですね
PRINTFORM 「な…膣内で……そんな……されたら……疼いてきちゃう…	PRINTFORM 「な…膣内で……そんな……されたら……疼いてきちゃう…
PRINTFORM 　いくら私でもおちんちんの刺激には…なっ慣れてな…ッッ	PRINTFORM 　いくら私でもおちんちんの刺激には…なっ慣れてな…ッッ
PRINTFORMW 「なんだか心配ですし、触るのはやめておきましょうか」	PRINTFORMW 「なんだか心配ですし、触るのはやめておきましょうか」
PRINTFORM 「なんとか…一人で……目の前で、失礼…します…んん…っ	PRINTFORM 「なんとか…一人で……目の前で、失礼…します…んん…っ
PRINTFORM 「ふふ…パチュリー様も…私と同じで我慢できないんですね	PRINTFORM 「ふふ…パチュリー様も…私と同じで我慢できないんですね
PRINTFORMDW パチュリーは完全に無視して手で口と鼻を塞いでいる…	PRINTFORMDW パチュリーは完全に無視して手で口と鼻を塞いでいる…
PRINTFORMW 「だめ…襲い掛からない内に…一人で…解消しないと…」	PRINTFORMW 「だめ…襲い掛からない内に…一人で…解消しないと…」
PRINTFORMW 「私のお尻…こんなにヒクヒクして待ち切れないのに…」	PRINTFORMW 「私のお尻…こんなにヒクヒクして待ち切れないのに…」
PRINTFORM 　せーえき登って…キっ…ちゃ…ううううううぅぅぅっっっ	PRINTFORM 　せーえき登って…キっ…ちゃ…ううううううぅぅぅっっっ
PRINTFORMDL どぷっ！ぶびゅびゅびゅっ！びゅくっ！！びゅくっ！！	PRINTFORMDL どぷっ！ぶびゅびゅびゅっ！びゅくっ！！びゅくっ！！
PRINTFORM 　どうです？%CALLNAME_7_0(ARG:3)%	PRINTFORM 　どうです？%CALLNAME_7_0(ARG:3)%
PRINTFORM 　おちんちん生えてると…サキュバスの本分を忘れちゃうっ	PRINTFORM 　おちんちん生えてると…サキュバスの本分を忘れちゃうっ
PRINTFORM 「はぁ…%CALLNAME_7_0(ARG:3,1)%	PRINTFORM 「はぁ…%CALLNAME_7_0(ARG:3,1)%
PRINTFORM 　今…最後の仕上げを…いっぱい…注ぎ込んであげますね…	PRINTFORM 　今…最後の仕上げを…いっぱい…注ぎ込んであげますね…
PRINTFORMDW そして後ろにぴったりと張り付きながら、耳元で囁いた	PRINTFORMDW そして後ろにぴったりと張り付きながら、耳元で囁いた
PRINTFORM 「あ…私の方もシて頂けるんですか？　では…お願いします	PRINTFORM 「あ…私の方もシて頂けるんですか？　では…お願いします
PRINTFORMW 「……%CALLNAME_7_0(ARG:3)%…」	PRINTFORMW 「……%CALLNAME_7_0(ARG:3)%…」
PRINTFORMW 「……あ…触手が…離れた？　えーと、それはつまり…」	PRINTFORMW 「……あ…触手が…離れた？　えーと、それはつまり…」
PRINTFORM 　ねぇ…%CALLNAME_7_0(ARG:0,1)%	PRINTFORM 　ねぇ…%CALLNAME_7_0(ARG:0,1)%
PRINTFORM 　私がまだイってないのに…我慢できないおちんちんですね	PRINTFORM 　私がまだイってないのに…我慢できないおちんちんですね
PRINTFORMW 「あ、お母様……寝てる…わけではないみたいですね…」	PRINTFORMW 「あ、お母様……寝てる…わけではないみたいですね…」
PRINTFORMDW 蜜壷から床へと滴り落ちる愛液を分け合っている様だ…	PRINTFORMDW 蜜壷から床へと滴り落ちる愛液を分け合っている様だ…
PRINTFORMW 「身体が…熱くて……仕方ないです…自分で鎮めないと」	PRINTFORMW 「身体が…熱くて……仕方ないです…自分で鎮めないと」
PRINTFORM …淫魔なのに……こんなの……らめぇぇぇぇぇっっっッッッ	PRINTFORM …淫魔なのに……こんなの……らめぇぇぇぇぇっっっッッッ
PRINTFORMW 「…………なんだか身体が重い…体調不良でしょうか…」	PRINTFORMW 「…………なんだか身体が重い…体調不良でしょうか…」
PRINTFORMW 「ふぅ…とりあえず落ち着いてくれた、みたいですね…」	PRINTFORMW 「ふぅ…とりあえず落ち着いてくれた、みたいですね…」
PRINTFORM 　この触手さんに…目覚めさせられてしまったみたいです…	PRINTFORM 　この触手さんに…目覚めさせられてしまったみたいです…
PRINTFORM 「また…服の中に…びゅくびゅく射精しちゃってるぅ……っ	PRINTFORM 「また…服の中に…びゅくびゅく射精しちゃってるぅ……っ
PRINTFORM 　…ほんとこの服…敏感なところを責めるのが上手いですね	PRINTFORM 　…ほんとこの服…敏感なところを責めるのが上手いですね
PRINTFORM 「だめ…子宮にいっぱい注がれちゃうと…疼いてきちゃう…	PRINTFORM 「だめ…子宮にいっぱい注がれちゃうと…疼いてきちゃう…
PRINTFORMW 「…ん…………？　…あれ…私…寝ちゃってました…？」	PRINTFORMW 「…ん…………？　…あれ…私…寝ちゃってました…？」
PRINTFORM 　…アソコからお酒を味わうのも…なかなか良いものですね	PRINTFORM 　…アソコからお酒を味わうのも…なかなか良いものですね
PRINTFORM 「次に会った時は…とってもいい夢を見させてあげますから	PRINTFORM 「次に会った時は…とってもいい夢を見させてあげますから
PRINTFORM 　おっぱいの中で…もうビクビク震えだしちゃってますね	PRINTFORM 　おっぱいの中で…もうビクビク震えだしちゃってますね
PRINTFORM 「ほら…早くここから…びゅるるって…熱っついの下さい	PRINTFORM 「ほら…早くここから…びゅるるって…熱っついの下さい
PRINTFORM 　滑りがよくなったところで…もっと強くシてあげますね	PRINTFORM 　滑りがよくなったところで…もっと強くシてあげますね
PRINTFORMDW どうやらお互い、この迷宮での苦労話をしている様だ	PRINTFORMDW どうやらお互い、この迷宮での苦労話をしている様だ
PRINTFORM 「くすくす…こっちには居るかしら？　今夜のエ・モ・ノ	PRINTFORM 「くすくす…こっちには居るかしら？　今夜のエ・モ・ノ
PRINTFORM 　搾り取っちゃいますから…いっぱぁい…子種を下さいね	PRINTFORM 　搾り取っちゃいますから…いっぱぁい…子種を下さいね
PRINTFORMW 「それにしても張りがあって…柔らかくて素敵な胸…」	PRINTFORMW 「それにしても張りがあって…柔らかくて素敵な胸…」
PRINTFORM 「ちゃんと、ぐっちょぐちょに…かき回してあげますから	PRINTFORM 「ちゃんと、ぐっちょぐちょに…かき回してあげますから
PRINTFORM 「そんなクリちゃんは…シコシコしてあげないとですねぇ	PRINTFORM 「そんなクリちゃんは…シコシコしてあげないとですねぇ
PRINTFORM 「このおマメさんを弄られるのが…堪らないんですよねぇ	PRINTFORM 「このおマメさんを弄られるのが…堪らないんですよねぇ
PRINTFORM 「これじゃ弄って欲しいって言ってるみたいなものですよ	PRINTFORM 「これじゃ弄って欲しいって言ってるみたいなものですよ
PRINTFORM 　ふふ…おっぱいが出なくても魔力は染み出てきてますよ	PRINTFORM 　ふふ…おっぱいが出なくても魔力は染み出てきてますよ
PRINTFORM 　身動き取れないのは嫌ですから…一度離して貰いますね	PRINTFORM 　身動き取れないのは嫌ですから…一度離して貰いますね
PRINTFORMW 　まずい…です…正気を保ってる内に…逃げないと…」	PRINTFORMW 　まずい…です…正気を保ってる内に…逃げないと…」
PRINTFORMW 「ここは一旦引きましょう！　なんとか隙を見て……」	PRINTFORMW 「ここは一旦引きましょう！　なんとか隙を見て……」
PRINTFORMW 「皆さん、下がって下さい！　これでまとめてっ！！」	PRINTFORMW 「皆さん、下がって下さい！　これでまとめてっ！！」
PRINTFORMW 「ふふっ…足元をすくうのはちょっと得意なんです♪」	PRINTFORMW 「ふふっ…足元をすくうのはちょっと得意なんです♪」
PRINTFORM 　あ…解ってくれたんですね、私の身体が求めてるコト…	PRINTFORM 　あ…解ってくれたんですね、私の身体が求めてるコト…
PRINTFORM 「こちらの穴がお望みですか？　大丈夫ですよ、お尻でも	PRINTFORM 「こちらの穴がお望みですか？　大丈夫ですよ、お尻でも
PRINTFORMW 　満足…されましたか…ちょっと名残惜しいですが…」	PRINTFORMW 　満足…されましたか…ちょっと名残惜しいですが…」
PRINTFORM 　その動き…狙ってますね…女の子の一番大事な…うふっ	PRINTFORM 　その動き…狙ってますね…女の子の一番大事な…うふっ
PRINTFORMDW %ARGS:1%の膣内にぬぷぬぷと納まっていく…	PRINTFORMDW %ARGS:1%の膣内にぬぷぬぷと納まっていく…
PRINTFORMW 「下着が…って別に見られて困る様な人は居ませんか」	PRINTFORMW 「下着が…って別に見られて困る様な人は居ませんか」
PRINTFORMW 「…ふぅ、危ないところでし…あ！　お洋服に穴が！」	PRINTFORMW 「…ふぅ、危ないところでし…あ！　お洋服に穴が！」
PRINTFORM 　で…でも…せーえき……膣内に欲しい…のぉぉぉっっっ	PRINTFORM 　で…でも…せーえき……膣内に欲しい…のぉぉぉっっっ
PRINTFORMDW %ARGS:1%に{LOCAL:0}のダメージ！	PRINTFORMDW %ARGS:1%に{LOCAL:0}のダメージ！
PRINTFORMW 　このままじゃパチュリー様に迷惑が…鎮めなきゃ…」	PRINTFORMW 　このままじゃパチュリー様に迷惑が…鎮めなきゃ…」
PRINTFORMW 「……流石に何も着てないと、心もとないというか…」	PRINTFORMW 「……流石に何も着てないと、心もとないというか…」
PRINTFORMW 「大きいのも強みですが、戦闘では不利ですからね…」	PRINTFORMW 「大きいのも強みですが、戦闘では不利ですからね…」
PRINTFORMW 「…つっ！！　……あれ？　ここは…私…意識を？！」	PRINTFORMW 「…つっ！！　……あれ？　ここは…私…意識を？！」
PRINTFORMW 　ん…こんなにぐしょぐしょ……我慢…できません…」	PRINTFORMW 　ん…こんなにぐしょぐしょ……我慢…できません…」
PRINTFORM 　ね、私のおちんちん、敏感になり過ぎちゃったんですよ	PRINTFORM 　ね、私のおちんちん、敏感になり過ぎちゃったんですよ
PRINTFORM 　こんな溢れてきちゃうほど…でも…美味しかったですよ	PRINTFORM 　こんな溢れてきちゃうほど…でも…美味しかったですよ
PRINTFORMW 「…そう…じゃないの…今…私が一番欲しいのは……」	PRINTFORMW 「…そう…じゃないの…今…私が一番欲しいのは……」
PRINTFORM 「あんまり焦らされると…私の方から襲っちゃいますよ？	PRINTFORM 「あんまり焦らされると…私の方から襲っちゃいますよ？
PRINTFORMDL びゅくっ！びゅっ！びゅびゅーーーーーーーっ！！！	PRINTFORMDL びゅくっ！びゅっ！びゅびゅーーーーーーーっ！！！
PRINTFORMDL ブピュッ！！ピュッ！ブビュゥゥゥゥゥッッ！！！！	PRINTFORMDL ブピュッ！！ピュッ！ブビュゥゥゥゥゥッッ！！！！
PRINTFORM 「早く…精液出さないと…私…暴走しちゃいそうです……	PRINTFORM 「早く…精液出さないと…私…暴走しちゃいそうです……
PRINTFORM 　%CALLNAME_7_0(ARG:3)%のお尻っ	PRINTFORM 　%CALLNAME_7_0(ARG:3)%のお尻っ
PRINTFORM 「一回や二回イったところで…続けて搾り取ってあげます	PRINTFORM 「一回や二回イったところで…続けて搾り取ってあげます
PRINTFORM 　凄い臭ってきますね…　すぐに精液…出させてあげます	PRINTFORM 　凄い臭ってきますね…　すぐに精液…出させてあげます
PRINTFORMW 「…えっ！？　脚に触手が…？　や、やめて下さい…」	PRINTFORMW 「…えっ！？　脚に触手が…？　や、やめて下さい…」
PRINTFORMW 「何かアイテムが欲しいのですか？　そうですねぇ…」	PRINTFORMW 「何かアイテムが欲しいのですか？　そうですねぇ…」
PRINTFORM 「%CALLNAME_7_0(ARG:0)%…んもぅ	PRINTFORM 「%CALLNAME_7_0(ARG:0)%…んもぅ
PRINTFORM 「まだ…膣内で、おちんちん…びゅくんびゅくんさせて…	PRINTFORM 「まだ…膣内で、おちんちん…びゅくんびゅくんさせて…
PRINTFORMW （…駄目ですよ…そんな、倒れている人をだなんて…）	PRINTFORMW （…駄目ですよ…そんな、倒れている人をだなんて…）
PRINTFORMW 「…あ、咲夜さんでしたか。そちらはどうでしょう…」	PRINTFORMW 「…あ、咲夜さんでしたか。そちらはどうでしょう…」
PRINTFORMW 「そういえば、咲夜さんがお持ちの物と似ている様な」	PRINTFORMW 「そういえば、咲夜さんがお持ちの物と似ている様な」
PRINTFORMW 「……っっ？！　……んくっ……これ…もしかして…」	PRINTFORMW 「……っっ？！　……んくっ……これ…もしかして…」
PRINTFORMW 「……んっ……く…苦しい…早く…産まれて下さい…」	PRINTFORMW 「……んっ……く…苦しい…早く…産まれて下さい…」
PRINTFORMW 「あちらの方から何かの気配が…行ってみましょう！」	PRINTFORMW 「あちらの方から何かの気配が…行ってみましょう！」
PRINTFORMW 「あら…この服もしかして……触手が擬態をっっ？！」	PRINTFORMW 「あら…この服もしかして……触手が擬態をっっ？！」
PRINTFORM 　私のおまんこにたっぷりと……満足…してくれましたね	PRINTFORM 　私のおまんこにたっぷりと……満足…してくれましたね
PRINTFORM 　寂しいんですか…？　いいですよ…おっぱいに甘えて…	PRINTFORM 　寂しいんですか…？　いいですよ…おっぱいに甘えて…
PRINTFORM 　今の…まるで胸に…神経が集中したみたいに…んんっっ	PRINTFORM 　今の…まるで胸に…神経が集中したみたいに…んんっっ
PRINTFORM 「パチュリー様、あんまり前に出てると…危ないですよ	PRINTFORM 「パチュリー様、あんまり前に出てると…危ないですよ
PRINTFORM 「おやおや…私のおちんぽに御奉仕して頂けるんですか	PRINTFORM 「おやおや…私のおちんぽに御奉仕して頂けるんですか
PRINTFORM （さて…どうしましょうかねぇ…今なら簡単に…うふふ	PRINTFORM （さて…どうしましょうかねぇ…今なら簡単に…うふふ
PRINTFORMW 　ここだとちょっと期待しちゃいますね……すぅ…」	PRINTFORMW 　ここだとちょっと期待しちゃいますね……すぅ…」
PRINTFORM 「うっかり当たっちゃう様な人はぁ…犯しちゃいますよ	PRINTFORM 「うっかり当たっちゃう様な人はぁ…犯しちゃいますよ
PRINTFORM 「焦っちゃダメですよ…ゆっくりと弄ってあげますから	PRINTFORM 「焦っちゃダメですよ…ゆっくりと弄ってあげますから
PRINTFORM 「さぁ…%CALLNAME_7_0(ARG:2)%	PRINTFORM 「さぁ…%CALLNAME_7_0(ARG:2)%
PRINTFORM 「%CALLNAME_7_0(ARG:2,1)%…	PRINTFORM 「%CALLNAME_7_0(ARG:2,1)%…
PRINTFORMW 　この触手さん…服を脱がせたいのでしょうか…？」	PRINTFORMW 　この触手さん…服を脱がせたいのでしょうか…？」
PRINTFORM 　やっぱり…おちんちん付いてるとサキュバス的にはぁ	PRINTFORM 　やっぱり…おちんちん付いてるとサキュバス的にはぁ
PRINTFORM 　子宮口で…先っぽ、ちゅっちゅっしちゃうんだからぁ	PRINTFORM 　子宮口で…先っぽ、ちゅっちゅっしちゃうんだからぁ
PRINTFORMDW 『んーーー…やっぱり実体があるのはいいわね～』	PRINTFORMDW 『んーーー…やっぱり実体があるのはいいわね～』
PRINTFORMW 「え…おしりに…ぷりっぷりのを…射精されてる？」	PRINTFORMW 「え…おしりに…ぷりっぷりのを…射精されてる？」
PRINTFORMW 「私じゃなかったら絶対妊娠してますよ、これ……」	PRINTFORMW 「私じゃなかったら絶対妊娠してますよ、これ……」
PRINTFORMW 「狙いは…服っ？！　ふぅ…危ないところでした。」	PRINTFORMW 「狙いは…服っ？！　ふぅ…危ないところでした。」
PRINTFORMW 「あれ…何か……これはっ！！　子宮に寄生っ？！」	PRINTFORMW 「あれ…何か……これはっ！！　子宮に寄生っ？！」
PRINTFORMW 「皆さんの姿も見えない…さてどうしましょうか…」	PRINTFORMW 「皆さんの姿も見えない…さてどうしましょうか…」
PRINTFORMW 「この壁っ…！！　…はぁ、危ないところでした。」	PRINTFORMW 「この壁っ…！！　…はぁ、危ないところでした。」
PRINTFORMW 　この泉…身体中に染み渡って……いい気分です♪」	PRINTFORMW 　この泉…身体中に染み渡って……いい気分です♪」
PRINTFORMW 「誰がこんな量を……って、早く上がらないと…！」	PRINTFORMW 「誰がこんな量を……って、早く上がらないと…！」
PRINTFORM 「大丈夫ですよ…少しくらい……さぁ…愉しみましょう	PRINTFORM 「大丈夫ですよ…少しくらい……さぁ…愉しみましょう
PRINTFORM 　これは……なんだか気分が昂揚してきちゃいました…	PRINTFORM 　これは……なんだか気分が昂揚してきちゃいました…
PRINTFORMW （あ…振り向くことすらできないみたいですね……）	PRINTFORMW （あ…振り向くことすらできないみたいですね……）
PRINTFORMDL ドビュッ！ビュッ！ビューーーーーーーっっ！！！	PRINTFORMDL ドビュッ！ビュッ！ビューーーーーーーっっ！！！
PRINTFORM 「さぁ…%CALLNAME_7_0(ARG:3)%	PRINTFORM 「さぁ…%CALLNAME_7_0(ARG:3)%
PRINTFORM 「いいんですよ…私と…このまま一緒にイキましょう…	PRINTFORM 「いいんですよ…私と…このまま一緒にイキましょう…
PRINTFORM 「%CALLNAME_7_0(ARG:0,1)%…	PRINTFORM 「%CALLNAME_7_0(ARG:0,1)%…
PRINTFORM 　%CALLNAME_7_0(ARG:0,1)%っ	PRINTFORM 　%CALLNAME_7_0(ARG:0,1)%っ
PRINTFORM 　なんだか…随分とせーえき撒き散らしちゃいましたね	PRINTFORM 　なんだか…随分とせーえき撒き散らしちゃいましたね
PRINTFORM 　%CALLNAME_7_0(ARG:0,1)%…	PRINTFORM 　%CALLNAME_7_0(ARG:0,1)%…
PRINTFORM 　たっぷたぷになるくらい射精してもらっちゃいました	PRINTFORM 　たっぷたぷになるくらい射精してもらっちゃいました
PRINTFORML 「まったくこんな所でまで魔理沙に会うなんて……」	PRINTFORML 「まったくこんな所でまで魔理沙に会うなんて……」
PRINTFORMW （…はっ？　どうもいけませんね…溜まってると…）	PRINTFORMW （…はっ？　どうもいけませんね…溜まってると…）
PRINTFORMW 「あ、ありがとうございます。本当に助かります！」	PRINTFORMW 「あ、ありがとうございます。本当に助かります！」
PRINTFORMW 「これ…誰かを拘束しておくためのものですよね…」	PRINTFORMW 「これ…誰かを拘束しておくためのものですよね…」
PRINTFORMW 「これはっ！　この薬があれば…パチュリー様も！」	PRINTFORMW 「これはっ！　この薬があれば…パチュリー様も！」
PRINTFORMW 「気付け薬……これは貴重ですね。大事にしないと」	PRINTFORMW 「気付け薬……これは貴重ですね。大事にしないと」
PRINTFORMW 「……ふぅ、これなら…なんとか抑えられそうです」	PRINTFORMW 「……ふぅ、これなら…なんとか抑えられそうです」
PRINTFORMW 「最近悪かった体調もすっかり良くなりましたね♪」	PRINTFORMW 「最近悪かった体調もすっかり良くなりましたね♪」
PRINTFORMW 「そろそろどこか休む場所を見つけないとですね…」	PRINTFORMW 「そろそろどこか休む場所を見つけないとですね…」
PRINTFORMW 　耐えなきゃ…どうしても駄目そうなら…自分で…」	PRINTFORMW 　耐えなきゃ…どうしても駄目そうなら…自分で…」
PRINTFORMW 　誰も…来ないで…今は自分が…抑えられる…か…」	PRINTFORMW 　誰も…来ないで…今は自分が…抑えられる…か…」
PRINTFORMW 「さて、準備はいいですよ。いつでも来て下さい…」	PRINTFORMW 「さて、準備はいいですよ。いつでも来て下さい…」
PRINTFORMW 「あの…よろしければ私もご一緒させて頂けると…」	PRINTFORMW 「あの…よろしければ私もご一緒させて頂けると…」
PRINTFORMW 「ん…また母乳が……服が染みになっちゃいます…」	PRINTFORMW 「ん…また母乳が……服が染みになっちゃいます…」
PRINTFORM 「…んんんッッ！！！　やっぱり…脱ごうとする…とッ	PRINTFORM 「…んんんッッ！！！　やっぱり…脱ごうとする…とッ
PRINTFORM 　すっかり…おっぱいで気持ち良くされちゃいました…	PRINTFORM 　すっかり…おっぱいで気持ち良くされちゃいました…
PRINTFORM 「この手で…めちゃくちゃに乱れさせたら…くすくす…	PRINTFORM 「この手で…めちゃくちゃに乱れさせたら…くすくす…
PRINTFORM 　こうして擦り擦りするだけでも…結構イイんですよ	PRINTFORM 　こうして擦り擦りするだけでも…結構イイんですよ
PRINTFORMW 「えーい！　…あれ？　今ので崩れたんですか？」	PRINTFORMW 「えーい！　…あれ？　今ので崩れたんですか？」
PRINTFORM 「我慢しなくていいんです…私なら何回でも…くすっ	PRINTFORM 「我慢しなくていいんです…私なら何回でも…くすっ
PRINTFORM 　この精液の臭い…早く喉の奥で味あわせて下さいな	PRINTFORM 　この精液の臭い…早く喉の奥で味あわせて下さいな
PRINTFORM 「あの…意識はあります？　あ、良かった…くすくす	PRINTFORM 「あの…意識はあります？　あ、良かった…くすくす
PRINTFORMW 　いえ、貴女が生きていたのが嬉しかったんです」	PRINTFORMW 　いえ、貴女が生きていたのが嬉しかったんです」
PRINTFORM 「…パチュリー様　そこで少し…待っていて下さいね	PRINTFORM 「…パチュリー様　そこで少し…待っていて下さいね
PRINTFORM 　私におっぱい揉まれて乳首立ってきちゃってますよ	PRINTFORM 　私におっぱい揉まれて乳首立ってきちゃってますよ
PRINTFORMW 「全裸になっちゃったんですから隠さないでも…」	PRINTFORMW 「全裸になっちゃったんですから隠さないでも…」
PRINTFORM 「ほら%CALLNAME_7_0(ARG:2)%	PRINTFORM 「ほら%CALLNAME_7_0(ARG:2)%
PRINTFORMW 「移動を制限した後なら…大技も狙えますよね…」	PRINTFORMW 「移動を制限した後なら…大技も狙えますよね…」
PRINTFORMW 「ふっ！…ぐぐ…………はぁ…放して下さいよ…」	PRINTFORMW 「ふっ！…ぐぐ…………はぁ…放して下さいよ…」
PRINTFORMW （お尻を狙ってる気がします…気をつけないと…）	PRINTFORMW （お尻を狙ってる気がします…気をつけないと…）
PRINTFORM 　なんだか私の方があなたを求めちゃってるみたい…	PRINTFORM 　なんだか私の方があなたを求めちゃってるみたい…
PRINTFORM 　こんなに涎を垂らして…興奮してくれてるんですね	PRINTFORM 　こんなに涎を垂らして…興奮してくれてるんですね
PRINTFORM 　いいですよ…私のおまんこ…存分に味わって下さい	PRINTFORM 　いいですよ…私のおまんこ…存分に味わって下さい
PRINTFORMW 「ぁ……く…ぅ…ダメージ…受け過ぎましたね…」	PRINTFORMW 「ぁ……く…ぅ…ダメージ…受け過ぎましたね…」
PRINTFORM 　もっと…愉しみたい…のに……ここまで…なんて…	PRINTFORM 　もっと…愉しみたい…のに……ここまで…なんて…
PRINTFORM 「ふふ……もう何も…覆い隠すものは残ってませんね	PRINTFORM 「ふふ……もう何も…覆い隠すものは残ってませんね
PRINTFORMW 「…よしっ、振りほどければ、こっちのものです」	PRINTFORMW 「…よしっ、振りほどければ、こっちのものです」
PRINTFORMW 　小さな触手達が…だめ…戦いに集中しないと…」	PRINTFORMW 　小さな触手達が…だめ…戦いに集中しないと…」
PRINTFORMW 「気づかれてない…今なら安全に逃げられますね」	PRINTFORMW 「気づかれてない…今なら安全に逃げられますね」
PRINTFORMW 「……すみません…ちょっと気分が乗らなくて…」	PRINTFORMW 「……すみません…ちょっと気分が乗らなくて…」
PRINTFORM 「な…なんだか……気分が良くなってきちゃいました	PRINTFORM 「な…なんだか……気分が良くなってきちゃいました
PRINTFORMW 　いやだこれ…子宮に寄生されちゃってます…？」	PRINTFORMW 　いやだこれ…子宮に寄生されちゃってます…？」
PRINTFORMW 「ふえぇ……パチュリー様…大丈夫でしたか…？」	PRINTFORMW 「ふえぇ……パチュリー様…大丈夫でしたか…？」
PRINTFORM 　おちんちん…パックリ飲み込まれちゃって…ふーっ	PRINTFORM 　おちんちん…パックリ飲み込まれちゃって…ふーっ
PRINTFORMW 「んっ？！　んんんっ！（これ…もしかして…）」	PRINTFORMW 「んっ？！　んんんっ！（これ…もしかして…）」
PRINTFORMW 「はー…はー……あれ…これ…身体が…小さく？」	PRINTFORMW 「はー…はー……あれ…これ…身体が…小さく？」
PRINTFORMW 「おっぱい…弄って欲しいのに…意地悪です……」	PRINTFORMW 「おっぱい…弄って欲しいのに…意地悪です……」
PRINTFORM 「その…もっと気持ちいいところを責めてくれても…	PRINTFORM 「その…もっと気持ちいいところを責めてくれても…
PRINTFORMW 　射精しきって…取れたみたいですね…良かった」	PRINTFORMW 　射精しきって…取れたみたいですね…良かった」
PRINTFORM 　%CALLNAME_7_0(ARG:3,1)%	PRINTFORM 　%CALLNAME_7_0(ARG:3,1)%
PRINTFORMW 　どうです、お尻だって…立派な性器でしょう？」	PRINTFORMW 　どうです、お尻だって…立派な性器でしょう？」
PRINTFORM 　いいですよ…もっと自由に動いて…はぁぁぁんっっ	PRINTFORM 　いいですよ…もっと自由に動いて…はぁぁぁんっっ
PRINTFORM 「そうですね…その足で挟んで…コスって頂けますか	PRINTFORM 「そうですね…その足で挟んで…コスって頂けますか
PRINTFORM 「せっかくですし…思う存分膣内に射精して下さいね	PRINTFORM 「せっかくですし…思う存分膣内に射精して下さいね
PRINTFORM 　%CALLNAME_7_0(ARG:0,1)%	PRINTFORM 　%CALLNAME_7_0(ARG:0,1)%
PRINTFORMW 「はい…早く出口を見つけて、戻りたいですね…」	PRINTFORMW 「はい…早く出口を見つけて、戻りたいですね…」
PRINTFORMW 「では、ご一緒させて頂きます、パチュリー様♪」	PRINTFORMW 「では、ご一緒させて頂きます、パチュリー様♪」
PRINTFORM 　こんな所ですし…早く…満足しないと……ふはぁっ	PRINTFORM 　こんな所ですし…早く…満足しないと……ふはぁっ
PRINTFORMDW 熱く疼く己の秘裂を、すぅっと、なぞり上げた…	PRINTFORMDW 熱く疼く己の秘裂を、すぅっと、なぞり上げた…
PRINTFORMW 　それ…バイ…ブ…？　そんなに大きくなって…」	PRINTFORMW 　それ…バイ…ブ…？　そんなに大きくなって…」
PRINTFORM 「ちょ…やっやめて下さいそこは……はぁぁぁンンン	PRINTFORM 「ちょ…やっやめて下さいそこは……はぁぁぁンンン
PRINTFORM 　今は気にしない様に…気にしない様に……ふはぁ…	PRINTFORM 　今は気にしない様に…気にしない様に……ふはぁ…
PRINTFORM 　そんな膣内射精されたら…目覚めちゃいそうです…	PRINTFORM 　そんな膣内射精されたら…目覚めちゃいそうです…
PRINTFORM 　あったかい……精液…ナカで味わうと美味しいです	PRINTFORM 　あったかい……精液…ナカで味わうと美味しいです
PRINTFORMW 「美味しいお酒を頂けるなら…お安い御用です♪」	PRINTFORMW 「美味しいお酒を頂けるなら…お安い御用です♪」
PRINTFORML （覚醒していると悪堕ちが早まるので覚悟の上で）	PRINTFORML （覚醒していると悪堕ちが早まるので覚悟の上で）
PRINTFORM 「くすくす…奥の赤ちゃんの入口まで着きましたよ	PRINTFORM 「くすくす…奥の赤ちゃんの入口まで着きましたよ
PRINTFORM 「そういう元気なおちんちんには…チロチロ…んっ	PRINTFORM 「そういう元気なおちんちんには…チロチロ…んっ
PRINTFORM 　お尻だと…根元までずっぽり挿入っちゃいますね	PRINTFORM 　お尻だと…根元までずっぽり挿入っちゃいますね
PRINTFORMDW ぢゅぷっ…ぢゅぷ…ぬぶっ！ぬぶっ！ぬぶっ！	PRINTFORMDW ぢゅぷっ…ぢゅぷ…ぬぶっ！ぬぶっ！ぬぶっ！
PRINTFORM 　どうしました？　そんな物欲しそうな顔をして…	PRINTFORM 　どうしました？　そんな物欲しそうな顔をして…
PRINTFORM 「ちゃんと私も満足させてくれないと…イヤですよ	PRINTFORM 「ちゃんと私も満足させてくれないと…イヤですよ
PRINTFORMW 「この種…確か基礎能力を上げてくれるはず…」	PRINTFORMW 「この種…確か基礎能力を上げてくれるはず…」
PRINTFORM 「眠い…けれど…その前に他の欲求を満たさないと	PRINTFORM 「眠い…けれど…その前に他の欲求を満たさないと
PRINTFORM …どうするつもりですか？　うふふ…いただきます	PRINTFORM …どうするつもりですか？　うふふ…いただきます
PRINTFORMW 　我慢して…えっちな事…意識しない…様に…」	PRINTFORMW 　我慢して…えっちな事…意識しない…様に…」
PRINTFORM 「すべすべで…いくら撫で回していても飽きません	PRINTFORM 「すべすべで…いくら撫で回していても飽きません
PRINTFORM 　あんまり早いと…続けて何度もヤっちゃいますよ	PRINTFORM 　あんまり早いと…続けて何度もヤっちゃいますよ
PRINTFORMW 「下手な手出しは…少し防御に集中しましょう」	PRINTFORMW 「下手な手出しは…少し防御に集中しましょう」
PRINTFORMW 「パチュリー様っ！　下がっていてください！」	PRINTFORMW 「パチュリー様っ！　下がっていてください！」
PRINTFORM 　お願いします…これ以上抵抗しませんから…ねぇ	PRINTFORM 　お願いします…これ以上抵抗しませんから…ねぇ
PRINTFORM 「マスター…私の集めた精気…全部お渡ししますね	PRINTFORM 「マスター…私の集めた精気…全部お渡ししますね
PRINTFORM 　いいですよ、準備はできてますから…来て下さい	PRINTFORM 　いいですよ、準備はできてますから…来て下さい
PRINTFORM 「お尻の方も…して頂けると…その…お願いします	PRINTFORM 「お尻の方も…して頂けると…その…お願いします
PRINTFORM 　おっぱいだけじゃなくて…口も使ってあげますね	PRINTFORM 　おっぱいだけじゃなくて…口も使ってあげますね
PRINTFORM 　どうです…私の身体…もっと…溺れてください…	PRINTFORM 　どうです…私の身体…もっと…溺れてください…
PRINTFORMW 「もう…いいじゃないですか…早く下さいよ…」	PRINTFORMW 「もう…いいじゃないですか…早く下さいよ…」
PRINTFORM 　マスター…おっぱいの弄り方が…凄くいやらしい	PRINTFORM 　マスター…おっぱいの弄り方が…凄くいやらしい
PRINTFORM 　いいんですよ、もっと強く抱きしめて頂いても…	PRINTFORM 　いいんですよ、もっと強く抱きしめて頂いても…
PRINTFORM 　子宮口…押し付けてるって事は……あぁぁぁ……	PRINTFORM 　子宮口…押し付けてるって事は……あぁぁぁ……
PRINTFORM 　ぐぽぐぽってされると…も、もう…はぁんんっっ	PRINTFORM 　ぐぽぐぽってされると…も、もう…はぁんんっっ
PRINTFORM 　ねっとりとして…それでいてしつこくない精気が	PRINTFORM 　ねっとりとして…それでいてしつこくない精気が
PRINTFORMW 　このままじゃ皆さんに迷惑が…鎮めなきゃ…」	PRINTFORMW 　このままじゃ皆さんに迷惑が…鎮めなきゃ…」
PRINTFORMW 「…ぁ…吸われ…てる……力が入ら…ない……」	PRINTFORMW 「…ぁ…吸われ…てる……力が入ら…ない……」
PRINTFORMW 「…っく…逆に…精気を吸われる…なんて……」	PRINTFORMW 「…っく…逆に…精気を吸われる…なんて……」
PRINTFORM 　もう私を覆い隠すものは何もないですよ…さぁ…	PRINTFORM 　もう私を覆い隠すものは何もないですよ…さぁ…
PRINTFORMW 「きゃっ！？　眩しい─────────……」	PRINTFORMW 「きゃっ！？　眩しい─────────……」
PRINTFORMW 「どなたかの荷物ですね。中身は…着替えと…」	PRINTFORMW 「どなたかの荷物ですね。中身は…着替えと…」
PRINTFORM 「えーい！　…あっ　なんですこの壁っ？！　やっ	PRINTFORM 「えーい！　…あっ　なんですこの壁っ？！　やっ
PRINTFORMW 「えっ？！　何故こんなところから敵がっ？！」	PRINTFORMW 「えっ？！　何故こんなところから敵がっ？！」
PRINTFORMW 「はぁぁ～……飲んだだけで凄く癒されます…」	PRINTFORMW 「はぁぁ～……飲んだだけで凄く癒されます…」
PRINTFORMW 「なんだかスッキリして…目が冴えてきました」	PRINTFORMW 「なんだかスッキリして…目が冴えてきました」
PRINTFORM 　おちんちんへの刺激は…慣れてなくっ…てッッッ	PRINTFORM 　おちんちんへの刺激は…慣れてなくっ…てッッッ
PRINTFORM 　こういうのはできれば膣から頂きたいのですが…	PRINTFORM 　こういうのはできれば膣から頂きたいのですが…
PRINTFORMDW 小悪魔は、あらかじめ釘を刺されてしまった…	PRINTFORMDW 小悪魔は、あらかじめ釘を刺されてしまった…
PRINTFORM 　まずい…淫魔の血が……気を張らないと…んんっ	PRINTFORM 　まずい…淫魔の血が……気を張らないと…んんっ
PRINTFORMW 「お尻に…して欲しいのに…意地悪ですねぇ…」	PRINTFORMW 「お尻に…して欲しいのに…意地悪ですねぇ…」
PRINTFORM 　ぶびゅびゅびゅっっっ……ってぇぇぇぇぇっっっ	PRINTFORM 　ぶびゅびゅびゅっっっ……ってぇぇぇぇぇっっっ
PRINTFORMW 　…ぁ　おちんちん…取れちゃったんですね…」	PRINTFORMW 　…ぁ　おちんちん…取れちゃったんですね…」
PRINTFORM 　とっても良い生オナホール…見つけちゃいました	PRINTFORM 　とっても良い生オナホール…見つけちゃいました
PRINTFORM 「早く精液欲しいんですか？　慌てなくても…んっ	PRINTFORM 「早く精液欲しいんですか？　慌てなくても…んっ
PRINTFORM 「私のおちんちんに…しっとり吸い付いてきます…	PRINTFORM 「私のおちんちんに…しっとり吸い付いてきます…
PRINTFORMW 「足なんかでいいんですか？　では失礼して…」	PRINTFORMW 「足なんかでいいんですか？　では失礼して…」
PRINTFORM 　ちゃんと私も満足させてくれないと…イヤですよ	PRINTFORM 　ちゃんと私も満足させてくれないと…イヤですよ
PRINTFORMDW とても悪そうな顔で口の端を吊り上げて笑った	PRINTFORMDW とても悪そうな顔で口の端を吊り上げて笑った
PRINTFORM 「もちろんタダで…というわけにはいかないですね	PRINTFORM 「もちろんタダで…というわけにはいかないですね
PRINTFORMW 「そう…ですか…。　それはとても残念です…」	PRINTFORMW 「そう…ですか…。　それはとても残念です…」
PRINTFORM （…たまには親に甘えたって…実の娘なんですし…	PRINTFORM （…たまには親に甘えたって…実の娘なんですし…
PRINTFORMW （……私の娘…こんなに素敵な身体に育って…）	PRINTFORMW （……私の娘…こんなに素敵な身体に育って…）
PRINTFORML （……助ける前に…少し愉しませて頂いても…）	PRINTFORML （……助ける前に…少し愉しませて頂いても…）
PRINTFORMW 「あ、こんにちは魔理沙さん。お久しぶりです」	PRINTFORMW 「あ、こんにちは魔理沙さん。お久しぶりです」
PRINTFORMW 「パチュリー様、あいにくこんな状態でして…」	PRINTFORMW 「パチュリー様、あいにくこんな状態でして…」
PRINTFORMDW パチュリーは興味無さ気なそぶりをして答えた	PRINTFORMDW パチュリーは興味無さ気なそぶりをして答えた
PRINTFORMW 「いつもお使いの物とは型が違いますけれど…」	PRINTFORMW 「いつもお使いの物とは型が違いますけれど…」
PRINTFORMW 　襲える相手も居ないし…仕方ないですよね…」	PRINTFORMW 　襲える相手も居ないし…仕方ないですよね…」
PRINTFORM 　こう簡単にイかされてちゃ…私にもプライドがっ	PRINTFORM 　こう簡単にイかされてちゃ…私にもプライドがっ
PRINTFORM 　イクっイクっ…イっっっ……クぅぅぅぅぅぅッッ	PRINTFORM 　イクっイクっ…イっっっ……クぅぅぅぅぅぅッッ
PRINTFORMW 「この子…魔力を吸って…大きくなってる……」	PRINTFORMW 「この子…魔力を吸って…大きくなってる……」
PRINTFORMDW 小悪魔が淫魔覚醒する事が可能になりました。	PRINTFORMDW 小悪魔が淫魔覚醒する事が可能になりました。
PRINTFORM 「…さぁ、少し探索してみましょうか…くすくすっ	PRINTFORM 「…さぁ、少し探索してみましょうか…くすくすっ
PRINTFORMDL 小悪魔を最初から淫魔覚醒させておきますか？	PRINTFORMDL 小悪魔を最初から淫魔覚醒させておきますか？
PRINTFORMDW 小悪魔の中に眠っていた淫魔の血が覚醒した！	PRINTFORMDW 小悪魔の中に眠っていた淫魔の血が覚醒した！
PRINTFORMW 「大人しくなった今なら、脱げるでしょうか…」	PRINTFORMW 「大人しくなった今なら、脱げるでしょうか…」
PRINTFORM 　いきなり…お尻に突っ込んでくるなんて…んんっ	PRINTFORM 　いきなり…お尻に突っ込んでくるなんて…んんっ
PRINTFORM 　私の腸の中…どろっどろのザーメンで一杯です…	PRINTFORM 　私の腸の中…どろっどろのザーメンで一杯です…
PRINTFORM 　…せーえき…私の方が搾り取られちゃうなんて…	PRINTFORM 　…せーえき…私の方が搾り取られちゃうなんて…
PRINTFORMW 「…ふぅ　満足…してくれたみたいですね……」	PRINTFORMW 「…ふぅ　満足…してくれたみたいですね……」
PRINTFORM 　こ…このおちんちん…離れてるのに感覚がっ？！	PRINTFORM 　こ…このおちんちん…離れてるのに感覚がっ？！
PRINTFORM 　れんぶしゃせーしてだひひゃひまふぅぅぅぅッッ	PRINTFORM 　れんぶしゃせーしてだひひゃひまふぅぅぅぅッッ
PRINTFORM 　スライムが蠢いて…乳首立ちっぱなしです…ふぅ	PRINTFORM 　スライムが蠢いて…乳首立ちっぱなしです…ふぅ
PRINTFORMW 　私の母乳…スライムに吸われちゃってます…」	PRINTFORMW 　私の母乳…スライムに吸われちゃってます…」
PRINTFORM 　だ、ダメですよぉ…そんなにぬるぬるしちゃぁ…	PRINTFORM 　だ、ダメですよぉ…そんなにぬるぬるしちゃぁ…
PRINTFORMW 「……はぁ　お風呂に入ってスッキリしたい…」	PRINTFORMW 「……はぁ　お風呂に入ってスッキリしたい…」
PRINTFORM 「少し刺激を与えてあげれば…思い出すでしょう	PRINTFORM 「少し刺激を与えてあげれば…思い出すでしょう
PRINTFORM 「そんな可愛いらしい顔をして…逞しいおちんぽ	PRINTFORM 「そんな可愛いらしい顔をして…逞しいおちんぽ
PRINTFORM 　それなら…私だって本気で攻めちゃいますから	PRINTFORM 　それなら…私だって本気で攻めちゃいますから
PRINTFORMDW 静かな室内に、口淫の水音だけが響き渡る…	PRINTFORMDW 静かな室内に、口淫の水音だけが響き渡る…
PRINTFORM 「ほぉら…私の方も…その口で、お願いしますよ	PRINTFORM 「ほぉら…私の方も…その口で、お願いしますよ
PRINTFORM 「どうです…こうやって…シコシコされちゃって	PRINTFORM 「どうです…こうやって…シコシコされちゃって
PRINTFORM 　私の顔に…ぶっかけたいですか？　いいですよ	PRINTFORM 　私の顔に…ぶっかけたいですか？　いいですよ
PRINTFORM 「あらら…足首に触手が絡まってますね…ふふっ	PRINTFORM 「あらら…足首に触手が絡まってますね…ふふっ
PRINTFORM 　子宮いっぱい…射精してくれるまで離しません	PRINTFORM 　子宮いっぱい…射精してくれるまで離しません
PRINTFORM 「パチュリー様、この場所…色々と愉しいですね	PRINTFORM 「パチュリー様、この場所…色々と愉しいですね
PRINTFORM 「パチュリー様…ムラムラしちゃったら…くすっ	PRINTFORM 「パチュリー様…ムラムラしちゃったら…くすっ
PRINTFORMW 　貴方がたに邪魔をして頂きたくないもので」	PRINTFORMW 　貴方がたに邪魔をして頂きたくないもので」
PRINTFORM 「ほら…ここ…敏感なんでしょう？　クリクリっ	PRINTFORM 「ほら…ここ…敏感なんでしょう？　クリクリっ
PRINTFORM 　我慢した分だけ…より気持ちよくなれますから	PRINTFORM 　我慢した分だけ…より気持ちよくなれますから
PRINTFORM 「思う存分かきまわしてあげますよ…後ろの方を	PRINTFORM 「思う存分かきまわしてあげますよ…後ろの方を
PRINTFORM 　いいんですよ、びゅーびゅー射精しちゃっても	PRINTFORM 　いいんですよ、びゅーびゅー射精しちゃっても
PRINTFORM 「ほらほらぁ、もっとミルク出してくださいよぉ	PRINTFORM 「ほらほらぁ、もっとミルク出してくださいよぉ
PRINTFORMW 「申し訳ありませんが…やられて下さいっ！」	PRINTFORMW 「申し訳ありませんが…やられて下さいっ！」
PRINTFORMW 「はぁ…流石に…イったばかりでは…力が…」	PRINTFORMW 「はぁ…流石に…イったばかりでは…力が…」
PRINTFORMW （一応…そういう態度は見せておかないと…）	PRINTFORMW （一応…そういう態度は見せておかないと…）
PRINTFORM 　まるでおっぱい…犯されちゃってるみたいです	PRINTFORM 　まるでおっぱい…犯されちゃってるみたいです
PRINTFORM 「精液なら…好きなだけ射精してあげますからぁ	PRINTFORM 「精液なら…好きなだけ射精してあげますからぁ
PRINTFORM 　本当最高ですよ…こんな太いので満たされて…	PRINTFORM 　本当最高ですよ…こんな太いので満たされて…
PRINTFORM 　そこですよ……もっと強くしてもいいですから	PRINTFORM 　そこですよ……もっと強くしてもいいですから
PRINTFORML 　大丈夫…この程度の刺激には慣れてます…」	PRINTFORML 　大丈夫…この程度の刺激には慣れてます…」
PRINTFORMW 「…えっ？　身体が勝手に動いてますよ！？」	PRINTFORMW 「…えっ？　身体が勝手に動いてますよ！？」
PRINTFORM 　私…マスターの赤ちゃんなら…身篭りたいです	PRINTFORM 　私…マスターの赤ちゃんなら…身篭りたいです
PRINTFORM 　もっと…もっとグチュグチュして下さいっっっ	PRINTFORM 　もっと…もっとグチュグチュして下さいっっっ
PRINTFORM 「はぁ…はぁ……せーえき…こんなに…溢れてる	PRINTFORM 「はぁ…はぁ……せーえき…こんなに…溢れてる
PRINTFORM 「……はぁ、精液好き過ぎて…逆らえないです…	PRINTFORM 「……はぁ、精液好き過ぎて…逆らえないです…
PRINTFORM 　いっぱい…射精してくれたんですね。ご馳走様	PRINTFORM 　いっぱい…射精してくれたんですね。ご馳走様
PRINTFORMW 　このままじゃまずいですね…鎮めなきゃ…」	PRINTFORMW 　このままじゃまずいですね…鎮めなきゃ…」
PRINTFORM 「あぁ…身体中…えっちなお汁で…ぬるぬるです	PRINTFORM 「あぁ…身体中…えっちなお汁で…ぬるぬるです
PRINTFORM 　限界…みたいです…ありがとうございました…	PRINTFORM 　限界…みたいです…ありがとうございました…
PRINTFORM 　凄い…です…この…私が……こんな…快楽に…	PRINTFORM 　凄い…です…この…私が……こんな…快楽に…
PRINTFORM 　触手が…お尻に……ぁ…挿入ってきて…るっっ	PRINTFORM 　触手が…お尻に……ぁ…挿入ってきて…るっっ
PRINTFORMW 「た、助けて下さい！　パチュリー様っ！！」	PRINTFORMW 「た、助けて下さい！　パチュリー様っ！！」
PRINTFORMW 「あれ……調子が悪かったのが嘘みたいに…」	PRINTFORMW 「あれ……調子が悪かったのが嘘みたいに…」
PRINTFORM 「こっ…こらっ！　駄目です…おしりっ…は…っ	PRINTFORM 「こっ…こらっ！　駄目です…おしりっ…は…っ
PRINTFORM 「な、なんですか？　この蟲っ…おちんちんにっ	PRINTFORM 「な、なんですか？　この蟲っ…おちんちんにっ
PRINTFORM 　せっ精気が…また違った形で満ちてきてます…	PRINTFORM 　せっ精気が…また違った形で満ちてきてます…
PRINTFORM 「そういう事ですか…これは不可抗力ですよね…	PRINTFORM 「そういう事ですか…これは不可抗力ですよね…
PRINTFORMW 「あら…頭に何かふさふさなものが……え？」	PRINTFORMW 「あら…頭に何かふさふさなものが……え？」
PRINTFORM 「このガスは……パチュリー様、はい、深呼吸～	PRINTFORM 「このガスは……パチュリー様、はい、深呼吸～
PRINTFORMW 「身体が…求めちゃう……解消…しないと…」	PRINTFORMW 「身体が…求めちゃう……解消…しないと…」
PRINTFORM 　また…せーえきいっぱいびゅるるってできるぅ	PRINTFORM 　また…せーえきいっぱいびゅるるってできるぅ
PRINTFORM 　ぶちまけちゃうぅぅぅぅぅぅんんっっっっッッ	PRINTFORM 　ぶちまけちゃうぅぅぅぅぅぅんんっっっっッッ
PRINTFORMDL ぴゅっ！びゅるっ！！びゅるるるるるっっ！	PRINTFORMDL ぴゅっ！びゅるっ！！びゅるるるるるっっ！
PRINTFORM 　下半身から…じわ～って…か、身体が…熱い…	PRINTFORM 　下半身から…じわ～って…か、身体が…熱い…
PRINTFORM 　その可愛らしいお胸を…白濁で穢したいんです	PRINTFORM 　その可愛らしいお胸を…白濁で穢したいんです
PRINTFORM 「ほら…精を搾り出そうと締め付けて来てますっ	PRINTFORM 「ほら…精を搾り出そうと締め付けて来てますっ
PRINTFORM 「念のため…魅了の術の儀式をさせて頂きますね	PRINTFORM 「念のため…魅了の術の儀式をさせて頂きますね
PRINTFORMW 「この展開は…そうなりますよね、うんうん」	PRINTFORMW 「この展開は…そうなりますよね、うんうん」
PRINTFORM 「くすくす…淫魔の私に寝技じゃ勝てないですよ	PRINTFORM 「くすくす…淫魔の私に寝技じゃ勝てないですよ
PRINTFORMW 「ほら、パチュリー様。魔理沙さんですよ♪」	PRINTFORMW 「ほら、パチュリー様。魔理沙さんですよ♪」
PRINTFORMW 「パチュリー様っ！　ご無事で何よりです…」	PRINTFORMW 「パチュリー様っ！　ご無事で何よりです…」
PRINTFORMW 「…その翼は…フラン様？　あ、やっぱり！」	PRINTFORMW 「…その翼は…フラン様？　あ、やっぱり！」
PRINTFORMW 「このアイテムは…弾丸として使えますね。」	PRINTFORMW 「このアイテムは…弾丸として使えますね。」
PRINTFORML 「パチュリー様っ！良い物を拾いましたよ！」	PRINTFORML 「パチュリー様っ！良い物を拾いましたよ！」
PRINTFORM 「ふふ…この触手さん達が居れば…寝ている間も	PRINTFORM 「ふふ…この触手さん達が居れば…寝ている間も
PRINTFORM 　こんなところが感じるんですね…ううぅんっっ	PRINTFORM 　こんなところが感じるんですね…ううぅんっっ
PRINTFORMDW 下着の隙間から、そっと指を滑り込ませた…	PRINTFORMDW 下着の隙間から、そっと指を滑り込ませた…
PRINTFORMW 「では、早速この部屋の調査をしましょうか」	PRINTFORMW 「では、早速この部屋の調査をしましょうか」
PRINTFORMDW 小悪魔が淫魔覚醒する事はなくなりました。	PRINTFORMDW 小悪魔が淫魔覚醒する事はなくなりました。
PRINTFORM 　だ、ダメですよぉ…お尻に入ってきちゃぁぁん	PRINTFORM 　だ、ダメですよぉ…お尻に入ってきちゃぁぁん
PRINTFORM 　もっと吸って下さい…胸が張って苦しいんです	PRINTFORM 　もっと吸って下さい…胸が張って苦しいんです
PRINTFORM 　大きい…のを、プレゼントしてあげて下さい	PRINTFORM 　大きい…のを、プレゼントしてあげて下さい
PRINTFORM 　身体に毒ですよ。私が…搾り取ってあげます	PRINTFORM 　身体に毒ですよ。私が…搾り取ってあげます
PRINTFORM 　早く…膣内に、たぁっぷり射精して下さいよ	PRINTFORM 　早く…膣内に、たぁっぷり射精して下さいよ
PRINTFORM 　もう我慢汁ダラダラ溢れさせちゃってますね	PRINTFORM 　もう我慢汁ダラダラ溢れさせちゃってますね
PRINTFORM 　では、せっかくだから…お願いしましょうか	PRINTFORM 　では、せっかくだから…お願いしましょうか
PRINTFORM 　淫魔に迫ってきた事…後悔しても遅いですよ	PRINTFORM 　淫魔に迫ってきた事…後悔しても遅いですよ
PRINTFORM 　身体中這い回っちゃうかもしれませんけど…	PRINTFORM 　身体中這い回っちゃうかもしれませんけど…
PRINTFORM 「パチュリー様も…遠慮なくお申し付け下さい	PRINTFORM 「パチュリー様も…遠慮なくお申し付け下さい
PRINTFORMW 「ありがとうございます、パチュリー様！」	PRINTFORMW 「ありがとうございます、パチュリー様！」
PRINTFORM 「その綺麗な肌を…直接撫で回したいですから	PRINTFORM 「その綺麗な肌を…直接撫で回したいですから
PRINTFORM 「これはじっくりと…揉みしだいてあげないと	PRINTFORM 「これはじっくりと…揉みしだいてあげないと
PRINTFORMW 「…ん…………んんっ…………くはぁ……」	PRINTFORMW 「…ん…………んんっ…………くはぁ……」
PRINTFORMW 「パチュリー様、使っちゃいますね、これ」	PRINTFORMW 「パチュリー様、使っちゃいますね、これ」
PRINTFORMW 　駄目…みたいですね…どうしましょう…」	PRINTFORMW 　駄目…みたいですね…どうしましょう…」
PRINTFORM 　そんなせつない触り方しないで下さいよぉ…	PRINTFORM 　そんなせつない触り方しないで下さいよぉ…
PRINTFORMW 「…降参です……私の力ではどうにも……」	PRINTFORMW 「…降参です……私の力ではどうにも……」
PRINTFORMW （……パチュリー様が…居てくれれば……）	PRINTFORMW （……パチュリー様が…居てくれれば……）
PRINTFORM 　だって…ペットなのにとても上手ですから…	PRINTFORM 　だって…ペットなのにとても上手ですから…
PRINTFORM 　私を犯したいんですよね…どうぞご自由に…	PRINTFORM 　私を犯したいんですよね…どうぞご自由に…
PRINTFORMDW ずちゅっ…ずちゅっ…むにゅぅ…むにゅん	PRINTFORMDW ずちゅっ…ずちゅっ…むにゅぅ…むにゅん
PRINTFORM 「はい…おっぱいの隙間に…そう、挿し込んで	PRINTFORM 「はい…おっぱいの隙間に…そう、挿し込んで
PRINTFORMW 「服が…というか触手が剥がれてる…？！」	PRINTFORMW 「服が…というか触手が剥がれてる…？！」
PRINTFORMW 「服が…でも…なんだかドキドキします…」	PRINTFORMW 「服が…でも…なんだかドキドキします…」
PRINTFORM 　本当におっぱいが好きなんですね、マスター	PRINTFORM 　本当におっぱいが好きなんですね、マスター
PRINTFORM 　私の方の準備でしたら…とうに出来てますよ	PRINTFORM 　私の方の準備でしたら…とうに出来てますよ
PRINTFORM 　そう…おっぱい責められるの…好きなんです	PRINTFORM 　そう…おっぱい責められるの…好きなんです
PRINTFORM 　クリトリス…こんなに硬く尖っちゃってるっ	PRINTFORM 　クリトリス…こんなに硬く尖っちゃってるっ
PRINTFORM 　子宮に…熱いザーメン溢れるほどに射精して	PRINTFORM 　子宮に…熱いザーメン溢れるほどに射精して
PRINTFORMW 　生憎ですが、種付けはできませんけど♪」	PRINTFORMW 　生憎ですが、種付けはできませんけど♪」
PRINTFORM 　そのまま…思う存分射精していいんですよ…	PRINTFORM 　そのまま…思う存分射精していいんですよ…
PRINTFORM 　どくどくどくって…濃いせーえきが…素敵…	PRINTFORM 　どくどくどくって…濃いせーえきが…素敵…
PRINTFORM 　とても美味しい精気が…流れ込んできてます	PRINTFORM 　とても美味しい精気が…流れ込んできてます
PRINTFORM 「ふふ…焦らしてる…おつもりですか……ん…	PRINTFORM 「ふふ…焦らしてる…おつもりですか……ん…
PRINTFORMW 「…ふっ！　…そう簡単に当たりませんよ」	PRINTFORMW 「…ふっ！　…そう簡単に当たりませんよ」
PRINTFORM 「んぅ…また…いっぱい射精しちゃいました…	PRINTFORM 「んぅ…また…いっぱい射精しちゃいました…
PRINTFORM 「…こんなに…身体…疼いちゃってるのに……	PRINTFORM 「…こんなに…身体…疼いちゃってるのに……
PRINTFORMW 「こ、これなら…よし、全部取れましたっ」	PRINTFORMW 「こ、これなら…よし、全部取れましたっ」
PRINTFORM 　まだ何か子宮で動いて…だ、駄目ですよぉ…	PRINTFORM 　まだ何か子宮で動いて…だ、駄目ですよぉ…
PRINTFORMW 「……っぁ！！　……ぅ…パ……さ…ま…」	PRINTFORMW 「……っぁ！！　……ぅ…パ……さ…ま…」
PRINTFORMW 「……あれ？　私…助かっちゃいました？」	PRINTFORMW 「……あれ？　私…助かっちゃいました？」
PRINTFORM 「だ…め…おまんこ出入りされながら…じゃっ	PRINTFORM 「だ…め…おまんこ出入りされながら…じゃっ
PRINTFORM 　指なんかじゃ…だ…だめ…もっと…欲しい…	PRINTFORM 　指なんかじゃ…だ…だめ…もっと…欲しい…
PRINTFORMW 「…うん、なんだかパワーが沸いてきます」	PRINTFORMW 「…うん、なんだかパワーが沸いてきます」
PRINTFORMW 「ふぅ…ギリギリ気づいて避けられました」	PRINTFORMW 「ふぅ…ギリギリ気づいて避けられました」
PRINTFORM 　そんなされたら…我慢できなくなっちゃう…	PRINTFORM 　そんなされたら…我慢できなくなっちゃう…
PRINTFORMW 「え…白く濁っててこの臭い…もしかして…	PRINTFORMW 「え…白く濁っててこの臭い…もしかして…
PRINTFORM 　なんでしたらもっと念入りに調べて頂いても	PRINTFORM 　なんでしたらもっと念入りに調べて頂いても
PRINTFORM 　これで全部でしたよね、満足されましたか？	PRINTFORM 　これで全部でしたよね、満足されましたか？
PRINTFORM 「む、蟲っ？！　ス、スカートの中に……やっ	PRINTFORM 「む、蟲っ？！　ス、スカートの中に……やっ
PRINTFORM 　身体が…ポカポカしてきて…いい気持ちです	PRINTFORM 　身体が…ポカポカしてきて…いい気持ちです
PRINTFORMW 「す…すみません…でも…このままでは…」	PRINTFORMW 「す…すみません…でも…このままでは…」
PRINTFORMD %CALLNAME:(TARGET)%は	PRINTFORMD %CALLNAME:(TARGET)%は
PRINTFORMDW 何度も何度もペニスを激しく脈動させた…	PRINTFORMDW 何度も何度もペニスを激しく脈動させた…
PRINTFORMW 「…キス……しても宜しいでしょうか…？」	PRINTFORMW 「…キス……しても宜しいでしょうか…？」
PRINTFORMW 　挿入れただけで軽くイっちゃいました？」	PRINTFORMW 　挿入れただけで軽くイっちゃいました？」
PRINTFORMW 「えーと…ごめんなさい、パチュリー様。」	PRINTFORMW 「えーと…ごめんなさい、パチュリー様。」
PRINTFORM 　いいですよ…ほら…いっぱい射精して下さい	PRINTFORM 　いいですよ…ほら…いっぱい射精して下さい
PRINTFORM 「いつ見ても…精を放つ直前の顔って素敵です	PRINTFORM 「いつ見ても…精を放つ直前の顔って素敵です
PRINTFORMW 「あ…その魔族の翼と赤い髪…貴女は……」	PRINTFORMW 「あ…その魔族の翼と赤い髪…貴女は……」
PRINTFORMW 「よろしくお願いしますね、魔理沙さん♪」	PRINTFORMW 「よろしくお願いしますね、魔理沙さん♪」
PRINTFORMW 「あら……ご丁寧に一式揃っていますね♪」	PRINTFORMW 「あら……ご丁寧に一式揃っていますね♪」
PRINTFORML 「いつもお使いの物とは…むぎゅぅっ？！」	PRINTFORML 「いつもお使いの物とは…むぎゅぅっ？！」
PRINTFORMW 「この薬…胸を小さくするんでしたっけ？」	PRINTFORMW 「この薬…胸を小さくするんでしたっけ？」
PRINTFORM 「…ぁ……ふぁ…ぁ………………あぁぁんっっ	PRINTFORM 「…ぁ……ふぁ…ぁ………………あぁぁんっっ
PRINTFORM 　もう…むり…なのほぉぉぉぉぉぉ…ッッッッ	PRINTFORM 　もう…むり…なのほぉぉぉぉぉぉ…ッッッッ
PRINTFORM 　連続アクメが………止まりませんっっっっっ	PRINTFORM 　連続アクメが………止まりませんっっっっっ
PRINTFORMW 「次はこちらの部屋に行ってみましょうか」	PRINTFORMW 「次はこちらの部屋に行ってみましょうか」
PRINTFORMW 「………はぁ…動きが…はぁ…止まった？」	PRINTFORMW 「………はぁ…動きが…はぁ…止まった？」
PRINTFORM 「お気持ちは嬉しいですけど…今は…んんあっ	PRINTFORM 「お気持ちは嬉しいですけど…今は…んんあっ
PRINTFORMDL 周囲一面に自分の体液を撒き散らした中で	PRINTFORMDL 周囲一面に自分の体液を撒き散らした中で
PRINTFORMW 「流石に腸から直接呑むのは効きますね…」	PRINTFORMW 「流石に腸から直接呑むのは効きますね…」
PRINTFORML 長髪で大人しいサキュバスな小悪魔さんです	PRINTFORML 長髪で大人しいサキュバスな小悪魔さんです
PRINTFORM …皆さん一緒に…天国にイっちゃって下さい	PRINTFORM …皆さん一緒に…天国にイっちゃって下さい
PRINTFORM 　ちょっと…物足りないかもしれませんけど	PRINTFORM 　ちょっと…物足りないかもしれませんけど
PRINTFORMW 　ここまで来るだけでもう限界ですか？」	PRINTFORMW 　ここまで来るだけでもう限界ですか？」
PRINTFORM …おっぱいの間から顔を出しちゃってますね	PRINTFORM …おっぱいの間から顔を出しちゃってますね
PRINTFORM 「この展開だったら…する事はひとつですね	PRINTFORM 「この展開だったら…する事はひとつですね
PRINTFORM 「パチュリー様、どうされたんですか…ふふ	PRINTFORM 「パチュリー様、どうされたんですか…ふふ
PRINTFORM 　失礼、なんだか興奮してきちゃいまして…	PRINTFORM 　失礼、なんだか興奮してきちゃいまして…
PRINTFORMW 　色々と元気付けてあげたいのですが…」	PRINTFORMW 　色々と元気付けてあげたいのですが…」
PRINTFORM 「この瓶……有効に使わせて頂きましょうか	PRINTFORM 「この瓶……有効に使わせて頂きましょうか
PRINTFORM 「誰かが喘いでいる声が…私には判りますよ	PRINTFORM 「誰かが喘いでいる声が…私には判りますよ
PRINTFORM 「あの…パチュリー様…よろしければ…ふふ	PRINTFORM 「あの…パチュリー様…よろしければ…ふふ
PRINTFORMW …ご一緒させていただきたいのですが…」	PRINTFORMW …ご一緒させていただきたいのですが…」
PRINTFORMW 　こうやって一枚ずつ脱がしていって…」	PRINTFORMW 　こうやって一枚ずつ脱がしていって…」
PRINTFORM 「こんなに乳首ビンビンに勃起させちゃって	PRINTFORM 「こんなに乳首ビンビンに勃起させちゃって
PRINTFORMW 「おしりの穴がヒクヒク誘ってますね…」	PRINTFORMW 「おしりの穴がヒクヒク誘ってますね…」
PRINTFORM 「思う存分…膣内をかきまわしてあげますよ	PRINTFORM 「思う存分…膣内をかきまわしてあげますよ
PRINTFORM 　にゅるんってすんなり挿入っちゃいました	PRINTFORM 　にゅるんってすんなり挿入っちゃいました
PRINTFORM 　せーえき…たっぷりと搾り取りますからね	PRINTFORM 　せーえき…たっぷりと搾り取りますからね
PRINTFORM 「乳首からミルクが染み出して…美味しそう	PRINTFORM 「乳首からミルクが染み出して…美味しそう
PRINTFORMW 「…ひっ？！　…………ぁ……ぁぁ……」	PRINTFORMW 「…ひっ？！　…………ぁ……ぁぁ……」
PRINTFORMW 「いい加減に…して下さいっっっ！！！」	PRINTFORMW 「いい加減に…して下さいっっっ！！！」
PRINTFORMW 「これ以上矢面に立つのは…すみません」	PRINTFORMW 「これ以上矢面に立つのは…すみません」
PRINTFORMW 「当たらない……まず足を止めないと！」	PRINTFORMW 「当たらない……まず足を止めないと！」
PRINTFORMW 「ふふっ…この弾数、避けきれますか？」	PRINTFORMW 「ふふっ…この弾数、避けきれますか？」
PRINTFORMW 「パチュリー様、下がっていて下さい！」	PRINTFORMW 「パチュリー様、下がっていて下さい！」
PRINTFORM 「お尻は駄目ですよ…だって…欲しいのは…	PRINTFORM 「お尻は駄目ですよ…だって…欲しいのは…
PRINTFORM 「私の身体…好きにして下さいね、マスター	PRINTFORM 「私の身体…好きにして下さいね、マスター
PRINTFORM 「さぁ来て…一緒に気持ち良くなりましょう	PRINTFORM 「さぁ来て…一緒に気持ち良くなりましょう
PRINTFORM 「さらに言えば…膣内に…注いで頂けると…	PRINTFORM 「さらに言えば…膣内に…注いで頂けると…
PRINTFORM 　早く…こっちの方に欲しいです…くぅん…	PRINTFORM 　早く…こっちの方に欲しいです…くぅん…
PRINTFORM …とろとろとエッチな汁が染み出してます…	PRINTFORM …とろとろとエッチな汁が染み出してます…
PRINTFORM 　私も精一杯…気持ち良くしてさしあげます	PRINTFORM 　私も精一杯…気持ち良くしてさしあげます
PRINTFORM 「おまんこ…攻めたいんですね…いいですよ	PRINTFORM 「おまんこ…攻めたいんですね…いいですよ
PRINTFORM 「ふふ…頂けるのですね…あ・そ・こ・に…	PRINTFORM 「ふふ…頂けるのですね…あ・そ・こ・に…
PRINTFORM 「やぁ…こんな太いのでぬぷぬぷされちゃっ	PRINTFORM 「やぁ…こんな太いのでぬぷぬぷされちゃっ
PRINTFORM 　おちんちん…やっぱりこれ…気持ちいいっ	PRINTFORM 　おちんちん…やっぱりこれ…気持ちいいっ
PRINTFORM 　本当は……が良かったんですけど……んぅ	PRINTFORM 　本当は……が良かったんですけど……んぅ
PRINTFORM 　すぐ下に…挿入れてくれればいいの…にっ	PRINTFORM 　すぐ下に…挿入れてくれればいいの…にっ
PRINTFORM 　そんなにキツくしなくても…逃げませんよ	PRINTFORM 　そんなにキツくしなくても…逃げませんよ
PRINTFORM 「どうして…おまんこにくれないんですか…	PRINTFORM 「どうして…おまんこにくれないんですか…
PRINTFORM 「はぁぁん…もう…子宮…たぽたぽですけど	PRINTFORM 「はぁぁん…もう…子宮…たぽたぽですけど
PRINTFORMW 　溢れてもいいから射精してえぇぇぇぇぇ	PRINTFORMW 　溢れてもいいから射精してえぇぇぇぇぇ
PRINTFORM 　さぁ…淫魔の真髄…存分に味わって下さい	PRINTFORM 　さぁ…淫魔の真髄…存分に味わって下さい
PRINTFORM 　お願いですから放し…い、いや……その…	PRINTFORM 　お願いですから放し…い、いや……その…
PRINTFORMW 「あ……パチュリー様…きっと助け……」	PRINTFORMW 「あ……パチュリー様…きっと助け……」
PRINTFORMW 「いえ、私に構わず、逃げて下さいっ！」	PRINTFORMW 「いえ、私に構わず、逃げて下さいっ！」
PRINTFORMW 「どなたかの荷物ですね。中身は………」	PRINTFORMW 「どなたかの荷物ですね。中身は………」
PRINTFORMW 「…何故私の方を見て言うのよ、小悪魔」	PRINTFORMW 「…何故私の方を見て言うのよ、小悪魔」
PRINTFORMW 　大人しくなってくれたみたいですね…」	PRINTFORMW 　大人しくなってくれたみたいですね…」
PRINTFORMW 「解りました…私が強化を受けましょう」	PRINTFORMW 「解りました…私が強化を受けましょう」
PRINTFORMW 「それでは、私を強化して頂けますか？」	PRINTFORMW 「それでは、私を強化して頂けますか？」
PRINTFORMW 「パチュリー様っ！　このガスっ！！！」	PRINTFORMW 「パチュリー様っ！　このガスっ！！！」
PRINTFORMDW 身を震わせながら白濁液をぶちまけた…	PRINTFORMDW 身を震わせながら白濁液をぶちまけた…
PRINTFORM 「ほら…おちんちんで乳首擦れると…ふふっ	PRINTFORM 「ほら…おちんちんで乳首擦れると…ふふっ
PRINTFORM 「これで射精までされちゃったら…んぅんっ	PRINTFORM 「これで射精までされちゃったら…んぅんっ
PRINTFORM 　私としても犯り甲斐があるというものです	PRINTFORM 　私としても犯り甲斐があるというものです
PRINTFORMW 「あれ？　そんな事でいいんですか…？」	PRINTFORMW 「あれ？　そんな事でいいんですか…？」
PRINTFORM 　もう少し…繋がったままで居させて下さい	PRINTFORM 　もう少し…繋がったままで居させて下さい
PRINTFORM 「まだお望みであれば……続きは…夢の中で	PRINTFORM 「まだお望みであれば……続きは…夢の中で
PRINTFORMW 「どなたかが歩いて…あ、レミリア様！」	PRINTFORMW 「どなたかが歩いて…あ、レミリア様！」
PRINTFORMW 「私、お役に立てる様に頑張りますっ！」	PRINTFORMW 「私、お役に立てる様に頑張りますっ！」
PRINTFORMW 　いけない…誰かを襲ってしまう前に…」	PRINTFORMW 　いけない…誰かを襲ってしまう前に…」
PRINTFORMW 「……うぅ…子宮の中で…動いてます…」	PRINTFORMW 「……うぅ…子宮の中で…動いてます…」
PRINTFORMW 「……この子宮に脈打つ感じは…また…」	PRINTFORMW 「……この子宮に脈打つ感じは…また…」
PRINTFORMW 「では、引き続き私は別行動という事で」	PRINTFORMW 「では、引き続き私は別行動という事で」
PRINTFORM 「くすくす……どうなっても…知りませんよ	PRINTFORM 「くすくす……どうなっても…知りませんよ
PRINTFORMW 「ここは…魔界？　いや少し違う様な…」	PRINTFORMW 「ここは…魔界？　いや少し違う様な…」
PRINTFORMDW 通常の小悪魔のままにしておきました。	PRINTFORMDW 通常の小悪魔のままにしておきました。
PRINTFORMW 「…あら？　少し、胸が膨らみましたね」	PRINTFORMW 「…あら？　少し、胸が膨らみましたね」
PRINTFORM 　身体が…より快楽に素直になったみたい…	PRINTFORM 　身体が…より快楽に素直になったみたい…
PRINTFORM 　クリに当たる部分が…またブラシみたいに	PRINTFORM 　クリに当たる部分が…またブラシみたいに
PRINTFORM 　膣にぬぶぬぶって挿入ってくる…この感触	PRINTFORM 　膣にぬぶぬぶって挿入ってくる…この感触
PRINTFORM 　私の…おちんちんを自分で味わえるなんて	PRINTFORM 　私の…おちんちんを自分で味わえるなんて
PRINTFORM 　こんなに…せーえきいっぱい…くすくすっ	PRINTFORM 　こんなに…せーえきいっぱい…くすくすっ
PRINTFORM 　まだまだ…なかにザーメンほしいれすぅ…	PRINTFORM 　まだまだ…なかにザーメンほしいれすぅ…
PRINTFORM 「皆さん、少ぉし…下がっていて下さいね	PRINTFORM 「皆さん、少ぉし…下がっていて下さいね
PRINTFORM 「面倒ですし…一気にヤっちゃいましょう	PRINTFORM 「面倒ですし…一気にヤっちゃいましょう
PRINTFORM 「私と勝負するつもりですか…いいですよ	PRINTFORM 「私と勝負するつもりですか…いいですよ
PRINTFORM 　挿入れただけでも…精が満ち溢れてます	PRINTFORM 　挿入れただけでも…精が満ち溢れてます
PRINTFORMW 　気持ちよくなってきちゃいました？」	PRINTFORMW 　気持ちよくなってきちゃいました？」
PRINTFORM 「パチュリー様じゃないですか…くすくす	PRINTFORM 「パチュリー様じゃないですか…くすくす
PRINTFORM 　あぁ、娘さんでしたか…それはそれは…	PRINTFORM 　あぁ、娘さんでしたか…それはそれは…
PRINTFORM 　まずは…お風呂でどこから洗うか、とか	PRINTFORM 　まずは…お風呂でどこから洗うか、とか
PRINTFORM 「ありがとうございます。お礼は身体で…	PRINTFORM 「ありがとうございます。お礼は身体で…
PRINTFORM 　え？別に遠慮しなくてもいいんですよ…	PRINTFORM 　え？別に遠慮しなくてもいいんですよ…
PRINTFORMW 　お役に立てる様に頑張りますから…」	PRINTFORMW 　お役に立てる様に頑張りますから…」
PRINTFORMW 　道具に頼るつもりはありませんが…」	PRINTFORMW 　道具に頼るつもりはありませんが…」
PRINTFORM 「あちらの方から…あれはあえぎ声かしら	PRINTFORM 「あちらの方から…あれはあえぎ声かしら
PRINTFORMW 　えっちなアイテムが落ちているかも」	PRINTFORMW 　えっちなアイテムが落ちているかも」
PRINTFORM 「あの…よろしければ私もご一緒に…ふふ	PRINTFORM 「あの…よろしければ私もご一緒に…ふふ
PRINTFORMW 「えいっ！　…これくらいでしょうか」	PRINTFORMW 「えいっ！　…これくらいでしょうか」
PRINTFORM 　してくれないのなら…自分で…くぅんっ	PRINTFORM 　してくれないのなら…自分で…くぅんっ
PRINTFORM 　ダメなんです…ここに挿入れられちゃっ	PRINTFORM 　ダメなんです…ここに挿入れられちゃっ
PRINTFORM 「いいんですよ、しゃぶりついて頂いても	PRINTFORM 「いいんですよ、しゃぶりついて頂いても
PRINTFORM 　これ…私の方も…気持ちよくなっちゃう	PRINTFORM 　これ…私の方も…気持ちよくなっちゃう
PRINTFORMW 　安心して眠って…しまい…そう……」	PRINTFORMW 　安心して眠って…しまい…そう……」
PRINTFORM 　一番気持ちいい…秘所に頂けるんですね	PRINTFORM 　一番気持ちいい…秘所に頂けるんですね
PRINTFORMW 　そんな…もっと優しくして下さい…」	PRINTFORMW 　そんな…もっと優しくして下さい…」
PRINTFORMW 「はうぅ……このままだと…身体が…」	PRINTFORMW 「はうぅ……このままだと…身体が…」
PRINTFORM 　おまんこ…ずっぽりハメられるのがっっ	PRINTFORM 　おまんこ…ずっぽりハメられるのがっっ
PRINTFORM 「違う…違うの…お尻…は……ふぐぅ…っ	PRINTFORM 「違う…違うの…お尻…は……ふぐぅ…っ
PRINTFORM 　な、慣れてないので……が、我慢がぁっ	PRINTFORM 　な、慣れてないので……が、我慢がぁっ
PRINTFORMW 　……これは私も本気で行かないと…」	PRINTFORMW 　……これは私も本気で行かないと…」
PRINTFORM 　身体が痺れて…気持ち良過ぎちゃうぅっ	PRINTFORM 　身体が痺れて…気持ち良過ぎちゃうぅっ
PRINTFORMDW 『この身体、しばらく借りるわよ♪』	PRINTFORMDW 『この身体、しばらく借りるわよ♪』
PRINTFORMW 「んもぅ…意地悪…しないで下さい…」	PRINTFORMW 「んもぅ…意地悪…しないで下さい…」
PRINTFORM 「あ…んんんっ！？　んぅぅ…っ……んぅ	PRINTFORM 「あ…んんんっ！？　んぅぅ…っ……んぅ
PRINTFORM 　こんなに膨らんで…射精…するんですね	PRINTFORM 　こんなに膨らんで…射精…するんですね
PRINTFORM 奥で射精されるの…好きなのぉぉぉぉっっ	PRINTFORM 奥で射精されるの…好きなのぉぉぉぉっっ
PRINTFORMDW 満足げに妖艶な表情を浮かべている…	PRINTFORMDW 満足げに妖艶な表情を浮かべている…
PRINTFORMW 「……あ……身体が…限界…です……」	PRINTFORMW 「……あ……身体が…限界…です……」
PRINTFORM 　…このままじゃ…精液…漏れちゃうぅ…	PRINTFORM 　…このままじゃ…精液…漏れちゃうぅ…
PRINTFORMW 「パチュリー様っ！　崩れますっ！！」	PRINTFORMW 「パチュリー様っ！　崩れますっ！！」
PRINTFORMW 「皆さんっ！　横に跳んで下さいっ！」	PRINTFORMW 「皆さんっ！　横に跳んで下さいっ！」
PRINTFORM 　んんっ…我慢…がま…んんんぁぁぁっっ	PRINTFORM 　んんっ…我慢…がま…んんんぁぁぁっっ
PRINTFORMW 「美味しい…！　疲れも吹き飛びます」	PRINTFORMW 「美味しい…！　疲れも吹き飛びます」
PRINTFORM 　おちんちんだと…が、我慢の仕方が…ぁ	PRINTFORM 　おちんちんだと…が、我慢の仕方が…ぁ
PRINTFORM 「おちんちん…ビクビクしちゃって…るッ	PRINTFORM 「おちんちん…ビクビクしちゃって…るッ
PRINTFORM 　だから擦れると…私も余計に気持ちよく	PRINTFORM 　だから擦れると…私も余計に気持ちよく
PRINTFORM 　もう少しで…ですね。それでは一気に…	PRINTFORM 　もう少しで…ですね。それでは一気に…
PRINTFORMW 「……あ、起こしちゃいましたね……」	PRINTFORMW 「……あ、起こしちゃいましたね……」
PRINTFORM 　大丈夫です、こっちは優しくしますから	PRINTFORM 　大丈夫です、こっちは優しくしますから
PRINTFORMW 　赤ちゃんの部屋…入口こじ開けて…」	PRINTFORMW 　赤ちゃんの部屋…入口こじ開けて…」
PRINTFORM 　しっかり舌を出して受け止めて下さいっ	PRINTFORM 　しっかり舌を出して受け止めて下さいっ
PRINTFORMW 　どくどく射精てるの…わかります？」	PRINTFORMW 　どくどく射精てるの…わかります？」
PRINTFORM 　膣内に…射精してぇぇぇぇんんんッッッ	PRINTFORM 　膣内に…射精してぇぇぇぇんんんッッッ
PRINTFORMW 「これは…あ…眠気で目が霞んで……」	PRINTFORMW 「これは…あ…眠気で目が霞んで……」
PRINTFORMW 「ふぁぁ……もう疲れちゃいました…」	PRINTFORMW 「ふぁぁ……もう疲れちゃいました…」
PRINTFORM 　ちっ…乳首ばっかり…かみかみしちゃっ	PRINTFORM 　ちっ…乳首ばっかり…かみかみしちゃっ
PRINTFORM 　細かい振動が…乳首…ビリビリ来ます…	PRINTFORM 　細かい振動が…乳首…ビリビリ来ます…
PRINTFORM 　なんだか…ちょっと悔しいです…けどっ	PRINTFORM 　なんだか…ちょっと悔しいです…けどっ
PRINTFORM 　ィ…っくぅぅぅーーーーーーー…ッッッ	PRINTFORM 　ィ…っくぅぅぅーーーーーーー…ッッッ
PRINTFORM 　キちゃ……うぅぅぅぅんんんんッッッッ	PRINTFORM 　キちゃ……うぅぅぅぅんんんんッッッッ
PRINTFORM 　これ…は……イっちゃい……ますっっっ	PRINTFORM 　これ…は……イっちゃい……ますっっっ
PRINTFORM 「え……擦り寄ってきて……え……あんっ	PRINTFORM 「え……擦り寄ってきて……え……あんっ
PRINTFORMW 　もしかして…おっぱいが欲しいの？」	PRINTFORMW 　もしかして…おっぱいが欲しいの？」
PRINTFORM 　今…おっぱいあげますから…んうぅぅッ	PRINTFORM 　今…おっぱいあげますから…んうぅぅッ
PRINTFORMW 「…パチュリー様の受け売りですけど」	PRINTFORMW 「…パチュリー様の受け売りですけど」
PRINTFORMW 　ちょっと搾った方がいいですかね…」	PRINTFORMW 　ちょっと搾った方がいいですかね…」
PRINTFORM 「でも、この気分……全然悪くはないです	PRINTFORM 「でも、この気分……全然悪くはないです
PRINTFORM 　こっこのスライム……乳首のとこからッ	PRINTFORM 　こっこのスライム……乳首のとこからッ
PRINTFORM 　な、なんか入って来て…んんんぅっっっ	PRINTFORM 　な、なんか入って来て…んんんぅっっっ
PRINTFORMW 「…はぁ、美味しいですね、このお酒」	PRINTFORMW 「…はぁ、美味しいですね、このお酒」
PRINTFORM 「魔理沙さんを大人しくさせて…うふふ	PRINTFORM 「魔理沙さんを大人しくさせて…うふふ
PRINTFORM 　漏れない様に…我慢して…くすくすっ	PRINTFORM 　漏れない様に…我慢して…くすくすっ
PRINTFORM 　皆さんは下がっていて下さい、ふふっ	PRINTFORM 　皆さんは下がっていて下さい、ふふっ
PRINTFORM …弱いんですよね？　分かってますよ…	PRINTFORM …弱いんですよね？　分かってますよ…
PRINTFORM 　なんだか…身体が疼いてキましたよ…	PRINTFORM 　なんだか…身体が疼いてキましたよ…
PRINTFORM 「なんだか…目が冴えてきました…ふふ	PRINTFORM 「なんだか…目が冴えてきました…ふふ
PRINTFORM 　でも…まだ包み込んだだけですからね	PRINTFORM 　でも…まだ包み込んだだけですからね
PRINTFORMW 　…って、とってもイイでしょう？」	PRINTFORMW 　…って、とってもイイでしょう？」
PRINTFORM 「まぁだ…ぴゅっぴゅしちゃダメですよ	PRINTFORM 「まぁだ…ぴゅっぴゅしちゃダメですよ
PRINTFORM 　はーい、シコシコしてあげますからね	PRINTFORM 　はーい、シコシコしてあげますからね
PRINTFORM 　気をつけないと涎が垂れちゃいそう…	PRINTFORM 　気をつけないと涎が垂れちゃいそう…
PRINTFORM 「申し訳ありません、できれば…うふふ	PRINTFORM 「申し訳ありません、できれば…うふふ
PRINTFORM 　おっぱい…そんな強く吸ったりしてぇ	PRINTFORM 　おっぱい…そんな強く吸ったりしてぇ
PRINTFORM 　準備は出来てます…いつでも来てぇ…	PRINTFORM 　準備は出来てます…いつでも来てぇ…
PRINTFORMW 「……ぅ…………ぅぅ…………っっ」	PRINTFORMW 「……ぅ…………ぅぅ…………っっ」
PRINTFORMW 「んぅっ！………ぁぅ………ぁ……」	PRINTFORMW 「んぅっ！………ぁぅ………ぁ……」
PRINTFORMW 「これが当たれば……はぁっ！！！」	PRINTFORMW 「これが当たれば……はぁっ！！！」
PRINTFORMW 「威力重視でないと貫けませんね…」	PRINTFORMW 「威力重視でないと貫けませんね…」
PRINTFORM 「私だって…魔力を集中させれば…うぅ	PRINTFORM 「私だって…魔力を集中させれば…うぅ
PRINTFORMW 　まずい…ですよ…抜け出せない…」	PRINTFORMW 　まずい…ですよ…抜け出せない…」
PRINTFORM 「ここは少し集中して力を……くぅんっ	PRINTFORM 「ここは少し集中して力を……くぅんっ
PRINTFORM 　どうせ治まらないのなら…自分で……	PRINTFORM 　どうせ治まらないのなら…自分で……
PRINTFORM 　胸にマスターの感触が伝わってきて…	PRINTFORM 　胸にマスターの感触が伝わってきて…
PRINTFORML 「ああっ？！　せっかくの服が……」	PRINTFORML 「ああっ？！　せっかくの服が……」
PRINTFORMW 　これじゃ下着が…丸見えですね…」	PRINTFORMW 　これじゃ下着が…丸見えですね…」
PRINTFORM 「や…やめて下さいぃ……おちんちんっ	PRINTFORM 「や…やめて下さいぃ……おちんちんっ
PRINTFORM 　…こ、こしゅこしゅひちゃぁ…ぁぁぁ	PRINTFORM 　…こ、こしゅこしゅひちゃぁ…ぁぁぁ
PRINTFORM 「さぁ…思いっきりかき回して下さい…	PRINTFORM 「さぁ…思いっきりかき回して下さい…
PRINTFORM 　身体の芯から疼いて…ふぁぁぁんっっ	PRINTFORM 　身体の芯から疼いて…ふぁぁぁんっっ
PRINTFORM 　マスター…たっぷりと膣内に…下さい	PRINTFORM 　マスター…たっぷりと膣内に…下さい
PRINTFORM 　この子…精液貰って反応して…るっっ	PRINTFORM 　この子…精液貰って反応して…るっっ
PRINTFORM 「はぁ…こんなにたぽたぽになるまで…	PRINTFORM 「はぁ…こんなにたぽたぽになるまで…
PRINTFORMW 「もう…出すなら言って下さいよ…」	PRINTFORMW 「もう…出すなら言って下さいよ…」
PRINTFORMDW そこはかとなく満足げにも見える…	PRINTFORMDW そこはかとなく満足げにも見える…
PRINTFORM 「んんっっ！！！　…こく…こく…んぅ	PRINTFORM 「んんっっ！！！　…こく…こく…んぅ
PRINTFORMW 　びゅるびゅるってぇぇぇ…………」	PRINTFORMW 　びゅるびゅるってぇぇぇ…………」
PRINTFORMW 「これは見事に…つるぺたですね…」	PRINTFORMW 「これは見事に…つるぺたですね…」
PRINTFORMW 「ごめんなさい…パチュリー様……」	PRINTFORMW 「ごめんなさい…パチュリー様……」
PRINTFORMW 「…………えっ！？　敵…っ！！！」	PRINTFORMW 「…………えっ！？　敵…っ！！！」
PRINTFORMW 「…ふぅ。リフレッシュできました」	PRINTFORMW 「…ふぅ。リフレッシュできました」
PRINTFORMW 「…？　えぇぇぇっ落とし穴っ？！」	PRINTFORMW 「…？　えぇぇぇっ落とし穴っ？！」
PRINTFORMW 　蟲は離れてくれました…けど……」	PRINTFORMW 　蟲は離れてくれました…けど……」
PRINTFORM 　いいですよね…このピッタリした感覚	PRINTFORM 　いいですよね…このピッタリした感覚
PRINTFORMW 「え？　私ですか？　パチュリー様」	PRINTFORMW 「え？　私ですか？　パチュリー様」
PRINTFORMW 　腰が動かせないのが残念ですが…）	PRINTFORMW 　腰が動かせないのが残念ですが…）
PRINTFORMW 「え？　そこに居るのは……私！？」	PRINTFORMW 「え？　そこに居るのは……私！？」
PRINTFORMW 「でも、自分に生えるというのは…」	PRINTFORMW 「でも、自分に生えるというのは…」
PRINTFORM 　思う存分…どぴゅどぴゅしちゃいます	PRINTFORM 　思う存分…どぴゅどぴゅしちゃいます
PRINTFORM 　お…おちんちんが…射精させろ…って	PRINTFORM 　お…おちんちんが…射精させろ…って
PRINTFORM 　改めて触れると…本当に大きいですね	PRINTFORM 　改めて触れると…本当に大きいですね
PRINTFORM 　こういう優しい奉仕もできるんですね	PRINTFORM 　こういう優しい奉仕もできるんですね
PRINTFORM 「それなら、こっちを使えば……んぅぅ	PRINTFORM 「それなら、こっちを使えば……んぅぅ
PRINTFORM 「その羞恥と快楽に染まった顔…うふふ	PRINTFORM 「その羞恥と快楽に染まった顔…うふふ
PRINTFORM 　いつまで射精すれば気が済むんですか	PRINTFORM 　いつまで射精すれば気が済むんですか
PRINTFORM 　気の済むまで…吐き出してくれれば…	PRINTFORM 　気の済むまで…吐き出してくれれば…
PRINTFORMW 「あ、美鈴さん。お元気でしたか？」	PRINTFORMW 「あ、美鈴さん。お元気でしたか？」
PRINTFORMW 「…え？　娘？　パチュリー様の？」	PRINTFORMW 「…え？　娘？　パチュリー様の？」
PRINTFORML 「余計な事は言わないでよろしい！」	PRINTFORML 「余計な事は言わないでよろしい！」
PRINTFORM 　なんで…いっそ…挿入ってくれればッ	PRINTFORM 　なんで…いっそ…挿入ってくれればッ
PRINTFORM 　少しもどかしいくらいが…段々と…あ	PRINTFORM 　少しもどかしいくらいが…段々と…あ
PRINTFORM 　キちゃ……うぅぅぅぅんんんんッッッ	PRINTFORM 　キちゃ……うぅぅぅぅんんんんッッッ
PRINTFORMW 　出てくるなら早く…して下さい…」	PRINTFORMW 　出てくるなら早く…して下さい…」
PRINTFORM 　なんで…教えたわけじゃないの…にっ	PRINTFORM 　なんで…教えたわけじゃないの…にっ
PRINTFORM 「…パチュリー…さま…え……んんぅっ	PRINTFORM 「…パチュリー…さま…え……んんぅっ
PRINTFORMDL 小悪魔の淫魔覚醒を許可しますか？	PRINTFORMDL 小悪魔の淫魔覚醒を許可しますか？
PRINTFORM 　精をたくさん頂いたらなんだか…ふふ	PRINTFORM 　精をたくさん頂いたらなんだか…ふふ
PRINTFORM 　こ、股間のところ…ブラシみたいにっ	PRINTFORM 　こ、股間のところ…ブラシみたいにっ
PRINTFORM 「また…気持ちよくしてくれるんですね	PRINTFORM 「また…気持ちよくしてくれるんですね
PRINTFORM 　自分に膣内射精しちゃってるぅぅっっ	PRINTFORM 　自分に膣内射精しちゃってるぅぅっっ
PRINTFORM 　そ、そこ…ぬぢゅるって…そ、そうっ	PRINTFORM 　そ、そこ…ぬぢゅるって…そ、そうっ
PRINTFORM 　皆が寝ている間は…静かにしないとぉ	PRINTFORM 　皆が寝ている間は…静かにしないとぉ
PRINTFORM 　おっぱい…欲しいんですか？　きゃっ	PRINTFORM 　おっぱい…欲しいんですか？　きゃっ
PRINTFORM 「少し…集中して…魔力を溜めますね	PRINTFORM 「少し…集中して…魔力を溜めますね
PRINTFORM 　まず…動きを制限させて頂きますね	PRINTFORM 　まず…動きを制限させて頂きますね
PRINTFORM 　い～～っぱい、ご馳走しちゃいます	PRINTFORM 　い～～っぱい、ご馳走しちゃいます
PRINTFORM 「あらあら…元気が良過ぎて…ふふっ	PRINTFORM 「あらあら…元気が良過ぎて…ふふっ
PRINTFORM 　じゃあ…本気でイかせちゃいますよ	PRINTFORM 　じゃあ…本気でイかせちゃいますよ
PRINTFORM （それにしても…美味しそうな身体…	PRINTFORM （それにしても…美味しそうな身体…
PRINTFORM 「……私の裸…チラチラ見てますよね	PRINTFORM 「……私の裸…チラチラ見てますよね
PRINTFORM 　どうぞお先にお休みなられて下さい	PRINTFORM 　どうぞお先にお休みなられて下さい
PRINTFORM 　もちろん、私は構わないですからね	PRINTFORM 　もちろん、私は構わないですからね
PRINTFORM 　早速この部屋の調査をしましょうか	PRINTFORM 　早速この部屋の調査をしましょうか
PRINTFORM 　私流の、ご奉仕をさせて頂きますね	PRINTFORM 　私流の、ご奉仕をさせて頂きますね
PRINTFORMW …どうなるか…わかりませんよ？」	PRINTFORMW …どうなるか…わかりませんよ？」
PRINTFORM イキたいですか…？　でもぉ…だぁめ	PRINTFORM イキたいですか…？　でもぉ…だぁめ
PRINTFORMW 「あれ…抵抗の色が薄いですね…」	PRINTFORMW 「あれ…抵抗の色が薄いですね…」
PRINTFORMW 　これが欲しかったんでしょう？」	PRINTFORMW 　これが欲しかったんでしょう？」
PRINTFORM 「こうやって乳首つねる度に…んぅっ	PRINTFORM 「こうやって乳首つねる度に…んぅっ
PRINTFORM 　もっと…お互いクリクリしましょう	PRINTFORM 　もっと…お互いクリクリしましょう
PRINTFORMW 「わ…私が…囮になりますからっ」	PRINTFORMW 「わ…私が…囮になりますからっ」
PRINTFORM 「今…おっぱい…弄られたら…んんっ	PRINTFORM 「今…おっぱい…弄られたら…んんっ
PRINTFORMW 「ほら…すぐ下は無防備ですよ…」	PRINTFORMW 「ほら…すぐ下は無防備ですよ…」
PRINTFORM 　どうなっても知りませんが…くすっ	PRINTFORM 　どうなっても知りませんが…くすっ
PRINTFORM 　…痛みも…もう全部ただの刺激に…	PRINTFORM 　…痛みも…もう全部ただの刺激に…
PRINTFORMW 　…こ…これくらい大丈夫です…」	PRINTFORMW 　…こ…これくらい大丈夫です…」
PRINTFORM 　もう…私にも攻めさせて下さいよぉ	PRINTFORM 　もう…私にも攻めさせて下さいよぉ
PRINTFORM 「おしりが…疼いちゃって…もっと…	PRINTFORM 「おしりが…疼いちゃって…もっと…
PRINTFORM 　やっとおちんちん弄ってくれました	PRINTFORM 　やっとおちんちん弄ってくれました
PRINTFORM 「あ…それ…挿入れて下さるんですか	PRINTFORM 「あ…それ…挿入れて下さるんですか
PRINTFORM 「…いや…そこじゃ…なくて……んぅ	PRINTFORM 「…いや…そこじゃ…なくて……んぅ
PRINTFORM 　慣れてないから…凄くキちゃうっっ	PRINTFORM 　慣れてないから…凄くキちゃうっっ
PRINTFORM 「ら、らめですぅ…おちんちんは…っ	PRINTFORM 「ら、らめですぅ…おちんちんは…っ
PRINTFORM 　もう…我慢しなくてもいいですよね	PRINTFORM 　もう…我慢しなくてもいいですよね
PRINTFORM 　おっぱいまでは防御の手が…んんっ	PRINTFORM 　おっぱいまでは防御の手が…んんっ
PRINTFORM 「……っ…くあぁぁぁっっんんっっっ	PRINTFORM 「……っ…くあぁぁぁっっんんっっっ
PRINTFORM 　これ以上は…私も…んふぅんんっっ	PRINTFORM 　これ以上は…私も…んふぅんんっっ
PRINTFORMW 「……あれ…急に瞼が…重く……」	PRINTFORMW 「……あれ…急に瞼が…重く……」
PRINTFORM 「やだっ…おっぱいに群って…んんっ	PRINTFORM 「やだっ…おっぱいに群って…んんっ
PRINTFORMW 「パチュリー様っ！　上からっ！」	PRINTFORMW 「パチュリー様っ！　上からっ！」
PRINTFORM 　こんな格好で…犯されちゃってるっ	PRINTFORM 　こんな格好で…犯されちゃってるっ
PRINTFORMDW 入れ替わり {LOCAL:0}	PRINTFORMDW 入れ替わり {LOCAL:0}
PRINTFORMW 「皆さん、息を止めて下さいっ！」	PRINTFORMW 「皆さん、息を止めて下さいっ！」
PRINTFORM 　とっ止められっ……ああああッッッ	PRINTFORM 　とっ止められっ……ああああッッッ
PRINTFORM 　私と…気持ち良いコトしましょうか	PRINTFORM 　私と…気持ち良いコトしましょうか
PRINTFORMW 　私がいつも搾り取ってる分を…」	PRINTFORMW 　私がいつも搾り取ってる分を…」
PRINTFORMW 　口で…ですね、了解致しました」	PRINTFORMW 　口で…ですね、了解致しました」
PRINTFORM 「では、実際にレイプを始めましょう	PRINTFORM 「では、実際にレイプを始めましょう
PRINTFORMW 　その…１回だけでもいいので…」	PRINTFORMW 　その…１回だけでもいいので…」
PRINTFORM 　精液を搾り取ろうと絡まってきます	PRINTFORM 　精液を搾り取ろうと絡まってきます
PRINTFORM 　好きな様に…動いて下さって…んん	PRINTFORM 　好きな様に…動いて下さって…んん
PRINTFORM 　また…おちんちん生えちゃいました	PRINTFORM 　また…おちんちん生えちゃいました
PRINTFORMW 　これ以上は……むり…です……」	PRINTFORMW 　これ以上は……むり…です……」
PRINTFORM 　これから…もっと凄いのがキますよ	PRINTFORM 　これから…もっと凄いのがキますよ
PRINTFORM 　だっ…だめぇぇぇぇぇぇぇ～～～っ	PRINTFORM 　だっ…だめぇぇぇぇぇぇぇ～～～っ
PRINTFORMW 「パチュリー様、レミリア様が！」	PRINTFORMW 「パチュリー様、レミリア様が！」
PRINTFORMW 「よかったですね、パチュリー様」	PRINTFORMW 「よかったですね、パチュリー様」
PRINTFORMW 「あれ…この懐中時計どこかで…」	PRINTFORMW 「あれ…この懐中時計どこかで…」
PRINTFORMW 「この瓶……私には判りますよ♪」	PRINTFORMW 「この瓶……私には判りますよ♪」
PRINTFORM 　ちょ…待って下さい…おっ…しりッ	PRINTFORM 　ちょ…待って下さい…おっ…しりッ
PRINTFORM 「これで…スイッチを入れれば…んん	PRINTFORM 「これで…スイッチを入れれば…んん
PRINTFORM 　大き…ぃ…波……………んんんッッ	PRINTFORM 　大き…ぃ…波……………んんんッッ
PRINTFORMW 「それはもちろん、頂きますが…」	PRINTFORMW 「それはもちろん、頂きますが…」
PRINTFORM …いい気分になってきちゃいました…	PRINTFORM …いい気分になってきちゃいました…
PRINTFORM 　ま、またおっぱいからミルク出てる	PRINTFORM 　ま、またおっぱいからミルク出てる
PRINTFORM 「ん～ぅ♪　膣内に…挿入ってきてる	PRINTFORM 「ん～ぅ♪　膣内に…挿入ってきてる
PRINTFORM 　もっと…ゴシゴシ刺激してぇっっっ	PRINTFORM 　もっと…ゴシゴシ刺激してぇっっっ
PRINTFORM 　私のミルク…美味しかったですか？	PRINTFORM 　私のミルク…美味しかったですか？
PRINTFORM 　やっぱり射精されるなら膣内ですね	PRINTFORM 　やっぱり射精されるなら膣内ですね
PRINTFORMW 　これでよろしいでしょうか？」	PRINTFORMW 　これでよろしいでしょうか？」
PRINTFORM 　まとめて…お相手しちゃいますよ	PRINTFORM 　まとめて…お相手しちゃいますよ
PRINTFORM 「どちらの技が優れているか…ふふ	PRINTFORM 「どちらの技が優れているか…ふふ
PRINTFORM 　お願い…もっと深く…激しくぅん	PRINTFORM 　お願い…もっと深く…激しくぅん
PRINTFORM 「もう…そんなに溜め込んじゃって	PRINTFORM 「もう…そんなに溜め込んじゃって
PRINTFORM 「私の方は動けませんので…どうぞ	PRINTFORM 「私の方は動けませんので…どうぞ
PRINTFORM 「このご恩はまたいつか…うふふっ	PRINTFORM 「このご恩はまたいつか…うふふっ
PRINTFORM 　ちゃぁんと…避けてくださいねぇ	PRINTFORM 　ちゃぁんと…避けてくださいねぇ
PRINTFORMW 　ミルク出せないんですかぁ？」	PRINTFORMW 　ミルク出せないんですかぁ？」
PRINTFORM 　……はぁ……………んんんっっっ	PRINTFORM 　……はぁ……………んんんっっっ
PRINTFORM 「な…なんとか持ちこたえ…んふぅ	PRINTFORM 「な…なんとか持ちこたえ…んふぅ
PRINTFORMW 「使っちゃいましょうか、これ」	PRINTFORMW 「使っちゃいましょうか、これ」
PRINTFORMW 「少し強く…行きますよっ！！」	PRINTFORMW 「少し強く…行きますよっ！！」
PRINTFORMW 「皆さん下がっていて下さい！」	PRINTFORMW 「皆さん下がっていて下さい！」
PRINTFORMW 「これくらいに抑えて…やっ！」	PRINTFORMW 「これくらいに抑えて…やっ！」
PRINTFORM 「ほら…こちらにいらして下さい…	PRINTFORM 「ほら…こちらにいらして下さい…
PRINTFORM 　いかがでしょう…私のおっぱいは	PRINTFORM 　いかがでしょう…私のおっぱいは
PRINTFORMW 　まだ…服が邪魔なんですか？」	PRINTFORMW 　まだ…服が邪魔なんですか？」
PRINTFORM 「私だって…負けませんよ…んんっ	PRINTFORM 「私だって…負けませんよ…んんっ
PRINTFORM 　マスターの…お気の済むまで…ん	PRINTFORM 　マスターの…お気の済むまで…ん
PRINTFORM 「もう…早く挿入れて頂きたいのに	PRINTFORM 「もう…早く挿入れて頂きたいのに
PRINTFORM 　一番奥…届いて…ぐりぐりってぇ	PRINTFORM 　一番奥…届いて…ぐりぐりってぇ
PRINTFORM 　クリちゃん…欲しかったんですっ	PRINTFORM 　クリちゃん…欲しかったんですっ
PRINTFORM 　ずぷずぷって出し入れされる度っ	PRINTFORM 　ずぷずぷって出し入れされる度っ
PRINTFORM 　もう…このまま続けて下さぁい…	PRINTFORM 　もう…このまま続けて下さぁい…
PRINTFORM 　勝手が分からない…のほぉぉっっ	PRINTFORM 　勝手が分からない…のほぉぉっっ
PRINTFORMW 　ふぅ…これくらいだったら…」	PRINTFORMW 　ふぅ…これくらいだったら…」
PRINTFORMW 「今の…確かに私の体の中に…」	PRINTFORMW 「今の…確かに私の体の中に…」
PRINTFORM 　どぷどぷって膣内に下さいッッッ	PRINTFORM 　どぷどぷって膣内に下さいッッッ
PRINTFORM 　子宮に…熱いの欲しいのぉぉっっ	PRINTFORM 　子宮に…熱いの欲しいのぉぉっっ
PRINTFORM 　射精しちゃい…ましたね…膣内に	PRINTFORM 　射精しちゃい…ましたね…膣内に
PRINTFORM 　いい匂い…興奮して来ちゃいます	PRINTFORM 　いい匂い…興奮して来ちゃいます
PRINTFORM 　…胸にまで…こんなにたくさん…	PRINTFORM 　…胸にまで…こんなにたくさん…
PRINTFORM 　どうせなら前の…んんんぅッッッ	PRINTFORM 　どうせなら前の…んんんぅッッッ
PRINTFORM 　完全に…拘束されちゃいました…	PRINTFORM 　完全に…拘束されちゃいました…
PRINTFORMW 「……さぁ、頑張りましょう！」	PRINTFORMW 「……さぁ、頑張りましょう！」
PRINTFORMW 「落石っ？！　間に合ってっ！」	PRINTFORMW 「落石っ？！　間に合ってっ！」
PRINTFORM 「クリちゃん…そんなにされたらっ	PRINTFORM 「クリちゃん…そんなにされたらっ
PRINTFORM 　そこ…挿入れちゃうん…ですか…	PRINTFORM 　そこ…挿入れちゃうん…ですか…
PRINTFORMW 「え…？　お風呂って……！？」	PRINTFORMW 「え…？　お風呂って……！？」
PRINTFORM 　すっかり…のぼせちゃいました…	PRINTFORM 　すっかり…のぼせちゃいました…
PRINTFORMW 「…あ、はい。分かりました…」	PRINTFORMW 「…あ、はい。分かりました…」
PRINTFORM 　淫魔が…精液出しちゃうなんてっ	PRINTFORM 　淫魔が…精液出しちゃうなんてっ
PRINTFORMDL どくんっ！ドクッ！ドクッ！！	PRINTFORMDL どくんっ！ドクッ！ドクッ！！
PRINTFORMDW 激しく己の欲望を吐き出した…	PRINTFORMDW 激しく己の欲望を吐き出した…
PRINTFORM 　お尻にされるの…好きなんですね	PRINTFORM 　お尻にされるの…好きなんですね
PRINTFORM 　私が鎮めてさしあげましょうか…	PRINTFORM 　私が鎮めてさしあげましょうか…
PRINTFORM 「むしろ意識があった方が…くすっ	PRINTFORM 「むしろ意識があった方が…くすっ
PRINTFORM 　焦らすおつもりですか？　くすっ	PRINTFORM 　焦らすおつもりですか？　くすっ
PRINTFORM 　限界でしょう…さぁ…思う存分…	PRINTFORM 　限界でしょう…さぁ…思う存分…
PRINTFORMW 「あ…お久しぶりです、お母様」	PRINTFORMW 「あ…お久しぶりです、お母様」
PRINTFORMW 　はっ？　いけないいけない…）	PRINTFORMW 　はっ？　いけないいけない…）
PRINTFORMW 「では、一緒に行きましょうか」	PRINTFORMW 「では、一緒に行きましょうか」
PRINTFORM 「これで…お尻を……おしっ…りっ	PRINTFORM 「これで…お尻を……おしっ…りっ
PRINTFORM 　…あぁぁぁぁぁ～～～～～ッッッ	PRINTFORM 　…あぁぁぁぁぁ～～～～～ッッッ
PRINTFORM 　ふみゅぅぅぅ………………っっっ	PRINTFORM 　ふみゅぅぅぅ………………っっっ
PRINTFORM 　中で動かれると…子宮が響いて…	PRINTFORM 　中で動かれると…子宮が響いて…
PRINTFORM 「そんな…私のはまだ出な…んんっ	PRINTFORM 「そんな…私のはまだ出な…んんっ
PRINTFORM 　おっぱい…飲みたいん…ですか…	PRINTFORM 　おっぱい…飲みたいん…ですか…
PRINTFORMW 　あっ…母乳が垂れてきてる…」	PRINTFORMW 　あっ…母乳が垂れてきてる…」
PRINTFORM 「……え…これ…膣の中に…んんっ	PRINTFORM 「……え…これ…膣の中に…んんっ
PRINTFORM 　…貴方のお汁…凄く美味しいです	PRINTFORM 　…貴方のお汁…凄く美味しいです
PRINTFORM 　すっかり…酔ってしまいました…	PRINTFORM 　すっかり…酔ってしまいました…
PRINTFORM 「これ…当たっちゃうと…うふふ	PRINTFORM 「これ…当たっちゃうと…うふふ
PRINTFORM …感覚も過敏になっちゃいます…	PRINTFORM …感覚も過敏になっちゃいます…
PRINTFORM 「ほら…魔弾がこんなに…大きく	PRINTFORM 「ほら…魔弾がこんなに…大きく
PRINTFORM 　凄いの…イキ…ますッッッッッ	PRINTFORM 　凄いの…イキ…ますッッッッッ
PRINTFORM 「ここ…責められると…くすくす	PRINTFORM 「ここ…責められると…くすくす
PRINTFORM …イかさないとイけない様ですね	PRINTFORM …イかさないとイけない様ですね
PRINTFORM 　なんだかこの壁…いやらしい…	PRINTFORM 　なんだかこの壁…いやらしい…
PRINTFORM …そのまま射精しちゃって下さい	PRINTFORM …そのまま射精しちゃって下さい
PRINTFORMDW ずりゅ…ずりゅ……ぬぷんっ	PRINTFORMDW ずりゅ…ずりゅ……ぬぷんっ
PRINTFORM 「足で…シて欲しい…？　ふふっ	PRINTFORM 「足で…シて欲しい…？　ふふっ
PRINTFORMW 　ちょっと待って下さいね…」	PRINTFORMW 　ちょっと待って下さいね…」
PRINTFORM 「貴女…パチュリー様そっくり…	PRINTFORM 「貴女…パチュリー様そっくり…
PRINTFORMW 　ビクっとしちゃいました？」	PRINTFORMW 　ビクっとしちゃいました？」
PRINTFORM （特にパチュリー様に…くすくす	PRINTFORM （特にパチュリー様に…くすくす
PRINTFORM 　早く…誰か探して……うふふっ	PRINTFORM 　早く…誰か探して……うふふっ
PRINTFORM 「このお礼は改めて今度…うふふ	PRINTFORM 「このお礼は改めて今度…うふふ
PRINTFORM 　最大限…ご奉仕させて頂きます	PRINTFORM 　最大限…ご奉仕させて頂きます
PRINTFORM 　おっぱい…優しくして下さいね	PRINTFORM 　おっぱい…優しくして下さいね
PRINTFORM 　この膣で搾り取る感覚…最高…	PRINTFORM 　この膣で搾り取る感覚…最高…
PRINTFORM 　私おなか空いてるんですからぁ	PRINTFORM 　私おなか空いてるんですからぁ
PRINTFORM 「さぁ…邪魔な布は脱ぎましょう	PRINTFORM 「さぁ…邪魔な布は脱ぎましょう
PRINTFORM 　クリちゃんくりくり～♪　あっ	PRINTFORM 　クリちゃんくりくり～♪　あっ
PRINTFORM 「ほら、私のおちんぽを、きゅっ	PRINTFORM 「ほら、私のおちんぽを、きゅっ
PRINTFORM 「すぐにイっちゃわないで下さい	PRINTFORM 「すぐにイっちゃわないで下さい
PRINTFORM 「口の中も…たっぷり犯しちゃう	PRINTFORM 「口の中も…たっぷり犯しちゃう
PRINTFORM 「もっとぉ…擦り合わせましょう	PRINTFORM 「もっとぉ…擦り合わせましょう
PRINTFORMW 「はぅ……ぅ……ぁ…………」	PRINTFORMW 「はぅ……ぅ……ぁ…………」
PRINTFORMW 「ぅぁ…………はぁ…………」	PRINTFORMW 「ぅぁ…………はぁ…………」
PRINTFORM 「ん……ぁ………ああぁぁんっっ	PRINTFORM 「ん……ぁ………ああぁぁんっっ
PRINTFORM 　あぁ～～～～～～～～～～ッッ	PRINTFORM 　あぁ～～～～～～～～～～ッッ
PRINTFORM 　ああああぁぁーーーーー……っ	PRINTFORM 　ああああぁぁーーーーー……っ
PRINTFORMW 「…くっ、駄目でしたか……」	PRINTFORMW 「…くっ、駄目でしたか……」
PRINTFORMW 「当たって……下さいっっ！」	PRINTFORMW 「当たって……下さいっっ！」
PRINTFORMW 　ねぇ…お願いですからぁ…」	PRINTFORMW 　ねぇ…お願いですからぁ…」
PRINTFORM 　どうです…気持ちいいでしょう	PRINTFORM 　どうです…気持ちいいでしょう
PRINTFORM 　凄く…舐め甲斐がありますよ…	PRINTFORM 　凄く…舐め甲斐がありますよ…
PRINTFORM 「マスターの身体…大きいですね	PRINTFORM 「マスターの身体…大きいですね
PRINTFORM 　ではマスターの仰せのままに…	PRINTFORM 　ではマスターの仰せのままに…
PRINTFORM 　でも…まだイかないで下さいね	PRINTFORM 　でも…まだイかないで下さいね
PRINTFORM 　先から精気が溢れてきてます…	PRINTFORM 　先から精気が溢れてきてます…
PRINTFORM 　おちんちんの快感…凄いんです	PRINTFORM 　おちんちんの快感…凄いんです
PRINTFORMW 　痛くしないで…下さい……」	PRINTFORMW 　痛くしないで…下さい……」
PRINTFORM 　おちんぽ…気持ち良くしてぇ…	PRINTFORM 　おちんぽ…気持ち良くしてぇ…
PRINTFORM 　根元まで完全に飲み込めますよ	PRINTFORM 　根元まで完全に飲み込めますよ
PRINTFORM 　マスター…焦らさないで下さい	PRINTFORM 　マスター…焦らさないで下さい
PRINTFORM 　ささ、一気に…んんんんぅっっ	PRINTFORM 　ささ、一気に…んんんんぅっっ
PRINTFORM 　そっちまでは手が回らな…ぅぅ	PRINTFORM 　そっちまでは手が回らな…ぅぅ
PRINTFORM 「パチュリー様の前で…こんなっ	PRINTFORM 「パチュリー様の前で…こんなっ
PRINTFORMDW 『私が乗っ取ったからね♪』	PRINTFORMDW 『私が乗っ取ったからね♪』
PRINTFORM 　きゅぅうんってキちゃうッッッ	PRINTFORM 　きゅぅうんってキちゃうッッッ
PRINTFORM 　子宮でビクビク動かないでぇ…	PRINTFORM 　子宮でビクビク動かないでぇ…
PRINTFORM 「…あ…魔…眼……？　…んんっ	PRINTFORM 「…あ…魔…眼……？　…んんっ
PRINTFORMW 　もう…動けない…です……」	PRINTFORMW 　もう…動けない…です……」
PRINTFORM 「ぁ…もっとして下さいよぉ……	PRINTFORM 「ぁ…もっとして下さいよぉ……
PRINTFORM 　小さいからと侮っていたら…ぁ	PRINTFORM 　小さいからと侮っていたら…ぁ
PRINTFORMW 　だ…だめです…触っちゃ…」	PRINTFORMW 　だ…だめです…触っちゃ…」
PRINTFORMW 「パチュリー様っ危ないっ！」	PRINTFORMW 「パチュリー様っ危ないっ！」
PRINTFORMW 　こんな事してる場合じゃ…」	PRINTFORMW 　こんな事してる場合じゃ…」
PRINTFORMW 　身が引き締まる思いです。」	PRINTFORMW 　身が引き締まる思いです。」
PRINTFORM 「え…腹を満たすって…そういう	PRINTFORM 「え…腹を満たすって…そういう
PRINTFORM 　熱いのが子宮の中いっぱいに…	PRINTFORM 　熱いのが子宮の中いっぱいに…
PRINTFORM 　腰から下…痺れてキちゃうっっ	PRINTFORM 　腰から下…痺れてキちゃうっっ
PRINTFORM 　ここは我慢しないと…くぅンッ	PRINTFORM 　ここは我慢しないと…くぅンッ
PRINTFORMW 　…抑えられてる…うちに…」	PRINTFORMW 　…抑えられてる…うちに…」
PRINTFORM 「この…こみ上げてくる…感覚っ	PRINTFORM 「この…こみ上げてくる…感覚っ
PRINTFORM 「…んんっ？　これ…ま…またっ	PRINTFORM 「…んんっ？　これ…ま…またっ
PRINTFORM 　でっでも無理ぃぃぃぃぃっっっ	PRINTFORM 　でっでも無理ぃぃぃぃぃっっっ
PRINTFORM 「…ほら…濃いぃせーえき…っっ	PRINTFORM 「…ほら…濃いぃせーえき…っっ
PRINTFORM 　私も…とっても気持ち良いです	PRINTFORM 　私も…とっても気持ち良いです
PRINTFORM 　そんなに激しく動かなくてもっ	PRINTFORM 　そんなに激しく動かなくてもっ
PRINTFORM 　ずりゅずりゅずりゅって凄いぃ	PRINTFORM 　ずりゅずりゅずりゅって凄いぃ
PRINTFORM 「いいですよ…一番奥に…んんっ	PRINTFORM 「いいですよ…一番奥に…んんっ
PRINTFORM 「…とりあえずは満足できました	PRINTFORM 「…とりあえずは満足できました
PRINTFORM 　中が…ねっとり纏わりついてっ	PRINTFORM 　中が…ねっとり纏わりついてっ
PRINTFORM 　ひゃいまふぅぅぅぅぅッッッッ	PRINTFORM 　ひゃいまふぅぅぅぅぅッッッッ
PRINTFORM 　ぁ…ミル…ク…吸われて…る…	PRINTFORM 　ぁ…ミル…ク…吸われて…る…
PRINTFORM 　子宮口…内側から探られてる…	PRINTFORM 　子宮口…内側から探られてる…
PRINTFORMW 　ちょっと触れた…だけで…」	PRINTFORMW 　ちょっと触れた…だけで…」
PRINTFORM 　～～～～～～～～～～～っっっ	PRINTFORM 　～～～～～～～～～～～っっっ
PRINTFORM 　ぢゅっぽぢゅっぽっってッッッ	PRINTFORM 　ぢゅっぽぢゅっぽっってッッッ
PRINTFORM 　前も後ろも…グイングインって	PRINTFORM 　前も後ろも…グイングインって
PRINTFORM 　…ぁぁ…この子…愛撫が上手…	PRINTFORM 　…ぁぁ…この子…愛撫が上手…
PRINTFORM 　少しづつ…強くしてあげます	PRINTFORM 　少しづつ…強くしてあげます
PRINTFORMW 　リフレッシュできました」	PRINTFORMW 　リフレッシュできました」
PRINTFORM …スッキリさせてあげますから	PRINTFORM …スッキリさせてあげますから
PRINTFORM 　勃たせて搾り取ってあげます	PRINTFORM 　勃たせて搾り取ってあげます
PRINTFORM 　せいぜい我慢してみて下さい	PRINTFORM 　せいぜい我慢してみて下さい
PRINTFORM 「どうです？　私のおっぱいは	PRINTFORM 「どうです？　私のおっぱいは
PRINTFORM 「ほぉら…こうやって、たぷん	PRINTFORM 「ほぉら…こうやって、たぷん
PRINTFORMDW ぶごっ！ぶごっ！ぶごっ！	PRINTFORMDW ぶごっ！ぶごっ！ぶごっ！
PRINTFORM 　お相手してもらいたいなぁ…	PRINTFORM 　お相手してもらいたいなぁ…
PRINTFORM 　耳を貸して下さい……フーッ	PRINTFORM 　耳を貸して下さい……フーッ
PRINTFORM 「おや……道具が一式…ふふふ	PRINTFORM 「おや……道具が一式…ふふふ
PRINTFORM 「寝ている間に誰かが…くすっ	PRINTFORM 「寝ている間に誰かが…くすっ
PRINTFORM 　ミルク…飲まれちゃってる…	PRINTFORM 　ミルク…飲まれちゃってる…
PRINTFORM 　ふふ…こっそりと混ざって…	PRINTFORM 　ふふ…こっそりと混ざって…
PRINTFORM 　誰か…獲物は…まだかしら…	PRINTFORM 　誰か…獲物は…まだかしら…
PRINTFORM 「ここは待ち構えて…くすくす	PRINTFORM 「ここは待ち構えて…くすくす
PRINTFORM 「私…酔ってしまったら…ふふ	PRINTFORM 「私…酔ってしまったら…ふふ
PRINTFORM 　すっごく濃いぃせーえき…ん	PRINTFORM 　すっごく濃いぃせーえき…ん
PRINTFORM 　……はぅ……最高…です……	PRINTFORM 　……はぅ……最高…です……
PRINTFORMW 「行きますよ……ッッ！！」	PRINTFORMW 「行きますよ……ッッ！！」
PRINTFORMW 「これで…まとめてっ！！」	PRINTFORMW 「これで…まとめてっ！！」
PRINTFORMW 　とにかく守らないと……」	PRINTFORMW 　とにかく守らないと……」
PRINTFORM 　あなたとの事を考えてたら…	PRINTFORM 　あなたとの事を考えてたら…
PRINTFORM 　いつでもイっていいんですよ	PRINTFORM 　いつでもイっていいんですよ
PRINTFORM 　腰…止まらなくなっちゃうぅ	PRINTFORM 　腰…止まらなくなっちゃうぅ
PRINTFORM 　簡単に搾られるわけに…はっ	PRINTFORM 　簡単に搾られるわけに…はっ
PRINTFORM 　先にイかされる…わけにはっ	PRINTFORM 　先にイかされる…わけにはっ
PRINTFORM 　ほら…ずりゅりゅりゅって…	PRINTFORM 　ほら…ずりゅりゅりゅって…
PRINTFORM 　膣内で…うねうね動いてるぅ	PRINTFORM 　膣内で…うねうね動いてるぅ
PRINTFORM ちゅうちゅうされるのイイっっ	PRINTFORM ちゅうちゅうされるのイイっっ
PRINTFORM 「クリトリス…じゃなく…てッ	PRINTFORM 「クリトリス…じゃなく…てッ
PRINTFORM 　ぢゅぷぢゅぷして下さいっっ	PRINTFORM 　ぢゅぷぢゅぷして下さいっっ
PRINTFORM 　普段抑えてたから…余計に…	PRINTFORM 　普段抑えてたから…余計に…
PRINTFORM 　あ…これ…は…はぁぁぁっっ	PRINTFORM 　あ…これ…は…はぁぁぁっっ
PRINTFORM 「え…キス…ですか？　…んっ	PRINTFORM 「え…キス…ですか？　…んっ
PRINTFORM 　一緒に…イって下さいッッッ	PRINTFORM 　一緒に…イって下さいッッッ
PRINTFORM 「はうぅぅぅぅぅぅ～～ッッッ	PRINTFORM 「はうぅぅぅぅぅぅ～～ッッッ
PRINTFORM 　おまんこ…かき回されるとっ	PRINTFORM 　おまんこ…かき回されるとっ
PRINTFORM 　ここの魔物だと…赤ちゃんっ	PRINTFORM 　ここの魔物だと…赤ちゃんっ
PRINTFORM 　膣内…どっっぷり射精して…	PRINTFORM 　膣内…どっっぷり射精して…
PRINTFORM 「……ふふふ……くすくすくす	PRINTFORM 「……ふふふ……くすくすくす
PRINTFORM 「顔中…かかっちゃってますね	PRINTFORM 「顔中…かかっちゃってますね
PRINTFORMW 「あ…もう……動けません」	PRINTFORMW 「あ…もう……動けません」
PRINTFORM 　これ…子宮に何かが…んんっ	PRINTFORM 　これ…子宮に何かが…んんっ
PRINTFORM 　ミルク…吸わないで下さい…	PRINTFORM 　ミルク…吸わないで下さい…
PRINTFORM 　この服、好きなんですよねぇ	PRINTFORM 　この服、好きなんですよねぇ
PRINTFORMW 　ありがとうございます♪」	PRINTFORMW 　ありがとうございます♪」
PRINTFORM 　胸を小さくするって……すっ	PRINTFORM 　胸を小さくするって……すっ
PRINTFORM 　皆さん…私から離れ…んんっ	PRINTFORM 　皆さん…私から離れ…んんっ
PRINTFORML 　射精っっっ？？？！！！」	PRINTFORML 　射精っっっ？？？！！！」
PRINTFORM 「くすくす…イっちゃいますよ	PRINTFORM 「くすくす…イっちゃいますよ
PRINTFORM 　凄く気持ち良さそうでしたよ	PRINTFORM 　凄く気持ち良さそうでしたよ
PRINTFORM 　腰が…自然に動いちゃいます	PRINTFORM 　腰が…自然に動いちゃいます
PRINTFORM 「この包まれてる中で…中でっ	PRINTFORM 「この包まれてる中で…中でっ
PRINTFORM 「乳首凄く…固くなってますよ	PRINTFORM 「乳首凄く…固くなってますよ
PRINTFORM 「じゃあ…お口でお願いします	PRINTFORM 「じゃあ…お口でお願いします
PRINTFORM 「諦めて…続き、しましょうか	PRINTFORM 「諦めて…続き、しましょうか
PRINTFORM 「そんなに足を絡めちゃってぇ	PRINTFORM 「そんなに足を絡めちゃってぇ
PRINTFORM 　んんあああああぁぁぁんッッ	PRINTFORM 　んんあああああぁぁぁんッッ
PRINTFORM 　膣内にっ…下さいっっっっっ	PRINTFORM 　膣内にっ…下さいっっっっっ
PRINTFORM 　あっ…あ～～～～～～～っっ	PRINTFORM 　あっ…あ～～～～～～～っっ
PRINTFORM 「だ…駄目です…そんな強く…	PRINTFORM 「だ…駄目です…そんな強く…
PRINTFORM 　…え…あ…な、何か…乳首っ	PRINTFORM 　…え…あ…な、何か…乳首っ
PRINTFORMW 「…………ぅ……ん……？」	PRINTFORMW 「…………ぅ……ん……？」
PRINTFORMDL おや…小悪魔の様子が…？	PRINTFORMDL おや…小悪魔の様子が…？
PRINTFORMDL [0] 今こそ覚醒の時！	PRINTFORMDL [0] 今こそ覚醒の時！
PRINTFORM 　子宮口…ぐりぐりされてるっ	PRINTFORM 　子宮口…ぐりぐりされてるっ
PRINTFORM 　種付けしちゃうぅぅぅッッッ	PRINTFORM 　種付けしちゃうぅぅぅッッッ
PRINTFORM 「…えっ！？　服が…うそッッ	PRINTFORM 「…えっ！？　服が…うそッッ
PRINTFORMW 　お…おわり…まし…た？」	PRINTFORMW 　お…おわり…まし…た？」
PRINTFORMW 　やっぱり何かしてる！？」	PRINTFORMW 　やっぱり何かしてる！？」
PRINTFORM 　いっぱい…射精したんですね	PRINTFORM 　いっぱい…射精したんですね
PRINTFORM 「ぁ……おなかの中…たぷたぷ	PRINTFORM 「ぁ……おなかの中…たぷたぷ
PRINTFORM 　すっごく美味しかったです…	PRINTFORM 　すっごく美味しかったです…
PRINTFORM 　そんなにがっつかないでも…	PRINTFORM 　そんなにがっつかないでも…
PRINTFORM 「魔力を集中させて…んんぅ	PRINTFORM 「魔力を集中させて…んんぅ
PRINTFORM 　これは困っちゃいますよね	PRINTFORM 　これは困っちゃいますよね
PRINTFORM 「ねぇ…パチュリーさまぁ…	PRINTFORM 「ねぇ…パチュリーさまぁ…
PRINTFORMW 　もじもじしちゃって…」	PRINTFORMW 　もじもじしちゃって…」
PRINTFORM 「お困りなんですよね…それ	PRINTFORM 「お困りなんですよね…それ
PRINTFORM 「一回だけじゃなくて…くす	PRINTFORM 「一回だけじゃなくて…くす
PRINTFORM 「え…？　足で…そうですか	PRINTFORM 「え…？　足で…そうですか
PRINTFORM 「お久しぶりですね、お母様	PRINTFORM 「お久しぶりですね、お母様
PRINTFORM 　悦ぶ顔が目に浮かびます…	PRINTFORM 　悦ぶ顔が目に浮かびます…
PRINTFORM 「はぁ…もう待ち切れない…	PRINTFORM 「はぁ…もう待ち切れない…
PRINTFORM 「別に何もしませんよ…今は	PRINTFORM 「別に何もしませんよ…今は
PRINTFORMW 　なんで魔物がお酒に…」	PRINTFORMW 　なんで魔物がお酒に…」
PRINTFORM 「このご恩はいつか…くすっ	PRINTFORM 「このご恩はいつか…くすっ
PRINTFORMW 「ふふ…可愛いおしり…」	PRINTFORMW 「ふふ…可愛いおしり…」
PRINTFORM 「ふふふ…捕まえちゃいます	PRINTFORM 「ふふふ…捕まえちゃいます
PRINTFORM 　膣内がきゅーって締まって	PRINTFORM 　膣内がきゅーって締まって
PRINTFORM …気持ちよく…なりましょう	PRINTFORM …気持ちよく…なりましょう
PRINTFORM 　ここも…ここも…ここもぉ	PRINTFORM 　ここも…ここも…ここもぉ
PRINTFORM 　こっちですよ…そう…ここ	PRINTFORM 　こっちですよ…そう…ここ
PRINTFORM 「もう…こんなにしちゃって	PRINTFORM 「もう…こんなにしちゃって
PRINTFORM 　ぢゅぷぢゅぷして…ぁぁん	PRINTFORM 　ぢゅぷぢゅぷして…ぁぁん
PRINTFORM 「足で踏んで欲しいんですか	PRINTFORM 「足で踏んで欲しいんですか
PRINTFORM 　これからもっと……ふふふ	PRINTFORM 　これからもっと……ふふふ
PRINTFORM 　シテ欲しくてぇぇぇっっっ	PRINTFORM 　シテ欲しくてぇぇぇっっっ
PRINTFORM 　同じサキュバス属として…	PRINTFORM 　同じサキュバス属として…
PRINTFORM 　私…満たされちゃってる…	PRINTFORM 　私…満たされちゃってる…
PRINTFORM 　もうお尻でいいですぅっっ	PRINTFORM 　もうお尻でいいですぅっっ
PRINTFORM 「だ…だめ…おちんちんはっ	PRINTFORM 「だ…だめ…おちんちんはっ
PRINTFORM 　でもやっぱり…最高ですっ	PRINTFORM 　でもやっぱり…最高ですっ
PRINTFORM 「お尻じゃないですよぉ……	PRINTFORM 「お尻じゃないですよぉ……
PRINTFORM 　はぁ…おっぱい…好きぃ…	PRINTFORM 　はぁ…おっぱい…好きぃ…
PRINTFORM 　堕ちちゃい…そうですっっ	PRINTFORM 　堕ちちゃい…そうですっっ
PRINTFORM 　今の…凄く良かったですよ	PRINTFORM 　今の…凄く良かったですよ
PRINTFORM 　子宮の中…満たされてる…	PRINTFORM 　子宮の中…満たされてる…
PRINTFORM 　妊娠しちゃうぅぅっっっっ	PRINTFORM 　妊娠しちゃうぅぅっっっっ
PRINTFORM 「この快感…しゅごいぃぃぃ	PRINTFORM 「この快感…しゅごいぃぃぃ
PRINTFORM 　集中でき…はあぁぁんっっ	PRINTFORM 　集中でき…はあぁぁんっっ
PRINTFORMW 「…はぁ、美味しかった」	PRINTFORMW 「…はぁ、美味しかった」
PRINTFORM 「……身体が……疼く…んん	PRINTFORM 「……身体が……疼く…んん
PRINTFORMW 「この床…崩れるっ？！」	PRINTFORMW 「この床…崩れるっ？！」
PRINTFORM 　なにこの蟲達…ちっ乳首っ	PRINTFORM 　なにこの蟲達…ちっ乳首っ
PRINTFORM 　む、蟲が…次から次へと…	PRINTFORM 　む、蟲が…次から次へと…
PRINTFORM 「だめですよっ、いっ今は…	PRINTFORM 「だめですよっ、いっ今は…
PRINTFORM 　そ、そんなにしたら…でっ	PRINTFORM 　そ、そんなにしたら…でっ
PRINTFORM 　そんなに強く揉ん…だらっ	PRINTFORM 　そんなに強く揉ん…だらっ
PRINTFORM 早く吸い終わって下さいッッ	PRINTFORM 早く吸い終わって下さいッッ
PRINTFORM 　お願いします……はぁ……	PRINTFORM 　お願いします……はぁ……
PRINTFORM 　精液全部…でちゃうッッッ	PRINTFORM 　精液全部…でちゃうッッッ
PRINTFORM 　おちんぽ…ギンギンですよ	PRINTFORM 　おちんぽ…ギンギンですよ
PRINTFORM 　お困りなんですよね…それ	PRINTFORM 　お困りなんですよね…それ
PRINTFORM 　これが欲しかったんですっ	PRINTFORM 　これが欲しかったんですっ
PRINTFORM 　ほら…こうすると…キャっ	PRINTFORM 　ほら…こうすると…キャっ
PRINTFORM 「ほら…私の顔を見て下さい	PRINTFORM 「ほら…私の顔を見て下さい
PRINTFORM 　もっと…愛し合いましょう	PRINTFORM 　もっと…愛し合いましょう
PRINTFORM 「それでは私の方から…んぅ	PRINTFORM 「それでは私の方から…んぅ
PRINTFORMW 　なんとか解けましたね」	PRINTFORMW 　なんとか解けましたね」
PRINTFORM 　びゅびゅーーーってッッッ	PRINTFORM 　びゅびゅーーーってッッッ
PRINTFORM 　ほら…舐めてみて下さい…	PRINTFORM 　ほら…舐めてみて下さい…
PRINTFORM 　精液…こんなにいっぱい…	PRINTFORM 　精液…こんなにいっぱい…
PRINTFORM 　今度は…膣内にも下さいね	PRINTFORM 　今度は…膣内にも下さいね
PRINTFORM 　ああぁぁ～～～～～～……	PRINTFORM 　ああぁぁ～～～～～～……
PRINTFORM 　んんんぅぅーーーーー…ッ	PRINTFORM 　んんんぅぅーーーーー…ッ
PRINTFORM 　イっちゃ……うぅっッッッ	PRINTFORM 　イっちゃ……うぅっッッッ
PRINTFORMW 「そーーーーっと………」	PRINTFORMW 「そーーーーっと………」
PRINTFORMDW [1] いつものままで	PRINTFORMDW [1] いつものままで
PRINTFORM 「早く私を見つけて…くすっ	PRINTFORM 「早く私を見つけて…くすっ
PRINTFORM 　そんなに絡ん…じゃっッッ	PRINTFORM 　そんなに絡ん…じゃっッッ
PRINTFORML 　完全に包み込まれて…」	PRINTFORML 　完全に包み込まれて…」
PRINTFORM 　こしゅこしゅひちゃッッッ	PRINTFORM 　こしゅこしゅひちゃッッッ
PRINTFORM 「ひいいいいううぅぅぅっっ	PRINTFORM 「ひいいいいううぅぅぅっっ
PRINTFORM 「…っ？！　んあああッッッ	PRINTFORM 「…っ？！　んあああッッッ
PRINTFORM 　中で…乳首…かぷっってッ	PRINTFORM 　中で…乳首…かぷっってッ
PRINTFORM 　ミルク…吸われてるっっっ	PRINTFORM 　ミルク…吸われてるっっっ
PRINTFORM 　胸のとこ…うねうね動いて	PRINTFORM 　胸のとこ…うねうね動いて
PRINTFORM 　いっぱい過ぎますぅぅッッ	PRINTFORM 　いっぱい過ぎますぅぅッッ
PRINTFORM 「しっかり狙って…あぁん	PRINTFORM 「しっかり狙って…あぁん
PRINTFORM 「少し強くしちゃいます…	PRINTFORM 「少し強くしちゃいます…
PRINTFORM 「準備が要る技は…んんっ	PRINTFORM 「準備が要る技は…んんっ
PRINTFORM 　是非とも味わって下さい	PRINTFORM 　是非とも味わって下さい
PRINTFORM 　とても美味しかったです	PRINTFORM 　とても美味しかったです
PRINTFORM 「膣内に射精して下さいね	PRINTFORM 「膣内に射精して下さいね
PRINTFORM 　いい場所じゃないですか	PRINTFORM 　いい場所じゃないですか
PRINTFORM 　情報交換…しましょうか	PRINTFORM 　情報交換…しましょうか
PRINTFORM 「寝るんですか？　うふふ	PRINTFORM 「寝るんですか？　うふふ
PRINTFORMW 　急いで行かないと！」	PRINTFORMW 　急いで行かないと！」
PRINTFORM 　ありがとうございました	PRINTFORM 　ありがとうございました
PRINTFORM 　早く次に…イきましょう	PRINTFORM 　早く次に…イきましょう
PRINTFORMW 　イキますよっ！！！」	PRINTFORMW 　イキますよっ！！！」
PRINTFORM 「早くヤられて下さいよぉ	PRINTFORM 「早くヤられて下さいよぉ
PRINTFORMW 　仕方ないですねぇ…」	PRINTFORMW 　仕方ないですねぇ…」
PRINTFORMW 「パチュリー様っ！！」	PRINTFORMW 「パチュリー様っ！！」
PRINTFORM 　一緒に愉しみましょう…	PRINTFORM 　一緒に愉しみましょう…
PRINTFORM 　ほら…我慢しないで…ね	PRINTFORM 　ほら…我慢しないで…ね
PRINTFORM 　今…ビクっとしましたよ	PRINTFORM 　今…ビクっとしましたよ
PRINTFORM 「目を瞑って下さい……ん	PRINTFORM 「目を瞑って下さい……ん
PRINTFORM 「戦闘中…ですが…んふぅ	PRINTFORM 「戦闘中…ですが…んふぅ
PRINTFORM 　痛覚が…全部快感に……	PRINTFORM 　痛覚が…全部快感に……
PRINT 「…攻撃？！　避けられ…ッッ！！	PRINT 「…攻撃？！　避けられ…ッッ！！
PRINTFORM 　マスターの…本当に素敵	PRINTFORM 　マスターの…本当に素敵
PRINTFORM 「そんな事されたら…ぅん	PRINTFORM 「そんな事されたら…ぅん
PRINTFORM 　もっと…しこしこしてぇ	PRINTFORM 　もっと…しこしこしてぇ
PRINTFORM おまんこが一番いいですっ	PRINTFORM おまんこが一番いいですっ
PRINTFORM 　この私がっ…こんなにっ	PRINTFORM 　この私がっ…こんなにっ
PRINTFORM 「そんなに…され…るとっ	PRINTFORM 「そんなに…され…るとっ
PRINTFORM 　ハマっちゃいそうです…	PRINTFORM 　ハマっちゃいそうです…
PRINTFORM 　パチュリー…さま…私っ	PRINTFORM 　パチュリー…さま…私っ
PRINTFORM 　お、大きいいいッッッッ	PRINTFORM 　お、大きいいいッッッッ
PRINTFORM 　もっとしゃせーしたいっ	PRINTFORM 　もっとしゃせーしたいっ
PRINTFORM 　なかなか良かったですよ	PRINTFORM 　なかなか良かったですよ
PRINTFORML 「ねぇ、パチュリー様」	PRINTFORML 「ねぇ、パチュリー様」
PRINTFORMW 「…ぁ…眠気…が……」	PRINTFORMW 「…ぁ…眠気…が……」
PRINTFORMW 「うぅ…痛たたた……」	PRINTFORMW 「うぅ…痛たたた……」
PRINTFORM 「…きっ、きついですよぉ	PRINTFORM 「…きっ、きついですよぉ
PRINTFORM 　ブラシのサービスまで…	PRINTFORM 　ブラシのサービスまで…
PRINTFORM 　とても…いい気分です…	PRINTFORM 　とても…いい気分です…
PRINTFORM 　はあぁぁぁぁんんっっっ	PRINTFORM 　はあぁぁぁぁんんっっっ
PRINTFORM 「そろそろ…動きを速くっ	PRINTFORM 「そろそろ…動きを速くっ
PRINTFORM せーえき登って来てるッッ	PRINTFORM せーえき登って来てるッッ
PRINTFORM 　小さくても気にしないで	PRINTFORM 　小さくても気にしないで
PRINTFORM 「どうです…私のおっぱい	PRINTFORM 「どうです…私のおっぱい
PRINTFORM 　では失礼して……かぷっ	PRINTFORM 　では失礼して……かぷっ
PRINTFORM 　ぅん…挿入ってくる……	PRINTFORM 　ぅん…挿入ってくる……
PRINTFORM 　そんな事…させませんよ	PRINTFORM 　そんな事…させませんよ
PRINTFORM 　膣内でどくんどくんって	PRINTFORM 　膣内でどくんどくんって
PRINTFORM 「あああぁぁーーー…っっ	PRINTFORM 「あああぁぁーーー…っっ
PRINTFORM 　あ～～～～～～……ッッ	PRINTFORM 　あ～～～～～～……ッッ
PRINTFORM 　…ーーーーーーーっっっ	PRINTFORM 　…ーーーーーーーっっっ
PRINTFORMW 「次の部屋の様子は…」	PRINTFORMW 「次の部屋の様子は…」
PRINTFORMDW [1] そこまでよ！	PRINTFORMDW [1] そこまでよ！
PRINTFORMDL [0] 望むところだ	PRINTFORMDL [0] 望むところだ
PRINTFORM 　一緒に愉しみましょうね	PRINTFORM 　一緒に愉しみましょうね
PRINTFORMDW 気のせいだった様だ…	PRINTFORMDW 気のせいだった様だ…
PRINTFORM 「ああぁあああぁぁッッっ	PRINTFORM 「ああぁあああぁぁッッっ
PRINTFORM 　もう…終わりなんですか	PRINTFORM 　もう…終わりなんですか
PRINTFORMW 　仕方ないですね……」	PRINTFORMW 　仕方ないですね……」
PRINTFORM 「…ふああぁぁんんんっっ	PRINTFORM 「…ふああぁぁんんんっっ
PRINTFORM 　しゅっしゅごいいいっっ	PRINTFORM 　しゅっしゅごいいいっっ
PRINTFORM 　うん、そこがイイのぉっ	PRINTFORM 　うん、そこがイイのぉっ
PRINTFORM 　一気に攻められたらッッ	PRINTFORM 　一気に攻められたらッッ
PRINTFORM 　おちんちんは弱…ひぅっ	PRINTFORM 　おちんちんは弱…ひぅっ
PRINTFORM 　おちんちんは…弱…ッッ	PRINTFORM 　おちんちんは…弱…ッッ
PRINTFORM 　さぁ撃っちゃいますぉ	PRINTFORM 　さぁ撃っちゃいますぉ
PRINTFORM 　よぉく狙って…んんぅ	PRINTFORM 　よぉく狙って…んんぅ
PRINTFORM 　やられちゃって下さい	PRINTFORM 　やられちゃって下さい
PRINTFORM …大人しくさせて…んっ	PRINTFORM …大人しくさせて…んっ
PRINTFORM 「さぁ…私の出番ですね	PRINTFORM 「さぁ…私の出番ですね
PRINTFORMW 「あの光は…出口？」	PRINTFORMW 「あの光は…出口？」
PRINTFORM …決着を付けましょうか	PRINTFORM …決着を付けましょうか
PRINTFORM 「えーい！　え……やっ	PRINTFORM 「えーい！　え……やっ
PRINTFORM 　力が…漲ってきました	PRINTFORM 　力が…漲ってきました
PRINTFORM 　心配しないで…ふふっ	PRINTFORM 　心配しないで…ふふっ
PRINTFORM 「ふぅ…鼻息荒いですよ	PRINTFORM 「ふぅ…鼻息荒いですよ
PRINTFORM …警戒しないで下さいよ	PRINTFORM …警戒しないで下さいよ
PRINTFORM 「触手とか…色々…ふふ	PRINTFORM 「触手とか…色々…ふふ
PRINTFORM 「いつもみたいに…ふふ	PRINTFORM 「いつもみたいに…ふふ
PRINTFORMW 「当たって下さい！」	PRINTFORMW 「当たって下さい！」
PRINTFORMW 「これで…一気に！」	PRINTFORMW 「これで…一気に！」
PRINTFORM 「えーと…その…んんっ	PRINTFORM 「えーと…その…んんっ
PRINTFORM 「早く…くださいよぉ…	PRINTFORM 「早く…くださいよぉ…
PRINTFORM 　先っぽ…弱いんですね	PRINTFORM 　先っぽ…弱いんですね
PRINTFORM 「さぁ…いらして下さい	PRINTFORM 「さぁ…いらして下さい
PRINTFORM 　どうぞ…お願いします	PRINTFORM 　どうぞ…お願いします
PRINTFORM 「え…子宮が…疼くぅ…	PRINTFORM 「え…子宮が…疼くぅ…
PRINTFORM 　どう…です？マスター	PRINTFORM 　どう…です？マスター
PRINTFORM 　いい…そこ…もっと…	PRINTFORM 　いい…そこ…もっと…
PRINTFORM 　声…抑えられないっっ	PRINTFORM 　声…抑えられないっっ
PRINTFORM 　い…意表を突かれてっ	PRINTFORM 　い…意表を突かれてっ
PRINTFORM 　こんなの久し…ぶりっ	PRINTFORM 　こんなの久し…ぶりっ
PRINTFORM 　堕ちちゃい…そうっっ	PRINTFORM 　堕ちちゃい…そうっっ
PRINTFORM 　こっ…これ以上…はっ	PRINTFORM 　こっ…これ以上…はっ
PRINTFORM 　クリちゃん止めてぇっ	PRINTFORM 　クリちゃん止めてぇっ
PRINTFORMW 　中々やりますね…」	PRINTFORMW 　中々やりますね…」
PRINTFORM 　精液と一緒に…なに？	PRINTFORM 　精液と一緒に…なに？
PRINTFORM 　またああぁぁぁぁッッ	PRINTFORM 　またああぁぁぁぁッッ
PRINTFORMW 　…あ、今の水……」	PRINTFORMW 　…あ、今の水……」
PRINTFORM 　だからダメです…あぁ	PRINTFORM 　だからダメです…あぁ
PRINTFORM 　それならそうと先に…	PRINTFORM 　それならそうと先に…
PRINTFORML 「こく……こく……」	PRINTFORML 「こく……こく……」
PRINTFORM 　お…奥まで…もっとっ	PRINTFORM 　お…奥まで…もっとっ
PRINTFORM 　ぬぷぬぷ下さいっっっ	PRINTFORM 　ぬぷぬぷ下さいっっっ
PRINTFORM 　どなたかが……はぁん	PRINTFORM 　どなたかが……はぁん
PRINTFORM 「ふはぁ…また…来るっ	PRINTFORM 「ふはぁ…また…来るっ
PRINTFORM 　ーーーーーーーッッッ	PRINTFORM 　ーーーーーーーッッッ
PRINTFORM 　溜めて…溜めて…ふふ	PRINTFORM 　溜めて…溜めて…ふふ
PRINTFORMW 「パチュリー様……」	PRINTFORMW 「パチュリー様……」
PRINTFORM 　今度は…私の番ですね	PRINTFORM 　今度は…私の番ですね
PRINTFORM 　凄く…イイ具合ですよ	PRINTFORM 　凄く…イイ具合ですよ
PRINTFORM 　そこ…舌を這わせて…	PRINTFORM 　そこ…舌を這わせて…
PRINTFORM 　それに…感度も良くて	PRINTFORM 　それに…感度も良くて
PRINTFORM 　全部…飲んで下さいね	PRINTFORM 　全部…飲んで下さいね
PRINTFORM 　きっと治りますからっ	PRINTFORM 　きっと治りますからっ
PRINTFORM 　凄く…いい具合です…	PRINTFORM 　凄く…いい具合です…
PRINTFORM 　このまま一緒に……ん	PRINTFORM 　このまま一緒に……ん
PRINTFORM 　イっちゃうんですよね	PRINTFORM 　イっちゃうんですよね
PRINTFORM 　ぐいんぐいんってッッ	PRINTFORM 　ぐいんぐいんってッッ
PRINTFORM 　この無機物な感じもっ	PRINTFORM 　この無機物な感じもっ
PRINTFORM 　ああぁぁぁんんんっっ	PRINTFORM 　ああぁぁぁんんんっっ
PRINTFORM 　身体が持ちませんっっ	PRINTFORM 　身体が持ちませんっっ
PRINTFORM 　イキっぱなしですッッ	PRINTFORM 　イキっぱなしですッッ
PRINTFORM 　ひぐぅぅぅっっっっっ	PRINTFORM 　ひぐぅぅぅっっっっっ
PRINTFORM 「こ、これ以上……はッ	PRINTFORM 「こ、これ以上……はッ
PRINTFORM 　…ぁ…あぁ………はぁ	PRINTFORM 　…ぁ…あぁ………はぁ
PRINTFORM 「…ぁ……ぁ…ぁ…はぁ	PRINTFORM 「…ぁ……ぁ…ぁ…はぁ
PRINTFORM 「ぇ……お、おっぱいっ	PRINTFORM 「ぇ……お、おっぱいっ
PRINTFORM 　らめえぇえぇぇぇッッ	PRINTFORM 　らめえぇえぇぇぇッッ
PRINTFORM 　激し…過ぎますよぉ…	PRINTFORM 　激し…過ぎますよぉ…
PRINTFORM 「うにゅうううぅぅっっ	PRINTFORM 「うにゅうううぅぅっっ
PRINTFORM 　奥の奥まで…ぴっちり	PRINTFORM 　奥の奥まで…ぴっちり
PRINTFORM 　刺激っ…そ、そんなっ	PRINTFORM 　刺激っ…そ、そんなっ
PRINTFORM 　し、仕方ないですね…	PRINTFORM 　し、仕方ないですね…
PRINTFORM 　入って来てるみたい…	PRINTFORM 　入って来てるみたい…
PRINTFORM 　もっと…くらさぁい…	PRINTFORM 　もっと…くらさぁい…
PRINTFORM 「いっぱい…射精てる…	PRINTFORM 「いっぱい…射精てる…
PRINTFORM 　照準が定まらない…	PRINTFORM 　照準が定まらない…
PRINTFORM 「威力重視で…くすっ	PRINTFORM 「威力重視で…くすっ
PRINTFORM 「魔理沙さんを…んぅ	PRINTFORM 「魔理沙さんを…んぅ
PRINTFORM 　吐息が…漏れちゃう	PRINTFORM 　吐息が…漏れちゃう
PRINTFORM 　下手に動くと…うん	PRINTFORM 　下手に動くと…うん
PRINTFORM 「いいですよ…その顔	PRINTFORM 「いいですよ…その顔
PRINTFORM 　お尻の中に…んんっ	PRINTFORM 　お尻の中に…んんっ
PRINTFORM 　限界まで…我慢して	PRINTFORM 　限界まで…我慢して
PRINTFORM 　ん…ん……ふはぁ…	PRINTFORM 　ん…ん……ふはぁ…
PRINTFORM 「私の手までヌルヌル	PRINTFORM 「私の手までヌルヌル
PRINTFORM 　私が…満足するまで	PRINTFORM 　私が…満足するまで
PRINTFORM 「ここにも何か…くす	PRINTFORM 「ここにも何か…くす
PRINTFORM 「私を酔わせて…くす	PRINTFORM 「私を酔わせて…くす
PRINTFORM …退屈はさせませんよ	PRINTFORM …退屈はさせませんよ
PRINTFORM 　はい…お願いします	PRINTFORM 　はい…お願いします
PRINTFORM 「んはあああぁぁんん	PRINTFORM 「んはあああぁぁんん
PRINTFORM 「……ん…………ぅぁ	PRINTFORM 「……ん…………ぅぁ
PRINTFORM …開発……秘密…んっ	PRINTFORM …開発……秘密…んっ
PRINTFORM …です…が……あぁん	PRINTFORM …です…が……あぁん
PRINTFORM 　目を…瞑って……ん	PRINTFORM 　目を…瞑って……ん
PRINTFORM 　もう指が…ぬるぬる	PRINTFORM 　もう指が…ぬるぬる
PRINTFORM 「少し強く…しますよ	PRINTFORM 「少し強く…しますよ
PRINTFORM 　マスターの…逞しい	PRINTFORM 　マスターの…逞しい
PRINTFORMW 　イイでしょう？」	PRINTFORMW 　イイでしょう？」
PRINTFORMW 　次はなんとか…」	PRINTFORMW 　次はなんとか…」
PRINTFORM 　お尻がいいんですか	PRINTFORM 　お尻がいいんですか
PRINTFORM 　欲しかったんですっ	PRINTFORM 　欲しかったんですっ
PRINTFORM 　もっとぉぉ～～……	PRINTFORM 　もっとぉぉ～～……
PRINTFORM 　イボイボが擦れてっ	PRINTFORM 　イボイボが擦れてっ
PRINTFORM 　おっぱいもイイっっ	PRINTFORM 　おっぱいもイイっっ
PRINTFORM 　お尻も感じちゃうっ	PRINTFORM 　お尻も感じちゃうっ
PRINTFORM 「そこじゃ…くぅぅっ	PRINTFORM 「そこじゃ…くぅぅっ
PRINTFORM 　しゅごいのぉぉぉっ	PRINTFORM 　しゅごいのぉぉぉっ
PRINTFORM 　ビクっってしてる…	PRINTFORM 　ビクっってしてる…
PRINTFORM 　子宮口に…ぴったり	PRINTFORM 　子宮口に…ぴったり
PRINTFORM 　おなか…いっぱい…	PRINTFORM 　おなか…いっぱい…
PRINTFORM 「んぷっ？！　……ん	PRINTFORM 「んぷっ？！　……ん
PRINTFORM 　とても…いい気分…	PRINTFORM 　とても…いい気分…
PRINTFORM 　今…吸われた…らっ	PRINTFORM 　今…吸われた…らっ
PRINTFORM 　美味しかったですよ	PRINTFORM 　美味しかったですよ
PRINTFORM 　そんないっぺんにっ	PRINTFORM 　そんないっぺんにっ
PRINTFORM 「この触手…んんぅ…	PRINTFORM 「この触手…んんぅ…
PRINTFORMW 　身体が…熱い…」	PRINTFORMW 　身体が…熱い…」
PRINTFORM 　そう…その感じです	PRINTFORM 　そう…その感じです
PRINTFORM 　逞しいですね…それ	PRINTFORM 　逞しいですね…それ
PRINTFORM 　ぴゅっぴゅすればっ	PRINTFORM 　ぴゅっぴゅすればっ
PRINTFORM 「足でですか…ふふっ	PRINTFORM 「足でですか…ふふっ
PRINTFORM 「ふひゅぅぅぅ………	PRINTFORM 「ふひゅぅぅぅ………
PRINTFORM 　もう…我慢が…んっ	PRINTFORM 　もう…我慢が…んっ
PRINTFORM 「まっまだ射精ますっ	PRINTFORM 「まっまだ射精ますっ
PRINTFORM 「おなかの中…ふふっ	PRINTFORM 「おなかの中…ふふっ
PRINTFORML 「……（ごくり）」	PRINTFORML 「……（ごくり）」
PRINTFORM …きっ…来ちゃうッッ	PRINTFORM …きっ…来ちゃうッッ
PRINTFORM 　はぁぁぁ…んんっっ	PRINTFORM 　はぁぁぁ…んんっっ
PRINTFORM 　ぐりぐり暴れてっっ	PRINTFORM 　ぐりぐり暴れてっっ
PRINTFORM 　凄くイイ…ですよっ	PRINTFORM 　凄くイイ…ですよっ
PRINTFORM 　い…イイっっっっっ	PRINTFORM 　い…イイっっっっっ
PRINTFORM 「き…来まし…た…っ	PRINTFORM 「き…来まし…た…っ
PRINTFORM 　はぁぁぁっんんんっ	PRINTFORM 　はぁぁぁっんんんっ
PRINTFORM 「はああああぁんッッ	PRINTFORM 「はああああぁんッッ
PRINTFORM 　ポケットみたいにっ	PRINTFORM 　ポケットみたいにっ
PRINTFORM 　うねってるぅぅぅっ	PRINTFORM 　うねってるぅぅぅっ
PRINTFORM 　クリちゃ…んんっっ	PRINTFORM 　クリちゃ…んんっっ
PRINTFORM 　ぐいんぐいん…って	PRINTFORM 　ぐいんぐいん…って
PRINTFORM 「んんんんぅぅぅッッ	PRINTFORM 「んんんんぅぅぅッッ
PRINTFORM 　…もっと…下さいよ	PRINTFORM 　…もっと…下さいよ
PRINTFORM 　…駄目…ですよぉ…	PRINTFORM 　…駄目…ですよぉ…
PRINTFORML しかし覚醒すると…	PRINTFORML しかし覚醒すると…
PRINTFORM 「当たって…お願い	PRINTFORM 「当たって…お願い
PRINTFORM 「さぁパチュリー様	PRINTFORM 「さぁパチュリー様
PRINTFORM 「ちょっとだけ…ね	PRINTFORM 「ちょっとだけ…ね
PRINTFORM 　食べちゃいたい…	PRINTFORM 　食べちゃいたい…
PRINTFORM 「んはぁ…美味しい	PRINTFORM 「んはぁ…美味しい
PRINTFORM 　えぇ、いいですよ	PRINTFORM 　えぇ、いいですよ
PRINTFORM 　挿入って…くるぅ	PRINTFORM 　挿入って…くるぅ
PRINTFORM 　お元気そうで…ん	PRINTFORM 　お元気そうで…ん
PRINTFORM 　そんなに…くすっ	PRINTFORM 　そんなに…くすっ
PRINTFORM 「…っう……ふはぁ	PRINTFORM 「…っう……ふはぁ
PRINTFORM 「それじゃあ…んっ	PRINTFORM 「それじゃあ…んっ
PRINTFORM って締め付けてくる	PRINTFORM って締め付けてくる
PRINTFORM 「こうして…あんっ	PRINTFORM 「こうして…あんっ
PRINTFORM 「ぅぁ………んんっ	PRINTFORM 「ぅぁ………んんっ
PRINTFORM …下半身が熱く……	PRINTFORM …下半身が熱く……
PRINTFORM 「魔理沙さん…んぅ	PRINTFORM 「魔理沙さん…んぅ
PRINTFORMW 「撃ちますっ！」	PRINTFORMW 「撃ちますっ！」
PRINTFORM 「お願い…します…	PRINTFORM 「お願い…します…
PRINTFORM 「はい、どうぞ……	PRINTFORM 「はい、どうぞ……
PRINTFORM 「ねぇ…口…開いて	PRINTFORM 「ねぇ…口…開いて
PRINTFORM 「先っぽから…んふ	PRINTFORM 「先っぽから…んふ
PRINTFORM …これからですよ…	PRINTFORM …これからですよ…
PRINTFORM 「んぅぅ…　んぷっ	PRINTFORM 「んぅぅ…　んぷっ
PRINTFORM 　ぬぷぬぷってぇッ	PRINTFORM 　ぬぷぬぷってぇッ
PRINTFORM 「お願いしますぅ…	PRINTFORM 「お願いしますぅ…
PRINTFORM 　突き上げられてっ	PRINTFORM 　突き上げられてっ
PRINTFORM 　凄く硬くなってる	PRINTFORM 　凄く硬くなってる
PRINTFORM 　ふぁぁあぁ…っっ	PRINTFORM 　ふぁぁあぁ…っっ
PRINTFORM 　これ…この感覚が	PRINTFORM 　これ…この感覚が
PRINTFORM 　もうすぐ…限界…	PRINTFORM 　もうすぐ…限界…
PRINTFORM 射精てるぅぅぅッッ	PRINTFORM 射精てるぅぅぅッッ
PRINTFORM 「で…でも…無理っ	PRINTFORM 「で…でも…無理っ
PRINTFORM 　中から刺激が……	PRINTFORM 　中から刺激が……
PRINTFORMW 　だめぇっ▼▼」	PRINTFORMW 　だめぇっ▼▼」
PRINTFORM 「え…お、お尻はっ	PRINTFORM 「え…お、お尻はっ
PRINTFORM 　吸うんですかっっ	PRINTFORM 　吸うんですかっっ
PRINTFORM 　もっと激しくぅ…	PRINTFORM 　もっと激しくぅ…
PRINTFORM 「…ぁ…このガス…	PRINTFORM 「…ぁ…このガス…
PRINTFORM 　イっちゃうぅぅっ	PRINTFORM 　イっちゃうぅぅっ
PRINTFORM 　精液射精ちゃうっ	PRINTFORM 　精液射精ちゃうっ
PRINTFORM 「…あはははははっ	PRINTFORM 「…あはははははっ
PRINTFORM 「…ぅふぅッッ？！	PRINTFORM 「…ぅふぅッッ？！
PRINTFORM 　んっんんぅぅッッ	PRINTFORM 　んっんんぅぅッッ
PRINTFORM 　ちゅく…くちゅ…	PRINTFORM 　ちゅく…くちゅ…
PRINTFORM 　精液が勢い良くっ	PRINTFORM 　精液が勢い良くっ
PRINTFORM イっちゃ…………ッ	PRINTFORM イっちゃ…………ッ
PRINTFORM 「んんんん～～ッッ	PRINTFORM 「んんんん～～ッッ
PRINTFORM 　…～～～～～っっ	PRINTFORM 　…～～～～～っっ
PRINTFORM 　これはこれでっっ	PRINTFORM 　これはこれでっっ
PRINTFORM 　…～～～～～ッッ	PRINTFORM 　…～～～～～ッッ
PRINTFORM イっちゃい…ますっ	PRINTFORM イっちゃい…ますっ
PRINTFORM 　もっと……あはっ	PRINTFORM 　もっと……あはっ
PRINTFORM 　はぁ～～～…ッッ	PRINTFORM 　はぁ～～～…ッッ
PRINTFORM 　んぅ────…ッ	PRINTFORM 　んぅ────…ッ
PRINTFORM …ふあぁぁぁんっっ	PRINTFORM …ふあぁぁぁんっっ
PRINTFORMW 　く…ふぅ<▼」	PRINTFORMW 　く…ふぅ<▼」
PRINTFORMW 　ぢゅんって…」	PRINTFORMW 　ぢゅんって…」
PRINTFORMW 「急がないと…」	PRINTFORMW 「急がないと…」
PRINTFORM 　す、凄いっっっっ	PRINTFORM 　す、凄いっっっっ
PRINTFORM 　暴れちゃうっっっ	PRINTFORM 　暴れちゃうっっっ
PRINTFORM 「…ふあぁ…………	PRINTFORM 「…ふあぁ…………
PRINTFORM 「…あぁ…おしりが	PRINTFORM 「…あぁ…おしりが
PRINTFORM 「さっさっきからっ	PRINTFORM 「さっさっきからっ
PRINTFORM 　今日は凄く元気…	PRINTFORM 　今日は凄く元気…
PRINTFORM 　自分のおまんこっ	PRINTFORM 　自分のおまんこっ
PRINTFORM 　流石に…こんなッ	PRINTFORM 　流石に…こんなッ
PRINTFORM 「そんなひたらぁッ	PRINTFORM 「そんなひたらぁッ
PRINTFORM 手元がぶれちゃう	PRINTFORM 手元がぶれちゃう
PRINTFORM 　どうです…これ	PRINTFORM 　どうです…これ
PRINTFORM …開発……あぁん	PRINTFORM …開発……あぁん
PRINTFORM こんなにいっぱい	PRINTFORM こんなにいっぱい
PRINTFORM 「それでは…んん	PRINTFORM 「それでは…んん
PRINTFORM 「パチュリー様ぁ	PRINTFORM 「パチュリー様ぁ
PRINTFORM 「くすくすくす…	PRINTFORM 「くすくすくす…
PRINTFORM 「……あ…んんぅ	PRINTFORM 「……あ…んんぅ
PRINTFORM 「いい…ですよっ	PRINTFORM 「いい…ですよっ
PRINTFORM 　結構耐えますね	PRINTFORM 　結構耐えますね
PRINTFORM 　私も助かります	PRINTFORM 　私も助かります
PRINTFORMW …何よりです」	PRINTFORMW …何よりです」
PRINTFORM …気になります？	PRINTFORM …気になります？
PRINTFORM 　とっても素敵…	PRINTFORM 　とっても素敵…
PRINTFORMW 　ぜーんぶ…」	PRINTFORMW 　ぜーんぶ…」
PRINTFORM 　気持ち…いい…	PRINTFORM 　気持ち…いい…
PRINTFORM 「んっ………ふぅ	PRINTFORM 「んっ………ふぅ
PRINTFORM 　逞しい…ですね	PRINTFORM 　逞しい…ですね
PRINTFORM 　まだまだ…ふふ	PRINTFORM 　まだまだ…ふふ
PRINTFORM 　んぢゅぅぅぅ…	PRINTFORM 　んぢゅぅぅぅ…
PRINTFORM 　ふふ…美味しい	PRINTFORM 　ふふ…美味しい
PRINTFORM 　不利ですよぉ…	PRINTFORM 　不利ですよぉ…
PRINTFORM 　やります…ねっ	PRINTFORM 　やります…ねっ
PRINTFORM 　マスターったら	PRINTFORM 　マスターったら
PRINTFORM 　太くて…長くて	PRINTFORM 　太くて…長くて
PRINTFORM 　もっと下さい…	PRINTFORM 　もっと下さい…
PRINTFORM なっちゃうぅッッ	PRINTFORM なっちゃうぅッッ
PRINTFORM 　お、おっぱいっ	PRINTFORM 　お、おっぱいっ
PRINTFORM 「胸は違う…のぉ	PRINTFORM 「胸は違う…のぉ
PRINTFORM 「胸……んんッッ	PRINTFORM 「胸……んんッッ
PRINTFORM 　心の準備がっっ	PRINTFORM 　心の準備がっっ
PRINTFORM 　～～～～ッッッ	PRINTFORM 　～～～～ッッッ
PRINTFORM 　だ、駄目です…	PRINTFORM 　だ、駄目です…
PRINTFORM 　しゅごいぃっっ	PRINTFORM 　しゅごいぃっっ
PRINTFORM 「駄目ですよぉっ	PRINTFORM 「駄目ですよぉっ
PRINTFORM 「はぁぁぁぁぁ…	PRINTFORM 「はぁぁぁぁぁ…
PRINTFORM 　これっ…駄目ぇ	PRINTFORM 　これっ…駄目ぇ
PRINTFORM 　ご馳走様でした	PRINTFORM 　ご馳走様でした
PRINTFORM 　嬉しい…けどっ	PRINTFORM 　嬉しい…けどっ
PRINTFORM 「…だ…だめぇ…	PRINTFORM 「…だ…だめぇ…
PRINTFORM 　駄目…ですよぉ	PRINTFORM 　駄目…ですよぉ
PRINTFORM 「……はぁぁぁぁ	PRINTFORM 「……はぁぁぁぁ
PRINTFORM 「…ぁ……ふぁ…	PRINTFORM 「…ぁ……ふぁ…
PRINTFORM 　しゃせーイイっ	PRINTFORM 　しゃせーイイっ
PRINTFORM 　いい…気分です	PRINTFORM 　いい…気分です
PRINTFORMW （ごくり……）	PRINTFORMW （ごくり……）
PRINTFORM 「イキますよ…ッ	PRINTFORM 「イキますよ…ッ
PRINTFORM 　口をすぼめて…	PRINTFORM 　口をすぼめて…
PRINTFORM 　いい…ですよ…	PRINTFORM 　いい…ですよ…
PRINTFORM 　大丈夫ですよ…	PRINTFORM 　大丈夫ですよ…
PRINTFORM 「んんんぅぅぅ…	PRINTFORM 「んんんぅぅぅ…
PRINTFORM 　んんんんぅぅ…	PRINTFORM 　んんんんぅぅ…
PRINTFORM 「んんんんぅッッ	PRINTFORM 「んんんんぅッッ
PRINTFORM 「さぁ…クスクス	PRINTFORM 「さぁ…クスクス
PRINTFORM 「最高の…ふふっ	PRINTFORM 「最高の…ふふっ
PRINTFORM 　擦っ…てぇぇん	PRINTFORM 　擦っ…てぇぇん
PRINTFORM 「つまり…ふふふ	PRINTFORM 「つまり…ふふふ
PRINTFORM 　私の方が…さっ	PRINTFORM 　私の方が…さっ
PRINTFORM 　お疲れ様でした	PRINTFORM 　お疲れ様でした
PRINTFORM 　気持ちいいっっ	PRINTFORM 　気持ちいいっっ
PRINTFORM 「んんんんッッッ	PRINTFORM 「んんんんッッッ
PRINTFORM 　くぅ……んっっ	PRINTFORM 　くぅ……んっっ
PRINTFORM 　んんんぅぅっっ	PRINTFORM 　んんんぅぅっっ
PRINTFORM 　イかされ…れっ	PRINTFORM 　イかされ…れっ
PRINTFORM 「このくら…ひっ	PRINTFORM 「このくら…ひっ
PRINTFORM 　この…私…がっ	PRINTFORM 　この…私…がっ
PRINTFORM 　きもひいいのっ	PRINTFORM 　きもひいいのっ
PRINTFORM イクぅぅぅぅっっ	PRINTFORM イクぅぅぅぅっっ
PRINTFORM 　そ…そのままっ	PRINTFORM 　そ…そのままっ
PRINTFORM 　ふぅ………ぅん	PRINTFORM 　ふぅ………ぅん
PRINTFORM 　…ぅぁ…あぁ…	PRINTFORM 　…ぅぁ…あぁ…
PRINTFORM 「この…吸い方っ	PRINTFORM 「この…吸い方っ
PRINTFORM 　んんぅぅぅっっ	PRINTFORM 　んんぅぅぅっっ
PRINTFORM 　イキっぱなしっ	PRINTFORM 　イキっぱなしっ
PRINTFORMW 　だ、だめ…」	PRINTFORMW 　だ、だめ…」
PRINTFORM 　両方の感覚がっ	PRINTFORM 　両方の感覚がっ
PRINTFORM 　自分で自分にっ	PRINTFORM 　自分で自分にっ
PRINTFORM 　んひぃぃぃぃッ	PRINTFORM 　んひぃぃぃぃッ
PRINTFORM 「んくぅぅんんっ	PRINTFORM 「んくぅぅんんっ
PRINTFORMW 　くすくす…」	PRINTFORMW 　くすくす…」
PRINTFORM 「パチュリー様	PRINTFORM 「パチュリー様
PRINTFORM 「当たってぇ…	PRINTFORM 「当たってぇ…
PRINTFORM 「では…ふふっ	PRINTFORM 「では…ふふっ
PRINTFORM 　犯されてるっ	PRINTFORM 　犯されてるっ
PRINTFORM 　私が…ふふっ	PRINTFORM 　私が…ふふっ
PRINTFORM 　熱くて…硬い	PRINTFORM 　熱くて…硬い
PRINTFORM 　わかりました	PRINTFORM 　わかりました
PRINTFORM 「知りませんよ	PRINTFORM 「知りませんよ
PRINTFORM 　解ってますよ	PRINTFORM 　解ってますよ
PRINTFORM 「んんぅ…はぁ	PRINTFORM 「んんぅ…はぁ
PRINTFORM 「いいですよ…	PRINTFORM 「いいですよ…
PRINTFORM 「あら…くすっ	PRINTFORM 「あら…くすっ
PRINTFORM 「一緒に…うふ	PRINTFORM 「一緒に…うふ
PRINTFORMW 「えいっ！」	PRINTFORMW 「えいっ！」
PRINTFORMW 「それっ！」	PRINTFORMW 「それっ！」
PRINTFORMW 「やぁっ！」	PRINTFORMW 「やぁっ！」
PRINTFORM 　…れろ…んぅ	PRINTFORM 　…れろ…んぅ
PRINTFORM 「ちろ…くすっ	PRINTFORM 「ちろ…くすっ
PRINT 「っく…厳しいですね…	PRINT 「っく…厳しいですね…
PRINT 「あ、痛い…ですけど…	PRINT 「あ、痛い…ですけど…
PRINTFORM 　なかなか…ん	PRINTFORM 　なかなか…ん
PRINTFORM 「いい…ですよ	PRINTFORM 「いい…ですよ
PRINTFORM 「おっおしりっ	PRINTFORM 「おっおしりっ
PRINTFORM 　もっとぉぉっ	PRINTFORM 　もっとぉぉっ
PRINTFORM 　吸出し…てっ	PRINTFORM 　吸出し…てっ
PRINTFORM 「ぅん…はぁぁ	PRINTFORM 「ぅん…はぁぁ
PRINTFORM 　い…いいのっ	PRINTFORM 　い…いいのっ
PRINTFORM 「んくぅぅっっ	PRINTFORM 「んくぅぅっっ
PRINTFORM 　ん…もっとぉ	PRINTFORM 　ん…もっとぉ
PRINTFORM 　ふぅんんッッ	PRINTFORM 　ふぅんんッッ
PRINTFORM 　いいですよっ	PRINTFORM 　いいですよっ
PRINTFORM 　そ、そう……	PRINTFORM 　そ、そう……
PRINTFORM 　くぅぅんっっ	PRINTFORM 　くぅぅんっっ
PRINTFORM 「…んんぅッッ	PRINTFORM 「…んんぅッッ
PRINTFORM 　出来ちゃう…	PRINTFORM 　出来ちゃう…
PRINTFORM 　はあぁぁっっ	PRINTFORM 　はあぁぁっっ
PRINTFORM 　これ以上はっ	PRINTFORM 　これ以上はっ
PRINTFORM 奥まで…んんっ	PRINTFORM 奥まで…んんっ
PRINTFORM 「…ぁ…だめ…	PRINTFORM 「…ぁ…だめ…
PRINTFORM 「また触手…ん	PRINTFORM 「また触手…ん
PRINTFORM 「くふぅ…はぁ	PRINTFORM 「くふぅ…はぁ
PRINTFORM 「ぁ……はぁ…	PRINTFORM 「ぁ……はぁ…
PRINTFORM 　こ、これがっ	PRINTFORM 　こ、これがっ
PRINTFORM 　止まらないっ	PRINTFORM 　止まらないっ
PRINTFORM 　射精ちゃうっ	PRINTFORM 　射精ちゃうっ
PRINTFORM 「くすくすっ…	PRINTFORM 「くすくすっ…
PRINTFORMDW ゆさゆさ…	PRINTFORMDW ゆさゆさ…
PRINTFORM 「そう…ですか	PRINTFORM 「そう…ですか
PRINTFORM 「くぅっんんっ	PRINTFORM 「くぅっんんっ
PRINTFORM 「では…どうぞ	PRINTFORM 「では…どうぞ
PRINTFORM 「あぁ…んんぅ	PRINTFORM 「あぁ…んんぅ
PRINTFORM 「ん…ぅぅんっ	PRINTFORM 「ん…ぅぅんっ
PRINTFORM 「くぅ…んんっ	PRINTFORM 「くぅ…んんっ
PRINTFORM 「くぅぅぅっっ	PRINTFORM 「くぅぅぅっっ
PRINTFORM 「うぅん……っ	PRINTFORM 「うぅん……っ
PRINTFORML 「…そうね」	PRINTFORML 「…そうね」
PRINTFORML 「…………」	PRINTFORML 「…………」
PRINTFORM 「ぅ…はぅぅ…	PRINTFORM 「ぅ…はぅぅ…
PRINTFORM 　ああぁぁ…っ	PRINTFORM 　ああぁぁ…っ
PRINTFORM 　な、膣内でっ	PRINTFORM 　な、膣内でっ
PRINTFORM 「はぁぁんっっ	PRINTFORM 「はぁぁんっっ
PRINTFORM 「まっ…またっ	PRINTFORM 「まっ…またっ
PRINTFORM 「くぅぅぅんっ	PRINTFORM 「くぅぅぅんっ
PRINTFORM 　でっでもッッ	PRINTFORM 　でっでもッッ
PRINTFORM 　もうらめぇっ	PRINTFORM 　もうらめぇっ
PRINTFORM これ無理ですっ	PRINTFORM これ無理ですっ
PRINTFORM 　そ、そうっッ	PRINTFORM 　そ、そうっッ
PRINTFORM 　ん……ふはぁ	PRINTFORM 　ん……ふはぁ
PRINTFORM 　身体…中…っ	PRINTFORM 　身体…中…っ
PRINTFORM 　はぁーーー…	PRINTFORM 　はぁーーー…
PRINTFORM 「…ふぃぃ……	PRINTFORM 「…ふぃぃ……
PRINTFORM 「やあぁぁんっ	PRINTFORM 「やあぁぁんっ
PRINTFORM 　おちん…ぽっ	PRINTFORM 　おちん…ぽっ
PRINTFORM 「ひゃんっ？！	PRINTFORM 「ひゃんっ？！
PRINTFORM 　おまんこもッ	PRINTFORM 　おまんこもッ
PRINTFORM 　おしりもッッ	PRINTFORM 　おしりもッッ
PRINTFORM 「…ふ…んふぁ	PRINTFORM 「…ふ…んふぁ
PRINTFORM 　乳首にッッッ	PRINTFORM 　乳首にッッッ
PRINTFORM 「…乳首…にっ	PRINTFORM 「…乳首…にっ
PRINTFORM 「………ふはぁ	PRINTFORM 「………ふはぁ
PRINTFORM 　んぅぅぅんっ	PRINTFORM 　んぅぅぅんっ
PRINTFORM 射精ちゃうッッ	PRINTFORM 射精ちゃうッッ
PRINTFORM 「じっ自分でっ	PRINTFORM 「じっ自分でっ
PRINTFORM 「ふあぁぁ…っ	PRINTFORM 「ふあぁぁ…っ
PRINTFORM 「ふぐぅぅッッ	PRINTFORM 「ふぐぅぅッッ
PRINTFORM 取られてるっっ	PRINTFORM 取られてるっっ
PRINTFORM 「はぁぁぁぁ…	PRINTFORM 「はぁぁぁぁ…
PRINTFORM 「……はぁぁ…	PRINTFORM 「……はぁぁ…
PRINTFORM 「くすくす…	PRINTFORM 「くすくす…
PRINTFORM 　大変ですよ	PRINTFORM 　大変ですよ
PRINTFORM 「あぁぁぁ…	PRINTFORM 「あぁぁぁ…
PRINTFORM 「はぁぁぁぁ	PRINTFORM 「はぁぁぁぁ
PRINTFORM 「くすくすっ	PRINTFORM 「くすくすっ
PRINTFORM 「あらあら…	PRINTFORM 「あらあら…
PRINTFORM 　最高ですよ	PRINTFORM 　最高ですよ
PRINTFORM 「うふふふ…	PRINTFORM 「うふふふ…
PRINTFORM 　ん…れろぉ	PRINTFORM 　ん…れろぉ
PRINTFORM 「いいですよ	PRINTFORM 「いいですよ
PRINTFORM 　くすくすっ	PRINTFORM 　くすくすっ
PRINTFORM 「失礼します	PRINTFORM 「失礼します
PRINTFORM 「あははは…	PRINTFORM 「あははは…
PRINTFORM 　…っくはぁ	PRINTFORM 　…っくはぁ
PRINTFORM 　はーーー…	PRINTFORM 　はーーー…
PRINTFORM 　……んふぅ	PRINTFORM 　……んふぅ
PRINTFORM 　れろ…はぁ	PRINTFORM 　れろ…はぁ
PRINTFORM 「はぁ…素敵	PRINTFORM 「はぁ…素敵
PRINTFORM 　んぅ…むっ	PRINTFORM 　んぅ…むっ
PRINTFORM 　ちろちろ…	PRINTFORM 　ちろちろ…
PRINTFORM 「くぅん…っ	PRINTFORM 「くぅん…っ
PRINTFORM 「うふふっ…	PRINTFORM 「うふふっ…
PRINTFORM 「くぅ…んっ	PRINTFORM 「くぅ…んっ
PRINTFORM 　どうですっ	PRINTFORM 　どうですっ
PRINTFORM 「ん…んんぅ	PRINTFORM 「ん…んんぅ
PRINTFORM 「ん…んぅ…	PRINTFORM 「ん…んぅ…
PRINTFORM 「ふ…んはぁ	PRINTFORM 「ふ…んはぁ
PRINTFORM 「んんあぁっ	PRINTFORM 「んんあぁっ
PRINTFORM 　そこですっ	PRINTFORM 　そこですっ
PRINTFORM 「そ、そうっ	PRINTFORM 「そ、そうっ
PRINTFORM 「くぅ…んッ	PRINTFORM 「くぅ…んッ
PRINTFORM 「うぅぅんっ	PRINTFORM 「うぅぅんっ
PRINTFORM 　んぅ…ん…	PRINTFORM 　んぅ…ん…
PRINTFORM 　だっダメっ	PRINTFORM 　だっダメっ
PRINTFORM 　だめだめっ	PRINTFORM 　だめだめっ
PRINTFORM 　感じっっっ	PRINTFORM 　感じっっっ
PRINTFORM 　本気…でっ	PRINTFORM 　本気…でっ
PRINTFORM 「こ、これっ	PRINTFORM 「こ、これっ
PRINTFORM 　はぁぁんっ	PRINTFORM 　はぁぁんっ
PRINTFORM 　でっでもっ	PRINTFORM 　でっでもっ
PRINTFORM 「ふぁあっっ	PRINTFORM 「ふぁあっっ
PRINTFORM 「くぅぅっっ	PRINTFORM 「くぅぅっっ
PRINTFORM 　んちゅぅ…	PRINTFORM 　んちゅぅ…
PRINTFORM 「んんんっっ	PRINTFORM 「んんんっっ
PRINTFORM 「やめ…てぇ	PRINTFORM 「やめ…てぇ
PRINTFORM 「な、膣内っ	PRINTFORM 「な、膣内っ
PRINTFORM 　ぶびゅって	PRINTFORM 　ぶびゅって
PRINTFORM 　そ、そうっ	PRINTFORM 　そ、そうっ
PRINTFORM 　くっ来るッ	PRINTFORM 　くっ来るッ
PRINTFORM 「…はぁぁぁ	PRINTFORM 「…はぁぁぁ
PRINTFORM 「…ん～～ぅ	PRINTFORM 「…ん～～ぅ
PRINTFORM 　美味しい…	PRINTFORM 　美味しい…
PRINTFORM 「ぅぅぅ……	PRINTFORM 「ぅぅぅ……
PRINTFORM 「はぅぅっっ	PRINTFORM 「はぅぅっっ
PRINTFORM 　おし…りっ	PRINTFORM 　おし…りっ
PRINTFORM 「…くぅ…ん	PRINTFORM 「…くぅ…ん
PRINTFORM 「…ぁ…ぅ…	PRINTFORM 「…ぁ…ぅ…
PRINTFORM 「あぁんんっ	PRINTFORM 「あぁんんっ
PRINTFORM 「え…ちょっ	PRINTFORM 「え…ちょっ
PRINTFORM 　でちゃうっ	PRINTFORM 　でちゃうっ
PRINTFORM 　おっぱいっ	PRINTFORM 　おっぱいっ
PRINTFORM 　駄目ですっ	PRINTFORM 　駄目ですっ
PRINTFORM 「ふぁぁ…っ	PRINTFORM 「ふぁぁ…っ
PRINTFORM 「んふふふ…	PRINTFORM 「んふふふ…
PRINTFORM 「はーーー…	PRINTFORM 「はーーー…
PRINTFORM 　す…すぐっ	PRINTFORM 　す…すぐっ
PRINTFORM 　素敵…です	PRINTFORM 　素敵…です
PRINTFORM 「はぁぁんっ	PRINTFORM 「はぁぁんっ
PRINTFORM 　これですっ	PRINTFORM 　これですっ
PRINTFORM 　たくさんっ	PRINTFORM 　たくさんっ
PRINTFORM 　ビクンって	PRINTFORM 　ビクンって
PRINTFORM 　挿入ったぁ	PRINTFORM 　挿入ったぁ
PRINTFORM 「…くぅぅん	PRINTFORM 「…くぅぅん
PRINTFORMDW すてんっ	PRINTFORMDW すてんっ
PRINTFORM 「…ぶちゅぅ	PRINTFORM 「…ぶちゅぅ
PRINTFORM 　ちゅぷ……	PRINTFORM 　ちゅぷ……
PRINTFORM 　…ふぁぁっ	PRINTFORM 　…ふぁぁっ
PRINTFORM 「くぅんっっ	PRINTFORM 「くぅんっっ
PRINTFORM 　だ、だめっ	PRINTFORM 　だ、だめっ
PRINTFORM 「……ふぁぁ	PRINTFORM 「……ふぁぁ
PRINTFORM 「……ふはぁ	PRINTFORM 「……ふはぁ
PRINTFORM 「…ぅん…ぅ	PRINTFORM 「…ぅん…ぅ
PRINTFORM 　一緒…にっ	PRINTFORM 　一緒…にっ
PRINTFORM 「んあああっ	PRINTFORM 「んあああっ
PRINTFORM 　イキ過ぎっ	PRINTFORM 　イキ過ぎっ
PRINTFORM 　さっきから	PRINTFORM 　さっきから
PRINTFORM 　ずっとッッ	PRINTFORM 　ずっとッッ
PRINTFORM 「だっダメっ	PRINTFORM 「だっダメっ
PRINTFORM 「………っあ	PRINTFORM 「………っあ
PRINTFORM 　…ふはぁ…	PRINTFORM 　…ふはぁ…
PRINTFORM 素敵…ですっ	PRINTFORM 素敵…ですっ
PRINTFORM 　く…来るっ	PRINTFORM 　く…来るっ
PRINTFORM 「んぅ…んっ	PRINTFORM 「んぅ…んっ
PRINTFORM 「…はひ…ぃ	PRINTFORM 「…はひ…ぃ
PRINTFORM 「あぁんっっ	PRINTFORM 「あぁんっっ
PRINTFORM 搾っ…ちゃっ	PRINTFORM 搾っ…ちゃっ
PRINTFORM 　こ、これっ	PRINTFORM 　こ、これっ
PRINTFORM 「ふうぅッッ	PRINTFORM 「ふうぅッッ
PRINTFORM 感じ…過ぎっ	PRINTFORM 感じ…過ぎっ
PRINTFORM 「…くすくす	PRINTFORM 「…くすくす
PRINTFORM 「ふぅ…はぁ	PRINTFORM 「ふぅ…はぁ
PRINTFORM 「…ひぁんっ	PRINTFORM 「…ひぁんっ
PRINTFORM 「んんっ？！	PRINTFORM 「んんっ？！
PRINTFORM 「…んんぅっ	PRINTFORM 「…んんぅっ
PRINTFORM 「……ぁ…ぅ	PRINTFORM 「……ぁ…ぅ
PRINTFORM 　そ、そこっ	PRINTFORM 　そ、そこっ
PRINTFORM 　射精…るっ	PRINTFORM 　射精…るっ
PRINTFORM 「くぅぅんッ	PRINTFORM 「くぅぅんッ
PRINTFORM 「……ぅ……	PRINTFORM 「……ぅ……
PRINTFORM 「はぁ…ぁ…	PRINTFORM 「はぁ…ぁ…
PRINTFORM 「はぁぁぁ…	PRINTFORM 「はぁぁぁ…
PRINTFORM 「ふあぁぁ…	PRINTFORM 「ふあぁぁ…
PRINTFORM 「……ふふっ	PRINTFORM 「……ふふっ
PRINTFORM 　んんんぅぅ	PRINTFORM 　んんんぅぅ
PRINTFORM 「やぁぁっ	PRINTFORM 「やぁぁっ
PRINTFORM 「うふふ…	PRINTFORM 「うふふ…
PRINTFORM 「さーて…	PRINTFORM 「さーて…
PRINTFORM 「…はぁぁ	PRINTFORM 「…はぁぁ
PRINTFORM （はあんっ	PRINTFORM （はあんっ
PRINTFORM 「ぅぅんっ	PRINTFORM 「ぅぅんっ
PRINTFORM 　頑張って	PRINTFORM 　頑張って
PRINTFORM 「ああんっ	PRINTFORM 「ああんっ
PRINTFORM 「うふふっ	PRINTFORM 「うふふっ
PRINTFORM 「ほぉら…	PRINTFORM 「ほぉら…
PRINTFORM 「ん…んぅ	PRINTFORM 「ん…んぅ
PRINTFORM 「くすくす	PRINTFORM 「くすくす
PRINTFORM 「んぅっっ	PRINTFORM 「んぅっっ
PRINTFORM 「ふぁ…ん	PRINTFORM 「ふぁ…ん
PRINTFORM 　ああっっ	PRINTFORM 　ああっっ
PRINTFORM 「んもぅ…	PRINTFORM 「んもぅ…
PRINTFORM 「だ…め…	PRINTFORM 「だ…め…
PRINTFORM 「くすっ…	PRINTFORM 「くすっ…
PRINTFORM 「…ちゅっ	PRINTFORM 「…ちゅっ
PRINTFORM 　んぢゅっ	PRINTFORM 　んぢゅっ
PRINTFORM 　ん…んぅ	PRINTFORM 　ん…んぅ
PRINTFORM 　んむぅ…	PRINTFORM 　んむぅ…
PRINTFORM 「れろぉ…	PRINTFORM 「れろぉ…
PRINTFORM 　…ふふっ	PRINTFORM 　…ふふっ
PRINTFORM 　れろ…ん	PRINTFORM 　れろ…ん
PRINTFORM 　…んんっ	PRINTFORM 　…んんっ
PRINTFORM 「あ…んッ	PRINTFORM 「あ…んッ
PRINTFORM 「あぁんっ	PRINTFORM 「あぁんっ
PRINTFORM 「んんんぅ	PRINTFORM 「んんんぅ
PRINTFORM 　下からっ	PRINTFORM 　下からっ
PRINTFORM 「くす…っ	PRINTFORM 「くす…っ
PRINTFORM 　…くぅん	PRINTFORM 　…くぅん
PRINTFORM 　ミルクっ	PRINTFORM 　ミルクっ
PRINTFORM 「はぁ…ん	PRINTFORM 「はぁ…ん
PRINTFORM 「んんっっ	PRINTFORM 「んんっっ
PRINTFORM 「くぅっっ	PRINTFORM 「くぅっっ
PRINTFORM やっぱりっ	PRINTFORM やっぱりっ
PRINTFORM 　幸せにっ	PRINTFORM 　幸せにっ
PRINTFORM 　おしりっ	PRINTFORM 　おしりっ
PRINTFORM 「ひぅぅっ	PRINTFORM 「ひぅぅっ
PRINTFORM 「…うふふ	PRINTFORM 「…うふふ
PRINTFORM 　ふぁぁ…	PRINTFORM 　ふぁぁ…
PRINTFORM 　もっとぉ	PRINTFORM 　もっとぉ
PRINTFORM 　気持ひっ	PRINTFORM 　気持ひっ
PRINTFORM 　ああぁっ	PRINTFORM 　ああぁっ
PRINTFORM 「ふあぁっ	PRINTFORM 「ふあぁっ
PRINTFORM 「くぅ…ん	PRINTFORM 「くぅ…ん
PRINTFORM 「ぁ…あ…	PRINTFORM 「ぁ…あ…
PRINTFORM 「くぅんっ	PRINTFORM 「くぅんっ
PRINTFORM 　……はぁ	PRINTFORM 　……はぁ
PRINTFORM 「く…ふぅ	PRINTFORM 「く…ふぅ
PRINTFORM 　うそぉっ	PRINTFORM 　うそぉっ
PRINTFORM 　ぅぅんっ	PRINTFORM 　ぅぅんっ
PRINTFORM 　んぅん…	PRINTFORM 　んぅん…
PRINTFORM 「んふぅ…	PRINTFORM 「んふぅ…
PRINTFORM 　マスター	PRINTFORM 　マスター
PRINTFORM 　あぁんっ	PRINTFORM 　あぁんっ
PRINTFORM 「んんんっ	PRINTFORM 「んんんっ
PRINTFORM 「んんぅッ	PRINTFORM 「んんぅッ
PRINTFORM 「ぅ…んぅ	PRINTFORM 「ぅ…んぅ
PRINTFORM 「ふはぁ…	PRINTFORM 「ふはぁ…
PRINTFORM 「…んはっ	PRINTFORM 「…んはっ
PRINTFORM 「くぅん…	PRINTFORM 「くぅん…
PRINTFORM 「…んもぅ	PRINTFORM 「…んもぅ
PRINTFORM 「…あぁ…	PRINTFORM 「…あぁ…
PRINTFORM 　やぁ…ん	PRINTFORM 　やぁ…ん
PRINTFORM 「あぁ……	PRINTFORM 「あぁ……
PRINTFORM 「んんぅ…	PRINTFORM 「んんぅ…
PRINTFORM 　ふあぁ…	PRINTFORM 　ふあぁ…
PRINTFORM 「んぅ……	PRINTFORM 「んぅ……
PRINTFORM 「はぁ……	PRINTFORM 「はぁ……
PRINTFORM 　やぁんっ	PRINTFORM 　やぁんっ
PRINTFORM 　んふぅ…	PRINTFORM 　んふぅ…
PRINTFORM 「はぁぁ…	PRINTFORM 「はぁぁ…
PRINTFORM 　んぅぅ…	PRINTFORM 　んぅぅ…
PRINTFORM 「くふぅっ	PRINTFORM 「くふぅっ
PRINTFORM 　…ふーっ	PRINTFORM 　…ふーっ
PRINTFORM 「ふはぁぁ	PRINTFORM 「ふはぁぁ
PRINTFORM 「はうぅッ	PRINTFORM 「はうぅッ
PRINTFORM 「んんんッ	PRINTFORM 「んんんッ
PRINTFORM 「…ふはぁ	PRINTFORM 「…ふはぁ
PRINTFORM （ああんっ	PRINTFORM （ああんっ
PRINTFORM （んんぅ…	PRINTFORM （んんぅ…
PRINTFORM 「…ぁぁ…	PRINTFORM 「…ぁぁ…
PRINTFORM 「…ふぁっ	PRINTFORM 「…ふぁっ
PRINTFORM 駄目なのっ	PRINTFORM 駄目なのっ
PRINTFORM 　あ…あッ	PRINTFORM 　あ…あッ
PRINTFORM 「早くぅ…	PRINTFORM 「早くぅ…
PRINTFORM 「ん…ふぅ	PRINTFORM 「ん…ふぅ
PRINTFORM 「ん…上手	PRINTFORM 「ん…上手
PRINTFORM 　膣内でっ	PRINTFORM 　膣内でっ
PRINTFORM 「んもう…	PRINTFORM 「んもう…
PRINTFORM 　うふふ…	PRINTFORM 　うふふ…
PRINTFORM 　ちゅぱっ	PRINTFORM 　ちゅぱっ
PRINTFORM 　ちゅぷ…	PRINTFORM 　ちゅぷ…
PRINTFORM 「…はふぅ	PRINTFORM 「…はふぅ
PRINTFORM 　ん……っ	PRINTFORM 　ん……っ
PRINTFORM 　んむ……	PRINTFORM 　んむ……
PRINTFORM 　…んむっ	PRINTFORM 　…んむっ
PRINTFORM 　ちぷゅっ	PRINTFORM 　ちぷゅっ
PRINTFORM 「…くすっ	PRINTFORM 「…くすっ
PRINTFORM 　んふぅっ	PRINTFORM 　んふぅっ
PRINTFORM 「あ…ぁ…	PRINTFORM 「あ…ぁ…
PRINTFORM 「んぅ…っ	PRINTFORM 「んぅ…っ
PRINTFORM 「ん……ぅ	PRINTFORM 「ん……ぅ
PRINTFORM 「…んふぅ	PRINTFORM 「…んふぅ
PRINTFORM 「んっ…く	PRINTFORM 「んっ…く
PRINTFORM 「…ふふっ	PRINTFORM 「…ふふっ
PRINTFORM 「………ん	PRINTFORM 「………ん
PRINTFORM 「……ふふ	PRINTFORM 「……ふふ
PRINTFORM 「…あぁぁ	PRINTFORM 「…あぁぁ
PRINTFORM （…んんっ	PRINTFORM （…んんっ
PRINTFORM 「んはぁっ	PRINTFORM 「んはぁっ
PRINTFORM 「…んんっ	PRINTFORM 「…んんっ
PRINTFORM 「ぅん…っ	PRINTFORM 「ぅん…っ
PRINTFORM 「……ふぅ	PRINTFORM 「……ふぅ
PRINTFORM キちゃうッ	PRINTFORM キちゃうッ
PRINTFORM 　連続でッ	PRINTFORM 　連続でッ
PRINTFORM これじゃっ	PRINTFORM これじゃっ
PRINTFORM 「…ゃ…ぁ	PRINTFORM 「…ゃ…ぁ
PRINTFORM 「はぁんっ	PRINTFORM 「はぁんっ
PRINTFORM 　続けて…	PRINTFORM 　続けて…
PRINTFORM 　いっ今っ	PRINTFORM 　いっ今っ
PRINTFORM 「…んぁ…	PRINTFORM 「…んぁ…
PRINTFORM 「…はぁ…	PRINTFORM 「…はぁ…
PRINTFORM 「んんッッ	PRINTFORM 「んんッッ
PRINTFORM 「…くぅん	PRINTFORM 「…くぅん
PRINTFORM 「はーー…	PRINTFORM 「はーー…
PRINTFORM 　はーー…	PRINTFORM 　はーー…
PRINTFORM はぁぁぁ…	PRINTFORM はぁぁぁ…
PRINTFORM 「ふぁぁ…	PRINTFORM 「ふぁぁ…
PRINTFORM 「ひっ？！	PRINTFORM 「ひっ？！
PRINTFORM …ちゃうぅ	PRINTFORM …ちゃうぅ
PRINTFORM 「回復完了	PRINTFORM 「回復完了
PRINTFORM 「…ふぁぁ	PRINTFORM 「…ふぁぁ
PRINTFORM 　ああんっ	PRINTFORM 　ああんっ
PRINTFORM 　わらひっ	PRINTFORM 　わらひっ
PRINTFORM 　らってッ	PRINTFORM 　らってッ
PRINTFORM 　らめぇっ	PRINTFORM 　らめぇっ
PRINTFORM 「ぁ…ぁ…	PRINTFORM 「ぁ…ぁ…
PRINTFORM 「……んぅ	PRINTFORM 「……んぅ
﻿PRINTFORM 「んふふ	PRINTFORM 「んふふ
PRINTFORM 　やぁん	PRINTFORM 　やぁん
PRINTFORM 「んぅ…	PRINTFORM 「んぅ…
PRINTFORM 「えいっ	PRINTFORM 「えいっ
PRINTFORM 「それっ	PRINTFORM 「それっ
PRINTFORM 「あぁっ	PRINTFORM 「あぁっ
PRINTFORM 「ほぉら	PRINTFORM 「ほぉら
PRINTFORM 　お願い	PRINTFORM 　お願い
PRINTFORM 「…はぁ	PRINTFORM 「…はぁ
PRINTFORM 「…んぅ	PRINTFORM 「…んぅ
PRINTFORM 「大丈夫	PRINTFORM 「大丈夫
PRINTFORM 　んんっ	PRINTFORM 　んんっ
PRINTFORM 　たぷん	PRINTFORM 　たぷん
PRINTFORM 「くすっ	PRINTFORM 「くすっ
PRINTFORM 　はむっ	PRINTFORM 　はむっ
PRINTFORM 「あはぁ	PRINTFORM 「あはぁ
PRINTFORM 　あぁ…	PRINTFORM 　あぁ…
PRINTFORM 「んはぁ	PRINTFORM 「んはぁ
PRINTFORM 　ふふっ	PRINTFORM 　ふふっ
PRINTFORM 　んむ…	PRINTFORM 　んむ…
PRINTFORM 「ふふっ	PRINTFORM 「ふふっ
PRINTFORM 「ふぅ…	PRINTFORM 「ふぅ…
PRINTFORM 「はぁ…	PRINTFORM 「はぁ…
PRINTFORM 「んむっ	PRINTFORM 「んむっ
PRINTFORM 「んんぅ	PRINTFORM 「んんぅ
PRINTFORM 「はー…	PRINTFORM 「はー…
PRINTFORM 　はー…	PRINTFORM 　はー…
PRINTFORM 「ほらぁ	PRINTFORM 「ほらぁ
PRINTFORM 　はぁ…	PRINTFORM 　はぁ…
PRINTFORM 　かぷっ	PRINTFORM 　かぷっ
PRINTFORM 　んむっ	PRINTFORM 　んむっ
PRINTFORM 「んもぅ	PRINTFORM 「んもぅ
PRINTFORM 　イイっ	PRINTFORM 　イイっ
PRINTFORM 「んん…	PRINTFORM 「んん…
PRINTFORM 「あぁ…	PRINTFORM 「あぁ…
PRINTFORM 「ふふ…	PRINTFORM 「ふふ…
PRINTFORM 　くすっ	PRINTFORM 　くすっ
PRINTFORM 　んん…	PRINTFORM 　んん…
PRINTFORM 　むぅ…	PRINTFORM 　むぅ…
PRINTFORM 　んぅ…	PRINTFORM 　んぅ…
PRINTFORM 「ぢゅぷ	PRINTFORM 「ぢゅぷ
PRINTFORM 「んむ…	PRINTFORM 「んむ…
PRINTFORM 　ぐぷっ	PRINTFORM 　ぐぷっ
PRINTFORM 　美味し	PRINTFORM 　美味し
PRINTFORM 「素敵…	PRINTFORM 「素敵…
PRINTFORM 　んぷっ	PRINTFORM 　んぷっ
PRINTFORM 　…ふぅ	PRINTFORM 　…ふぅ
PRINTFORM 　ちゅっ	PRINTFORM 　ちゅっ
PRINTFORM 「…ふぅ	PRINTFORM 「…ふぅ
PRINTFORM 　ふあっ	PRINTFORM 　ふあっ
PRINTFORM 　いい…	PRINTFORM 　いい…
PRINTFORM 「んふぅ	PRINTFORM 「んふぅ
PRINTFORM 「んんっ	PRINTFORM 「んんっ
PRINTFORM 　ほらぁ	PRINTFORM 　ほらぁ
PRINTFORM 「ぐっ…	PRINTFORM 「ぐっ…
PRINTFORM 「あんっ	PRINTFORM 「あんっ
PRINTFORM 「んくっ	PRINTFORM 「んくっ
PRINTFORM 「だって	PRINTFORM 「だって
PRINTFORM 「…んん	PRINTFORM 「…んん
PRINTFORM 　ふぅっ	PRINTFORM 　ふぅっ
PRINTFORM 「…あっ	PRINTFORM 「…あっ
PRINTFORM 　はぁん	PRINTFORM 　はぁん
PRINTFORM 　そこっ	PRINTFORM 　そこっ
PRINTFORM 　ふぅ…	PRINTFORM 　ふぅ…
PRINTFORM 　はあっ	PRINTFORM 　はあっ
PRINTFORM 「…らッ	PRINTFORM 「…らッ
PRINTFORM 　らめっ	PRINTFORM 　らめっ
PRINTFORM 　はぁっ	PRINTFORM 　はぁっ
PRINTFORM 「…ぁん	PRINTFORM 「…ぁん
PRINTFORM 「ん……	PRINTFORM 「ん……
PRINTFORM 　こく…	PRINTFORM 　こく…
PRINTFORM 　膣内っ	PRINTFORM 　膣内っ
PRINTFORM 「ふはぁ	PRINTFORM 「ふはぁ
PRINTFORM 　いいっ	PRINTFORM 　いいっ
PRINTFORM 「ぁぁ…	PRINTFORM 「ぁぁ…
PRINTFORM 　あれっ	PRINTFORM 　あれっ
PRINTFORM 「いいっ	PRINTFORM 「いいっ
PRINTFORM 「…んふ	PRINTFORM 「…んふ
PRINTFORM 「ぁんっ	PRINTFORM 「ぁんっ
PRINTFORM 「ちょっ	PRINTFORM 「ちょっ
PRINTFORM 　んはぁ	PRINTFORM 　んはぁ
PRINTFORM 「くはぁ	PRINTFORM 「くはぁ
PRINTFORM 「んぅっ	PRINTFORM 「んぅっ
PRINTFORM 　もっと	PRINTFORM 　もっと
PRINTFORM 「んはっ	PRINTFORM 「んはっ
PRINTFORM 　や…っ	PRINTFORM 　や…っ
PRINTFORM 「んんッ	PRINTFORM 「んんッ
PRINTFORM 　もうっ	PRINTFORM 　もうっ
PRINTFORM 　だめっ	PRINTFORM 　だめっ
PRINTFORM 「イイっ	PRINTFORM 「イイっ
PRINTFORM 「ふはっ	PRINTFORM 「ふはっ
PRINTFORM 大きくっ	PRINTFORM 大きくっ
PRINTFORM 　ほらっ	PRINTFORM 　ほらっ
PRINTFORM 「私のっ	PRINTFORM 「私のっ
PRINTFORM 　ふぁぁ	PRINTFORM 　ふぁぁ
PRINTFORM 「うふふ	PRINTFORM 「うふふ
PRINTFORM 　ん……	PRINTFORM 　ん……
PRINTFORM 　…んっ	PRINTFORM 　…んっ
PRINTFORM 　凄い…	PRINTFORM 　凄い…
PRINTFORM 「…あぁ	PRINTFORM 「…あぁ
PRINTFORM 　…はぁ	PRINTFORM 　…はぁ
PRINTFORM 「ぅぅ…	PRINTFORM 「ぅぅ…
PRINTFORM 　凄いっ	PRINTFORM 　凄いっ
PRINTFORM 　これっ	PRINTFORM 　これっ
PRINTFORM 「ふぁっ	PRINTFORM 「ふぁっ
PRINTFORM 　…あっ	PRINTFORM 　…あっ
PRINTFORM 「……ん	PRINTFORM 「……ん
PRINTFORM 　んあっ	PRINTFORM 　んあっ
PRINTFORM 「…っあ	PRINTFORM 「…っあ
PRINTFORM 　んくっ	PRINTFORM 　んくっ
PRINTFORM 「…イっ	PRINTFORM 「…イっ
PRINTFORM 「イくっ	PRINTFORM 「イくっ
PRINTFORM そんなっ	PRINTFORM そんなっ
PRINTFORM キちゃっ	PRINTFORM キちゃっ
PRINTFORM 「あはっ	PRINTFORM 「あはっ
PRINTFORM 　またっ	PRINTFORM 　またっ
PRINTFORM キますっ	PRINTFORM キますっ
PRINTFORM 　ふはっ	PRINTFORM 　ふはっ
PRINTFORM 「ひぁっ	PRINTFORM 「ひぁっ
PRINTFORM 　すごっ	PRINTFORM 　すごっ
PRINTFORM 　いのっ	PRINTFORM 　いのっ
PRINTFORM 「ふあっ	PRINTFORM 「ふあっ
PRINTFORM 「…ぅん	PRINTFORM 「…ぅん
PRINTFORM 「…ふぁ	PRINTFORM 「…ふぁ
PRINTFORM 「…んむ	PRINTFORM 「…んむ
PRINTFORM 服の中っ	PRINTFORM 服の中っ
PRINTFORM 　うねっ	PRINTFORM 　うねっ
PRINTFORM らめっっ	PRINTFORM らめっっ
PRINTFORM 「んっっ	PRINTFORM 「んっっ
PRINTFORM 「そう…	PRINTFORM 「そう…
PRINTFORM 　ひはッ	PRINTFORM 　ひはッ
PRINTFORM 耐えっっ	PRINTFORM 耐えっっ
PRINTFORM 「んふ…	PRINTFORM 「んふ…
PRINTFORM 　幸せ…	PRINTFORM 　幸せ…
PRINTFORM 　ほら	PRINTFORM 　ほら
PRINTFORM 「ん…	PRINTFORM 「ん…
PRINTFORM 　ん…	PRINTFORM 　ん…
PRINTFORM （んっ	PRINTFORM （んっ
PRINTFORM 「はぁ	PRINTFORM 「はぁ
PRINTFORM 　はぁ	PRINTFORM 　はぁ
PRINTFORM 「ふぅ	PRINTFORM 「ふぅ
PRINTFORM 「ふふ	PRINTFORM 「ふふ
PRINTFORM 「んっ	PRINTFORM 「んっ
PRINTFORM 　んっ	PRINTFORM 　んっ
PRINTFORM 　…ぁ	PRINTFORM 　…ぁ
PRINTFORM ……ぁ	PRINTFORM ……ぁ
PRINTFORM 「ぁ…	PRINTFORM 「ぁ…
PRINTFORM 「あっ	PRINTFORM 「あっ
PRINTFORM 「…ぅ	PRINTFORM 「…ぅ
PRINTFORM 　んぷ	PRINTFORM 　んぷ
PRINTFORM ぐぷっ	PRINTFORM ぐぷっ
PRINTFORM 「…ん	PRINTFORM 「…ん
PRINT 「痛たたたっ…	PRINT 「痛たたたっ…
PRINTFORM 「ぁん	PRINTFORM 「ぁん
PRINTFORM 　…ん	PRINTFORM 　…ん
PRINTFORM 「ふあ	PRINTFORM 「ふあ
PRINTFORM 　あ…	PRINTFORM 　あ…
PRINTFORM 　そっ	PRINTFORM 　そっ
PRINTFORM 「ちっ	PRINTFORM 「ちっ
PRINTFORM 乳首っ	PRINTFORM 乳首っ
PRINTFORM 「やっ	PRINTFORM 「やっ
PRINTFORM 「もう	PRINTFORM 「もう
PRINTFORM 「いっ	PRINTFORM 「いっ
PRINTFORM 　ひッ	PRINTFORM 　ひッ
PRINTFORM 　あっ	PRINTFORM 　あっ
PRINTFORM 「ほっ	PRINTFORM 「ほっ
PRINTFORM 　うっ	PRINTFORM 　うっ
PRINTFORM 　でっ	PRINTFORM 　でっ
PRINTFORM 「…あ	PRINTFORM 「…あ
PRINTFORM 「おっ	PRINTFORM 「おっ
PRINTFORM 　やっ	PRINTFORM 　やっ
PRINTFORM 「あぁ	PRINTFORM 「あぁ
PRINTFORM 　はっ	PRINTFORM 　はっ
PRINTFORM 「あ…	PRINTFORM 「あ…
PRINTFORM 「だっ	PRINTFORM 「だっ
PRINTFORM 　とっ	PRINTFORM 　とっ
PRINTFORM 　イっ	PRINTFORM 　イっ
PRINTFORM 「んぅ	PRINTFORM 「んぅ
PRINTFORM 「…ぁ	PRINTFORM 「…ぁ
PRINTFORM 「はい	PRINTFORM 「はい
PRINTFORM そこぉ	PRINTFORM そこぉ
PRINTFORM 先にッ	PRINTFORM 先にッ
PRINTFORM 　ふぅ	PRINTFORM 　ふぅ
PRINTFORM 　きっ	PRINTFORM 　きっ
PRINTFORM 　こっ	PRINTFORM 　こっ
PRINTFORM 「…ッ	PRINTFORM 「…ッ
PRINTFORM 　んッ	PRINTFORM 　んッ
PRINTFORM 「らっ	PRINTFORM 「らっ
PRINTFORM らめっ	PRINTFORM らめっ
PRINTFORM またっ	PRINTFORM またっ
PRINTFORM 　たっ	PRINTFORM 　たっ
PRINTFORM 耐えっ	PRINTFORM 耐えっ
PRINTFORM 　もっ	PRINTFORM 　もっ
PRINTFORM 「こっ	PRINTFORM 「こっ
PRINTFORM 「そっ	PRINTFORM 「そっ
PRINTFORM 「きっ	PRINTFORM 「きっ
PRINTFORM 「まっ	PRINTFORM 「まっ
PRINTFORM 「…っ	PRINTFORM 「…っ
PRINTFORM だめ…	PRINTFORM だめ…
PRINTFORM 　おっ	PRINTFORM 　おっ
PRINTFORM 　ふっ	PRINTFORM 　ふっ
PRINTFORM 　らっ	PRINTFORM 　らっ
PRINTFORM 　かっ	PRINTFORM 　かっ
PRINTFORM 　…っ	PRINTFORM 　…っ
PRINTFORM またッ	PRINTFORM またッ
PRINTFORM 　ひっ	PRINTFORM 　ひっ
PRINTFORM 　しっ	PRINTFORM 　しっ
PRINTFORM 搾りッ	PRINTFORM 搾りッ
PRINTFORM はぁ	PRINTFORM はぁ
PRINTFORML 」	PRINTFORML 」
PRINTFORM 　ん	PRINTFORM 　ん
PRINTFORM 「ん	PRINTFORM 「ん
PRINTFORM 「あ	PRINTFORM 「あ
PRINT 「…っつ？！	PRINT 「…っつ？！
PRINT 「んんっ……	PRINT 「んんっ……
PRINT 「…ぅ…く…	PRINT 「…ぅ…く…
PRINT 「うぅぅ……	PRINT 「うぅぅ……
PRINTFORM でっ	PRINTFORM でっ
PRINTFORM 　あ	PRINTFORM 　あ
PRINTFORM あっ	PRINTFORM あっ
PRINTFORML ）	PRINTFORML ）
PRINTFORM 「ま	PRINTFORM 「ま
PRINTFORM うッ	PRINTFORM うッ
PRINTFORM はっ	PRINTFORM はっ
PRINTFORM 　だ	PRINTFORM 　だ
PRINTFORM 　ぁ	PRINTFORM 　ぁ
PRINTFORM 「で	PRINTFORM 「で
PRINTFORM 「わ	PRINTFORM 「わ
PRINTFORM 「ら	PRINTFORM 「ら
PRINT 「あっ…！	PRINT 「あっ…！
PRINTFORM あ	PRINTFORM あ
PRINTFORM ぁ	PRINTFORM ぁ
PRINT 「ぅ…	PRINT 「ぅ…
PRINTL	PRINTL
