//口上:

PRINTFORM 「%CALLNAME_8_0(CFLAG:900)%の指がぁ……%CALLNAME_8_0(CFLAG:900)%…%CALLNAME_8_0(CFLAG:900, 1)%っっ	PRINTFORM 「%CALLNAME_8_0(CFLAG:900)%の指がぁ……%CALLNAME_8_0(CFLAG:900)%…%CALLNAME_8_0(CFLAG:900, 1)%っっ
PRINTFORMDW 断続的に続く%CALLNAME:(TARGET)%の射精に合わせ、全て飲み干すかの様に%SAVESTR:(CFLAG:902)%は膣内を脈動させていた…	PRINTFORMDW 断続的に続く%CALLNAME:(TARGET)%の射精に合わせ、全て飲み干すかの様に%SAVESTR:(CFLAG:902)%は膣内を脈動させていた…
PRINTFORMW 「あら、%CALLNAME_8_0(GET_ID_FROM_NO(NO:(ARG:1)))%…じゃ、ないか。　どうもこう本人そっくりだと調子が狂うわね」	PRINTFORMW 「あら、%CALLNAME_8_0(GET_ID_FROM_NO(NO:(ARG:1)))%…じゃ、ないか。　どうもこう本人そっくりだと調子が狂うわね」
PRINTFORMDW トドメとばかりに激しく腰を突き落とした%SAVESTR:(CFLAG:902)%の最奥で、%CALLNAME:(TARGET)%の熱い滾りが迸る…！	PRINTFORMDW トドメとばかりに激しく腰を突き落とした%SAVESTR:(CFLAG:902)%の最奥で、%CALLNAME:(TARGET)%の熱い滾りが迸る…！
PRINTFORMDW %CALLNAME:(ARG:3)%は背徳感ある行為を%CALLNAME:(TARGET)%に見せ付けるかの様に、じっくりと深く桃尻を上下させた…	PRINTFORMDW %CALLNAME:(ARG:3)%は背徳感ある行為を%CALLNAME:(TARGET)%に見せ付けるかの様に、じっくりと深く桃尻を上下させた…
PRINTFORMW 「なんで私が目の前に……というか、この身体……もしかして%CALLNAME_8_0(GET_ID_FROM_NO(CFLAG:114))%の…」	PRINTFORMW 「なんで私が目の前に……というか、この身体……もしかして%CALLNAME_8_0(GET_ID_FROM_NO(CFLAG:114))%の…」
PRINTFORMDW 必死に耐える%CALLNAME:(TARGET)%をからかう様に、%SAVESTR:(CFLAG:902)%は妖艶な笑みを浮かべて攻め立てる！	PRINTFORMDW 必死に耐える%CALLNAME:(TARGET)%をからかう様に、%SAVESTR:(CFLAG:902)%は妖艶な笑みを浮かべて攻め立てる！
PRINTFORMDW %CALLNAME:(TARGET)%の限界を察した%SAVESTR:(CFLAG:902)%は射精に備え子宮口をピタリと鈴口に吸い付けた…	PRINTFORMDW %CALLNAME:(TARGET)%の限界を察した%SAVESTR:(CFLAG:902)%は射精に備え子宮口をピタリと鈴口に吸い付けた…
PRINTFORMDW %SAVESTR:(CFLAG:902)%の淫肉が、一滴残らず搾り取ろうと%CALLNAME:(TARGET)%のペニスに絡みついている…	PRINTFORMDW %SAVESTR:(CFLAG:902)%の淫肉が、一滴残らず搾り取ろうと%CALLNAME:(TARGET)%のペニスに絡みついている…
PRINTFORMDW %CALLNAME:(TARGET)%は黙ったまま%CALLNAME:(ARG:3)%の顔に手をやり、物欲しげに開いた口元へと引き寄せた…	PRINTFORMDW %CALLNAME:(TARGET)%は黙ったまま%CALLNAME:(ARG:3)%の顔に手をやり、物欲しげに開いた口元へと引き寄せた…
PRINTFORMW 「%SAVESTR:(TFLAG:53)%ッッ！！！　お願いだから…私の%CALLNAME_8_0(LOCAL:0)%を返してっ！！！」	PRINTFORMW 「%SAVESTR:(TFLAG:53)%ッッ！！！　お願いだから…私の%CALLNAME_8_0(LOCAL:0)%を返してっ！！！」
PRINTFORMW 「この%SAVESTR:(TFLAG:53)%風情が…私の%CALLNAME_8_0(LOCAL:0)%をさっさと解放しなさいっ！！！」	PRINTFORMW 「この%SAVESTR:(TFLAG:53)%風情が…私の%CALLNAME_8_0(LOCAL:0)%をさっさと解放しなさいっ！！！」
PRINTFORMDW %SAVESTR:(CFLAG:902)%から視線を逸らすと同時に、%CALLNAME:(TARGET)%はたまらず最後の嬌声を上げた	PRINTFORMDW %SAVESTR:(CFLAG:902)%から視線を逸らすと同時に、%CALLNAME:(TARGET)%はたまらず最後の嬌声を上げた
PRINTFORMW 「貴女の好きにして、%CALLNAME_8_0(CFLAG:900, 0, ARGS:1)%……ううん、違うのは解っているけれど…」	PRINTFORMW 「貴女の好きにして、%CALLNAME_8_0(CFLAG:900, 0, ARGS:1)%……ううん、違うのは解っているけれど…」
PRINTFORMDW %CALLNAME:(ARG:3)%の乳房の間に男根を挟み込み、%CALLNAME:(TARGET)%は腰を激しく前後させている…	PRINTFORMDW %CALLNAME:(ARG:3)%の乳房の間に男根を挟み込み、%CALLNAME:(TARGET)%は腰を激しく前後させている…
PRINTFORMDW %CALLNAME:(TARGET)%は熱く滾った剛直を%CALLNAME:(ARG:3)%に頬張らせ、その火照りを鎮め様とする…	PRINTFORMDW %CALLNAME:(TARGET)%は熱く滾った剛直を%CALLNAME:(ARG:3)%に頬張らせ、その火照りを鎮め様とする…
PRINTFORMW 「……この子…%CALLNAME_8_0(GET_ID_FROM_NO(NO:(ARG:1)))%そっくり…。まだ息はあるみたいね」	PRINTFORMW 「……この子…%CALLNAME_8_0(GET_ID_FROM_NO(NO:(ARG:1)))%そっくり…。まだ息はあるみたいね」
PRINTFORMDW %CALLNAME:(TARGET)%は性の衝動に抗えず、身動きの取れない%CALLNAME:(ARG:3)%を犯し続けている…	PRINTFORMDW %CALLNAME:(TARGET)%は性の衝動に抗えず、身動きの取れない%CALLNAME:(ARG:3)%を犯し続けている…
PRINTFORMDL 張り詰め膨らみあがった%CALLNAME:(TARGET)%のペニスを、%ARGS:1%は吐息と共に自身の中に飲み込んでいく…	PRINTFORMDL 張り詰め膨らみあがった%CALLNAME:(TARGET)%のペニスを、%ARGS:1%は吐息と共に自身の中に飲み込んでいく…
PRINTFORMDW 目の前に現れたよく見慣れた使い魔は、%CALLNAME:(TARGET)%%TACHI()%を舐め回す様に淫靡に微笑んでいる…	PRINTFORMDW 目の前に現れたよく見慣れた使い魔は、%CALLNAME:(TARGET)%%TACHI()%を舐め回す様に淫靡に微笑んでいる…
PRINTFORMDW %CALLNAME:(ARG:3)%の腰をがっしりと掴み、%CALLNAME:(TARGET)%は激しく抽挿を繰り返している…	PRINTFORMDW %CALLNAME:(ARG:3)%の腰をがっしりと掴み、%CALLNAME:(TARGET)%は激しく抽挿を繰り返している…
PRINTFORMDW %CALLNAME:(TARGET)%のペニスを擦りながら、%SAVESTR:(CFLAG:902)%は鈴口に舌を這わせた…	PRINTFORMDW %CALLNAME:(TARGET)%のペニスを擦りながら、%SAVESTR:(CFLAG:902)%は鈴口に舌を這わせた…
PRINTFORMW （%CALLNAME_8_0(LOCAL:0)%ったら%SAVESTR:(TFLAG:53)%に抱きしめられて…羨ましい…）	PRINTFORMW （%CALLNAME_8_0(LOCAL:0)%ったら%SAVESTR:(TFLAG:53)%に抱きしめられて…羨ましい…）
PRINTFORMW 「いやあぁ……%CALLNAME_8_0(LOCAL:0)%が！　%CALLNAME_8_0(LOCAL:0)%がぁぁぁ！」	PRINTFORMW 「いやあぁ……%CALLNAME_8_0(LOCAL:0)%が！　%CALLNAME_8_0(LOCAL:0)%がぁぁぁ！」
PRINTFORMDL %CALLNAME:(TARGET)%を拘束している%SAVESTR:(LOCAL:0)%は掴んだ両脚を大きく左右に開いた	PRINTFORMDL %CALLNAME:(TARGET)%を拘束している%SAVESTR:(LOCAL:0)%は掴んだ両脚を大きく左右に開いた
PRINTFORMDW %CALLNAME:(TARGET)%は少し頬を赤く染めながら、%CALLNAME:(1)%のペニスからそっと口を離した…	PRINTFORMDW %CALLNAME:(TARGET)%は少し頬を赤く染めながら、%CALLNAME:(1)%のペニスからそっと口を離した…
PRINTFORMDW %CALLNAME:(TARGET)%は%CALLNAME:(ARG:3)%を四つんばいにさせ、不浄の穴を犯し続けている…	PRINTFORMDW %CALLNAME:(TARGET)%は%CALLNAME:(ARG:3)%を四つんばいにさせ、不浄の穴を犯し続けている…
PRINTFORMDW %CALLNAME:(ARG:3)%の頭を掴み…%CALLNAME:(TARGET)%は欲望の赴くままに腰を突き動かした…	PRINTFORMDW %CALLNAME:(ARG:3)%の頭を掴み…%CALLNAME:(TARGET)%は欲望の赴くままに腰を突き動かした…
PRINTFORMDW そう言って%CALLNAME:(ARG:1)%は微笑みながら%CALLNAME:(ARG:0)%の下腹部を優しく撫で回した	PRINTFORMDW そう言って%CALLNAME:(ARG:1)%は微笑みながら%CALLNAME:(ARG:0)%の下腹部を優しく撫で回した
PRINTFORMDW %CALLNAME:(ARG:3)%を上に跨らせ、%CALLNAME:(TARGET)%は一心不乱に腰を突き上げている…	PRINTFORMDW %CALLNAME:(ARG:3)%を上に跨らせ、%CALLNAME:(TARGET)%は一心不乱に腰を突き上げている…
PRINTFORMDW 上に跨った%CALLNAME:(ARG:3)%の激しい腰使いに、%CALLNAME:(TARGET)%は酔いしれている…	PRINTFORMDW 上に跨った%CALLNAME:(ARG:3)%の激しい腰使いに、%CALLNAME:(TARGET)%は酔いしれている…
PRINTFORMDW %CALLNAME:(ARG:3)%が激しく腰を落とすたび、%CALLNAME:(TARGET)%は大きな嬌声を上げる…	PRINTFORMDW %CALLNAME:(ARG:3)%が激しく腰を落とすたび、%CALLNAME:(TARGET)%は大きな嬌声を上げる…
PRINTFORMDW いったいどこを叩いているつもりなのだろう、%CALLNAME:(TARGET)%は恐る恐るペチペチと触手を叩いている…	PRINTFORMDW いったいどこを叩いているつもりなのだろう、%CALLNAME:(TARGET)%は恐る恐るペチペチと触手を叩いている…
PRINTFORMDW 上半身をスライムに包まれた%CALLNAME:(TARGET)%は声も出せないまま、尻を高く上げた状態でもがいている…	PRINTFORMDW 上半身をスライムに包まれた%CALLNAME:(TARGET)%は声も出せないまま、尻を高く上げた状態でもがいている…
PRINTFORMDL %CALLNAME:(ARG:0)%と繋がったまま、全身に激しい快楽を受け続けた%CALLNAME:(ARG:1)%は	PRINTFORMDL %CALLNAME:(ARG:0)%と繋がったまま、全身に激しい快楽を受け続けた%CALLNAME:(ARG:1)%は
PRINTFORMDW %CALLNAME:(ARG:0)%と%CALLNAME:(ARG:1)%は強く抱き合いながらお互いの鼓動を感じている	PRINTFORMDW %CALLNAME:(ARG:0)%と%CALLNAME:(ARG:1)%は強く抱き合いながらお互いの鼓動を感じている
PRINTFORMDW 部屋に蠢く触手達は%CALLNAME:(TARGET)%の下着の隙間から次々と入り込み、中の敏感な突起に群がっている…	PRINTFORMDW 部屋に蠢く触手達は%CALLNAME:(TARGET)%の下着の隙間から次々と入り込み、中の敏感な突起に群がっている…
PRINTFORMDL たっぷり舐め上げた%ARGS:1%の男根から%CALLNAME:(TARGET)%は小さな口を名残惜しそうに離した。	PRINTFORMDL たっぷり舐め上げた%ARGS:1%の男根から%CALLNAME:(TARGET)%は小さな口を名残惜しそうに離した。
PRINTFORMW 「今だけは…せめて%CALLNAME_8_0(CFLAG:900, 0, ARGS:1)%に抱かれていると思わせて…」	PRINTFORMW 「今だけは…せめて%CALLNAME_8_0(CFLAG:900, 0, ARGS:1)%に抱かれていると思わせて…」
PRINTFORMDW 叩いても叩いても反動で起き上がってくる触手が、%CALLNAME:(TARGET)%の目にはどう映っているのだろう…	PRINTFORMDW 叩いても叩いても反動で起き上がってくる触手が、%CALLNAME:(TARGET)%の目にはどう映っているのだろう…
PRINTFORMDW %CALLNAME:(TARGET)%は涙に濡れた目を固く閉じ、口から伝わる感触から気を逸らそうと必死に耐えている…	PRINTFORMDW %CALLNAME:(TARGET)%は涙に濡れた目を固く閉じ、口から伝わる感触から気を逸らそうと必死に耐えている…
PRINTFORMDW 不意に唇を奪われ最初は必死に抵抗したものの、次第に%CALLNAME:(TARGET)%は恍惚の表情を浮かべ始めた…	PRINTFORMDW 不意に唇を奪われ最初は必死に抵抗したものの、次第に%CALLNAME:(TARGET)%は恍惚の表情を浮かべ始めた…
PRINTFORMDW %PETNAME%との永遠の誓いを交わした%CALLNAME:(TARGET)%は息も絶え絶え幸せそうに震えている…	PRINTFORMDW %PETNAME%との永遠の誓いを交わした%CALLNAME:(TARGET)%は息も絶え絶え幸せそうに震えている…
PRINTFORMDW %CALLNAME:(ARG:1)%はそう言って%CALLNAME:(ARG:0)%に抱きつき、ペニスをなぞり上げた	PRINTFORMDW %CALLNAME:(ARG:1)%はそう言って%CALLNAME:(ARG:0)%に抱きつき、ペニスをなぞり上げた
PRINTFORMDW 震えながら欲望を吐き出す%CALLNAME:(ARG:0)%を%CALLNAME:(ARG:1)%は優しく抱きしめた	PRINTFORMDW 震えながら欲望を吐き出す%CALLNAME:(ARG:0)%を%CALLNAME:(ARG:1)%は優しく抱きしめた
PRINTFORMDW 部屋に蠢く触手達は%CALLNAME:(TARGET)%の尻穴の疼きを察知したのか、その身をうねらせながら殺到した…	PRINTFORMDW 部屋に蠢く触手達は%CALLNAME:(TARGET)%の尻穴の疼きを察知したのか、その身をうねらせながら殺到した…
PRINTFORMDW 部屋に蠢く触手達は%CALLNAME:(TARGET)%の無防備にさらけ出された最も敏感な突起を次々と擦りあげた……	PRINTFORMDW 部屋に蠢く触手達は%CALLNAME:(TARGET)%の無防備にさらけ出された最も敏感な突起を次々と擦りあげた……
PRINTFORMDW %CALLNAME:(TARGET)%の下着の隙間から入り込んだ触手達は、秘腔を一杯まで押し拡げうねりを上げている…	PRINTFORMDW %CALLNAME:(TARGET)%の下着の隙間から入り込んだ触手達は、秘腔を一杯まで押し拡げうねりを上げている…
PRINTFORMDW 口の中に出された白濁液をなんとか全て飲み込んだ%CALLNAME:(TARGET)%は、少し苦しげに笑顔を浮かべた	PRINTFORMDW 口の中に出された白濁液をなんとか全て飲み込んだ%CALLNAME:(TARGET)%は、少し苦しげに笑顔を浮かべた
PRINTFORMDW %CALLNAME:(TARGET)%は自分の裸体が見え始めている事も厭わず、傷ついた触手スーツを気にかけている…	PRINTFORMDW %CALLNAME:(TARGET)%は自分の裸体が見え始めている事も厭わず、傷ついた触手スーツを気にかけている…
PRINTFORMDL 激しく脈打つペニスから大量の子種汁が噴き出し、%CALLNAME:(TARGET)%の子宮中を真っ白に染め上げた…	PRINTFORMDL 激しく脈打つペニスから大量の子種汁が噴き出し、%CALLNAME:(TARGET)%の子宮中を真っ白に染め上げた…
PRINTFORMDW %CALLNAME:(TARGET)%は%CALLNAME:(ARG:3)%が何かいつもと違う事に気が付いた様だ…	PRINTFORMDW %CALLNAME:(TARGET)%は%CALLNAME:(ARG:3)%が何かいつもと違う事に気が付いた様だ…
PRINTFORMDW %CALLNAME:(TARGET)%は%CALLNAME:(ARG:3)%の胸板に、自らの欲望を擦りつけている…	PRINTFORMDW %CALLNAME:(TARGET)%は%CALLNAME:(ARG:3)%の胸板に、自らの欲望を擦りつけている…
PRINTFORMDW %CALLNAME:(TARGET)%は%CALLNAME:(ARG:3)%の尻を抱え込み、激しく打ち付けている…	PRINTFORMDW %CALLNAME:(TARGET)%は%CALLNAME:(ARG:3)%の尻を抱え込み、激しく打ち付けている…
PRINTFORMDW %CALLNAME:(TARGET)%の豊かな乳房は常時触手服によって持ち上げられ、その存在を周囲に主張している…	PRINTFORMDW %CALLNAME:(TARGET)%の豊かな乳房は常時触手服によって持ち上げられ、その存在を周囲に主張している…
PRINTFORMW 　こうして%CALLNAME_8_0(CFLAG:900, 0, ARGS:1)%に抱かれてるなんて夢みたい……」	PRINTFORMW 　こうして%CALLNAME_8_0(CFLAG:900, 0, ARGS:1)%に抱かれてるなんて夢みたい……」
PRINTFORMDW %CALLNAME:(TARGET)%の瞳から徐々に光が消え、代わりに敵に対して好意を持った笑顔を浮かべだした…	PRINTFORMDW %CALLNAME:(TARGET)%の瞳から徐々に光が消え、代わりに敵に対して好意を持った笑顔を浮かべだした…
PRINTFORMDW 目の前に無防備に曝け出された尻を見て、%CALLNAME:(TARGET)%は湧き上がる痴情を抑え切れなかった…	PRINTFORMDW 目の前に無防備に曝け出された尻を見て、%CALLNAME:(TARGET)%は湧き上がる痴情を抑え切れなかった…
PRINTFORMDW %CALLNAME:(TARGET)%は舌舐めずりしながら%CALLNAME:(ARG:2)%に目配せしている…	PRINTFORMDW %CALLNAME:(TARGET)%は舌舐めずりしながら%CALLNAME:(ARG:2)%に目配せしている…
PRINTFORMW 「もう…そんなに急かさなくても…せっかく%CALLNAME_8_0(ARG:0)%とゆっくり愛し合いたいのにぃ…」	PRINTFORMW 「もう…そんなに急かさなくても…せっかく%CALLNAME_8_0(ARG:0)%とゆっくり愛し合いたいのにぃ…」
PRINTFORMDW 触手を何かと思って弄っていた%CALLNAME:(TARGET)%だったが、勢い余って強く曲げてしまった様だ…	PRINTFORMDW 触手を何かと思って弄っていた%CALLNAME:(TARGET)%だったが、勢い余って強く曲げてしまった様だ…
PRINTFORM 「女の子なのに、こんなにおちんぽギンギンにさせちゃって…えっちなんですね、%CALLNAME:(TARGET)%様	PRINTFORM 「女の子なのに、こんなにおちんぽギンギンにさせちゃって…えっちなんですね、%CALLNAME:(TARGET)%様
PRINTFORMDW %CALLNAME:(TARGET)%の悲痛な叫びも虚しく、久々の食事に満足したスライムは闇へと消えて行った…	PRINTFORMDW %CALLNAME:(TARGET)%の悲痛な叫びも虚しく、久々の食事に満足したスライムは闇へと消えて行った…
PRINTFORMDW %SAVESTR:(CFLAG:902)%は顔にかかった精液を舌で舐め取りながら、淫靡な眼差しで見つめている…	PRINTFORMDW %SAVESTR:(CFLAG:902)%は顔にかかった精液を舌で舐め取りながら、淫靡な眼差しで見つめている…
PRINTFORMDW %CALLNAME:(TARGET)%の無防備な秘壷の入口に無数の触手達が群がり、敏感な粘膜全てを擦りあげる…	PRINTFORMDW %CALLNAME:(TARGET)%の無防備な秘壷の入口に無数の触手達が群がり、敏感な粘膜全てを擦りあげる…
PRINTFORMDW %CALLNAME:(TARGET)%は口の周りを粘液だらけにしながら触手とのディープキスを繰り返している…	PRINTFORMDW %CALLNAME:(TARGET)%は口の周りを粘液だらけにしながら触手とのディープキスを繰り返している…
PRINTFORMDW %CALLNAME:(TARGET)%は口から糸を引かせ、今まで口に含んでいた触手を潤んだ瞳で見つめている…	PRINTFORMDW %CALLNAME:(TARGET)%は口から糸を引かせ、今まで口に含んでいた触手を潤んだ瞳で見つめている…
PRINTFORMDW %CALLNAME:(TARGET)%は激しくうねる触手を乳房で抑えながら…柔肉に伝わる感触を愉しんでいる…	PRINTFORMDW %CALLNAME:(TARGET)%は激しくうねる触手を乳房で抑えながら…柔肉に伝わる感触を愉しんでいる…
PRINTFORMDW 己の肉棒を深く咥え込まれた%CALLNAME:(TARGET)%は、こみ上げてくる快感から必死に耐えている…	PRINTFORMDW 己の肉棒を深く咥え込まれた%CALLNAME:(TARGET)%は、こみ上げてくる快感から必死に耐えている…
PRINTFORMDW %CALLNAME:(ARG:3)%の胸による奉仕に、%CALLNAME:(TARGET)%は陶酔している…	PRINTFORMDW %CALLNAME:(ARG:3)%の胸による奉仕に、%CALLNAME:(TARGET)%は陶酔している…
PRINTFORM 「ごめんなさい…%CALLNAME_8_0(ARG:3)%のおっぱいを見ていたら…どうしても我慢できなかったの…	PRINTFORM 「ごめんなさい…%CALLNAME_8_0(ARG:3)%のおっぱいを見ていたら…どうしても我慢できなかったの…
PRINTFORMDW %CALLNAME:(ARG:3)%の卓越した口技に%CALLNAME:(TARGET)%は翻弄されている…	PRINTFORMDW %CALLNAME:(ARG:3)%の卓越した口技に%CALLNAME:(TARGET)%は翻弄されている…
PRINTFORMDW %CALLNAME:(ARG:3)%の懸命な奉仕に、%CALLNAME:(TARGET)%は身を任せている…	PRINTFORMDW %CALLNAME:(ARG:3)%の懸命な奉仕に、%CALLNAME:(TARGET)%は身を任せている…
PRINTFORMDW 恥ずかしがって顔を赤らめながらも、結構な威力の張り手を見舞う%CALLNAME:(TARGET)%だった…	PRINTFORMDW 恥ずかしがって顔を赤らめながらも、結構な威力の張り手を見舞う%CALLNAME:(TARGET)%だった…
PRINTFORMDW %CALLNAME:(TARGET)%は激しく腰を突き上げながらも快感に耐え、熱いマグマを練り上げている…	PRINTFORMDW %CALLNAME:(TARGET)%は激しく腰を突き上げながらも快感に耐え、熱いマグマを練り上げている…
PRINTFORM 「ぃやぁ…%CALLNAME_8_0(CFLAG:900)%に握られてるだけで…おちんぽビクビクしちゃうのぉ…	PRINTFORM 「ぃやぁ…%CALLNAME_8_0(CFLAG:900)%に握られてるだけで…おちんぽビクビクしちゃうのぉ…
PRINTFORMDW %CALLNAME:(TARGET)%は、ねっとりと滴り落ちる白濁液を拭う事すらせず舌なめずりをしている…	PRINTFORMDW %CALLNAME:(TARGET)%は、ねっとりと滴り落ちる白濁液を拭う事すらせず舌なめずりをしている…
PRINTFORMDW %CALLNAME:(TARGET)%は被った帽子を押し分けて生えてきた猫の様な耳を、興味深く弄っている…	PRINTFORMDW %CALLNAME:(TARGET)%は被った帽子を押し分けて生えてきた猫の様な耳を、興味深く弄っている…
PRINTFORMW 「……動かないで……もう少し……%CALLNAME_8_0(ARG:0)%の膣内で……埋もれていたいの……」	PRINTFORMW 「……動かないで……もう少し……%CALLNAME_8_0(ARG:0)%の膣内で……埋もれていたいの……」
PRINTFORMDW %CALLNAME:(TARGET)%の周りを取り囲んだ5つの輝く宝石が光弾となり一斉に撃ち放たれる！！	PRINTFORMDW %CALLNAME:(TARGET)%の周りを取り囲んだ5つの輝く宝石が光弾となり一斉に撃ち放たれる！！
PRINTFORM 　気持ちいいの……でも…自分でするより%CALLNAME_8_0(CFLAG:900)%にしてもらった方が…	PRINTFORM 　気持ちいいの……でも…自分でするより%CALLNAME_8_0(CFLAG:900)%にしてもらった方が…
PRINTFORMDW 自由の利かない自分の身体が何をしようとしているか…%CALLNAME:(TARGET)%は察してしまった	PRINTFORMDW 自由の利かない自分の身体が何をしようとしているか…%CALLNAME:(TARGET)%は察してしまった
PRINTFORM 　こんなに簡単に押し倒されちゃって、もしかして期待しちゃってます？　%CALLNAME:(TARGET)%様	PRINTFORM 　こんなに簡単に押し倒されちゃって、もしかして期待しちゃってます？　%CALLNAME:(TARGET)%様
PRINTFORMDW 眼前の敵とは別方面からの不意打ちに、%CALLNAME:(TARGET)%の尻穴は屈服しようとしていた…	PRINTFORMDW 眼前の敵とは別方面からの不意打ちに、%CALLNAME:(TARGET)%の尻穴は屈服しようとしていた…
PRINTFORM 「おや%CALLNAME_8_0(ARG:2)%ったら、女の子なのに股にそんな立派なおちんぽを生やしちゃって	PRINTFORM 「おや%CALLNAME_8_0(ARG:2)%ったら、女の子なのに股にそんな立派なおちんぽを生やしちゃって
PRINTFORMW 「わかったわ、%CALLNAME_8_0(ARG:0)%も…ここ…辛いのでしょう？　私が楽にしてあげる…」	PRINTFORMW 「わかったわ、%CALLNAME_8_0(ARG:0)%も…ここ…辛いのでしょう？　私が楽にしてあげる…」
PRINTFORM （あぁ…捕まえられてるのが%CALLNAME_8_0(LOCAL:0)%じゃなくて…私だったらどんなに……	PRINTFORM （あぁ…捕まえられてるのが%CALLNAME_8_0(LOCAL:0)%じゃなくて…私だったらどんなに……
PRINTFORM 「%CALLNAME:(TARGET)%様のおちんぽが欲しくて…こんなにトロトロになっちゃってるんですぅ…	PRINTFORM 「%CALLNAME:(TARGET)%様のおちんぽが欲しくて…こんなにトロトロになっちゃってるんですぅ…
PRINTFORMDW 激しくうねる触手の動きに合わせて、%CALLNAME:(TARGET)%は腰を艶かしくくねらせている…	PRINTFORMDW 激しくうねる触手の動きに合わせて、%CALLNAME:(TARGET)%は腰を艶かしくくねらせている…
PRINTFORM 「いいのよ…好きなだけ触って……私も%CALLNAME_8_0(CFLAG:900)%に触られるの…好き…	PRINTFORM 「いいのよ…好きなだけ触って……私も%CALLNAME_8_0(CFLAG:900)%に触られるの…好き…
PRINTFORMDW %CALLNAME:(TARGET)%の尻穴がヒクついているのが見えると周囲の触手達が一斉に群がった…	PRINTFORMDW %CALLNAME:(TARGET)%の尻穴がヒクついているのが見えると周囲の触手達が一斉に群がった…
PRINTFORMW 「はぁ…観念するしかないみたいね…せめて優しくしなさいよ、%CALLNAME_8_0(ARG:2)%…」	PRINTFORMW 「はぁ…観念するしかないみたいね…せめて優しくしなさいよ、%CALLNAME_8_0(ARG:2)%…」
PRINTFORM 「散々暴れた分…このおちんぽを膣内で暴れさせてあげるわ、%CALLNAME_8_0(ARG:0, 1)%…	PRINTFORM 「散々暴れた分…このおちんぽを膣内で暴れさせてあげるわ、%CALLNAME_8_0(ARG:0, 1)%…
PRINTFORM 「もう…そんなに急かさなくても…すぐに%CALLNAME_8_0(ARG:0)%の膣内、たぷたぷにするわよ	PRINTFORM 「もう…そんなに急かさなくても…すぐに%CALLNAME_8_0(ARG:0)%の膣内、たぷたぷにするわよ
PRINTFORMDL %CALLNAME:(ARG:1)%は満足げな表情で%CALLNAME:(ARG:0)%の胸に倒れこみ	PRINTFORMDL %CALLNAME:(ARG:1)%は満足げな表情で%CALLNAME:(ARG:0)%の胸に倒れこみ
PRINTFORMDW 突如しゃがみこんだ%CALLNAME:(TARGET)%は身体をガクガク震わせながら奇声を張り上げた。	PRINTFORMDW 突如しゃがみこんだ%CALLNAME:(TARGET)%は身体をガクガク震わせながら奇声を張り上げた。
PRINTFORMDW %CALLNAME:(TARGET)%の考えに反して動く身体は、その乳房を使い触手に奉仕をしている…	PRINTFORMDW %CALLNAME:(TARGET)%の考えに反して動く身体は、その乳房を使い触手に奉仕をしている…
PRINTFORM 　戦闘中だっていうのに…%CALLNAME_8_0(ARG:2)%のココ…ぐしょぐしょのヌルヌルじゃない	PRINTFORM 　戦闘中だっていうのに…%CALLNAME_8_0(ARG:2)%のココ…ぐしょぐしょのヌルヌルじゃない
PRINTFORMDW %ARGS:1%の舌が%CALLNAME:(TARGET)%の口内を撫で回し、絶えず唾液を送り込む！	PRINTFORMDW %ARGS:1%の舌が%CALLNAME:(TARGET)%の口内を撫で回し、絶えず唾液を送り込む！
PRINTFORMDW %CALLNAME:(TARGET)%は潤んだ瞳で敵を見つめている。完全に恋に落ちた少女さながらだ…	PRINTFORMDW %CALLNAME:(TARGET)%は潤んだ瞳で敵を見つめている。完全に恋に落ちた少女さながらだ…
PRINTFORMDW 自慰を止めらない%CALLNAME:(TARGET)%は、快楽に飲み込まれながらぐったりと力尽きた…	PRINTFORMDW 自慰を止めらない%CALLNAME:(TARGET)%は、快楽に飲み込まれながらぐったりと力尽きた…
PRINTFORMW 「……あれ……%CALLNAME_8_0(CFLAG:900, 0, ARGS:1)%は……どこ…？」	PRINTFORMW 「……あれ……%CALLNAME_8_0(CFLAG:900, 0, ARGS:1)%は……どこ…？」
PRINTFORMW 「%CALLNAME_8_0(FLAG:10)%！　%CALLNAME_8_0(FLAG:11)%！」	PRINTFORMW 「%CALLNAME_8_0(FLAG:10)%！　%CALLNAME_8_0(FLAG:11)%！」
PRINTFORMW 「%CALLNAME_8_0(FLAG:10)%も見当たらない…どこか別の場所に飛ばされたのかしら…」	PRINTFORMW 「%CALLNAME_8_0(FLAG:10)%も見当たらない…どこか別の場所に飛ばされたのかしら…」
PRINTFORMDW %CALLNAME:(TARGET)%は大量の白濁液に溺れ息苦しそうにしつつも、うっとりとしている…	PRINTFORMDW %CALLNAME:(TARGET)%は大量の白濁液に溺れ息苦しそうにしつつも、うっとりとしている…
PRINTFORMW 「ごめんなさい、%CALLNAME_8_0(ARG:0)%……これじゃ私…すぐに果ててしまうかも……」	PRINTFORMW 「ごめんなさい、%CALLNAME_8_0(ARG:0)%……これじゃ私…すぐに果ててしまうかも……」
PRINTFORM 「もう出ちゃう？　びゅくびゅく射精しちゃう？　いいのよ…%CALLNAME_8_0(ARG:0, 1)%	PRINTFORM 「もう出ちゃう？　びゅくびゅく射精しちゃう？　いいのよ…%CALLNAME_8_0(ARG:0, 1)%
PRINTFORMDW %CALLNAME:(TARGET)%は、もじもじと脚を擦り合わせながら、仲間と少し距離を置いている	PRINTFORMDW %CALLNAME:(TARGET)%は、もじもじと脚を擦り合わせながら、仲間と少し距離を置いている
PRINTFORMDW 下着が丸見えになっている事にも構わず、%CALLNAME:(TARGET)%は足での奉仕を始めた…	PRINTFORMDW 下着が丸見えになっている事にも構わず、%CALLNAME:(TARGET)%は足での奉仕を始めた…
PRINTFORMW 「うぅ……これ…たぶん性器よね……私の手が…ぺしぺしって……身体の自由が戻ったらすぐ拭かないと……」	PRINTFORMW 「うぅ……これ…たぶん性器よね……私の手が…ぺしぺしって……身体の自由が戻ったらすぐ拭かないと……」
PRINTFORM 「ふぁぁ…もっと強くぅ…そう、乳首も弄ってぇ%CALLNAME_8_0(CFLAG:900, 1)%…	PRINTFORM 「ふぁぁ…もっと強くぅ…そう、乳首も弄ってぇ%CALLNAME_8_0(CFLAG:900, 1)%…
PRINTFORMDW %CALLNAME:(TARGET)%は自らを抱きしめ腰をくねらせながら恍惚の表情を浮かべている…	PRINTFORMDW %CALLNAME:(TARGET)%は自らを抱きしめ腰をくねらせながら恍惚の表情を浮かべている…
PRINTFORMDW %CALLNAME:(TARGET)%は指に絡みつく粘液を舐め取りながら恍惚の表情を浮かべている…	PRINTFORMDW %CALLNAME:(TARGET)%は指に絡みつく粘液を舐め取りながら恍惚の表情を浮かべている…
PRINTFORMDW ヒクヒク待ちわびる様にねっとりと蜜を垂れ流す秘穴に、首をもたげ見上げていた触手達が一斉に殺到する…	PRINTFORMDW ヒクヒク待ちわびる様にねっとりと蜜を垂れ流す秘穴に、首をもたげ見上げていた触手達が一斉に殺到する…
PRINTFORMDW 妖しい香りを放つ液体に浸かった%CALLNAME:(TARGET)%は、みるみる顔が紅潮していく…	PRINTFORMDW 妖しい香りを放つ液体に浸かった%CALLNAME:(TARGET)%は、みるみる顔が紅潮していく…
PRINTFORM 　ゆっくり動くから…%CALLNAME_8_0(ARG:3)%のお尻に…挿入ってるところ全部見えちゃう	PRINTFORM 　ゆっくり動くから…%CALLNAME_8_0(ARG:3)%のお尻に…挿入ってるところ全部見えちゃう
PRINTFORMDW 両手で下半身を隠しながら、うつむいた%CALLNAME:(ARG:1)%は、今にも泣き出しそうだ…	PRINTFORMDW 両手で下半身を隠しながら、うつむいた%CALLNAME:(ARG:1)%は、今にも泣き出しそうだ…
PRINTFORM 「…ぁ…抜いた…のね……%CALLNAME_8_0(ARG:0)%のせーえき…子宮に…欲しかったのにぃ	PRINTFORM 「…ぁ…抜いた…のね……%CALLNAME_8_0(ARG:0)%のせーえき…子宮に…欲しかったのにぃ
PRINTFORMDW 部屋に蠢く触手達は%CALLNAME:(TARGET)%の硬く震える乳首を代わる代わる責め立てる…	PRINTFORMDW 部屋に蠢く触手達は%CALLNAME:(TARGET)%の硬く震える乳首を代わる代わる責め立てる…
PRINTFORMDW %CALLNAME:(TARGET)%は身体をビクンビクンと痙攣させながら恍惚の表情を浮かべている	PRINTFORMDW %CALLNAME:(TARGET)%は身体をビクンビクンと痙攣させながら恍惚の表情を浮かべている
PRINTFORMW 「%CALLNAME_8_0(LOCAL:0)%！　必ず助ける…からっ！　もう少しだけ…耐えて…」	PRINTFORMW 「%CALLNAME_8_0(LOCAL:0)%！　必ず助ける…からっ！　もう少しだけ…耐えて…」
PRINTFORMDW %CALLNAME:(TARGET)%は無意識に股間に手をやり、自らの指を秘裂に埋めさせていた…	PRINTFORMDW %CALLNAME:(TARGET)%は無意識に股間に手をやり、自らの指を秘裂に埋めさせていた…
PRINTFORM 　%CALLNAME:(TARGET)%様…おちんちん、しゃぶって欲しくてたまらないって顔してますよ	PRINTFORM 　%CALLNAME:(TARGET)%様…おちんちん、しゃぶって欲しくてたまらないって顔してますよ
PRINTFORM 「ここ…グリグリされると、すぐイっちゃうんですよね、敏感な%CALLNAME:(TARGET)%様は	PRINTFORM 「ここ…グリグリされると、すぐイっちゃうんですよね、敏感な%CALLNAME:(TARGET)%様は
PRINTFORMW 「ぅん…%CALLNAME_8_0(CFLAG:900, 1)%…そんなところ……しちゃだめぇ…」	PRINTFORMW 「ぅん…%CALLNAME_8_0(CFLAG:900, 1)%…そんなところ……しちゃだめぇ…」
PRINTFORMDW %CALLNAME:(TARGET)%は美鈴に目配せしながら『いくわよ』とばかりにニヤリと笑った	PRINTFORMDW %CALLNAME:(TARGET)%は美鈴に目配せしながら『いくわよ』とばかりにニヤリと笑った
PRINTFORM 「んもう…%CALLNAME:(TARGET)%様ったら、こんなにザーメン溜め込んじゃってたんですね	PRINTFORM 「んもう…%CALLNAME:(TARGET)%様ったら、こんなにザーメン溜め込んじゃってたんですね
PRINTFORMDW そう言いながら%ARGS:1%はペニスで%ARGS:0%の口を無理やり塞ぎ、激しく腰を動かした！	PRINTFORMDW そう言いながら%ARGS:1%はペニスで%ARGS:0%の口を無理やり塞ぎ、激しく腰を動かした！
PRINTFORMW 「こ、これってもしかして…私と%CALLNAME_8_0(ARG:2)%を交わらせようと触手が…」	PRINTFORMW 「こ、これってもしかして…私と%CALLNAME_8_0(ARG:2)%を交わらせようと触手が…」
PRINTFORMW 「お願いやめて…%CALLNAME_8_0(ARG:2)%…手でも口でも思う存分シてあげるから…」	PRINTFORMW 「お願いやめて…%CALLNAME_8_0(ARG:2)%…手でも口でも思う存分シてあげるから…」
PRINTFORMDW %CALLNAME:(ARG:0)%が散々放った子種汁が、役目は終えたとばかりに溢れ出していた…	PRINTFORMDW %CALLNAME:(ARG:0)%が散々放った子種汁が、役目は終えたとばかりに溢れ出していた…
PRINTFORMDW 不安感から耐え切れず、つい自分から切り出してしまった%CALLNAME:(TARGET)%だった	PRINTFORMDW 不安感から耐え切れず、つい自分から切り出してしまった%CALLNAME:(TARGET)%だった
PRINTFORMDW 大きくなってきたおなかを擦りながら、%CALLNAME:(TARGET)%は悟った様な顔で応えた	PRINTFORMDW 大きくなってきたおなかを擦りながら、%CALLNAME:(TARGET)%は悟った様な顔で応えた
PRINTFORMDW %CALLNAME:(TARGET)%は悩ましげな表情を浮かべ、%ARGS:1%に抱きついた…	PRINTFORMDW %CALLNAME:(TARGET)%は悩ましげな表情を浮かべ、%ARGS:1%に抱きついた…
PRINTFORMDW %ARGS:1%を抱き寄せながら%CALLNAME:(TARGET)%は敵の方へと振り返った…	PRINTFORMDW %ARGS:1%を抱き寄せながら%CALLNAME:(TARGET)%は敵の方へと振り返った…
PRINTFORM 「%CALLNAME_8_0(ARG:2)%…貴女なら…分かるでしょ？　解消するのに協力しなさい…	PRINTFORM 「%CALLNAME_8_0(ARG:2)%…貴女なら…分かるでしょ？　解消するのに協力しなさい…
PRINTFORMDW %CALLNAME:(TARGET)%は触手の上にまたがり、ゆっくりと割れ目を擦り付けている…	PRINTFORMDW %CALLNAME:(TARGET)%は触手の上にまたがり、ゆっくりと割れ目を擦り付けている…
PRINTFORMDW そう言って%PETNAME%は愛しげに%CALLNAME:(TARGET)%の下腹部を擦った…	PRINTFORMDW そう言って%PETNAME%は愛しげに%CALLNAME:(TARGET)%の下腹部を擦った…
PRINTFORMDL みるみる内に%CALLNAME:(TARGET)%の身体をピッチリと覆ったウエディングドレスが	PRINTFORMDL みるみる内に%CALLNAME:(TARGET)%の身体をピッチリと覆ったウエディングドレスが
PRINTFORMDW %CALLNAME:(TARGET)%は小さくなった手のひらで全身をペタペタ確認しながら呟いた	PRINTFORMDW %CALLNAME:(TARGET)%は小さくなった手のひらで全身をペタペタ確認しながら呟いた
PRINTFORMW 「ねぇ%CALLNAME_8_0(ARG:2)%…貴女なんだか…男の人みたいな臭いがするわね？」	PRINTFORMW 「ねぇ%CALLNAME_8_0(ARG:2)%…貴女なんだか…男の人みたいな臭いがするわね？」
PRINTFORMW 「え、えっ？！　ちょっ…%CALLNAME_8_0(ARG:0)%ったら何してるのよっっ！！！」	PRINTFORMW 「え、えっ？！　ちょっ…%CALLNAME_8_0(ARG:0)%ったら何してるのよっっ！！！」
PRINTFORM 「ほら…強く抱いて…最後の一滴まで…注ぎ込むわよ、%CALLNAME_8_0(ARG:0, 1)%	PRINTFORM 「ほら…強く抱いて…最後の一滴まで…注ぎ込むわよ、%CALLNAME_8_0(ARG:0, 1)%
PRINTFORMW 「あら、ママ。あなたの娘は今、元気に%CALLNAME:1%さん%TACHI()%と探索中よ♪」	PRINTFORMW 「あら、ママ。あなたの娘は今、元気に%CALLNAME:1%さん%TACHI()%と探索中よ♪」
PRINTFORMDW %CALLNAME:(TARGET)%は火照る身体を鎮めようと静かに自ら身体をまさぐり始めた…	PRINTFORMDW %CALLNAME:(TARGET)%は火照る身体を鎮めようと静かに自ら身体をまさぐり始めた…
PRINTFORMDL 心のどこかで解っていて、あえて目を逸らしていた%CALLNAME:(TARGET)%だったが、	PRINTFORMDL 心のどこかで解っていて、あえて目を逸らしていた%CALLNAME:(TARGET)%だったが、
PRINTFORMDW たらふく母乳を吸って満足した使い魔は、ようやく%CALLNAME:(TARGET)%を解放した	PRINTFORMDW たらふく母乳を吸って満足した使い魔は、ようやく%CALLNAME:(TARGET)%を解放した
PRINTFORM 　そう…もっとして…%CALLNAME_8_0(CFLAG:900, 1, ARGS:1)%……	PRINTFORM 　そう…もっとして…%CALLNAME_8_0(CFLAG:900, 1, ARGS:1)%……
PRINTFORMDW %CALLNAME:(TARGET)%は青竹踏みをしているつもりで触手を両脚で踏みつけている	PRINTFORMDW %CALLNAME:(TARGET)%は青竹踏みをしているつもりで触手を両脚で踏みつけている
PRINTFORMDW %CALLNAME:(TARGET)%は普段から行なっているかの様に触手にキスを繰り返した…	PRINTFORMDW %CALLNAME:(TARGET)%は普段から行なっているかの様に触手にキスを繰り返した…
PRINTFORMDW ぐちゅぐちゅと激しい音を立て、%CALLNAME:(TARGET)%は触手を擦りあげている…	PRINTFORMDW ぐちゅぐちゅと激しい音を立て、%CALLNAME:(TARGET)%は触手を擦りあげている…
PRINTFORM 「%CALLNAME:(TARGET)%様のクリちゃん…息がかかっただけでもヒクヒクしちゃってる	PRINTFORM 「%CALLNAME:(TARGET)%様のクリちゃん…息がかかっただけでもヒクヒクしちゃってる
PRINTFORM 「%CALLNAME_8_0(CFLAG:900)%ので突かれてるってだけで……ンああぁんッッッ	PRINTFORM 「%CALLNAME_8_0(CFLAG:900)%ので突かれてるってだけで……ンああぁんッッッ
PRINTFORM 「だめっ%CALLNAME_8_0(CFLAG:900)%…　そこ…敏感なんだから…抓っちゃあっ	PRINTFORM 「だめっ%CALLNAME_8_0(CFLAG:900)%…　そこ…敏感なんだから…抓っちゃあっ
PRINTFORMDL 身を守り隠すものが何もないながらも必死に戦う%CALLNAME:(TARGET)%だったが、	PRINTFORMDL 身を守り隠すものが何もないながらも必死に戦う%CALLNAME:(TARGET)%だったが、
PRINTFORMDL %PETNAME%は最後の仕上げとばかりに%CALLNAME:(TARGET)%を抱きかかえ	PRINTFORMDL %PETNAME%は最後の仕上げとばかりに%CALLNAME:(TARGET)%を抱きかかえ
PRINTFORMDL 激しい責めにあい続け、ついに意識を失い倒れた%CALLNAME:(ARG:1)%の膣口からは	PRINTFORMDL 激しい責めにあい続け、ついに意識を失い倒れた%CALLNAME:(ARG:1)%の膣口からは
PRINTFORMDL そう言って%CALLNAME:(ARG:1)%は射精を続けながら子宮口を撫でるように腰を回し	PRINTFORMDL そう言って%CALLNAME:(ARG:1)%は射精を続けながら子宮口を撫でるように腰を回し
PRINTFORMW 「あ……これを飲ませれば%CALLNAME_8_0(LOCAL:0)%も戦力に復帰できるわね」	PRINTFORMW 「あ……これを飲ませれば%CALLNAME_8_0(LOCAL:0)%も戦力に復帰できるわね」
PRINTFORMDW %CALLNAME:(TARGET)%は顔を赤らめつつ、そわそわしながら玩具を仕舞い込んだ。	PRINTFORMDW %CALLNAME:(TARGET)%は顔を赤らめつつ、そわそわしながら玩具を仕舞い込んだ。
PRINTFORMDW そう呟く%CALLNAME:(TARGET)%の顔は、明らかに何かを期待して赤くなっている…	PRINTFORMDW そう呟く%CALLNAME:(TARGET)%の顔は、明らかに何かを期待して赤くなっている…
PRINTFORMDW 丸見えの秘部を見せつける様に、%CALLNAME:(TARGET)%は足での奉仕を始めた…	PRINTFORMDW 丸見えの秘部を見せつける様に、%CALLNAME:(TARGET)%は足での奉仕を始めた…
PRINTFORMW 「こ…こらっ　聞いてるの、%CALLNAME_8_0(ARG:2)%？　早く離れなさ…い…」	PRINTFORMW 「こ…こらっ　聞いてるの、%CALLNAME_8_0(ARG:2)%？　早く離れなさ…い…」
PRINTFORMDW 愛する触手スーツを失い、%CALLNAME:(TARGET)%は酷くショックを受けている…	PRINTFORMDW 愛する触手スーツを失い、%CALLNAME:(TARGET)%は酷くショックを受けている…
PRINTFORMDL 下半身を登ってくる蟲達からの刺激に%CALLNAME:(TARGET)%はたまらず跪いた。	PRINTFORMDL 下半身を登ってくる蟲達からの刺激に%CALLNAME:(TARGET)%はたまらず跪いた。
PRINTFORM 　%CALLNAME_8_0(ARG:3)%のおっぱい…こんなに大きいんだから使わないと損よね	PRINTFORM 　%CALLNAME_8_0(ARG:3)%のおっぱい…こんなに大きいんだから使わないと損よね
PRINTFORMW 「ごめんなさい%CALLNAME_8_0(1)%…私もう…手や口じゃ我慢できそうにないの…」	PRINTFORMW 「ごめんなさい%CALLNAME_8_0(1)%…私もう…手や口じゃ我慢できそうにないの…」
PRINTFORM 「やぁ…%CALLNAME_8_0(ARG:0)%の膣内に…どんどん飲み込まれて行っちゃうぅ…	PRINTFORM 「やぁ…%CALLNAME_8_0(ARG:0)%の膣内に…どんどん飲み込まれて行っちゃうぅ…
PRINTFORMDW 部屋に蠢く触手達は華奢な身体には不釣合いな股間の剛直に絡みつき、熱い滾りをせり上げていく…	PRINTFORMDW 部屋に蠢く触手達は華奢な身体には不釣合いな股間の剛直に絡みつき、熱い滾りをせり上げていく…
PRINTFORMW 「こらっ！暴れないで…んんっ？！　だっだめ…そんなとこ入っちゃ……ふああぁぁぁッッッ！！！」	PRINTFORMW 「こらっ！暴れないで…んんっ？！　だっだめ…そんなとこ入っちゃ……ふああぁぁぁッッッ！！！」
PRINTFORMDW %CALLNAME:(TARGET)%の足元から聖なる光が次々と立ち登り敵を浄化する！！	PRINTFORMDW %CALLNAME:(TARGET)%の足元から聖なる光が次々と立ち登り敵を浄化する！！
PRINTFORMDL %CALLNAME:(TARGET)%は愛おしそうに%ARGS:1%のペニスを口に咥え、	PRINTFORMDL %CALLNAME:(TARGET)%は愛おしそうに%ARGS:1%のペニスを口に咥え、
PRINTFORMDW 激しく口を犯していた触手を前に、%CALLNAME:(TARGET)%は息を整えている…	PRINTFORMDW 激しく口を犯していた触手を前に、%CALLNAME:(TARGET)%は息を整えている…
PRINTFORMW 「…って、%CALLNAME_8_0(ARG:2)%ったら捕まってるじゃないのよっ！！！」	PRINTFORMW 「…って、%CALLNAME_8_0(ARG:2)%ったら捕まってるじゃないのよっ！！！」
PRINTFORM 　お腹の中…%CALLNAME_8_0(CFLAG:900)%の精液で…満たされちゃってる…	PRINTFORM 　お腹の中…%CALLNAME_8_0(CFLAG:900)%の精液で…満たされちゃってる…
PRINTFORMDW いつまでも続く射精感の中、%CALLNAME:(TARGET)%は、ぐったりとしている…	PRINTFORMDW いつまでも続く射精感の中、%CALLNAME:(TARGET)%は、ぐったりとしている…
PRINTFORMW 「残念です、%CALLNAME:(TARGET)%様…また今度、気が変わりましたら是非♪」	PRINTFORMW 「残念です、%CALLNAME:(TARGET)%様…また今度、気が変わりましたら是非♪」
PRINTFORMW （そんな風にお尻を突き出しちゃって…今なら…ちょっとくらいイタズラしても判らないわよね…）	PRINTFORMW （そんな風にお尻を突き出しちゃって…今なら…ちょっとくらいイタズラしても判らないわよね…）
PRINTFORM 　%CALLNAME_8_0(ARG:0)%のおまんこに…プリプリのせーえき射精しちゃうッッ	PRINTFORM 　%CALLNAME_8_0(ARG:0)%のおまんこに…プリプリのせーえき射精しちゃうッッ
PRINTFORM 　%CALLNAME_8_0(ARG:0)%の膣内…せーえき欲しいって、ずっと吸い付いてる…	PRINTFORM 　%CALLNAME_8_0(ARG:0)%の膣内…せーえき欲しいって、ずっと吸い付いてる…
PRINTFORM 　どうしたの、膣の中がピクピク震えてるわよ、%CALLNAME_8_0(ARG:0, 1)%	PRINTFORM 　どうしたの、膣の中がピクピク震えてるわよ、%CALLNAME_8_0(ARG:0, 1)%
PRINTFORM 「いいわ…%CALLNAME_8_0(ARG:0)%の膣内…良過ぎて…すぐ…イっちゃうっっっ	PRINTFORM 「いいわ…%CALLNAME_8_0(ARG:0)%の膣内…良過ぎて…すぐ…イっちゃうっっっ
PRINTFORM 　だっだめ…もうイっちゃう…お願い…一緒に…%CALLNAME_8_0(ARG:0, 1)%	PRINTFORM 　だっだめ…もうイっちゃう…お願い…一緒に…%CALLNAME_8_0(ARG:0, 1)%
PRINTFORMW 「この薬は……正直、今みたいに動き回る時にはちょっと邪魔だし、使ってみるのもいいかもね…」	PRINTFORMW 「この薬は……正直、今みたいに動き回る時にはちょっと邪魔だし、使ってみるのもいいかもね…」
PRINTFORMDW %CALLNAME:(TARGET)%は少し距離を置いて、もじもじと脚を擦り合わせている	PRINTFORMDW %CALLNAME:(TARGET)%は少し距離を置いて、もじもじと脚を擦り合わせている
PRINTFORMDW %CALLNAME:(TARGET)%は敵に擦り寄りながら穏やかな目線で見上げている…	PRINTFORMDW %CALLNAME:(TARGET)%は敵に擦り寄りながら穏やかな目線で見上げている…
PRINTFORMW 「ごめんなさい、%CALLNAME_8_0(RESULT)%！　これは…身体が勝手に…」	PRINTFORMW 「ごめんなさい、%CALLNAME_8_0(RESULT)%！　これは…身体が勝手に…」
PRINTFORM 「ねぇ%CALLNAME_8_0(RESULT, 1)%…貴女も一緒に愉しみましょう…ねっ	PRINTFORM 「ねぇ%CALLNAME_8_0(RESULT, 1)%…貴女も一緒に愉しみましょう…ねっ
PRINTFORM 「あの人が私と%CALLNAME_8_0(RESULT)%のえっちなところを見せてくれって	PRINTFORM 「あの人が私と%CALLNAME_8_0(RESULT)%のえっちなところを見せてくれって
PRINTFORMDW %CALLNAME:(TARGET)%は口から糸を引かせ、触手を涙目で睨みつけている…	PRINTFORMDW %CALLNAME:(TARGET)%は口から糸を引かせ、触手を涙目で睨みつけている…
PRINTFORM 　%CALLNAME_8_0(ARG:2)%も感じてるのね…ほら…もっと擦り合わせましょう	PRINTFORM 　%CALLNAME_8_0(ARG:2)%も感じてるのね…ほら…もっと擦り合わせましょう
PRINTFORM 「%CALLNAME:(TARGET)%様の乳首…こんなにビンビンに勃起しちゃってますよ…	PRINTFORM 「%CALLNAME:(TARGET)%様の乳首…こんなにビンビンに勃起しちゃってますよ…
PRINTFORM 「%CALLNAME:(TARGET)%様ったら…アソコからだらだら涎を垂れ流しちゃって…	PRINTFORM 「%CALLNAME:(TARGET)%様ったら…アソコからだらだら涎を垂れ流しちゃって…
PRINTFORMDW 触手スーツを傷つけられ、%CALLNAME:(TARGET)%はショックを受けている…	PRINTFORMDW 触手スーツを傷つけられ、%CALLNAME:(TARGET)%はショックを受けている…
PRINTFORMDW 子宮にたっぷり精を受け、%CALLNAME:(TARGET)%は多幸感に包まれている…	PRINTFORMDW 子宮にたっぷり精を受け、%CALLNAME:(TARGET)%は多幸感に包まれている…
PRINTFORMW 「この草…普段なら喉から手が出るほど欲しいんだけど…今は少しでも寝て体力を回復しないと」	PRINTFORMW 「この草…普段なら喉から手が出るほど欲しいんだけど…今は少しでも寝て体力を回復しないと」
PRINTFORM 　%CALLNAME:(TARGET)%様ったら、まだまだ射精し足りないって顔してますよぉ	PRINTFORM 　%CALLNAME:(TARGET)%様ったら、まだまだ射精し足りないって顔してますよぉ
PRINTFORM 　%CALLNAME:(TARGET)%様ったら白目剥いてるのに、おちんちんは射精っぱなし	PRINTFORM 　%CALLNAME:(TARGET)%様ったら白目剥いてるのに、おちんちんは射精っぱなし
PRINTFORM 「ふふっ、これはもっと%CALLNAME_8_0(ARG:0)%を犯してあげなさいって事ね	PRINTFORM 「ふふっ、これはもっと%CALLNAME_8_0(ARG:0)%を犯してあげなさいって事ね
PRINTFORMDL そう言って事切れたかの様に眠りについた%CALLNAME:(ARG:1)%の膣口からは	PRINTFORMDL そう言って事切れたかの様に眠りについた%CALLNAME:(ARG:1)%の膣口からは
PRINTFORM 　もう…待ちきれないの……早く…挿入れて…%CALLNAME_8_0(ARG:0, 1)%	PRINTFORM 　もう…待ちきれないの……早く…挿入れて…%CALLNAME_8_0(ARG:0, 1)%
PRINTFORM 　私のどろどろせーえき…%CALLNAME_8_0(ARG:0)%の子宮で受け止めてッッッ	PRINTFORM 　私のどろどろせーえき…%CALLNAME_8_0(ARG:0)%の子宮で受け止めてッッッ
PRINTFORMDL 直前に引き抜かれた%CALLNAME:(ARG:1)%のペニスは今なお熱い滾りを迸らせ	PRINTFORMDL 直前に引き抜かれた%CALLNAME:(ARG:1)%のペニスは今なお熱い滾りを迸らせ
PRINTFORMW 「……%CALLNAME_8_0(ARG:1)%…そう、化け物にやられちゃったのね……」	PRINTFORMW 「……%CALLNAME_8_0(ARG:1)%…そう、化け物にやられちゃったのね……」
PRINTFORMW 「あの…アリス？　実は……うん、何かあったら起こして。後は自分でなんとかするわ…………」	PRINTFORMW 「あの…アリス？　実は……うん、何かあったら起こして。後は自分でなんとかするわ…………」
PRINTFORMDW %CALLNAME:(TARGET)%は、かろうじて動いた指で自らの身体を慰め始める…	PRINTFORMDW %CALLNAME:(TARGET)%は、かろうじて動いた指で自らの身体を慰め始める…
PRINTFORMDL ふと起きだした%CALLNAME:(TARGET)%は、周りを見渡して安全を確認すると	PRINTFORMDL ふと起きだした%CALLNAME:(TARGET)%は、周りを見渡して安全を確認すると
PRINTFORMW 「お願い…%CALLNAME_8_0(LOCAL:0)%を解放して…代わりなら私が…」	PRINTFORMW 「お願い…%CALLNAME_8_0(LOCAL:0)%を解放して…代わりなら私が…」
PRINTFORM 「ご主人様…そろそろ精気を吸収したくありませんか？　えぇ…存分に私を召し上がって下さい…	PRINTFORM 「ご主人様…そろそろ精気を吸収したくありませんか？　えぇ…存分に私を召し上がって下さい…
PRINTFORM 「お尻の穴…こんなにヒクヒクしちゃってるの…太いの何本も挿れていいから…ずちゅずちゅって	PRINTFORM 「お尻の穴…こんなにヒクヒクしちゃってるの…太いの何本も挿れていいから…ずちゅずちゅって
PRINTFORMDW 考えとは裏腹に、%CALLNAME:(TARGET)%は敵の方へと歩みを進めていく…	PRINTFORMDW 考えとは裏腹に、%CALLNAME:(TARGET)%は敵の方へと歩みを進めていく…
PRINTFORMDW 顔を背けたいが%CALLNAME:(TARGET)%の身体はそれすら許してくれない…	PRINTFORMDW 顔を背けたいが%CALLNAME:(TARGET)%の身体はそれすら許してくれない…
PRINTFORMDW %CALLNAME:(TARGET)%は半ば諦め顔で、小さい手での奉仕を続けている…	PRINTFORMDW %CALLNAME:(TARGET)%は半ば諦め顔で、小さい手での奉仕を続けている…
PRINTFORMDW %CALLNAME:(TARGET)%は触手を軽く握りゆっくりと上下に動かしている…	PRINTFORMDW %CALLNAME:(TARGET)%は触手を軽く握りゆっくりと上下に動かしている…
PRINTFORMDW %CALLNAME:(TARGET)%はその豊かな膨らみで、触手への奉仕をしている…	PRINTFORMDW %CALLNAME:(TARGET)%はその豊かな膨らみで、触手への奉仕をしている…
PRINTFORM 「…あのね、%CALLNAME_8_0(ARG:2)%。こういう事は…後でゆっくりと……	PRINTFORM 「…あのね、%CALLNAME_8_0(ARG:2)%。こういう事は…後でゆっくりと……
PRINTFORMDL %CALLNAME:(TARGET)%の身体に不釣合いなほど醜悪に反り返った剛直が、	PRINTFORMDL %CALLNAME:(TARGET)%の身体に不釣合いなほど醜悪に反り返った剛直が、
PRINTFORMW 「はぁ…はぁ…お腹の中…たぽたぽになるまで射精されて…赤ちゃん出来ちゃってるかな……」	PRINTFORMW 「はぁ…はぁ…お腹の中…たぽたぽになるまで射精されて…赤ちゃん出来ちゃってるかな……」
PRINTFORMDL 群がる小さな触手を意にも介していなかった%CALLNAME:(TARGET)%だが、	PRINTFORMDL 群がる小さな触手を意にも介していなかった%CALLNAME:(TARGET)%だが、
PRINTFORMDW ふと下半身に目をやると、そこには服のありとあらゆる隙間から蠢く触手が滑り込んでいた…	PRINTFORMDW ふと下半身に目をやると、そこには服のありとあらゆる隙間から蠢く触手が滑り込んでいた…
PRINTFORMDW 床から脚に絡み登り下半身を覆う小さな触手の群れに、快感の波は徐々に高くなっていった…	PRINTFORMDW 床から脚に絡み登り下半身を覆う小さな触手の群れに、快感の波は徐々に高くなっていった…
PRINTFORMW 「この場所は…%CALLNAME:(TARGET)%様！　ちょっと付いて来て下さい！」	PRINTFORMW 「この場所は…%CALLNAME:(TARGET)%様！　ちょっと付いて来て下さい！」
PRINTFORMDW %CALLNAME:(TARGET)%は身動きの取れないまま、露出した尻を犯される…	PRINTFORMDW %CALLNAME:(TARGET)%は身動きの取れないまま、露出した尻を犯される…
PRINTFORMW 「せーえき…射精したくて射精したくて仕方ないんだけど…お願いを…聞いて貰えるかしら？」	PRINTFORMW 「せーえき…射精したくて射精したくて仕方ないんだけど…お願いを…聞いて貰えるかしら？」
PRINTFORM 　%CALLNAME_8_0(ARG:3,1)%…貴女上手すぎるのよ…こんなんじゃすぐ…	PRINTFORM 　%CALLNAME_8_0(ARG:3,1)%…貴女上手すぎるのよ…こんなんじゃすぐ…
PRINTFORM 　%CALLNAME_8_0(ARG:3)%のお口を犯してると思うと…ゾクゾクしちゃうっ	PRINTFORM 　%CALLNAME_8_0(ARG:3)%のお口を犯してると思うと…ゾクゾクしちゃうっ
PRINTFORMDW そう言いながら%ARGS:1%は%ARGS:0%の触手を掴み、激しく腰を打ち付ける！	PRINTFORMDW そう言いながら%ARGS:1%は%ARGS:0%の触手を掴み、激しく腰を打ち付ける！
PRINTFORM 「%CALLNAME_8_0(ARG:2)%ったら…股間にそんな凶悪なモノを付けてるのね	PRINTFORM 「%CALLNAME_8_0(ARG:2)%ったら…股間にそんな凶悪なモノを付けてるのね
PRINTFORMW 「あら…%CALLNAME_8_0(ARG:0)%の服……これは…たしか、こうして…」	PRINTFORMW 「あら…%CALLNAME_8_0(ARG:0)%の服……これは…たしか、こうして…」
PRINTFORM 　射精てるぅ……子宮の中…%CALLNAME_8_0(ARG:0)%ので満たされてる……	PRINTFORM 　射精てるぅ……子宮の中…%CALLNAME_8_0(ARG:0)%ので満たされてる……
PRINTFORM 　%CALLNAME_8_0(ARG:0)%の膣内が…せーえき欲しいって吸い付いてくる…	PRINTFORM 　%CALLNAME_8_0(ARG:0)%の膣内が…せーえき欲しいって吸い付いてくる…
PRINTFORMDW そう言って%CALLNAME:(ARG:1)%は微笑みながら下腹部を優しく撫で回した	PRINTFORMDW そう言って%CALLNAME:(ARG:1)%は微笑みながら下腹部を優しく撫で回した
PRINTFORM 　%CALLNAME_8_0(ARG:0)%の…大きい…受け入れるだけで声が漏れちゃう…	PRINTFORM 　%CALLNAME_8_0(ARG:0)%の…大きい…受け入れるだけで声が漏れちゃう…
PRINTFORMW 「やった……これで元気になれるわよ、%CALLNAME_8_0(LOCAL:0)%！」	PRINTFORMW 「やった……これで元気になれるわよ、%CALLNAME_8_0(LOCAL:0)%！」
PRINTFORMW 「ちょっといいフラン？　お願いがあるんだけど…そう、起こしてくれればいいから…………」	PRINTFORMW 「ちょっといいフラン？　お願いがあるんだけど…そう、起こしてくれればいいから…………」
PRINTFORMDW すでに思考がまとまらない状態で、%ARGS:0%は、ただただ悦びの声を発している…	PRINTFORMDW すでに思考がまとまらない状態で、%ARGS:0%は、ただただ悦びの声を発している…
PRINTFORMDW 辺り一面をまぶしい光が覆い尽くし、その強烈なエネルギーの中に敵を飲み込んでいく！！	PRINTFORMDW 辺り一面をまぶしい光が覆い尽くし、その強烈なエネルギーの中に敵を飲み込んでいく！！
PRINTFORMW 「ぐっ…………んんっ…………はぁはぁ…私にペンを折る力なんてあるわけないじゃない…」	PRINTFORMW 「ぐっ…………んんっ…………はぁはぁ…私にペンを折る力なんてあるわけないじゃない…」
PRINTFORMDW %CALLNAME:(TARGET)%は口内での奉仕から、舌での奉仕に切り替えた。	PRINTFORMDW %CALLNAME:(TARGET)%は口内での奉仕から、舌での奉仕に切り替えた。
PRINTFORM 　%CALLNAME:(TARGET)%様ったら物欲しそうに、おっぱい震わせちゃって…	PRINTFORM 　%CALLNAME:(TARGET)%様ったら物欲しそうに、おっぱい震わせちゃって…
PRINTFORML 「くっ…傷…付いちゃった？　ごめんなさい、私がしっかり避けられなかったばっかりに…」	PRINTFORML 「くっ…傷…付いちゃった？　ごめんなさい、私がしっかり避けられなかったばっかりに…」
PRINTFORMDW ゆっくりとした動作で%CALLNAME:(TARGET)%は抽挿を繰り返している…	PRINTFORMDW ゆっくりとした動作で%CALLNAME:(TARGET)%は抽挿を繰り返している…
PRINTFORMW 「うぅぅ……溢れるほど膣内射精されて…こんなの…絶対赤ちゃん出来ちゃうじゃない……」	PRINTFORMW 「うぅぅ……溢れるほど膣内射精されて…こんなの…絶対赤ちゃん出来ちゃうじゃない……」
PRINTFORMDW %CALLNAME:(TARGET)%は顔を赤らめ、目の前の敵を熱く見つめ返した…	PRINTFORMDW %CALLNAME:(TARGET)%は顔を赤らめ、目の前の敵を熱く見つめ返した…
PRINTFORMW 「お生憎さまね、まずは服をどうにかして私の動きを止めようって魂胆だったんだろうけど」	PRINTFORMW 「お生憎さまね、まずは服をどうにかして私の動きを止めようって魂胆だったんだろうけど」
PRINTFORMDW %CALLNAME:(TARGET)%はついに一瞬脚の力が抜け膝をついてしまった。	PRINTFORMDW %CALLNAME:(TARGET)%はついに一瞬脚の力が抜け膝をついてしまった。
PRINTFORM 　%CALLNAME_8_0(ARG:3)%の顔を見てたら…ムラムラしてきちゃったのよ	PRINTFORM 　%CALLNAME_8_0(ARG:3)%の顔を見てたら…ムラムラしてきちゃったのよ
PRINTFORM 「あら、%CALLNAME_8_0(ARG:2)%…どうしたの、その股間の素敵なモノは	PRINTFORM 「あら、%CALLNAME_8_0(ARG:2)%…どうしたの、その股間の素敵なモノは
PRINTFORMW 「ちょ、ちょっと、何ニヤニヤしてるのよ%CALLNAME_8_0(ARG:2)%！」	PRINTFORMW 「ちょ、ちょっと、何ニヤニヤしてるのよ%CALLNAME_8_0(ARG:2)%！」
PRINTFORMW 「もう、暴れるから服がボロボロじゃない…じゃあ大人しくなったみたいだし…いいわよね」	PRINTFORMW 「もう、暴れるから服がボロボロじゃない…じゃあ大人しくなったみたいだし…いいわよね」
PRINTFORM 　%CALLNAME_8_0(ARG:0)%の膣内にたっぷり射精したのが溢れてきてる…	PRINTFORM 　%CALLNAME_8_0(ARG:0)%の膣内にたっぷり射精したのが溢れてきてる…
PRINTFORM 「きっと%CALLNAME_8_0(ARG:0)%が受精するまで注ぎ込めって事なんだわ	PRINTFORM 「きっと%CALLNAME_8_0(ARG:0)%が受精するまで注ぎ込めって事なんだわ
PRINTFORM 「これは…もっと%CALLNAME_8_0(ARG:0)%を愛してあげなさいって事よね	PRINTFORM 「これは…もっと%CALLNAME_8_0(ARG:0)%を愛してあげなさいって事よね
PRINTFORMDW %CALLNAME:(ARG:1)%は、そう言って顔を赤らめながらもじもじしている	PRINTFORMDW %CALLNAME:(ARG:1)%は、そう言って顔を赤らめながらもじもじしている
PRINTFORMDL 普段は他人の話などロクに聞かない事も多い%CALLNAME:(TARGET)%だが	PRINTFORMDL 普段は他人の話などロクに聞かない事も多い%CALLNAME:(TARGET)%だが
PRINTFORMDL 触手による強制自慰から、ようやく解放された%CALLNAME:(TARGET)%は	PRINTFORMDL 触手による強制自慰から、ようやく解放された%CALLNAME:(TARGET)%は
PRINTFORMW 「大丈夫？　%CALLNAME_8_0(LOCAL:0)%っ！　今助けるからっ！」	PRINTFORMW 「大丈夫？　%CALLNAME_8_0(LOCAL:0)%っ！　今助けるからっ！」
PRINTFORMDW そう言って%CALLNAME:(TARGET)%は一際大きい炎の塊を撃ち出した。	PRINTFORMDW そう言って%CALLNAME:(TARGET)%は一際大きい炎の塊を撃ち出した。
PRINTFORM 「普段は重いだけの特大おっぱい…せめてこういう時に…ほら…思い切り絡み付いてぇッッッ	PRINTFORM 「普段は重いだけの特大おっぱい…せめてこういう時に…ほら…思い切り絡み付いてぇッッッ
PRINTFORMDW %CALLNAME:(TARGET)%は腰をくねらせながら、敵に近づいていった…	PRINTFORMDW %CALLNAME:(TARGET)%は腰をくねらせながら、敵に近づいていった…
PRINTFORMDW %CALLNAME:(TARGET)%は両手で握っていた触手をぽいっと放り投げた	PRINTFORMDW %CALLNAME:(TARGET)%は両手で握っていた触手をぽいっと放り投げた
PRINTFORMDW %CALLNAME:(TARGET)%は身体を大きく使って、胸での奉仕を続ける…	PRINTFORMDW %CALLNAME:(TARGET)%は身体を大きく使って、胸での奉仕を続ける…
PRINTFORMDL 触手で口を塞がれたまま呼吸もままならない%CALLNAME:(TARGET)%は	PRINTFORMDL 触手で口を塞がれたまま呼吸もままならない%CALLNAME:(TARGET)%は
PRINTFORM 　…%CALLNAME_8_0(CFLAG:900)%との子供…孕んじゃうぅっっッッ	PRINTFORM 　…%CALLNAME_8_0(CFLAG:900)%との子供…孕んじゃうぅっっッッ
PRINTFORML 「あぁっ…！！　ひどい…せっかくお気に入りの服だったのに…あの子が居ないと…私…」	PRINTFORML 「あぁっ…！！　ひどい…せっかくお気に入りの服だったのに…あの子が居ないと…私…」
PRINTFORMDW %CALLNAME:(TARGET)%は落ちてきた石が頭にぶつかってのびている…	PRINTFORMDW %CALLNAME:(TARGET)%は落ちてきた石が頭にぶつかってのびている…
PRINTFORM 「ねぇ…%CALLNAME_8_0(RESULT)%……私…身体が熱くて眠れないの…	PRINTFORM 「ねぇ…%CALLNAME_8_0(RESULT)%……私…身体が熱くて眠れないの…
PRINTFORM 「おちんちんの先から我慢汁が溢れてますよ…%CALLNAME:(TARGET)%さま	PRINTFORM 「おちんちんの先から我慢汁が溢れてますよ…%CALLNAME:(TARGET)%さま
PRINTFORMDW そう言いながら%ARGS:1%は%ARGS:0%の豊満な胸にペニスを突き入れる！	PRINTFORMDW そう言いながら%ARGS:1%は%ARGS:0%の豊満な胸にペニスを突き入れる！
PRINTFORMDW そう言いながら%ARGS:1%は%ARGS:0%の胸に激しくペニスを擦り付ける！	PRINTFORMDW そう言いながら%ARGS:1%は%ARGS:0%の胸に激しくペニスを擦り付ける！
PRINTFORMDW %CALLNAME:(TARGET)%は解っていながら、とぼけた様に喋りかけた…	PRINTFORMDW %CALLNAME:(TARGET)%は解っていながら、とぼけた様に喋りかけた…
PRINTFORM 「だから…私のもお願いするわ。　ね、%CALLNAME_8_0(ARG:2,1)%…	PRINTFORM 「だから…私のもお願いするわ。　ね、%CALLNAME_8_0(ARG:2,1)%…
PRINTFORMW 「ほら、出しなさい、%CALLNAME_8_0(ARG:2)%。　足ね、解ったわ」	PRINTFORMW 「ほら、出しなさい、%CALLNAME_8_0(ARG:2)%。　足ね、解ったわ」
PRINTFORMW 「やめなさい%CALLNAME_8_0(ARG:2)%！　それ以上近づいたら……」	PRINTFORMW 「やめなさい%CALLNAME_8_0(ARG:2)%！　それ以上近づいたら……」
PRINTFORM 　まだ…%CALLNAME_8_0(ARG:0)%の膣内に、びゅーびゅー射精してる…	PRINTFORM 　まだ…%CALLNAME_8_0(ARG:0)%の膣内に、びゅーびゅー射精してる…
PRINTFORMDL ようやく触手スーツによる拘束を振りほどいた%CALLNAME:(ARG:1)%は	PRINTFORMDL ようやく触手スーツによる拘束を振りほどいた%CALLNAME:(ARG:1)%は
PRINTFORMW 　ただでさえ%CALLNAME_8_0(ARG:0)%にナカを愛されているのに…」	PRINTFORMW 　ただでさえ%CALLNAME_8_0(ARG:0)%にナカを愛されているのに…」
PRINTFORM 「もしかして……%CALLNAME_8_0(ARG:0)%の精子が子宮の中で……ふふ	PRINTFORM 「もしかして……%CALLNAME_8_0(ARG:0)%の精子が子宮の中で……ふふ
PRINTFORMW 「じゃ、これからよろしく。こんな場所だもの、個々の能力を活かして力を合わせないと」	PRINTFORMW 「じゃ、これからよろしく。こんな場所だもの、個々の能力を活かして力を合わせないと」
PRINTFORMDL 明らかに自慰の味が忘れられなくなっている%CALLNAME:(TARGET)%は	PRINTFORMDL 明らかに自慰の味が忘れられなくなっている%CALLNAME:(TARGET)%は
PRINTFORMDW %CALLNAME:(TARGET)%は慣れた手つきで自ら身体をまさぐり始めた…	PRINTFORMDW %CALLNAME:(TARGET)%は慣れた手つきで自ら身体をまさぐり始めた…
PRINTFORMDW 改めて下腹部を確認すると、わずかだがそこには新たな命が息づく膨らみが見て取れた…	PRINTFORMDW 改めて下腹部を確認すると、わずかだがそこには新たな命が息づく膨らみが見て取れた…
PRINTFORMW 「はぁ…はぁ……今ので…おちんちん膨れ上がっちゃって…元気になっちゃったみたい…」	PRINTFORMW 「はぁ…はぁ……今ので…おちんちん膨れ上がっちゃって…元気になっちゃったみたい…」
PRINTFORMW 「さっさと%CALLNAME_8_0(LOCAL:0)%を解放しなさいっ！！！」	PRINTFORMW 「さっさと%CALLNAME_8_0(LOCAL:0)%を解放しなさいっ！！！」
PRINTFORMW 「ちょっと我慢して待ってなさい…%CALLNAME_8_0(LOCAL:0)%」	PRINTFORMW 「ちょっと我慢して待ってなさい…%CALLNAME_8_0(LOCAL:0)%」
PRINTFORMW 「この股間のモノ…あなた達の一部でしょ…ビンビンになってるのをなんとかしてよ…」	PRINTFORMW 「この股間のモノ…あなた達の一部でしょ…ビンビンになってるのをなんとかしてよ…」
PRINTFORM 　%CALLNAME_8_0(ARG:2)%も感じてるのね…すっごく締め付けてくる	PRINTFORM 　%CALLNAME_8_0(ARG:2)%も感じてるのね…すっごく締め付けてくる
PRINTFORMW 「ふっ、グレイズすれば…この触手で出来たスーツだけにダメージを与えられるはず…」	PRINTFORMW 「ふっ、グレイズすれば…この触手で出来たスーツだけにダメージを与えられるはず…」
PRINTFORM 「それでは…吸い尽くさせて下さいね、%CALLNAME:(TARGET)%様の精力	PRINTFORM 「それでは…吸い尽くさせて下さいね、%CALLNAME:(TARGET)%様の精力
PRINTFORM 「はぁ…私の赤ちゃんの部屋…せーえきでいっぱい……これ…ぜったい受精してるわよね…	PRINTFORM 「はぁ…私の赤ちゃんの部屋…せーえきでいっぱい……これ…ぜったい受精してるわよね…
PRINTFORMW 「ごめんなさい、ご主人様。何か嫌な予感がするの…行ってはいけない場所みたいな…」	PRINTFORMW 「ごめんなさい、ご主人様。何か嫌な予感がするの…行ってはいけない場所みたいな…」
PRINTFORMW 「はーーーっ　はーーーっ　まったく…油断していたら味方にも襲われるの、ここは…」	PRINTFORMW 「はーーーっ　はーーーっ　まったく…油断していたら味方にも襲われるの、ここは…」
PRINTFORMW 　%CALLNAME:(TARGET)%様…いいんですよ？　もう限界ですよね…」	PRINTFORMW 　%CALLNAME:(TARGET)%様…いいんですよ？　もう限界ですよね…」
PRINTFORMW 　こんなにいっぱい射精せるなんて流石%CALLNAME:(TARGET)%様♪」	PRINTFORMW 　こんなにいっぱい射精せるなんて流石%CALLNAME:(TARGET)%様♪」
PRINTFORM 　あっついのを…%CALLNAME_8_0(ARG:3)%の子宮に注ぎ込むわよッッ	PRINTFORM 　あっついのを…%CALLNAME_8_0(ARG:3)%の子宮に注ぎ込むわよッッ
PRINTFORM 「ふふ…どうしたの%CALLNAME_8_0(1)%？　私の股間を見つめちゃって…	PRINTFORM 「ふふ…どうしたの%CALLNAME_8_0(1)%？　私の股間を見つめちゃって…
PRINTFORMW 「二度と私%TACHI()%に襲って来ない様に…悪いけど身体で理解して貰うわよ」	PRINTFORMW 「二度と私%TACHI()%に襲って来ない様に…悪いけど身体で理解して貰うわよ」
PRINTFORMW 「どうしたの…もじもじしちゃって？　くすっ、解ってるわよ。その股間のモノよね…」	PRINTFORMW 「どうしたの…もじもじしちゃって？　くすっ、解ってるわよ。その股間のモノよね…」
PRINTFORMDW 体液まみれの身体や床を気にする余裕も無く、そのまま崩れ落ちる様に眠りについた…	PRINTFORMDW 体液まみれの身体や床を気にする余裕も無く、そのまま崩れ落ちる様に眠りについた…
PRINTFORM 「ふふっ…%CALLNAME_8_0(ARG:0)%…凄く気持ち良いって顔してる…	PRINTFORM 「ふふっ…%CALLNAME_8_0(ARG:0)%…凄く気持ち良いって顔してる…
PRINTFORMDL ゆっくりとスカートをたくし上げた%CALLNAME:(ARG:1)%のそこには	PRINTFORMDL ゆっくりとスカートをたくし上げた%CALLNAME:(ARG:1)%のそこには
PRINTFORMW 「はぁ…気持ち良さそうにしちゃって…膣内で出していいとは一言も言ってないわよ…」	PRINTFORMW 「はぁ…気持ち良さそうにしちゃって…膣内で出していいとは一言も言ってないわよ…」
PRINTFORMW 「魔理沙。私ちょっと眠気が…いいでしょ、いつも本を貸してあげてるんだし…………」	PRINTFORMW 「魔理沙。私ちょっと眠気が…いいでしょ、いつも本を貸してあげてるんだし…………」
PRINTFORMW 「%CALLNAME_8_0(LOCAL:0)%の霊力がどんどん……だめ……」	PRINTFORMW 「%CALLNAME_8_0(LOCAL:0)%の霊力がどんどん……だめ……」
PRINTFORMW 「私の%CALLNAME_8_0(LOCAL:0)%を…離しなさいッッ！！！」	PRINTFORMW 「私の%CALLNAME_8_0(LOCAL:0)%を…離しなさいッッ！！！」
PRINTFORM 「ん……%CALLNAME_8_0(CFLAG:900, 1, ARGS:1)%	PRINTFORM 「ん……%CALLNAME_8_0(CFLAG:900, 1, ARGS:1)%
PRINTFORM 「ふふ…ここはダメよ…もう少し下…ここをかき回されると…もっと気持ち良くなれるの	PRINTFORM 「ふふ…ここはダメよ…もう少し下…ここをかき回されると…もっと気持ち良くなれるの
PRINTFORM 　ダメよ…ここは……ぐちゅぐちゅにかき回されちゃうと…私すぐイっちゃうんだから…	PRINTFORM 　ダメよ…ここは……ぐちゅぐちゅにかき回されちゃうと…私すぐイっちゃうんだから…
PRINTFORMW 「なんだか周りが騒がしいわね…貴方とこうしてゆっくり本を読んでいるというのに」	PRINTFORMW 「なんだか周りが騒がしいわね…貴方とこうしてゆっくり本を読んでいるというのに」
PRINTFORMW 「やっ！　お願いっ！　やめっ…んぷっ！？　んっ…んんんんぅぅぅ～～～…………」	PRINTFORMW 「やっ！　お願いっ！　やめっ…んぷっ！？　んっ…んんんんぅぅぅ～～～…………」
PRINTFORMW 　%CALLNAME_8_0(CFLAG:900)%……おっぱい…好きなの？」	PRINTFORMW 　%CALLNAME_8_0(CFLAG:900)%……おっぱい…好きなの？」
PRINTFORMW 「うぅ…お腹の中に赤ちゃん居るのに…どっぷりせーえき射精されて悦んじゃった…」	PRINTFORMW 「うぅ…お腹の中に赤ちゃん居るのに…どっぷりせーえき射精されて悦んじゃった…」
PRINTFORMDW と言う%CALLNAME:(TARGET)%だが、どこか少し寂しそうだった…	PRINTFORMDW と言う%CALLNAME:(TARGET)%だが、どこか少し寂しそうだった…
PRINTFORMDL %SAVESTR:(LOCAL:0)%にガッチリと拘束されているその隙間から	PRINTFORMDL %SAVESTR:(LOCAL:0)%にガッチリと拘束されているその隙間から
PRINTFORMDW ここまで涎を垂らしながら耐えていた男根も、ついにその時を迎えようとしていた…	PRINTFORMDW ここまで涎を垂らしながら耐えていた男根も、ついにその時を迎えようとしていた…
PRINTFORMW 「後ろに出口らしきものが…とはいえ、そう簡単に通してくれそうにもないわね……」	PRINTFORMW 「後ろに出口らしきものが…とはいえ、そう簡単に通してくれそうにもないわね……」
PRINTFORM 「%CALLNAME:(TARGET)%様…隠したって判りますよ♪　淫魔の私には	PRINTFORM 「%CALLNAME:(TARGET)%様…隠したって判りますよ♪　淫魔の私には
PRINTFORM 「ほら…もうすぐ貴女に気持ち良くしてもらえるって、おちんぽビクビク喜んじゃってる	PRINTFORM 「ほら…もうすぐ貴女に気持ち良くしてもらえるって、おちんぽビクビク喜んじゃってる
PRINTFORM 「眠りながらでいいから聞いて。私のアソコ…こんなぶっといおちんぽ生えちゃってるの	PRINTFORM 「眠りながらでいいから聞いて。私のアソコ…こんなぶっといおちんぽ生えちゃってるの
PRINTFORM 　%CALLNAME_8_0(ARG:3)%の膣内…きゅうきゅう締め上げてくるっ	PRINTFORM 　%CALLNAME_8_0(ARG:3)%の膣内…きゅうきゅう締め上げてくるっ
PRINTFORMDW そう言いながら%ARGS:1%は%ARGS:0%のヴァギナを激しく突き込む！	PRINTFORMDW そう言いながら%ARGS:1%は%ARGS:0%のヴァギナを激しく突き込む！
PRINTFORMW 「%CALLNAME_8_0(1)%がしゃぶってくれたら…きっと鎮まると思う」	PRINTFORMW 「%CALLNAME_8_0(1)%がしゃぶってくれたら…きっと鎮まると思う」
PRINTFORMW 「あら、%CALLNAME_8_0(1)%が処理してくれるの。じゃあ、お願い」	PRINTFORMW 「あら、%CALLNAME_8_0(1)%が処理してくれるの。じゃあ、お願い」
PRINTFORM 「ほら…私のおちんぽ…誰かにズポズポ挿入れたくてガチガチにそそり勃っちゃってるの	PRINTFORM 「ほら…私のおちんぽ…誰かにズポズポ挿入れたくてガチガチにそそり勃っちゃってるの
PRINTFORMW 「…ぇ？　服が…絡み付いて…や…嫌ぁ…これ以上続けたら…本当に妊娠しちゃう…」	PRINTFORMW 「…ぇ？　服が…絡み付いて…や…嫌ぁ…これ以上続けたら…本当に妊娠しちゃう…」
PRINTFORM 　んはぁ…%CALLNAME_8_0(ARG:0)%のが…私の膣内を押し広げて…	PRINTFORM 　んはぁ…%CALLNAME_8_0(ARG:0)%のが…私の膣内を押し広げて…
PRINTFORM 　%CALLNAME_8_0(ARG:0)%の子宮に…たっぷり注いであげるわっっ	PRINTFORM 　%CALLNAME_8_0(ARG:0)%の子宮に…たっぷり注いであげるわっっ
PRINTFORM 「そう…そういう事ね……頑張ったわね、%CALLNAME_8_0(ARG:0)%	PRINTFORM 「そう…そういう事ね……頑張ったわね、%CALLNAME_8_0(ARG:0)%
PRINTFORM 　ほら、まだ止めちゃダメって、%CALLNAME_8_0(ARG:0, 1)%…	PRINTFORM 　ほら、まだ止めちゃダメって、%CALLNAME_8_0(ARG:0, 1)%…
PRINTFORMDL 下着姿の%CALLNAME:(ARG:1)%のショーツに目をやると、そこには	PRINTFORMDL 下着姿の%CALLNAME:(ARG:1)%のショーツに目をやると、そこには
PRINTFORMDL 一糸纏わぬ%CALLNAME:(ARG:1)%の下腹部に目をやると、そこには	PRINTFORMDL 一糸纏わぬ%CALLNAME:(ARG:1)%の下腹部に目をやると、そこには
PRINTFORMW 　膣内で…%CALLNAME_8_0(ARG:0)%のがトクトク言ってる……」	PRINTFORMW 　膣内で…%CALLNAME_8_0(ARG:0)%のがトクトク言ってる……」
PRINTFORMW 「……%CALLNAME_8_0(ARG:1)%？　大丈…夫、ではなさそうね」	PRINTFORMW 「……%CALLNAME_8_0(ARG:1)%？　大丈…夫、ではなさそうね」
PRINTFORMDW 周囲の者達は何が起こったかも解らず、とりあえず一定の距離を空けて見守っている	PRINTFORMDW 周囲の者達は何が起こったかも解らず、とりあえず一定の距離を空けて見守っている
PRINTFORMDW %CALLNAME:(TARGET)%は無意識に自らの手を秘部に導いていた…	PRINTFORMDW %CALLNAME:(TARGET)%は無意識に自らの手を秘部に導いていた…
PRINTFORMW 「あ、お礼が後になってしまったけれど、どうもありがとう。じゃあ私は行くわね。」	PRINTFORMW 「あ、お礼が後になってしまったけれど、どうもありがとう。じゃあ私は行くわね。」
PRINTFORMW 「やだ…おっぱいのとこのスライム…私の出したミルクと混ざって白みがかって……」	PRINTFORMW 「やだ…おっぱいのとこのスライム…私の出したミルクと混ざって白みがかって……」
PRINTFORMW 「もう貴女の好きにして……自分に抱かれるというのもある意味貴重よね、ふふっ」	PRINTFORMW 「もう貴女の好きにして……自分に抱かれるというのもある意味貴重よね、ふふっ」
PRINTFORM 　%CALLNAME_8_0(CFLAG:900, 1, ARGS:1)%っっ	PRINTFORM 　%CALLNAME_8_0(CFLAG:900, 1, ARGS:1)%っっ
PRINTFORM 「だ…だめ…ここだけは…他のところは…いくらでも気持ち良くしてくれていいからぁ	PRINTFORM 「だ…だめ…ここだけは…他のところは…いくらでも気持ち良くしてくれていいからぁ
PRINTFORMDW 敵に身体を預け、%CALLNAME:(TARGET)%は静かに目を閉じた…	PRINTFORMDW 敵に身体を預け、%CALLNAME:(TARGET)%は静かに目を閉じた…
PRINTFORMDW %CALLNAME:(TARGET)%は敵に対して、さも当然の様に命令した	PRINTFORMDW %CALLNAME:(TARGET)%は敵に対して、さも当然の様に命令した
PRINTFORMW 「さて…シャワーでも浴びようかしら。なんだか体がぬるぬるしてる気がするし…」	PRINTFORMW 「さて…シャワーでも浴びようかしら。なんだか体がぬるぬるしてる気がするし…」
PRINTFORMDW %CALLNAME:(TARGET)%は触手に対して甘い口づけを繰り返す…	PRINTFORMDW %CALLNAME:(TARGET)%は触手に対して甘い口づけを繰り返す…
PRINTFORM 　そんなとこ…ダメ…だったらぁ…%CALLNAME_8_0(ARG:2,1)%	PRINTFORM 　そんなとこ…ダメ…だったらぁ…%CALLNAME_8_0(ARG:2,1)%
PRINTFORMW 「なっ…？！　たとえ下着姿だからって、私は別に動きが鈍くなったりしないわよ」	PRINTFORMW 「なっ…？！　たとえ下着姿だからって、私は別に動きが鈍くなったりしないわよ」
PRINTFORM 「それで…せーえき注ぎ込んで……私の奥…子宮の中が、たぷたぷに満たされるほど…	PRINTFORM 「それで…せーえき注ぎ込んで……私の奥…子宮の中が、たぷたぷに満たされるほど…
PRINTFORMW 「あぁ…生まれたままの姿に…やだ…ぐしょぐしょに濡れてるとこ…見ないで……」	PRINTFORMW 「あぁ…生まれたままの姿に…やだ…ぐしょぐしょに濡れてるとこ…見ないで……」
PRINTFORMDW と言う%CALLNAME:(TARGET)%は、どことなく残念そうだった…	PRINTFORMDW と言う%CALLNAME:(TARGET)%は、どことなく残念そうだった…
PRINTFORMW 「吸血鬼だし、しばらくは耐えられるでしょ？　体勢を立て直したらすぐ来るわ…」	PRINTFORMW 「吸血鬼だし、しばらくは耐えられるでしょ？　体勢を立て直したらすぐ来るわ…」
PRINTFORM 　ほら…%CALLNAME:(TARGET)%様の子宮が…私の子種でいっぱい…	PRINTFORM 　ほら…%CALLNAME:(TARGET)%様の子宮が…私の子種でいっぱい…
PRINTFORMDW %CALLNAME:(TARGET)%は涙を浮かべながら嬉しそうに微笑んだ	PRINTFORMDW %CALLNAME:(TARGET)%は涙を浮かべながら嬉しそうに微笑んだ
PRINTFORMW 「…っ？！　この種のスライムなら害はないわね…どうせ服も着てないのだし……」	PRINTFORMW 「…っ？！　この種のスライムなら害はないわね…どうせ服も着てないのだし……」
PRINTFORMDL %CALLNAME:(TARGET)%を襲ったスライムは少し離れた場所で、	PRINTFORMDL %CALLNAME:(TARGET)%を襲ったスライムは少し離れた場所で、
PRINTFORMW 「…あら？　あの忌々しいスーツが…そう、あのスライムもたまには役に立つのね」	PRINTFORMW 「…あら？　あの忌々しいスーツが…そう、あのスライムもたまには役に立つのね」
PRINTFORMW 「いや、ちょっ…服って別にそういうのが欲しかったわけじゃ…いやぁぁぁぁ……」	PRINTFORMW 「いや、ちょっ…服って別にそういうのが欲しかったわけじゃ…いやぁぁぁぁ……」
PRINTFORM 「早く…私の膣内に熱いせーえき…びゅくびゅく～～～って、ぶちまけちゃって下さい	PRINTFORM 「早く…私の膣内に熱いせーえき…びゅくびゅく～～～って、ぶちまけちゃって下さい
PRINTFORMW 「いい？　%CALLNAME_8_0(ARG:3)%、今から私の言う事を…」	PRINTFORMW 「いい？　%CALLNAME_8_0(ARG:3)%、今から私の言う事を…」
PRINTFORM 「こうやって四つんばいでお尻を犯されてたら…自分がいかに弱い存在か解るでしょっ	PRINTFORM 「こうやって四つんばいでお尻を犯されてたら…自分がいかに弱い存在か解るでしょっ
PRINTFORM 　%CALLNAME_8_0(ARG:0)%の子宮にどっぷり種付けしちゃった…	PRINTFORM 　%CALLNAME_8_0(ARG:0)%の子宮にどっぷり種付けしちゃった…
PRINTFORM 「そう…そういう事ね……おめでとう、%CALLNAME_8_0(ARG:0)%	PRINTFORM 「そう…そういう事ね……おめでとう、%CALLNAME_8_0(ARG:0)%
PRINTFORM 「やめ…てっ…そんな全身…愛撫されたら…私の子宮…受け入れちゃうぅ…んっあぁっ	PRINTFORM 「やめ…てっ…そんな全身…愛撫されたら…私の子宮…受け入れちゃうぅ…んっあぁっ
PRINTFORMW 　これ以上は…%CALLNAME_8_0(ARG:0)%も疲れちゃうわよね」	PRINTFORMW 　これ以上は…%CALLNAME_8_0(ARG:0)%も疲れちゃうわよね」
PRINTFORMDW 本来あるわけのない、ガチガチに勃起した男のシンボルがビクビクと戦慄いていた	PRINTFORMDW 本来あるわけのない、ガチガチに勃起した男のシンボルがビクビクと戦慄いていた
PRINTFORMDW %CALLNAME:(ARG:0)%の子宮内への注入を断続的に繰り返した…	PRINTFORMDW %CALLNAME:(ARG:0)%の子宮内への注入を断続的に繰り返した…
PRINTFORMW 　%CALLNAME_8_0(ARG:0)%のおちんちん…すごく膨らんで…」	PRINTFORMW 　%CALLNAME_8_0(ARG:0)%のおちんちん…すごく膨らんで…」
PRINTFORMW 「……はぁ。まぁここの魔物の強さじゃ仕方ないか。ほら、しっかりしなさい……」	PRINTFORMW 「……はぁ。まぁここの魔物の強さじゃ仕方ないか。ほら、しっかりしなさい……」
PRINTFORMW 「返事がない、ただの屍のようだ……って冗談はさておき、まだ息はあるみたいね」	PRINTFORMW 「返事がない、ただの屍のようだ……って冗談はさておき、まだ息はあるみたいね」
PRINTFORMW 「魔力が吸われてる感じ…ほんの少しだけど。…それに、段々大きくなって…る？」	PRINTFORMW 「魔力が吸われてる感じ…ほんの少しだけど。…それに、段々大きくなって…る？」
PRINTFORMW 「だいぶ体調もマシになってきたわね。この辺りは空気も悪いし気をつけないと…」	PRINTFORMW 「だいぶ体調もマシになってきたわね。この辺りは空気も悪いし気をつけないと…」
PRINTFORMW 「…いやよ。他人にお乳を搾られるだなんて…　これくらい一人でどうにかするわ」	PRINTFORMW 「…いやよ。他人にお乳を搾られるだなんて…　これくらい一人でどうにかするわ」
PRINTFORMW 「この服…一応隠れているとはいえ、乳首もあそこもぴっちりと貼り付いて形が…」	PRINTFORMW 「この服…一応隠れているとはいえ、乳首もあそこもぴっちりと貼り付いて形が…」
PRINTFORMDL ひゅーひゅーと微かに息の漏れる音を発しながら、指一本動かせず横たわっていた	PRINTFORMDL ひゅーひゅーと微かに息の漏れる音を発しながら、指一本動かせず横たわっていた
PRINTFORMDW 満足した使い魔は、ようやく%CALLNAME:(TARGET)%を解放した	PRINTFORMDW 満足した使い魔は、ようやく%CALLNAME:(TARGET)%を解放した
PRINTFORMW 「最近なんだか様子がおかしかったけれど…もしや…ここの妖気にアテられて！？」	PRINTFORMW 「最近なんだか様子がおかしかったけれど…もしや…ここの妖気にアテられて！？」
PRINTFORMW 「ねぇ…%CALLNAME_8_0(LOCAL:0)%じゃなくて…私を…」	PRINTFORMW 「ねぇ…%CALLNAME_8_0(LOCAL:0)%じゃなくて…私を…」
PRINTFORMW 「待ってなさい…今一発でおなかいっぱいになるのを…ご馳走してあげるから！」	PRINTFORMW 「待ってなさい…今一発でおなかいっぱいになるのを…ご馳走してあげるから！」
PRINTFORM 「%CALLNAME_8_0(CFLAG:900, 1, ARGS:1)%…	PRINTFORM 「%CALLNAME_8_0(CFLAG:900, 1, ARGS:1)%…
PRINTFORMW 　頭が…ぽわーんとして…どこからか…くちゅくちゅとエッチな音が聞こえる…」	PRINTFORMW 　頭が…ぽわーんとして…どこからか…くちゅくちゅとエッチな音が聞こえる…」
PRINTFORM 「そう…その太いのよ…それでぐちゅぐちゅして…膣内に熱いのをびゅーってして…	PRINTFORM 「そう…その太いのよ…それでぐちゅぐちゅして…膣内に熱いのをびゅーってして…
PRINTFORMW 　れろ…んちゅ………早く射精してくれると楽なんだけど…口が疲れちゃうわ…」	PRINTFORMW 　れろ…んちゅ………早く射精してくれると楽なんだけど…口が疲れちゃうわ…」
PRINTFORMDW %CALLNAME:(TARGET)%は、その胸で触手に奉仕を繰り返す…	PRINTFORMDW %CALLNAME:(TARGET)%は、その胸で触手に奉仕を繰り返す…
PRINTFORM 　%CALLNAME_8_0(CFLAG:900)%のが…全部挿入っちゃって	PRINTFORM 　%CALLNAME_8_0(CFLAG:900)%のが…全部挿入っちゃって
PRINTFORM 「これって……私達の子供を授かったって事よね？　改めまして…よろしくね、パパ	PRINTFORM 「これって……私達の子供を授かったって事よね？　改めまして…よろしくね、パパ
PRINTFORM 　%CALLNAME_8_0(CFLAG:900)%のが…膣内で膨らんでるっ	PRINTFORM 　%CALLNAME_8_0(CFLAG:900)%のが…膣内で膨らんでるっ
PRINTFORM 「…好き。　解ったわ。私…貴方が好きなのよ。…お願い　私の事…絶対離さないで	PRINTFORM 「…好き。　解ったわ。私…貴方が好きなのよ。…お願い　私の事…絶対離さないで
PRINTFORMDL 敵の攻撃に備え構えている%CALLNAME:(TARGET)%だったが、	PRINTFORMDL 敵の攻撃に備え構えている%CALLNAME:(TARGET)%だったが、
PRINTFORMW 「ってきゃああああっっ？！　何っここ？？？　だっだめっ！入って来ちゃ！！」	PRINTFORMW 「ってきゃああああっっ？！　何っここ？？？　だっだめっ！入って来ちゃ！！」
PRINTFORM 　そんなに…ミルク欲しいの？　いいわよ…こってりした濃いの…ご馳走してあげる	PRINTFORM 　そんなに…ミルク欲しいの？　いいわよ…こってりした濃いの…ご馳走してあげる
PRINTFORM 　%CALLNAME:(TARGET)%様の魔力が精液と一緒に流れ込んでくる	PRINTFORM 　%CALLNAME:(TARGET)%様の魔力が精液と一緒に流れ込んでくる
PRINTFORMW 　びゅるびゅる凄い勢いですね、%CALLNAME:(TARGET)%様♪」	PRINTFORMW 　びゅるびゅる凄い勢いですね、%CALLNAME:(TARGET)%様♪」
PRINTFORMDW そう言いながら%ARGS:1%は%ARGS:0%の尻穴を激しく突き込む！	PRINTFORMDW そう言いながら%ARGS:1%は%ARGS:0%の尻穴を激しく突き込む！
PRINTFORMW 「もう…射精する時は言ってよ。喉の奥に出されると、むせて苦しいんだから…」	PRINTFORMW 「もう…射精する時は言ってよ。喉の奥に出されると、むせて苦しいんだから…」
PRINTFORMW 「う…%CALLNAME_8_0(ARG:2)%…その顔は…もしかして…」	PRINTFORMW 「う…%CALLNAME_8_0(ARG:2)%…その顔は…もしかして…」
PRINTFORM 「あら…%CALLNAME_8_0(ARG:0)%ったらこんな服を着ていたの	PRINTFORM 「あら…%CALLNAME_8_0(ARG:0)%ったらこんな服を着ていたの
PRINTFORMW 「そう…大人しくしていれば…股間のコレでたくさん気持ち良くさせてあげる♪」	PRINTFORMW 「そう…大人しくしていれば…股間のコレでたくさん気持ち良くさせてあげる♪」
PRINTFORMW 　%CALLNAME_8_0(ARG:0)%も気持ちいいのね…よかった…」	PRINTFORMW 　%CALLNAME_8_0(ARG:0)%も気持ちいいのね…よかった…」
PRINTFORMW 「…ぇ？　服が…絡み付いて…や…嫌ぁ…もう…おなかに赤ちゃん居るのにぃ…」	PRINTFORMW 「…ぇ？　服が…絡み付いて…や…嫌ぁ…もう…おなかに赤ちゃん居るのにぃ…」
PRINTFORM 　%CALLNAME_8_0(ARG:0)%の膣内…ぬるぬるで…あたたかい…	PRINTFORM 　%CALLNAME_8_0(ARG:0)%の膣内…ぬるぬるで…あたたかい…
PRINTFORMW 「ごめんなさい、変な事を言って……コレがあると…気持ちが抑えられないの…」	PRINTFORMW 「ごめんなさい、変な事を言って……コレがあると…気持ちが抑えられないの…」
PRINTFORMW 「はぁ…驚かさないで。助け起こした人が自分だったとかどこのホラー映画よ…」	PRINTFORMW 「はぁ…驚かさないで。助け起こした人が自分だったとかどこのホラー映画よ…」
PRINTFORMW 「あら、こんなところで会うなんて奇遇ね。大方遺品でも漁りに来たのかしら？」	PRINTFORMW 「あら、こんなところで会うなんて奇遇ね。大方遺品でも漁りに来たのかしら？」
PRINTFORMDW %CALLNAME:(TARGET)%は心底呆れた顔で、ため息をついた。	PRINTFORMDW %CALLNAME:(TARGET)%は心底呆れた顔で、ため息をついた。
PRINTFORMW 「他に誰も居なかったの？　流石にバレるわよ、騙す本人と同じというのは……」	PRINTFORMW 「他に誰も居なかったの？　流石にバレるわよ、騙す本人と同じというのは……」
PRINTFORMW 「自分の顔と出会うというのも不思議ね。まぁ元気そうで……たぶん良かったわ」	PRINTFORMW 「自分の顔と出会うというのも不思議ね。まぁ元気そうで……たぶん良かったわ」
PRINTFORMW 「はぁ……まさか直接吸われるとは思いもしなかったわ…いや、いいのだけれど」	PRINTFORMW 「はぁ……まさか直接吸われるとは思いもしなかったわ…いや、いいのだけれど」
PRINTFORMW 「せっかくの美味しいお酒なんだからゆっくり自分のペースで飲ませなさいよ…」	PRINTFORMW 「せっかくの美味しいお酒なんだからゆっくり自分のペースで飲ませなさいよ…」
PRINTFORMDL 胸に絡みつく感触に目を覚ました%CALLNAME:(TARGET)%は、	PRINTFORMDL 胸に絡みつく感触に目を覚ました%CALLNAME:(TARGET)%は、
PRINTFORMDW 辺りの空気の流れが一変したかと思うと、圧縮された風の塊が撃ち出された。	PRINTFORMDW 辺りの空気の流れが一変したかと思うと、圧縮された風の塊が撃ち出された。
PRINTFORMW 「く…胸はマズイ…でもこれ…とてもじゃないけど隠し切れないじゃない……」	PRINTFORMW 「く…胸はマズイ…でもこれ…とてもじゃないけど隠し切れないじゃない……」
PRINTFORMW 「ここだけは…死守しないと。こいつら…幼体を寄生させてくるみたいだし…」	PRINTFORMW 「ここだけは…死守しないと。こいつら…幼体を寄生させてくるみたいだし…」
PRINTFORM 「私の敏感おっぱい…こんなに大きくなっちゃったの…お願い…イジってぇぇぇっ	PRINTFORM 「私の敏感おっぱい…こんなに大きくなっちゃったの…お願い…イジってぇぇぇっ
PRINTFORMW 「お願い…アソコでもお尻でも…どこでもいいから…私を気持ちよくさせて…」	PRINTFORMW 「お願い…アソコでもお尻でも…どこでもいいから…私を気持ちよくさせて…」
PRINTFORM 「ふふ…なんだか不思議ね…貴方と出会ったのが、つい最近の事の様な気がするわ	PRINTFORM 「ふふ…なんだか不思議ね…貴方と出会ったのが、つい最近の事の様な気がするわ
PRINTFORMDW %CALLNAME:(TARGET)%は唐突にその場で駆け足を始めた…	PRINTFORMDW %CALLNAME:(TARGET)%は唐突にその場で駆け足を始めた…
PRINTFORMW 　戦闘中くらい自重してよね、%CALLNAME_8_0(ARG:2)%」	PRINTFORMW 　戦闘中くらい自重してよね、%CALLNAME_8_0(ARG:2)%」
PRINTFORM 　かき回されて…そんなしたら…赤ちゃんのお部屋の扉…開いちゃうぅんっっッッ	PRINTFORM 　かき回されて…そんなしたら…赤ちゃんのお部屋の扉…開いちゃうぅんっっッッ
PRINTFORM 「やぁ……お願い%CALLNAME_8_0(CFLAG:900, 1)%…	PRINTFORM 「やぁ……お願い%CALLNAME_8_0(CFLAG:900, 1)%…
PRINTFORMW 「誰かの荷物かしら…こんな場所だし申し訳ないけど有効活用させて貰うわよ」	PRINTFORMW 「誰かの荷物かしら…こんな場所だし申し訳ないけど有効活用させて貰うわよ」
PRINTFORMW 「こんな場所で落ちてる荷物なんて怪しいわ。ひとます放置しておきましょう」	PRINTFORMW 「こんな場所で落ちてる荷物なんて怪しいわ。ひとます放置しておきましょう」
PRINTFORMW 「サキュバスの貴女が劣情のままに人を襲ったら、ただじゃ済まないでしょ…」	PRINTFORMW 「サキュバスの貴女が劣情のままに人を襲ったら、ただじゃ済まないでしょ…」
PRINTFORMW 「いつも言ってるでしょ、小悪魔。そう毎回相手なんて、できないんだから…」	PRINTFORMW 「いつも言ってるでしょ、小悪魔。そう毎回相手なんて、できないんだから…」
PRINTFORMW 「はぁ…そんなに欲求不満なら一人で解消してなさいよ…私を巻き込まないで」	PRINTFORMW 「はぁ…そんなに欲求不満なら一人で解消してなさいよ…私を巻き込まないで」
PRINTFORM 　%CALLNAME:(TARGET)%様ったら、もう射精しちゃうんですか	PRINTFORM 　%CALLNAME:(TARGET)%様ったら、もう射精しちゃうんですか
PRINTFORM 　もっとも…%CALLNAME:(TARGET)%様に選択権は無いですけど	PRINTFORM 　もっとも…%CALLNAME:(TARGET)%様に選択権は無いですけど
PRINTFORM 「こんなにたくさんぶちまけるくらい、魔女ザーメン溜め込んじゃってたんですね	PRINTFORM 「こんなにたくさんぶちまけるくらい、魔女ザーメン溜め込んじゃってたんですね
PRINTFORMW 「……散々見せ付けてくれたんだもの…私とだって少しくらい…いいわよね…」	PRINTFORMW 「……散々見せ付けてくれたんだもの…私とだって少しくらい…いいわよね…」
PRINTFORMW 「ねぇ…%CALLNAME_8_0(1,1)%？　お願い…解るでしょ？」	PRINTFORMW 「ねぇ…%CALLNAME_8_0(1,1)%？　お願い…解るでしょ？」
PRINTFORMW 「これ、どうするのがいいと思う…？　ねぇ、私の言いたい事…解るわよね？」	PRINTFORMW 「これ、どうするのがいいと思う…？　ねぇ、私の言いたい事…解るわよね？」
PRINTFORMW 「ほら、こっちを向きなさい%CALLNAME_8_0(ARG:3)%…」	PRINTFORMW 「ほら、こっちを向きなさい%CALLNAME_8_0(ARG:3)%…」
PRINTFORM 「いい…？　い、挿入れるわよ…%CALLNAME_8_0(ARG:0)%…	PRINTFORM 「いい…？　い、挿入れるわよ…%CALLNAME_8_0(ARG:0)%…
PRINTFORM 　%CALLNAME_8_0(ARG:0)%のおちんちん…挿入ってきた……	PRINTFORM 　%CALLNAME_8_0(ARG:0)%のおちんちん…挿入ってきた……
PRINTFORM 「もっともっと…%CALLNAME_8_0(ARG:0)%を愛してあげる…	PRINTFORM 「もっともっと…%CALLNAME_8_0(ARG:0)%を愛してあげる…
PRINTFORM 「…ふぅ、気持ち…よかったわよ、%CALLNAME_8_0(ARG:0)%	PRINTFORM 「…ふぅ、気持ち…よかったわよ、%CALLNAME_8_0(ARG:0)%
PRINTFORMDW 魔理沙に息がある事を確かめると、パチュリーは、ほっと小さく息を吐いた。	PRINTFORMDW 魔理沙に息がある事を確かめると、パチュリーは、ほっと小さく息を吐いた。
PRINTFORMW 「…なんだレミィか。ごめんなさい、こっちも驚かすつもりはなかったのよ。」	PRINTFORMW 「…なんだレミィか。ごめんなさい、こっちも驚かすつもりはなかったのよ。」
PRINTFORMW 「ねぇ咲夜。ちょっとだけ睡眠取りたいんだけど…うん、あとお願い…………」	PRINTFORMW 「ねぇ咲夜。ちょっとだけ睡眠取りたいんだけど…うん、あとお願い…………」
PRINTFORMW 「おっぱい…張っちゃって痛い……少し搾り出さないと…いけないわよね……」	PRINTFORMW 「おっぱい…張っちゃって痛い……少し搾り出さないと…いけないわよね……」
PRINTFORMW 「本当に助かったわ、ありがとう。今度そちらが困っていた時は善処するわよ」	PRINTFORMW 「本当に助かったわ、ありがとう。今度そちらが困っていた時は善処するわよ」
PRINTFORMW 「いっ！？　なっなによこれ…ヌチャヌチャ纏わり付いて…は、剥がせない…」	PRINTFORMW 「いっ！？　なっなによこれ…ヌチャヌチャ纏わり付いて…は、剥がせない…」
PRINTFORMW 「はぐぅっっ！？　お、お尻に…だっだめ…入っちゃ……んんんんん！！！！」	PRINTFORMW 「はぐぅっっ！？　お、お尻に…だっだめ…入っちゃ……んんんんん！！！！」
PRINTFORMW 「ちょっと催してきちゃったし…どこかで用を足しておいた方がいいかしら…」	PRINTFORMW 「ちょっと催してきちゃったし…どこかで用を足しておいた方がいいかしら…」
PRINTFORMW 「けほっけほっ！　うぅ…何よこれ…お酒の容器にまで擬態しているなんて…」	PRINTFORMW 「けほっけほっ！　うぅ…何よこれ…お酒の容器にまで擬態しているなんて…」
PRINTFORMW 「あら…%CALLNAME_8_0(ARG:2)%が見当たらないわね…」	PRINTFORMW 「あら…%CALLNAME_8_0(ARG:2)%が見当たらないわね…」
PRINTFORMW 「%CALLNAME_8_0(LOCAL:0)%っ！　今助けるわっ！」	PRINTFORMW 「%CALLNAME_8_0(LOCAL:0)%っ！　今助けるわっ！」
PRINTFORMDW %CALLNAME:(TARGET)%は無詠唱で燃え盛る火球を放つ。	PRINTFORMDW %CALLNAME:(TARGET)%は無詠唱で燃え盛る火球を放つ。
PRINTFORMW 「女性の身体から精気を吸収するんでしょ？　いいわ…私の身体を使って…」	PRINTFORMW 「女性の身体から精気を吸収するんでしょ？　いいわ…私の身体を使って…」
PRINTFORMW 「これだけ大きいおっぱいだったら…きっと触手さん達の目も引けるはず…」	PRINTFORMW 「これだけ大きいおっぱいだったら…きっと触手さん達の目も引けるはず…」
PRINTFORM 「どう…気持ちいい？　ん…そうね、こんなにえっちな汁を垂らしているものね	PRINTFORM 「どう…気持ちいい？　ん…そうね、こんなにえっちな汁を垂らしているものね
PRINTFORMDW %CALLNAME:(TARGET)%は触手を愛おしげに擦っている…	PRINTFORMDW %CALLNAME:(TARGET)%は触手を愛おしげに擦っている…
PRINTFORMW 「う…酷い臭い…こんなのを…んぷっっ…ふぐっ…ふぐっ…れろぉ……ん…」	PRINTFORMW 「う…酷い臭い…こんなのを…んぷっっ…ふぐっ…ふぐっ…れろぉ……ん…」
PRINTFORM 「え？　胸で…？　いいけど…これ結構疲れるのよ…けど、貴方がそう言うなら	PRINTFORM 「え？　胸で…？　いいけど…これ結構疲れるのよ…けど、貴方がそう言うなら
PRINTFORM 「%CALLNAME_8_0(CFLAG:900)%に膣内射精されてッッ	PRINTFORM 「%CALLNAME_8_0(CFLAG:900)%に膣内射精されてッッ
PRINTFORMW 「んっ……いつまで……って？！　まさか…やっやめっ…なっ、膣内は……」	PRINTFORMW 「んっ……いつまで……って？！　まさか…やっやめっ…なっ、膣内は……」
PRINTFORM 「…ぇ…吸われ…てる……ぁ…いや…こんなの……また…きッ…来ちゃ…うッッ	PRINTFORM 「…ぇ…吸われ…てる……ぁ…いや…こんなの……また…きッ…来ちゃ…うッッ
PRINTFORM 「ふふっ…貴方と居て楽しいかですって？　変な事言うのね、当たり前じゃない	PRINTFORM 「ふふっ…貴方と居て楽しいかですって？　変な事言うのね、当たり前じゃない
PRINTFORM 「もう疲れちゃったの…何もかも判らなくなるくらい…私を気持ち良くしてぇ…	PRINTFORM 「もう疲れちゃったの…何もかも判らなくなるくらい…私を気持ち良くしてぇ…
PRINTFORMDW %CALLNAME:(TARGET)%は、少しほっとした様子だった…	PRINTFORMDW %CALLNAME:(TARGET)%は、少しほっとした様子だった…
PRINTFORMW 「…え…ぬっ抜け出せな…ひぁっ？　ちょっ！ちょっとそこ…や…やめ……」	PRINTFORMW 「…え…ぬっ抜け出せな…ひぁっ？　ちょっ！ちょっとそこ…や…やめ……」
PRINTFORMW 「やっ…やめなさいっ！　早く出たいのに…引きずり込まないでっっ！！！」	PRINTFORMW 「やっ…やめなさいっ！　早く出たいのに…引きずり込まないでっっ！！！」
PRINTFORMW 「…いや…これはあれよ。たとえ触手で出来ていても服くらい着ていないと」	PRINTFORMW 「…いや…これはあれよ。たとえ触手で出来ていても服くらい着ていないと」
PRINTFORMW 「こっこれ？　もしかして…え…やだ駄目…膣内に入っちゃったりしたら…」	PRINTFORMW 「こっこれ？　もしかして…え…やだ駄目…膣内に入っちゃったりしたら…」
PRINTFORMW 「%CALLNAME_8_0(ARG:3)%……？　ひょっとして……」	PRINTFORMW 「%CALLNAME_8_0(ARG:3)%……？　ひょっとして……」
PRINTFORM 「その…包むとかは出来ないけど…なんだったら胸でシてあげても…いいわよ…	PRINTFORM 「その…包むとかは出来ないけど…なんだったら胸でシてあげても…いいわよ…
PRINTFORMW 「あら、何を後ずさりしてるのよ、%CALLNAME_8_0(1)%…」	PRINTFORMW 「あら、何を後ずさりしてるのよ、%CALLNAME_8_0(1)%…」
PRINTFORMW 「うふふっ♪　この邪魔な服を破っちゃったら少しは大人しくなるかしら？」	PRINTFORMW 「うふふっ♪　この邪魔な服を破っちゃったら少しは大人しくなるかしら？」
PRINTFORM 　凄く良かったわ♪　ありがとう%CALLNAME_8_0(ARG:0)%	PRINTFORM 　凄く良かったわ♪　ありがとう%CALLNAME_8_0(ARG:0)%
PRINTFORM 「そんなわけだから覚悟してね、%CALLNAME_8_0(ARG:0)%	PRINTFORM 「そんなわけだから覚悟してね、%CALLNAME_8_0(ARG:0)%
PRINTFORMW 　%CALLNAME_8_0(ARG:0)%の膣内…気持ち良過ぎて…」	PRINTFORMW 　%CALLNAME_8_0(ARG:0)%の膣内…気持ち良過ぎて…」
PRINTFORMDW %CALLNAME_8_0(ARG:0)%の身体に降りかかっていく…	PRINTFORMDW %CALLNAME_8_0(ARG:0)%の身体に降りかかっていく…
PRINTFORMW 「あら、ママじゃない。せっかくの娘との対面なのにぐったりしちゃって…」	PRINTFORMW 「あら、ママじゃない。せっかくの娘との対面なのにぐったりしちゃって…」
PRINTFORMW 「はぁ…貴女だったの。見ようによっちゃ自分が倒れているとか悪夢だわ…」	PRINTFORMW 「はぁ…貴女だったの。見ようによっちゃ自分が倒れているとか悪夢だわ…」
PRINTFORMW 「美鈴じゃない。無事だったの？　まぁ貴女はそう簡単にやられないわよね」	PRINTFORMW 「美鈴じゃない。無事だったの？　まぁ貴女はそう簡単にやられないわよね」
PRINTFORMW 「……そんなに、このおなかが気になる？　大丈夫よ、なんとか戦えるから」	PRINTFORMW 「……そんなに、このおなかが気になる？　大丈夫よ、なんとか戦えるから」
PRINTFORMW 「物理的な武器はあまり使う気ないけど…取っておけば誰かが使うかしら。」	PRINTFORMW 「物理的な武器はあまり使う気ないけど…取っておけば誰かが使うかしら。」
PRINTFORM 「どんな場所であろうと休める様にならないと…これは仕方のない事なのよね…	PRINTFORM 「どんな場所であろうと休める様にならないと…これは仕方のない事なのよね…
PRINTFORML 「こんなゴツゴツしたの…挿れてるだけでも凄いのに…スイッチ入れたら…」	PRINTFORML 「こんなゴツゴツしたの…挿れてるだけでも凄いのに…スイッチ入れたら…」
PRINTFORMW 「……とはいえ、股間のこっちの方がインパクトは断然強いわよね、くすっ」	PRINTFORMW 「……とはいえ、股間のこっちの方がインパクトは断然強いわよね、くすっ」
PRINTFORMW 「くぅ…　このスライム…胸のところに纏わりついて…気色悪い…ううぅ…」	PRINTFORMW 「くぅ…　このスライム…胸のところに纏わりついて…気色悪い…ううぅ…」
PRINTFORMW 　おっぱいみるくで…乳首の周りのスライム…真っ白になっちゃってる……」	PRINTFORMW 　おっぱいみるくで…乳首の周りのスライム…真っ白になっちゃってる……」
PRINTFORMDW %ARGS:0%は時折り痙攣しながら、声にならない声をあげている…	PRINTFORMDW %ARGS:0%は時折り痙攣しながら、声にならない声をあげている…
PRINTFORMDW %ARGS:0%は身体を微かに震わせ、くぐもった嬌声をあげている…	PRINTFORMDW %ARGS:0%は身体を微かに震わせ、くぐもった嬌声をあげている…
PRINTFORMW 「%CALLNAME_8_0(LOCAL:0)%を…離しなさいっ！」	PRINTFORMW 「%CALLNAME_8_0(LOCAL:0)%を…離しなさいっ！」
PRINTFORMDW 地中からいくつもの鋭利な石の槍が舞い上がり、敵の頭上から降り注ぐ。	PRINTFORMDW 地中からいくつもの鋭利な石の槍が舞い上がり、敵の頭上から降り注ぐ。
PRINTFORMDW 空中に集結した金属元素が、まるで丸鋸の刃の様な形となり飛んでいく。	PRINTFORMDW 空中に集結した金属元素が、まるで丸鋸の刃の様な形となり飛んでいく。
PRINTFORMDW 突如地中から輝く宝石の壁がせりあがり、近づく者を攻撃的に拒絶する。	PRINTFORMDW 突如地中から輝く宝石の壁がせりあがり、近づく者を攻撃的に拒絶する。
PRINTFORM 　このガチガチおちんぽ…にゅるって締め付けて、どぴゅどぴゅ射精させてぇ	PRINTFORM 　このガチガチおちんぽ…にゅるって締め付けて、どぴゅどぴゅ射精させてぇ
PRINTFORM 「おっぱいが寂しいの…たくさんの触手で…にゅるにゅるってされたいの……	PRINTFORM 「おっぱいが寂しいの…たくさんの触手で…にゅるにゅるってされたいの……
PRINTFORMW 「乳首…痛いくらい勃っちゃってる…こうしてれば苛めてくれるかしら…」	PRINTFORMW 「乳首…痛いくらい勃っちゃってる…こうしてれば苛めてくれるかしら…」
PRINTFORMW 「どうかしら…？　私のおっぱい…ちゃんと貴方を気持ちよくできてる？」	PRINTFORMW 「どうかしら…？　私のおっぱい…ちゃんと貴方を気持ちよくできてる？」
PRINTFORMW 「ほとんど下着しか残ってないのに…服なんてどうでもいいから…早く…」	PRINTFORMW 「ほとんど下着しか残ってないのに…服なんてどうでもいいから…早く…」
PRINTFORM 「おちんぽに来たっ！　そんなコスコスって…したら……すぐに…すぐにぃ…	PRINTFORM 「おちんぽに来たっ！　そんなコスコスって…したら……すぐに…すぐにぃ…
PRINTFORM 「やぁ…%CALLNAME_8_0(CFLAG:900)%の太過ぎィ…	PRINTFORM 「やぁ…%CALLNAME_8_0(CFLAG:900)%の太過ぎィ…
PRINTFORMW 「…あれ…目の前に居たゴーストは…？　もしかして…私の体の中に！？」	PRINTFORMW 「…あれ…目の前に居たゴーストは…？　もしかして…私の体の中に！？」
PRINTFORM 　%CALLNAME:(TARGET)%様の膣内で…イっちゃううぅぅぅ	PRINTFORM 　%CALLNAME:(TARGET)%様の膣内で…イっちゃううぅぅぅ
PRINTFORMDW 射精を感じ取った子宮が、少しでも精液を取り込もうと子宮口を伸ばす…	PRINTFORMDW 射精を感じ取った子宮が、少しでも精液を取り込もうと子宮口を伸ばす…
PRINTFORM 「…ふにゃぁ…%CALLNAME_8_0(CFLAG:900, 1)%	PRINTFORM 「…ふにゃぁ…%CALLNAME_8_0(CFLAG:900, 1)%
PRINTFORM 　もう…こんなんじゃ全然足りないの……早くそこのウネウネしてるものに…	PRINTFORM 　もう…こんなんじゃ全然足りないの……早くそこのウネウネしてるものに…
PRINTFORMW 「はぁ……私、こんな状態でどれだけ耐えられるか、わからないわよ……」	PRINTFORMW 「はぁ……私、こんな状態でどれだけ耐えられるか、わからないわよ……」
PRINTFORMW 「…はぁ。　また、いかにもな代物ね…この触手で出来た装置（？）は…」	PRINTFORMW 「…はぁ。　また、いかにもな代物ね…この触手で出来た装置（？）は…」
PRINTFORMW 「せっかくだから…そのイヤラシイおっぱいを使わせてもらおうかしら♪」	PRINTFORMW 「せっかくだから…そのイヤラシイおっぱいを使わせてもらおうかしら♪」
PRINTFORM 「……くすくす、どうだった？　おちんぽ気持ち良かった？　次は…私の番よ	PRINTFORM 「……くすくす、どうだった？　おちんぽ気持ち良かった？　次は…私の番よ
PRINTFORMW 「ちょっと…%CALLNAME_8_0(1)%？　何をする気なの…」	PRINTFORMW 「ちょっと…%CALLNAME_8_0(1)%？　何をする気なの…」
PRINTFORMW 「しょうがないわね…ほら、これでいい？　さっさと射精しちゃいなさい」	PRINTFORMW 「しょうがないわね…ほら、これでいい？　さっさと射精しちゃいなさい」
PRINTFORMW 「なんでいきなり触手が絡んで…？　い…いやっ！　脚…開かせないで…」	PRINTFORMW 「なんでいきなり触手が絡んで…？　い…いやっ！　脚…開かせないで…」
PRINTFORMW 「……ごめんなさい、これ…全然治まらなくて…もう我慢できないの……」	PRINTFORMW 「……ごめんなさい、これ…全然治まらなくて…もう我慢できないの……」
PRINTFORMW 「…そうね。これを貴女がどうにかしてくれるのなら…考えなくも無いわ」	PRINTFORMW 「…そうね。これを貴女がどうにかしてくれるのなら…考えなくも無いわ」
PRINTFORMW 　とてもいいわ…%CALLNAME_8_0(ARG:0)%の膣内…」	PRINTFORMW 　とてもいいわ…%CALLNAME_8_0(ARG:0)%の膣内…」
PRINTFORMDW %CALLNAME:(ARG:1)%は、少し残念そうにお辞儀をした	PRINTFORMDW %CALLNAME:(ARG:1)%は、少し残念そうにお辞儀をした
PRINTFORMW 「その顔…もうイくんでしょう？　膣内でいいとは…言ってないからね？」	PRINTFORMW 「その顔…もうイくんでしょう？　膣内でいいとは…言ってないからね？」
PRINTFORMW 「あぁ、これ。ちょっと寄生されたみたいなんだけど中々取れないのよ…」	PRINTFORMW 「あぁ、これ。ちょっと寄生されたみたいなんだけど中々取れないのよ…」
PRINTFORMW 「くすっ、なんだかんだ言ってレミィも一人じゃ心細かったんじゃない♪」	PRINTFORMW 「くすっ、なんだかんだ言ってレミィも一人じゃ心細かったんじゃない♪」
PRINTFORMW 「そろそろ寝ないと行動に支障が出るわね。まったく本当に面倒…………」	PRINTFORMW 「そろそろ寝ないと行動に支障が出るわね。まったく本当に面倒…………」
PRINTFORMW 「……ふぅ…体を休めなければいけないのに、どうも目が冴えちゃうわ…」	PRINTFORMW 「……ふぅ…体を休めなければいけないのに、どうも目が冴えちゃうわ…」
PRINTFORMW 「やだ…おっぱいがずっとじんじんしっぱなしで…母乳が止まらない……」	PRINTFORMW 「やだ…おっぱいがずっとじんじんしっぱなしで…母乳が止まらない……」
PRINTFORMW 「…同化…した？　…って、この服また元気になっちゃったんじゃない？」	PRINTFORMW 「…同化…した？　…って、この服また元気になっちゃったんじゃない？」
PRINTFORMW 　このスライム…敏感なところばかり重点的に纏わり付いてきてる様な…」	PRINTFORMW 　このスライム…敏感なところばかり重点的に纏わり付いてきてる様な…」
PRINTFORM 「もっもう…クリちゃん空気に触れてるだけでシビれるの…早く…早くぅぅ	PRINTFORM 「もっもう…クリちゃん空気に触れてるだけでシビれるの…早く…早くぅぅ
PRINTFORM 「そこの触手に…クリちゃんコスコスしてもらって…私をイかせて欲しい…	PRINTFORM 「そこの触手に…クリちゃんコスコスしてもらって…私をイかせて欲しい…
PRINTFORM 「あら…着たままがお好み？　それとも…あなたが脱がせてくれるのかしら	PRINTFORM 「あら…着たままがお好み？　それとも…あなたが脱がせてくれるのかしら
PRINTFORMW 「や、やぁ……足が…勝手にぃ……うぅ……ぐにゅって…気色悪い……」	PRINTFORMW 「や、やぁ……足が…勝手にぃ……うぅ……ぐにゅって…気色悪い……」
PRINTFORMW 「はぁ…もう諦めたわ……手ぐらいでいいのなら、好きにして…うぅ…」	PRINTFORMW 「はぁ…もう諦めたわ……手ぐらいでいいのなら、好きにして…うぅ…」
PRINTFORMW 「なんで…私がこんな…ぅぅ…おっぱい…ぬるぬるして気色悪いのに…」	PRINTFORMW 「なんで…私がこんな…ぅぅ…おっぱい…ぬるぬるして気色悪いのに…」
PRINTFORM 　加減して…%CALLNAME_8_0(CFLAG:900, 1)%	PRINTFORM 　加減して…%CALLNAME_8_0(CFLAG:900, 1)%
PRINTFORM 「やだ…種付け…されちゃうのに…子宮が出迎えちゃって…るっっっっッッ	PRINTFORM 「やだ…種付け…されちゃうのに…子宮が出迎えちゃって…るっっっっッッ
PRINTFORM 　%CALLNAME_8_0(CFLAG:900)%の…せーえきぃ…	PRINTFORM 　%CALLNAME_8_0(CFLAG:900)%の…せーえきぃ…
PRINTFORMW 「…んく…や……痺れが…ぢゅんって…だめ……抑えられそうにない…」	PRINTFORMW 「…んく…や……痺れが…ぢゅんって…だめ……抑えられそうにない…」
PRINTFORMW 「…ぁ…か…身体が……これは……つい……やり過ぎちゃったわね……」	PRINTFORMW 「…ぁ…か…身体が……これは……つい……やり過ぎちゃったわね……」
PRINTFORMW 「こいつをなんとかすれば、次々沸いて出てくるのも少しは減りそうね」	PRINTFORMW 「こいつをなんとかすれば、次々沸いて出てくるのも少しは減りそうね」
PRINTFORMW 「小悪魔、少しだけ耐えていなさい。今のままじゃどうしようもないの」	PRINTFORMW 「小悪魔、少しだけ耐えていなさい。今のままじゃどうしようもないの」
PRINTFORMDW びゅっ！ぶびゅびゅっ！びゅぐっっ！！ぶびゅびゅーーーーーっ！！！	PRINTFORMDW びゅっ！ぶびゅびゅっ！びゅぐっっ！！ぶびゅびゅーーーーーっ！！！
PRINTFORM 　こんなの初めて…これじゃ…おまんこ…もっともっと欲しくなっちゃう…	PRINTFORM 　こんなの初めて…これじゃ…おまんこ…もっともっと欲しくなっちゃう…
PRINTFORMW 「そうね、危険を冒して睡眠するくらいなら、これを使う手もありだわ」	PRINTFORMW 「そうね、危険を冒して睡眠するくらいなら、これを使う手もありだわ」
PRINTFORMW 　いやいやいや、私は何を喜んで…でも…またあの感覚が…（ごくり）」	PRINTFORMW 　いやいやいや、私は何を喜んで…でも…またあの感覚が…（ごくり）」
PRINTFORMW 「…え゛？　こ、これ……んんっ…取れない…というか感覚まである？」	PRINTFORMW 「…え゛？　こ、これ……んんっ…取れない…というか感覚まである？」
PRINTFORM 「%CALLNAME_8_0(ARG:3)%はお尻も気持ちいいのね…	PRINTFORM 「%CALLNAME_8_0(ARG:3)%はお尻も気持ちいいのね…
PRINTFORMW 「さて…小悪魔？　私に襲い掛かってきたその覚悟…できてるかしら？」	PRINTFORMW 「さて…小悪魔？　私に襲い掛かってきたその覚悟…できてるかしら？」
PRINTFORMW 「そうねぇ…足で擦って貰えればいいわ。手で触るよりはマシでしょ？」	PRINTFORMW 「そうねぇ…足で擦って貰えればいいわ。手で触るよりはマシでしょ？」
PRINTFORMW 　凄い太くてビクビクしてるでしょ…きっととっても気持ちいいわよ…」	PRINTFORMW 　凄い太くてビクビクしてるでしょ…きっととっても気持ちいいわよ…」
PRINTFORMW 「うう…ビクビクしてる…手とはいえ出来れば触れたくなかったわね…」	PRINTFORMW 「うう…ビクビクしてる…手とはいえ出来れば触れたくなかったわね…」
PRINTFORMW 「…え、違う！　だからといって挿入れて欲しいってわけじゃなくて…」	PRINTFORMW 「…え、違う！　だからといって挿入れて欲しいってわけじゃなくて…」
PRINTFORMW 「ねぇ…%CALLNAME_8_0(ARG:3)%…目を瞑って…」	PRINTFORMW 「ねぇ…%CALLNAME_8_0(ARG:3)%…目を瞑って…」
PRINTFORMW 「%CALLNAME_8_0(LOCAL:0)%…舌…出して……」	PRINTFORMW 「%CALLNAME_8_0(LOCAL:0)%…舌…出して……」
PRINTFORM 「びゅくびゅくって…スペルマたっぷり膣内射精したくなっちゃってるのぉ	PRINTFORM 「びゅくびゅくって…スペルマたっぷり膣内射精したくなっちゃってるのぉ
PRINTFORM 「息も絶え絶えって感じで大人しくなったわね。　でも…本番はこれからよ	PRINTFORM 「息も絶え絶えって感じで大人しくなったわね。　でも…本番はこれからよ
PRINTFORMW 　%CALLNAME_8_0(ARG:0)%の膣内…すごく熱い…」	PRINTFORMW 　%CALLNAME_8_0(ARG:0)%の膣内…すごく熱い…」
PRINTFORM 「こんなんじゃ…射精…止まらないわ……責任持って…全部飲み干してね…	PRINTFORM 「こんなんじゃ…射精…止まらないわ……責任持って…全部飲み干してね…
PRINTFORMW 「ふぅっ…　この極限状況で、これくらいの事も受け入れられないのね」	PRINTFORMW 「ふぅっ…　この極限状況で、これくらいの事も受け入れられないのね」
PRINTFORMW 「…あら、ぷるぷる震えちゃって。その調子でもっと締め付けるのよ…」	PRINTFORMW 「…あら、ぷるぷる震えちゃって。その調子でもっと締め付けるのよ…」
PRINTFORM 　%CALLNAME_8_0(ARG:0)%の膣内が…きゅううぅって	PRINTFORM 　%CALLNAME_8_0(ARG:0)%の膣内が…きゅううぅって
PRINTFORMW 「んっ…そのイキ顔見ながら……膣内に、たぁっぷり射精しちゃうわ♪」	PRINTFORMW 「んっ…そのイキ顔見ながら……膣内に、たぁっぷり射精しちゃうわ♪」
PRINTFORMW （……動けない…という事は、非力な私でも押さえ込めるという事よね）	PRINTFORMW （……動けない…という事は、非力な私でも押さえ込めるという事よね）
PRINTFORMW 「ふぅ…こんな場所でも知り合いに会えるとほっとするものね、咲夜。」	PRINTFORMW 「ふぅ…こんな場所でも知り合いに会えるとほっとするものね、咲夜。」
PRINTFORMW 「…こんにちは。会ったのが人の姿をしているだけで正直ほっとするわ」	PRINTFORMW 「…こんにちは。会ったのが人の姿をしているだけで正直ほっとするわ」
PRINTFORMW 「騒がせてごめんなさい、しばらく本を読んでいないから禁断症状が…」	PRINTFORMW 「騒がせてごめんなさい、しばらく本を読んでいないから禁断症状が…」
PRINTFORMW 「小悪魔、何か近づいて来る気配があったらすぐ起こしなさい…………」	PRINTFORMW 「小悪魔、何か近づいて来る気配があったらすぐ起こしなさい…………」
PRINTFORMW 「随分と成長が早いのね…流石異界の者の遺伝子と言ったところかしら」	PRINTFORMW 「随分と成長が早いのね…流石異界の者の遺伝子と言ったところかしら」
PRINTFORMW 「…んくっ…はぁ、はぁ、なか…で……あ、あ…出て…きて…る…！！」	PRINTFORMW 「…んくっ…はぁ、はぁ、なか…で……あ、あ…出て…きて…る…！！」
PRINTFORMW 「あっ…いたたっ……あ、赤ちゃん…顔出して……うっ…産まれるっ！」	PRINTFORMW 「あっ…いたたっ……あ、赤ちゃん…顔出して……うっ…産まれるっ！」
PRINTFORMW 「…はぁ、助けてくれたのね。　もしよかったら…一緒に行動しない？」	PRINTFORMW 「…はぁ、助けてくれたのね。　もしよかったら…一緒に行動しない？」
PRINTFORM 　おっぱいみるく…溢れ出してくるたび、気持ちいいのが止まらないのぉ…	PRINTFORM 　おっぱいみるく…溢れ出してくるたび、気持ちいいのが止まらないのぉ…
PRINTFORM 　今はちょっと待ってて…休んでいる時ならどれだけ激しくしてもいいから	PRINTFORM 　今はちょっと待ってて…休んでいる時ならどれだけ激しくしてもいいから
PRINTFORMW 「こう常時ヌメヌメと身体を弄られてると…しゅ、集中できないわね…」	PRINTFORMW 「こう常時ヌメヌメと身体を弄られてると…しゅ、集中できないわね…」
PRINTFORMW 「ちょ…調子はさておき、とっておきの魔法…お見舞いしてあげる！」	PRINTFORMW 「ちょ…調子はさておき、とっておきの魔法…お見舞いしてあげる！」
PRINTFORML 「さぁ覚悟はいい…？　骨まで残らないほど…焼き尽くしてあげる！」	PRINTFORML 「さぁ覚悟はいい…？　骨まで残らないほど…焼き尽くしてあげる！」
PRINTFORML 「待たせたわね。これが全ての属性を束ねた…とっておきのスペル！」	PRINTFORML 「待たせたわね。これが全ての属性を束ねた…とっておきのスペル！」
PRINTFORMW 「スペルを当てるためにも、まずは敵の足を止める必要があるわね…」	PRINTFORMW 「スペルを当てるためにも、まずは敵の足を止める必要があるわね…」
PRINTFORMW 「抵抗しても無駄ね……運が良ければ…誰かが助けてくれるでしょ…」	PRINTFORMW 「抵抗しても無駄ね……運が良ければ…誰かが助けてくれるでしょ…」
PRINTFORM 「ほ…ほら…こっちよ…中にはたくさんミルクも詰まってるんだから……	PRINTFORM 「ほ…ほら…こっちよ…中にはたくさんミルクも詰まってるんだから……
PRINTFORMW 「おっぱいが張って…苦しいの…トロトロの粘液で…擦って欲しい…」	PRINTFORMW 「おっぱいが張って…苦しいの…トロトロの粘液で…擦って欲しい…」
PRINTFORMW 「や、やめなさい…ッッ！！　服なんて脱がせて…どうするつもり！」	PRINTFORMW 「や、やめなさい…ッッ！！　服なんて脱がせて…どうするつもり！」
PRINTFORM 「%CALLNAME_8_0(ARG:2)%…やっ…やめなさ…いッ	PRINTFORM 「%CALLNAME_8_0(ARG:2)%…やっ…やめなさ…いッ
PRINTFORM 　私%CALLNAME:(TARGET)%様のおっぱい吸いたいです	PRINTFORM 　私%CALLNAME:(TARGET)%様のおっぱい吸いたいです
PRINTFORM 「だめ…そんなの見せつけられたら…孕みたくて仕方がなくなっちゃうっ	PRINTFORM 「だめ…そんなの見せつけられたら…孕みたくて仕方がなくなっちゃうっ
PRINTFORM 　おちんちん好きでしょ？　私が…膣内をぐちゅぐちゅかき回してあげる	PRINTFORM 　おちんちん好きでしょ？　私が…膣内をぐちゅぐちゅかき回してあげる
PRINTFORMW 「ぐっ……　人の身体使って…ううぅ…お尻…拡がっちゃってる……」	PRINTFORMW 「ぐっ……　人の身体使って…ううぅ…お尻…拡がっちゃってる……」
PRINTFORM 「も…もう…メインディッシュは取っておきたかったのにぃ……ぅぅんっ	PRINTFORM 「も…もう…メインディッシュは取っておきたかったのにぃ……ぅぅんっ
PRINTFORMW 　おまんこずっぽり埋められると…もう…どうでも良くなっちゃう…」	PRINTFORMW 　おまんこずっぽり埋められると…もう…どうでも良くなっちゃう…」
PRINTFORM 「そっ…そっち？！　ダメダメぇっ！…お豆イジっちゃ……んんんッッッ	PRINTFORM 「そっ…そっち？！　ダメダメぇっ！…お豆イジっちゃ……んんんッッッ
PRINTFORMDW 『ご名答！　さてさてこの体…どう料理してあげようかしらねぇ…』	PRINTFORMDW 『ご名答！　さてさてこの体…どう料理してあげようかしらねぇ…』
PRINTFORMW 「うぅ……早く…こいつから離れて…中の精液…かき出さないと……」	PRINTFORMW 「うぅ……早く…こいつから離れて…中の精液…かき出さないと……」
PRINTFORMW 「ぐほっ！！　けほっけほっ…………喉に…絡み付いて……んくっ…」	PRINTFORMW 「ぐほっ！！　けほっけほっ…………喉に…絡み付いて……んくっ…」
PRINTFORMW 「んくっ！！　…だ、駄目よ！さらに引きずり込まれたら…あぁっ！」	PRINTFORMW 「んくっ！！　…だ、駄目よ！さらに引きずり込まれたら…あぁっ！」
PRINTFORMW 「魔理沙、ちょっと待ってなさい。まったく世話が焼けるんだから…」	PRINTFORMW 「魔理沙、ちょっと待ってなさい。まったく世話が焼けるんだから…」
PRINTFORM 「ひゃっ？！　なっなにを…むきゅっ？！　んはぁっ　やっやめ…んんっ	PRINTFORM 「ひゃっ？！　なっなにを…むきゅっ？！　んはぁっ　やっやめ…んんっ
PRINTFORMW 「流石に、こんな場所に成っている実をおいそれと食べられないわ…」	PRINTFORMW 「流石に、こんな場所に成っている実をおいそれと食べられないわ…」
PRINTFORM 「そうね…とにかく…まずは射精しないと……勢い良くびゅるびゅるって	PRINTFORM 「そうね…とにかく…まずは射精しないと……勢い良くびゅるびゅるって
PRINTFORM 「ほら見て頂戴…私のアソコ…こんなぶっといおちんぽ生えちゃってるの	PRINTFORM 「ほら見て頂戴…私のアソコ…こんなぶっといおちんぽ生えちゃってるの
PRINTFORMW （ちょっと…待ちなさい、私…眠っている相手に…何を考えてるの…）	PRINTFORMW （ちょっと…待ちなさい、私…眠っている相手に…何を考えてるの…）
PRINTFORM 　%CALLNAME_8_0(ARG:3)%の膣内…気持ちいいのぉ	PRINTFORM 　%CALLNAME_8_0(ARG:3)%の膣内…気持ちいいのぉ
PRINTFORM 　%CALLNAME_8_0(ARG:3)%も私の動きに合わせてっ	PRINTFORM 　%CALLNAME_8_0(ARG:3)%も私の動きに合わせてっ
PRINTFORM 「パチュリーさまのご命令ですものね…念入りにご奉仕させて頂かないと	PRINTFORM 「パチュリーさまのご命令ですものね…念入りにご奉仕させて頂かないと
PRINTFORMW 「…いいわ、私が口でしてあげる。　困った時はお互い様だものね…」	PRINTFORMW 「…いいわ、私が口でしてあげる。　困った時はお互い様だものね…」
PRINTFORMW 「ちょっと、やめてよ！　今はそんな事してる場合じゃないでしょ！」	PRINTFORMW 「ちょっと、やめてよ！　今はそんな事してる場合じゃないでしょ！」
PRINTFORMW 「……はぁ…最悪……もし赤ちゃんデキちゃったらどうするのよ……」	PRINTFORMW 「……はぁ…最悪……もし赤ちゃんデキちゃったらどうするのよ……」
PRINTFORM 　%CALLNAME_8_0(ARG:0)%の顔…私のでどろどろよ	PRINTFORM 　%CALLNAME_8_0(ARG:0)%の顔…私のでどろどろよ
PRINTFORM 　%CALLNAME_8_0(ARG:0)%ったら…全身どろどろよ	PRINTFORM 　%CALLNAME_8_0(ARG:0)%ったら…全身どろどろよ
PRINTFORMDW 流石にこの極限状況では、少しでも心が休まる様な話を聞きたい様だ	PRINTFORMDW 流石にこの極限状況では、少しでも心が休まる様な話を聞きたい様だ
PRINTFORMW 「行きましょうフラン、ここなら思いっきりやっちゃってもいいわよ」	PRINTFORMW 「行きましょうフラン、ここなら思いっきりやっちゃってもいいわよ」
PRINTFORMW 「…まぁ捨てる事もないわね。今は手の内が多いに越した事はないし」	PRINTFORMW 「…まぁ捨てる事もないわね。今は手の内が多いに越した事はないし」
PRINTFORMW 「レミィいいかしら？　少し眠りたいから…うん、悪いわね…………」	PRINTFORMW 「レミィいいかしら？　少し眠りたいから…うん、悪いわね…………」
PRINTFORML 「数日しか経ってないというのに…日毎に大きく育ってるのが判る…」	PRINTFORML 「数日しか経ってないというのに…日毎に大きく育ってるのが判る…」
PRINTFORMW 「はぁ…早く帰って、お茶でも飲みながら読書していたいんだけど。」	PRINTFORMW 「はぁ…早く帰って、お茶でも飲みながら読書していたいんだけど。」
PRINTFORMW 「これ…やっぱり大きくなってるわよね…やけに肩が凝ると思ったら」	PRINTFORMW 「これ…やっぱり大きくなってるわよね…やけに肩が凝ると思ったら」
PRINTFORM 「わらひ…おひりで…こんなにかんじひゃうのぉ……おひり…なのにぃ…	PRINTFORM 「わらひ…おひりで…こんなにかんじひゃうのぉ……おひり…なのにぃ…
PRINTFORMW 　クリちゃん…吸ってくれるのは嬉しいけど…ミルクは出ないわよ？」	PRINTFORMW 　クリちゃん…吸ってくれるのは嬉しいけど…ミルクは出ないわよ？」
PRINTFORMW 　こうして支えられてると…大きい胸でも肩こりが軽減されるわね♪」	PRINTFORMW 　こうして支えられてると…大きい胸でも肩こりが軽減されるわね♪」
PRINTFORMW 「ひっ！？　ち、乳首のところのスライムが…な…なにしてるの……」	PRINTFORMW 「ひっ！？　ち、乳首のところのスライムが…な…なにしてるの……」
PRINTFORMW 「これじゃ埒が明かないわ…向こうが回復する間もなく倒さないと」	PRINTFORMW 「これじゃ埒が明かないわ…向こうが回復する間もなく倒さないと」
PRINTFORMDW 上空に放たれた光弾から光の雨が降り注ぎ、敵の動きを制限する。	PRINTFORMDW 上空に放たれた光弾から光の雨が降り注ぎ、敵の動きを制限する。
PRINTFORM 「ねぇ…%CALLNAME_8_0(CFLAG:900, 1)%	PRINTFORM 「ねぇ…%CALLNAME_8_0(CFLAG:900, 1)%
PRINTFORMW 「胸…大きくなっちゃったから格好の的かもね…気をつけないと…」	PRINTFORMW 「胸…大きくなっちゃったから格好の的かもね…気をつけないと…」
PRINTFORMW 　…どこでもいいの…そのヌルヌルした触手で弄ってもらえれば…」	PRINTFORMW 　…どこでもいいの…そのヌルヌルした触手で弄ってもらえれば…」
PRINTFORM 「まったく貴方ときたら足で頼むだなんて…わかったわ、やってあげる	PRINTFORM 「まったく貴方ときたら足で頼むだなんて…わかったわ、やってあげる
PRINTFORM 　だ…駄目よ…強引に挿入れさせられたって…我慢できるんだか…らぁ	PRINTFORM 　だ…駄目よ…強引に挿入れさせられたって…我慢できるんだか…らぁ
PRINTFORM 「ちっ…違うっ…声が漏れただけ…お尻で気持ちよくなんて…んふぅ…	PRINTFORM 「ちっ…違うっ…声が漏れただけ…お尻で気持ちよくなんて…んふぅ…
PRINTFORMW 「うぅ…なによこれ…髪の毛に張り付いたら中々取れないのに……」	PRINTFORMW 「うぅ…なによこれ…髪の毛に張り付いたら中々取れないのに……」
PRINTFORMDL 払っても払っても秘蜜を味わおうと蜜壷に入り込んでくる触手達に	PRINTFORMDL 払っても払っても秘蜜を味わおうと蜜壷に入り込んでくる触手達に
PRINTFORMW 「いかにも『親玉』って感じね…気を引き締めてかからないと……」	PRINTFORMW 「いかにも『親玉』って感じね…気を引き締めてかからないと……」
PRINTFORMW 「小悪魔…？　これは…ここの瘴気にアテられちゃってるようね…」	PRINTFORMW 「小悪魔…？　これは…ここの瘴気にアテられちゃってるようね…」
PRINTFORMW 「ちょっと小悪魔！　何処へ…確かに貴女の力だけじゃ無理よね。」	PRINTFORMW 「ちょっと小悪魔！　何処へ…確かに貴女の力だけじゃ無理よね。」
PRINTFORMW 「…返事が無いわね。　二人とも別の場所に飛ばされたのかしら…」	PRINTFORMW 「…返事が無いわね。　二人とも別の場所に飛ばされたのかしら…」
PRINTFORMDL もうすでに身も心も%PETNAME%に依存しきっている様だ…	PRINTFORMDL もうすでに身も心も%PETNAME%に依存しきっている様だ…
PRINTFORMW 「…このガス…ぁ…ダメよ…こんなところでシたくなるなんて……」	PRINTFORMW 「…このガス…ぁ…ダメよ…こんなところでシたくなるなんて……」
PRINTFORMW 「別にいいでしょ、いつもは貴女の方から誘ってきてるんだから…」	PRINTFORMW 「別にいいでしょ、いつもは貴女の方から誘ってきてるんだから…」
PRINTFORM 「ふふ…いいわよ、%CALLNAME_8_0(RESULT)%…	PRINTFORM 「ふふ…いいわよ、%CALLNAME_8_0(RESULT)%…
PRINTFORMW （ん…んんぅ！？　え…だっ誰！？　やっ…やめなさいっっ！！！）	PRINTFORMW （ん…んんぅ！？　え…だっ誰！？　やっ…やめなさいっっ！！！）
PRINTFORMDW 口から涎を垂れ流し惚けた顔で、凄まじい勢いの射精を繰り返す…	PRINTFORMDW 口から涎を垂れ流し惚けた顔で、凄まじい勢いの射精を繰り返す…
PRINTFORM 「ほら…ほら…ドロドロした熱っついのが…もうここまで登ってきてる	PRINTFORM 「ほら…ほら…ドロドロした熱っついのが…もうここまで登ってきてる
PRINTFORM 「そんなしかめっ面しても結局は無様に精液を吐き出しちゃうんですよ	PRINTFORM 「そんなしかめっ面しても結局は無様に精液を吐き出しちゃうんですよ
PRINTFORM 　ふたなりチンポから…こってりザーメンぶちまけちゃうぅぅぅッッッ	PRINTFORM 　ふたなりチンポから…こってりザーメンぶちまけちゃうぅぅぅッッッ
PRINTFORM 　誰でもいいから…おちんぽシゴいてビュービュー射精させてぇッッッ	PRINTFORM 　誰でもいいから…おちんぽシゴいてビュービュー射精させてぇッッッ
PRINTFORMW （ちょっと…待ちなさい、私…倒れてる相手に…何を考えてるの…）	PRINTFORMW （ちょっと…待ちなさい、私…倒れてる相手に…何を考えてるの…）
PRINTFORMW 「悪いわね、%CALLNAME_8_0(1)%…じゃあお願い」	PRINTFORMW 「悪いわね、%CALLNAME_8_0(1)%…じゃあお願い」
PRINTFORMW 「あ…あれ…？　急に足が重くなったと思ったら…触手がっっ！？」	PRINTFORMW 「あ…あれ…？　急に足が重くなったと思ったら…触手がっっ！？」
PRINTFORMW 「…キス…してもいいかしら？　なんだかしたくなっちゃったの…」	PRINTFORMW 「…キス…してもいいかしら？　なんだかしたくなっちゃったの…」
PRINTFORMW 「…どうせ抵抗しても無駄なんでしょう？　好きにしたらいいわ…」	PRINTFORMW 「…どうせ抵抗しても無駄なんでしょう？　好きにしたらいいわ…」
PRINTFORMW 「…ふぅ……あら…服が絡み付いて……これは解けそうにないわね」	PRINTFORMW 「…ふぅ……あら…服が絡み付いて……これは解けそうにないわね」
PRINTFORMW 「どうしたの？　まだ挿入れただけじゃない。本番はこれからよ…」	PRINTFORMW 「どうしたの？　まだ挿入れただけじゃない。本番はこれからよ…」
PRINTFORMW 「…いいわ。股間のそれ…辛いんでしょう？　ギブアンドテイクよ」	PRINTFORMW 「…いいわ。股間のそれ…辛いんでしょう？　ギブアンドテイクよ」
PRINTFORMW 　どうしたの…早くしないと、いつまた襲われるかわからないわよ」	PRINTFORMW 　どうしたの…早くしないと、いつまた襲われるかわからないわよ」
PRINTFORMW 　せっかくの交換条件なんだから…いっぱい…膣内で射精してね…」	PRINTFORMW 　せっかくの交換条件なんだから…いっぱい…膣内で射精してね…」
PRINTFORMW （……動けない…のよね、この子…私より腕力があるけど今なら…）	PRINTFORMW （……動けない…のよね、この子…私より腕力があるけど今なら…）
PRINTFORMW 「ふふっ…どうしたの？　このガチガチのおちんちんが気になる？」	PRINTFORMW 「ふふっ…どうしたの？　このガチガチのおちんちんが気になる？」
PRINTFORM 「…あ。　ごっ、ごめんなさいっ。　これ、全然治まらないの……ふぅ	PRINTFORM 「…あ。　ごっ、ごめんなさいっ。　これ、全然治まらないの……ふぅ
PRINTFORMW 「こういう時だけは貴女の行動力が心強いのよね…こういう時だけ」	PRINTFORMW 「こういう時だけは貴女の行動力が心強いのよね…こういう時だけ」
PRINTFORMW 「…それにしても……随分と人の形に近い子供も産まれるのね……」	PRINTFORMW 「…それにしても……随分と人の形に近い子供も産まれるのね……」
PRINTFORMW 「ミルク…染み出してくる……というかこの胸…美鈴より大きい？」	PRINTFORMW 「ミルク…染み出してくる……というかこの胸…美鈴より大きい？」
PRINTFORM 　びゅくんびゅくんしちゃうの…きもひいいのぉ…もっとコスってぇ…	PRINTFORM 　びゅくんびゅくんしちゃうの…きもひいいのぉ…もっとコスってぇ…
PRINTFORM 「ちっ、乳首…？　ちょっ…やっ…吸っ、吸ったって何も…んきゅぅっ	PRINTFORM 「ちっ、乳首…？　ちょっ…やっ…吸っ、吸ったって何も…んきゅぅっ
PRINTFORM 「ひぅッッ？！　やっ…やだっ？　これ…やっ、やっぱり吸ってるっっ	PRINTFORM 「ひぅッッ？！　やっ…やだっ？　これ…やっ、やっぱり吸ってるっっ
PRINTFORMW 「こう常に触手に揉まれていれば…胸も自然に大きくなるかしら？」	PRINTFORMW 「こう常に触手に揉まれていれば…胸も自然に大きくなるかしら？」
PRINTFORML 「ううっ…まるで誰かの手で、ずっとたぷたぷとされてるみたい…」	PRINTFORML 「ううっ…まるで誰かの手で、ずっとたぷたぷとされてるみたい…」
PRINTFORMW 「やっ…腕が勝手に……も、もう十分なのに……これ以上は…んんっ	PRINTFORMW 「やっ…腕が勝手に……も、もう十分なのに……これ以上は…んんっ
PRINTFORM 「さぁ…好きにしなさい。　でも…ちゃんと私も気持ち良くするのよ	PRINTFORM 「さぁ…好きにしなさい。　でも…ちゃんと私も気持ち良くするのよ
PRINTFORMW 「クリトリス…凄く敏感になっちゃってるから…ねぇ…お願い…」	PRINTFORMW 「クリトリス…凄く敏感になっちゃってるから…ねぇ…お願い…」
PRINTFORMW 「え？　そんなところを叩いて欲しいの…？　こっこうかしら？」	PRINTFORMW 「え？　そんなところを叩いて欲しいの…？　こっこうかしら？」
PRINTFORM 　%CALLNAME:(TARGET)%様の凄く硬くなってる…	PRINTFORM 　%CALLNAME:(TARGET)%様の凄く硬くなってる…
PRINTFORM 　挿入れちゃいますよ、%CALLNAME:(TARGET)%様	PRINTFORM 　挿入れちゃいますよ、%CALLNAME:(TARGET)%様
PRINTFORMW 「これだけ脱がせば十分でしょ…早く直接…お願い…欲しいの…」	PRINTFORMW 「これだけ脱がせば十分でしょ…早く直接…お願い…欲しいの…」
PRINTFORMW 　胸を触手がぐにぐにしてるのに…なすがままなんて…ううぅ…」	PRINTFORMW 　胸を触手がぐにぐにしてるのに…なすがままなんて…ううぅ…」
PRINTFORMW 　違うの…自分から擦り付けて…気持ちよくなってるわけじゃ…」	PRINTFORMW 　違うの…自分から擦り付けて…気持ちよくなってるわけじゃ…」
PRINTFORMW 「しまっ…？！　…ミスったわね。どうにか振りほどかないと…」	PRINTFORMW 「しまっ…？！　…ミスったわね。どうにか振りほどかないと…」
PRINTFORM 　ダメっ、%CALLNAME_8_0(CFLAG:900)%ッ	PRINTFORM 　ダメっ、%CALLNAME_8_0(CFLAG:900)%ッ
PRINTFORMW 「……はぁ…そんな事したって無駄よ……だってもうすでに……」	PRINTFORMW 「……はぁ…そんな事したって無駄よ……だってもうすでに……」
PRINTFORMW 「けほっけほっ……あ…今のひょっとして……身体が…熱い……」	PRINTFORMW 「けほっけほっ……あ…今のひょっとして……身体が…熱い……」
PRINTFORMW 「え…あ……やだ…急に疼いてきちゃって…どうしよう…これ…」	PRINTFORMW 「え…あ……やだ…急に疼いてきちゃって…どうしよう…これ…」
PRINTFORMDW %CALLNAME:(TARGET)%は平静を装っている…	PRINTFORMDW %CALLNAME:(TARGET)%は平静を装っている…
PRINTFORMW 「ふぅ…少し戻ったわね。流石にあの大きさのままでは困るわ…」	PRINTFORMW 「ふぅ…少し戻ったわね。流石にあの大きさのままでは困るわ…」
PRINTFORMW 「…胸なんて大きくても邪魔なだけよ、これくらいが丁度いいわ」	PRINTFORMW 「…胸なんて大きくても邪魔なだけよ、これくらいが丁度いいわ」
PRINTFORMDW その隙を見逃さず足元の触手達が一斉に蜜の分泌源に殺到する…	PRINTFORMDW その隙を見逃さず足元の触手達が一斉に蜜の分泌源に殺到する…
PRINTFORMW 「うぅ…もう入らないわよ…こんな溢れるまで射精しなくても…」	PRINTFORMW 「うぅ…もう入らないわよ…こんな溢れるまで射精しなくても…」
PRINTFORMW 「そ、そうね。身体能力的に私を底上げするのも良い作戦よね…」	PRINTFORMW 「そ、そうね。身体能力的に私を底上げするのも良い作戦よね…」
PRINTFORMW 　全部…吸われたのかしら…母乳が染み出して来なくなったわね」	PRINTFORMW 　全部…吸われたのかしら…母乳が染み出して来なくなったわね」
PRINTFORMW 「…えっ！？　このふさふさしたのは…耳？　って、尻尾まで…」	PRINTFORMW 「…えっ！？　このふさふさしたのは…耳？　って、尻尾まで…」
PRINTFORMDL ぶびゅるっ！！！ぶびっ！！どびゅるるるるるっっっっ！！！！	PRINTFORMDL ぶびゅるっ！！！ぶびっ！！どびゅるるるるるっっっっ！！！！
PRINTFORM 　膣内で…%CALLNAME:(TARGET)%様のが大きく…	PRINTFORM 　膣内で…%CALLNAME:(TARGET)%様のが大きく…
PRINTFORM 　%CALLNAME_8_0(ARG:3)%の胸…気持ちいい…	PRINTFORM 　%CALLNAME_8_0(ARG:3)%の胸…気持ちいい…
PRINTFORMW 　解ってるわよ…せーえき…思いっきり射精したいんでしょう？」	PRINTFORMW 　解ってるわよ…せーえき…思いっきり射精したいんでしょう？」
PRINTFORMW 「おちんちん、こんなになったままじゃ…お願い、いいでしょ？」	PRINTFORMW 「おちんちん、こんなになったままじゃ…お願い、いいでしょ？」
PRINTFORMW 「まぁ結果として大人しくなってくれれば私は構わないんだけど」	PRINTFORMW 「まぁ結果として大人しくなってくれれば私は構わないんだけど」
PRINTFORMW 「…ふぅ　…最後はなんとか…理性を取り戻して引き抜けたわ…」	PRINTFORMW 「…ふぅ　…最後はなんとか…理性を取り戻して引き抜けたわ…」
PRINTFORM 「んんぅ…そんなに優しく締め付けたら…射精止まらないじゃない…	PRINTFORM 「んんぅ…そんなに優しく締め付けたら…射精止まらないじゃない…
PRINTFORM 「はぁ…はぁ…………すっきり…した？　そう…それなら良かったわ	PRINTFORM 「はぁ…はぁ…………すっきり…した？　そう…それなら良かったわ
PRINTFORM 　凄く良かったわ…%CALLNAME_8_0(ARG:0)%…	PRINTFORM 　凄く良かったわ…%CALLNAME_8_0(ARG:0)%…
PRINTFORMDW 幸せそうな顔を浮かべながら意識を失いそのまま眠りについた…	PRINTFORMDW 幸せそうな顔を浮かべながら意識を失いそのまま眠りについた…
PRINTFORM 　ごめんなさい%CALLNAME_8_0(ARG:0)%…私っ	PRINTFORM 　ごめんなさい%CALLNAME_8_0(ARG:0)%…私っ
PRINTFORM 　イかされちゃう…わたし…身体を売った相手にイかされちゃうのぉ	PRINTFORM 　イかされちゃう…わたし…身体を売った相手にイかされちゃうのぉ
PRINTFORM 　たくさん…出たのね。　膣内に射精してくれても…良かったのにぃ	PRINTFORM 　たくさん…出たのね。　膣内に射精してくれても…良かったのにぃ
PRINTFORMW 「…ぅ……うああわぁぁぁぁぁぁあああぁっっっっっっ！！！！」	PRINTFORMW 「…ぅ……うああわぁぁぁぁぁぁあああぁっっっっっっ！！！！」
PRINTFORMW 「…………拾ったからって別に無理に使わなくてもいいんだし…」	PRINTFORMW 「…………拾ったからって別に無理に使わなくてもいいんだし…」
PRINTFORMDW おもむろに少しだけ湿った秘部にその小さな手を滑り込ませた…	PRINTFORMDW おもむろに少しだけ湿った秘部にその小さな手を滑り込ませた…
PRINTFORMW 「んきゅぅ…こんな大きなお腹だと…とても動きづらいわね……」	PRINTFORMW 「んきゅぅ…こんな大きなお腹だと…とても動きづらいわね……」
PRINTFORMW 「少し部屋の中を調べてみましょうか、何かあるかもしれないし」	PRINTFORMW 「少し部屋の中を調べてみましょうか、何かあるかもしれないし」
PRINTFORMW 「まずは自分の居る場所の状態を、しっかり理解するのが重要ね」	PRINTFORMW 「まずは自分の居る場所の状態を、しっかり理解するのが重要ね」
PRINTFORM 「そっ、それ何っ？！　そんなの挿入れられンあアァああぁぁッッッ	PRINTFORM 「そっ、それ何っ？！　そんなの挿入れられンあアァああぁぁッッッ
PRINTFORMDW その舌と亀頭の間にかかる唾液の橋が淫靡な輝きを放っている	PRINTFORMDW その舌と亀頭の間にかかる唾液の橋が淫靡な輝きを放っている
PRINTFORMDW %CALLNAME:(TARGET)%は自嘲気味に笑った	PRINTFORMDW %CALLNAME:(TARGET)%は自嘲気味に笑った
PRINTFORM 「わ…私…もう…待ち切れないんです……お願いします…ご主人様	PRINTFORM 「わ…私…もう…待ち切れないんです……お願いします…ご主人様
PRINTFORMW 「お尻っ…お尻の穴…早くぬぽぬぽしてっ！！　お願いよぉ…」	PRINTFORMW 「お尻っ…お尻の穴…早くぬぽぬぽしてっ！！　お願いよぉ…」
PRINTFORMW 「ほら見て%CALLNAME_8_0(RESULT)%…」	PRINTFORMW 「ほら見て%CALLNAME_8_0(RESULT)%…」
PRINTFORM 「はぁ…%CALLNAME:(TARGET)%様の牝の匂い…	PRINTFORM 「はぁ…%CALLNAME:(TARGET)%様の牝の匂い…
PRINTFORMW 「んっ…！　こっちも少し痛い…けど…このまま我慢すれば…」	PRINTFORMW 「んっ…！　こっちも少し痛い…けど…このまま我慢すれば…」
PRINTFORM 　もっと…気持ちいいの溜めてから…どっびゅーーーって射精すの	PRINTFORM 　もっと…気持ちいいの溜めてから…どっびゅーーーって射精すの
PRINTFORM 　そんなに私のおちんちんで…気持ちよくなりたいの？　んはぁ…	PRINTFORM 　そんなに私のおちんちんで…気持ちよくなりたいの？　んはぁ…
PRINTFORM 「いっいや…身体が勝手に…腰を落として…ぬぶぬぶって……んぅ	PRINTFORM 「いっいや…身体が勝手に…腰を落として…ぬぶぬぶって……んぅ
PRINTFORM 　ダメなのに…膣内にびゅくびゅくされて…イっちゃうぅぅぅッッ	PRINTFORM 　ダメなのに…膣内にびゅくびゅくされて…イっちゃうぅぅぅッッ
PRINTFORMW 「うわぁ…私の顔に向かって何を……もうやだ……しくしく…」	PRINTFORMW 「うわぁ…私の顔に向かって何を……もうやだ……しくしく…」
PRINTFORMW 「あ…下着が……ううん、恥ずかしくない恥ずかしくない……」	PRINTFORMW 「あ…下着が……ううん、恥ずかしくない恥ずかしくない……」
PRINTFORM 「もう…誰の声も届かない……あ…それなら別に気負わないでも…	PRINTFORM 「もう…誰の声も届かない……あ…それなら別に気負わないでも…
PRINTFORMW 「ごめんなさい、ちょっと対策を考える時間が必要そうなの…」	PRINTFORMW 「ごめんなさい、ちょっと対策を考える時間が必要そうなの…」
PRINTFORM 「皆の前でご主人様に抱かれるだなんて…恥ずかしいけど嬉しいっ	PRINTFORM 「皆の前でご主人様に抱かれるだなんて…恥ずかしいけど嬉しいっ
PRINTFORMW 「いっ？！　いやっ！！　入って来ちゃ…ぁあっ！　あぁ……」	PRINTFORMW 「いっ？！　いやっ！！　入って来ちゃ…ぁあっ！　あぁ……」
PRINTFORMDW 体内に捕食したスーツ形状の生物をゆっくりと味わっていた…	PRINTFORMDW 体内に捕食したスーツ形状の生物をゆっくりと味わっていた…
PRINTFORMW 「…っ？！　身体に害はないけど…この服はもう着れないわね」	PRINTFORMW 「…っ？！　身体に害はないけど…この服はもう着れないわね」
PRINTFORMW 「なにこれ…ベトベトして生臭くて、まるで……んぶっ！！！」	PRINTFORMW 「なにこれ…ベトベトして生臭くて、まるで……んぶっ！！！」
PRINTFORM 　私の胸…どうなっちゃったの…触ってるだけで…シビれちゃう…	PRINTFORM 　私の胸…どうなっちゃったの…触ってるだけで…シビれちゃう…
PRINTFORM 「だ…ダメ……そんな沢山で来ても……もう入らな…んあああッッ	PRINTFORM 「だ…ダメ……そんな沢山で来ても……もう入らな…んあああッッ
PRINTFORM 「ふふっ……これなら…好きなだけおちんちんイジっていられるわ	PRINTFORM 「ふふっ……これなら…好きなだけおちんちんイジっていられるわ
PRINTFORM 　まだですよ…しっかり精を溜めて…たっぷりとおくちに下さいね	PRINTFORM 　まだですよ…しっかり精を溜めて…たっぷりとおくちに下さいね
PRINTFORM 「パチュリーさま…私のこの舌で念入りに…ご奉仕させて頂きます	PRINTFORM 「パチュリーさま…私のこの舌で念入りに…ご奉仕させて頂きます
PRINTFORMW 「…解ったわよ。　ほら、シてあげるから股間のモノを出して」	PRINTFORMW 「…解ったわよ。　ほら、シてあげるから股間のモノを出して」
PRINTFORMW 「（ごくっ）…この服の形した触手…そんなに良かったの…？」	PRINTFORMW 「（ごくっ）…この服の形した触手…そんなに良かったの…？」
PRINTFORMW 「はぁ…はぁ……ご…ごめんなさい…どうしても抗えなくて…」	PRINTFORMW 「はぁ…はぁ……ご…ごめんなさい…どうしても抗えなくて…」
PRINTFORM 「…ふふっ…いっぱい射精たわね…体中べとべとになっちゃったわ	PRINTFORM 「…ふふっ…いっぱい射精たわね…体中べとべとになっちゃったわ
PRINTFORM 　さっき…射精されたばっかりなのに…また…膣内で…大きくッッ	PRINTFORM 　さっき…射精されたばっかりなのに…また…膣内で…大きくッッ
PRINTFORM 「お願い…%CALLNAME_8_0(ARG:0, 1)%っ	PRINTFORM 「お願い…%CALLNAME_8_0(ARG:0, 1)%っ
PRINTFORML 「…そうね。別にアイテムをあげるのは構わないのだけれど…」	PRINTFORML 「…そうね。別にアイテムをあげるのは構わないのだけれど…」
PRINTFORML 「その…これ…鎮まらなくて困っているの…だから……いい？」	PRINTFORML 「その…これ…鎮まらなくて困っているの…だから……いい？」
PRINTFORML 「これ、鎮まらなくて困っているの…だから……解るわよね？」	PRINTFORML 「これ、鎮まらなくて困っているの…だから……解るわよね？」
PRINTFORMW 　…ふぅ　本当にごめんなさい…私だけ先にイってしまって…」	PRINTFORMW 　…ふぅ　本当にごめんなさい…私だけ先にイってしまって…」
PRINTFORMW 　…ひど…い…なかで…いい…なんて…いってない…のにぃ…」	PRINTFORMW 　…ひど…い…なかで…いい…なんて…いってない…のにぃ…」
PRINTFORMW 　…膣内で射精したのね。　その分…良いアイテム貰うわよ♪」	PRINTFORMW 　…膣内で射精したのね。　その分…良いアイテム貰うわよ♪」
PRINTFORMW （やだ……考えただけで…おちんちん…びくんびくんしてる…）	PRINTFORMW （やだ……考えただけで…おちんちん…びくんびくんしてる…）
PRINTFORMW 「あらフラン。みんなは見なかった？　……そう、ありがとう」	PRINTFORMW 「あらフラン。みんなは見なかった？　……そう、ありがとう」
PRINTFORMW 「アリス…どう？そっちは……ん、出口は見つからない…か…」	PRINTFORMW 「アリス…どう？そっちは……ん、出口は見つからない…か…」
PRINTFORMW 「…敵？！　…じゃないみたいね。失礼、こんな場所だから…」	PRINTFORMW 「…敵？！　…じゃないみたいね。失礼、こんな場所だから…」
PRINTFORMW 「それじゃひとつ共闘と行きましょうか。よろしくね、アリス」	PRINTFORMW 「それじゃひとつ共闘と行きましょうか。よろしくね、アリス」
PRINTFORMW 「この丸薬…不眠症だからって使うとエラい目に合うのよね…」	PRINTFORMW 「この丸薬…不眠症だからって使うとエラい目に合うのよね…」
PRINTFORMW 「……はぁ…こんな事…してる場合じゃないのだろうけれど…」	PRINTFORMW 「……はぁ…こんな事…してる場合じゃないのだろうけれど…」
PRINTFORMW 「…そうね。　今のところは別行動の方が効率がいいわよね。」	PRINTFORMW 「…そうね。　今のところは別行動の方が効率がいいわよね。」
PRINTFORMW 「ぅぁ…？　やっ、やだっ…おしりの穴…ぅぅ…拡げないで…」	PRINTFORMW 「ぅぁ…？　やっ、やだっ…おしりの穴…ぅぅ…拡げないで…」
PRINTFORMW 「……しかも、こんなモノが付いてるのが一目瞭然じゃない…」	PRINTFORMW 「……しかも、こんなモノが付いてるのが一目瞭然じゃない…」
PRINTFORM 「な…なんで……子宮に射精されるのがこんなに…気持ちいいの…	PRINTFORM 「な…なんで……子宮に射精されるのがこんなに…気持ちいいの…
PRINTFORML ふたなり関係を見たい人はコンフィグのスイッチもONにしてね	PRINTFORML ふたなり関係を見たい人はコンフィグのスイッチもONにしてね
PRINTFORMW 「あれ…前…出たら…真っ先に狙われちゃうんじゃない…？」	PRINTFORMW 「あれ…前…出たら…真っ先に狙われちゃうんじゃない…？」
PRINTFORMW 　…もう…こっちからおっぱいで挟み込んじゃおうかしら…」	PRINTFORMW 　…もう…こっちからおっぱいで挟み込んじゃおうかしら…」
PRINTFORMW 「…え…う…うそ…逃げたいのに…足が勝手に敵の方へと…」	PRINTFORMW 「…え…う…うそ…逃げたいのに…足が勝手に敵の方へと…」
PRINTFORMW 「また身体が勝手に……横になって……あ…意識……が……」	PRINTFORMW 「また身体が勝手に……横になって……あ…意識……が……」
PRINTFORM 「少し疲れたわ。先に休ませてもらえるかしら？　貴方の側で…	PRINTFORM 「少し疲れたわ。先に休ませてもらえるかしら？　貴方の側で…
PRINTFORMW 「これが東洋の健康器具ねぇ…こんなもので効くのかしら？」	PRINTFORMW 「これが東洋の健康器具ねぇ…こんなもので効くのかしら？」
PRINTFORM 　したくないのに…こんなにえっちに…腰をくねらせて…んんっ	PRINTFORM 　したくないのに…こんなにえっちに…腰をくねらせて…んんっ
PRINTFORM 「ずるずる…ぶっといのが出たり入ったりして…はあぁぁんっっ	PRINTFORM 「ずるずる…ぶっといのが出たり入ったりして…はあぁぁんっっ
PRINTFORM 「…やっぱりそっちだったわね…解ってたけど裏をかい…んふぅ	PRINTFORM 「…やっぱりそっちだったわね…解ってたけど裏をかい…んふぅ
PRINTFORM 「%CALLNAME:(TARGET)%様の身体…柔らかい	PRINTFORM 「%CALLNAME:(TARGET)%様の身体…柔らかい
PRINTFORMDW やがて観念して口内を埋め尽くす多量の粘液の飲み下した…	PRINTFORMDW やがて観念して口内を埋め尽くす多量の粘液の飲み下した…
PRINTFORM 　せーえき…あふれちゃったからぁ…もっとぉ…ちょうらぁい…	PRINTFORM 　せーえき…あふれちゃったからぁ…もっとぉ…ちょうらぁい…
PRINTFORMW 「んん…そんな焦らすように動いても……負けないわよ……」	PRINTFORMW 「んん…そんな焦らすように動いても……負けないわよ……」
PRINTFORMW 「グロテスクね…私の下腹部目掛けて来てたけど…もしや…」	PRINTFORMW 「グロテスクね…私の下腹部目掛けて来てたけど…もしや…」
PRINTFORMW 　こんなに搾り取られちゃ……身体が……持たないわよ……」	PRINTFORMW 　こんなに搾り取られちゃ……身体が……持たないわよ……」
PRINTFORM 　すみません…ご主人様……私が…先に……果ててしまって……	PRINTFORM 　すみません…ご主人様……私が…先に……果ててしまって……
PRINTFORMW 「え…膣内に何か残って……違う、これ…子宮にっ……？！」	PRINTFORMW 「え…膣内に何か残って……違う、これ…子宮にっ……？！」
PRINTFORM 　おちんちんが……これ…下着が擦れるだけでイっちゃいそう…	PRINTFORM 　おちんちんが……これ…下着が擦れるだけでイっちゃいそう…
PRINTFORM 　クリトリスが……これ…下着が擦れるだけでイっちゃいそう…	PRINTFORM 　クリトリスが……これ…下着が擦れるだけでイっちゃいそう…
PRINTFORMW 「じゃあ頑張って。　貴女を強化するのが一番効率良いの。」	PRINTFORMW 「じゃあ頑張って。　貴女を強化するのが一番効率良いの。」
PRINTFORM 「ほら…こんな状況だし…せめて一緒に愉しみましょう……んっ	PRINTFORM 「ほら…こんな状況だし…せめて一緒に愉しみましょう……んっ
PRINTFORMDL びゅくっ！びゅくるるッッ！！！びゅくっ！びゅくっ！！！	PRINTFORMDL びゅくっ！びゅくるるッッ！！！びゅくっ！びゅくっ！！！
PRINTFORM 　%CALLNAME:(TARGET)%様の濃いぃせーえき	PRINTFORM 　%CALLNAME:(TARGET)%様の濃いぃせーえき
PRINTFORMW 　はぁ…　こういう悪趣味なのは…今後勘弁願いたいわね…」	PRINTFORMW 　はぁ…　こういう悪趣味なのは…今後勘弁願いたいわね…」
PRINTFORM 　%CALLNAME_8_0(ARG:3)%のお尻の穴にっ	PRINTFORM 　%CALLNAME_8_0(ARG:3)%のお尻の穴にっ
PRINTFORM 　相変わらずね%CALLNAME_8_0(ARG:3)%…	PRINTFORM 　相変わらずね%CALLNAME_8_0(ARG:3)%…
PRINTFORM 「そんな臭い嗅がせられるから私…我慢できなくなっちゃったわ	PRINTFORM 「そんな臭い嗅がせられるから私…我慢できなくなっちゃったわ
PRINTFORM 　私のお尻で気持ち良～くしてあげるから…いっぱい射精してね	PRINTFORM 　私のお尻で気持ち良～くしてあげるから…いっぱい射精してね
PRINTFORM 「お尻だったら…いいわよ？　貴女のおちんちんを挿入れても…	PRINTFORM 「お尻だったら…いいわよ？　貴女のおちんちんを挿入れても…
PRINTFORMW 「まったく、そもそも裸なんだからやる事はひとつでしょ…」	PRINTFORMW 「まったく、そもそも裸なんだからやる事はひとつでしょ…」
PRINTFORM 　どうしたの？　そんな顔してキュウキュウ締め付けちゃって…	PRINTFORM 　どうしたの？　そんな顔してキュウキュウ締め付けちゃって…
PRINTFORMW 「…仕方ないわね。背に腹は変えられないし…早く済ませて」	PRINTFORMW 「…仕方ないわね。背に腹は変えられないし…早く済ませて」
PRINTFORMW （やだ…何考えてるの…仮にも自分の娘に欲情するなんて…）	PRINTFORMW （やだ…何考えてるの…仮にも自分の娘に欲情するなんて…）
PRINTFORMW 「どこ行ってたのよ小悪魔。テレパスも通じないんだもの…」	PRINTFORMW 「どこ行ってたのよ小悪魔。テレパスも通じないんだもの…」
PRINTFORMW 「……なあに？　女同士だというのに裸がそんなに珍しい？」	PRINTFORMW 「……なあに？　女同士だというのに裸がそんなに珍しい？」
PRINTFORMW 「何か拾ったけど…調べるのは後でいいわ…ふぁぁ…ねむ…」	PRINTFORMW 「何か拾ったけど…調べるのは後でいいわ…ふぁぁ…ねむ…」
PRINTFORMW 「うう…気味悪いけど…それほど害があるわけでもないし…」	PRINTFORMW 「うう…気味悪いけど…それほど害があるわけでもないし…」
PRINTFORMW 「いっ……んく…この痛み……きっと、もうじき産まれて…」	PRINTFORMW 「いっ……んく…この痛み……きっと、もうじき産まれて…」
PRINTFORMW 「もういい加減寝られそうな場所を見つけないと…急ぐわよ」	PRINTFORMW 「もういい加減寝られそうな場所を見つけないと…急ぐわよ」
PRINTFORM 「だ…誰か…来ないの……この際誰でもいいから…この身体を…	PRINTFORM 「だ…誰か…来ないの……この際誰でもいいから…この身体を…
PRINTFORM 　ミルク欲しいの…？　いいわよ…そう…たっぷり吸って…んっ	PRINTFORM 　ミルク欲しいの…？　いいわよ…そう…たっぷり吸って…んっ
PRINTFORMW 「乳首…ずっと勃起しちゃってる…皆に見られちゃってる…」	PRINTFORMW 「乳首…ずっと勃起しちゃってる…皆に見られちゃってる…」
PRINTFORM 　おっぱいのところのスライムが…じゅるじゅるって蠢いてる…	PRINTFORM 　おっぱいのところのスライムが…じゅるじゅるって蠢いてる…
PRINTFORM 「あ…やだ、私、口の周りべとべとで……ぺろ……ん…美味しい	PRINTFORM 「あ…やだ、私、口の周りべとべとで……ぺろ……ん…美味しい
PRINTFORML 「……はぁ…ようやく身体が動かせる様になってきたわね。」	PRINTFORML 「……はぁ…ようやく身体が動かせる様になってきたわね。」
PRINTFORMW 「気持ち悪いだろうけど…すぐ解放してあげるからっ！！」	PRINTFORMW 「気持ち悪いだろうけど…すぐ解放してあげるからっ！！」
PRINTFORMW 「守りにはあまり自信ないけど、なんとか耐えて勝機を…」	PRINTFORMW 「守りにはあまり自信ないけど、なんとか耐えて勝機を…」
PRINTFORMDW 手をかざした瞬間、凶器と化した水流が敵の足元を襲う。	PRINTFORMDW 手をかざした瞬間、凶器と化した水流が敵の足元を襲う。
PRINTFORMW 　私のナカをいっぱいに満たし…ぅぅん、集中しなきゃ…」	PRINTFORMW 　私のナカをいっぱいに満たし…ぅぅん、集中しなきゃ…」
PRINTFORML 「……これで終わり。さっさと私の視界から消えなさい！」	PRINTFORML 「……これで終わり。さっさと私の視界から消えなさい！」
PRINTFORMDW 両手から放たれた水流が周囲の敵全てをなぎ払っていく。	PRINTFORMDW 両手から放たれた水流が周囲の敵全てをなぎ払っていく。
PRINTFORM 「た…耐えなきゃ…なんとか耐えて…力を集中……ひゃぁんっ	PRINTFORM 「た…耐えなきゃ…なんとか耐えて…力を集中……ひゃぁんっ
PRINTFORM 「ペットのあなたに精気を吸われるのも…私の役目よね…ほら	PRINTFORM 「ペットのあなたに精気を吸われるのも…私の役目よね…ほら
PRINTFORM 「お願い…おちんちん…破裂しそうなの……コスコスしてぇっ	PRINTFORM 「お願い…おちんちん…破裂しそうなの……コスコスしてぇっ
PRINTFORM 「…わかった。私のとっておきの一張羅を見せて、あ・げ・る	PRINTFORM 「…わかった。私のとっておきの一張羅を見せて、あ・げ・る
PRINTFORMW 「私も少しは身体を…動かさないといけないかもね…っと」	PRINTFORMW 「私も少しは身体を…動かさないといけないかもね…っと」
PRINTFORM 　お願い%CALLNAME_8_0(ARG:2,1)%…	PRINTFORM 　お願い%CALLNAME_8_0(ARG:2,1)%…
PRINTFORM 「ねぇ…%CALLNAME_8_0(ARG:2,1)%…	PRINTFORM 「ねぇ…%CALLNAME_8_0(ARG:2,1)%…
PRINTFORM 「確実に受精するくらい…たっっぷりと種付けして欲しいの…	PRINTFORM 「確実に受精するくらい…たっっぷりと種付けして欲しいの…
PRINTFORM 「おしりの穴…広がっちゃうくらい…もっとズポズポしてぇっ	PRINTFORM 「おしりの穴…広がっちゃうくらい…もっとズポズポしてぇっ
PRINTFORM 　おっぱいとろとろぉ…もっと…いっぱい…にゅるにゅるって	PRINTFORM 　おっぱいとろとろぉ…もっと…いっぱい…にゅるにゅるって
PRINTFORM 　おマメ…イジってとは言ったけど…こんなに強くなんてぇっ	PRINTFORM 　おマメ…イジってとは言ったけど…こんなに強くなんてぇっ
PRINTFORM 　太いぬるぬる出し入れされるだけで…幸せになっちゃうぅぅ	PRINTFORM 　太いぬるぬる出し入れされるだけで…幸せになっちゃうぅぅ
PRINTFORMW 「…やった。ついに…あの忌々しい服から解放されたわ…」	PRINTFORMW 「…やった。ついに…あの忌々しい服から解放されたわ…」
PRINTFORMW 「もう身に纏っているだけ無駄ね、こんなボロボロの布…」	PRINTFORMW 「もう身に纏っているだけ無駄ね、こんなボロボロの布…」
PRINTFORMW 「…うちの門番も、あれくらいのプレッシャーがあればね」	PRINTFORMW 「…うちの門番も、あれくらいのプレッシャーがあればね」
PRINTFORM 「%CALLNAME:(TARGET)%様…愛しています	PRINTFORM 「%CALLNAME:(TARGET)%様…愛しています
PRINTFORM 　このヌルヌルした液体…身体中に染み込んでくる……ふはぁ	PRINTFORM 　このヌルヌルした液体…身体中に染み込んでくる……ふはぁ
PRINTFORMW 「…………（ガスが……一時たりとも油断しちゃダメね）」	PRINTFORMW 「…………（ガスが……一時たりとも油断しちゃダメね）」
PRINTFORM 「や…こっこの蟲達……だっダメっ！　おしり入って来ちゃっ	PRINTFORM 「や…こっこの蟲達……だっダメっ！　おしり入って来ちゃっ
PRINTFORMDW が…その体勢は余計に蟲を群がらせてしまうのであった…	PRINTFORMDW が…その体勢は余計に蟲を群がらせてしまうのであった…
PRINTFORMW 　このままだと戦いにも支障が出るでしょう？　だから…」	PRINTFORMW 　このままだと戦いにも支障が出るでしょう？　だから…」
PRINTFORM 　奥…ぴったり押し付けて…たっぷり搾り取って…あ・げ・る	PRINTFORM 　奥…ぴったり押し付けて…たっぷり搾り取って…あ・げ・る
PRINTFORM 　やだ…股間に付いてるコレから…何か痺れの様な……ふはぁ	PRINTFORM 　やだ…股間に付いてるコレから…何か痺れの様な……ふはぁ
PRINTFORMW 「…ねぇ…いいでしょ？　女同士なんだし少しくらい……」	PRINTFORMW 「…ねぇ…いいでしょ？　女同士なんだし少しくらい……」
PRINTFORM 　貴女達のを見てたら私も…先に謝っておくわ、ごめんなさい	PRINTFORM 　貴女達のを見てたら私も…先に謝っておくわ、ごめんなさい
PRINTFORM 　いいわ…%CALLNAME_8_0(ARG:3,1)%	PRINTFORM 　いいわ…%CALLNAME_8_0(ARG:3,1)%
PRINTFORM 　いいわよ…%CALLNAME_8_0(ARG:3)%…	PRINTFORM 　いいわよ…%CALLNAME_8_0(ARG:3)%…
PRINTFORM 「その辺に射精されちゃ勿体無いわ…私が…全部飲んであげる	PRINTFORM 「その辺に射精されちゃ勿体無いわ…私が…全部飲んであげる
PRINTFORMW 「な…なによ？　この触手っっ！？　急に絡まってきて…」	PRINTFORMW 「な…なによ？　この触手っっ！？　急に絡まってきて…」
PRINTFORM 　%CALLNAME_8_0(LOCAL:0, 1)%…	PRINTFORM 　%CALLNAME_8_0(LOCAL:0, 1)%…
PRINTFORMW 「……んん……えっ？　ちょっ、ちょっと何をしようと…」	PRINTFORMW 「……んん……えっ？　ちょっ、ちょっと何をしようと…」
PRINTFORMW 「大人しくしていてね…なるべく痛くない様にするから…」	PRINTFORMW 「大人しくしていてね…なるべく痛くない様にするから…」
PRINTFORMW 「え…ぶるぶるして…ちょっ、ちょっと！もしかして……」	PRINTFORMW 「え…ぶるぶるして…ちょっ、ちょっと！もしかして……」
PRINTFORMW 「…ぅ…ぅぅ………おわ…ったの？　もういい…ねる……」	PRINTFORMW 「…ぅ…ぅぅ………おわ…ったの？　もういい…ねる……」
PRINTFORM 「え…膣内に…欲しかった？　じゃあ…次にする時は……ねっ	PRINTFORM 「え…膣内に…欲しかった？　じゃあ…次にする時は……ねっ
PRINTFORM 「ん…%CALLNAME_8_0(ARG:0, 1)%…	PRINTFORM 「ん…%CALLNAME_8_0(ARG:0, 1)%…
PRINTFORMW 「小悪魔、会えて丁度良かったわ。暖かい紅茶をお願……」	PRINTFORMW 「小悪魔、会えて丁度良かったわ。暖かい紅茶をお願……」
PRINTFORMW 「お互いの知っている情報を合わせて整理しましょうか…」	PRINTFORMW 「お互いの知っている情報を合わせて整理しましょうか…」
PRINTFORM 　そんなにぬりゅんって巻きついて…やっ…搾り…出される…	PRINTFORM 　そんなにぬりゅんって巻きついて…やっ…搾り…出される…
PRINTFORMW 「ぐ…中で暴れて…いい加減出てきてくれないかしら……」	PRINTFORMW 「ぐ…中で暴れて…いい加減出てきてくれないかしら……」
PRINTFORMW 「魔物と…の…赤ちゃん……産まれちゃうっ……ッッ！！」	PRINTFORMW 「魔物と…の…赤ちゃん……産まれちゃうっ……ッッ！！」
PRINTFORMW 「……可哀相だし勿体無い気もするけど…ごめんなさいっ」	PRINTFORMW 「……可哀相だし勿体無い気もするけど…ごめんなさいっ」
PRINTFORMW 「そろそろ…眠たいんだけど…今度の部屋はどうかしら…」	PRINTFORMW 「そろそろ…眠たいんだけど…今度の部屋はどうかしら…」
PRINTFORMW 「えーと、何か落ちて…………はっ？！　少し意識が……」	PRINTFORMW 「えーと、何か落ちて…………はっ？！　少し意識が……」
PRINTFORMW 「けほっけほっ…　持ち直して早々、えらい目にあったわ」	PRINTFORMW 「けほっけほっ…　持ち直して早々、えらい目にあったわ」
PRINTFORM 「…ぁ…ぅ…無理…こんなのを剥がすの…途中で絶対……ぅぅ	PRINTFORM 「…ぁ…ぅ…無理…こんなのを剥がすの…途中で絶対……ぅぅ
PRINTFORM 　奥まで突いてくれたら…きゅぅって締めちゃうから…ほらぁ	PRINTFORM 　奥まで突いてくれたら…きゅぅって締めちゃうから…ほらぁ
PRINTFORMW 　この温もりに包まれている感じ…なんだか落ち着くわ…」	PRINTFORMW 　この温もりに包まれている感じ…なんだか落ち着くわ…」
PRINTFORM 　待ってたわ…溜まっちゃってるおちんちんミルク…搾ってぇ	PRINTFORM 　待ってたわ…溜まっちゃってるおちんちんミルク…搾ってぇ
PRINTFORMW 　だ…だめ…服の中で射精しちゃう…そんなの…だめぇ…」	PRINTFORMW 　だ…だめ…服の中で射精しちゃう…そんなの…だめぇ…」
PRINTFORMW 　歩いている最中に胸が揉まれるのにも慣れてきた様な…」	PRINTFORMW 　歩いている最中に胸が揉まれるのにも慣れてきた様な…」
PRINTFORM 「あぁ……赤ちゃんの部屋…たっぷり満たされちゃってる……	PRINTFORM 「あぁ……赤ちゃんの部屋…たっぷり満たされちゃってる……
PRINTFORMW 「……んん…まだ…残ってるわよね…全部…飲ませて……」	PRINTFORMW 「……んん…まだ…残ってるわよね…全部…飲ませて……」
PRINTFORMDW 突如視界に飛び込んで来たその光景に大きく目を見開いた	PRINTFORMDW 突如視界に飛び込んで来たその光景に大きく目を見開いた
PRINTFORMDW 突如空中に現れた刃が、敵に狙いを定め唸りを上げる。	PRINTFORMDW 突如空中に現れた刃が、敵に狙いを定め唸りを上げる。
PRINTFORMDW 地中からせり出す巨大な宝石が次々と敵を襲っていく。	PRINTFORMDW 地中からせり出す巨大な宝石が次々と敵を襲っていく。
PRINTFORMDW 激しい水流が渦を巻き、螺旋の奇跡を描いて敵を貫く。	PRINTFORMDW 激しい水流が渦を巻き、螺旋の奇跡を描いて敵を貫く。
PRINTFORMW 「敵の数が多い…こうなったら、ありったけを使うわ！」	PRINTFORMW 「敵の数が多い…こうなったら、ありったけを使うわ！」
PRINTFORMW （ん…抜け出さなきゃいけないのに……私…本当は……）	PRINTFORMW （ん…抜け出さなきゃいけないのに……私…本当は……）
PRINTFORMW 「……はっ？　集中しようとしたのにぼーっとして……」	PRINTFORMW 「……はっ？　集中しようとしたのにぼーっとして……」
PRINTFORM 「も…もう…限界……私は……私は、目の前の快楽を選ぶわ	PRINTFORM 「も…もう…限界……私は……私は、目の前の快楽を選ぶわ
PRINTFORM 　なんだか私…あなたとのえっちにハマっちゃったみたい…	PRINTFORM 　なんだか私…あなたとのえっちにハマっちゃったみたい…
PRINTFORMW 「ねぇ…私のここ…満たされたくてヒクヒクしてるの…」	PRINTFORMW 「ねぇ…私のここ…満たされたくてヒクヒクしてるの…」
PRINTFORMW 「何かしらこれ？　いつの間に図書館にこんなものが…」	PRINTFORMW 「何かしらこれ？　いつの間に図書館にこんなものが…」
PRINTFORMW 「なんで私が…こんな事を…うぅ…違う…違うのよぉ…」	PRINTFORMW 「なんで私が…こんな事を…うぅ…違う…違うのよぉ…」
PRINTFORM 　もっと腰振らないと…いつまでも戦闘に集中できないわよ	PRINTFORM 　もっと腰振らないと…いつまでも戦闘に集中できないわよ
PRINTFORM 　やっぱり…ぢゅぽぢゅぽってハメられちゃうのが最高っっ	PRINTFORM 　やっぱり…ぢゅぽぢゅぽってハメられちゃうのが最高っっ
PRINTFORM 「やっ…やだっ？！　お尻だなんて聞いてな…ンあぁぁんっ	PRINTFORM 「やっ…やだっ？！　お尻だなんて聞いてな…ンあぁぁんっ
PRINTFORMW 　……お、落ち着いて…ちょっと気持ちよかっただけ…」	PRINTFORMW 　……お、落ち着いて…ちょっと気持ちよかっただけ…」
PRINTFORMW 「え…？　体の自由が…というか勝手に動いているわ？」	PRINTFORMW 「え…？　体の自由が…というか勝手に動いているわ？」
PRINTFORM 　そっそんなに射精したらっ…せーえき溢れちゃうぅぅっっ	PRINTFORM 　そっそんなに射精したらっ…せーえき溢れちゃうぅぅっっ
PRINTFORM 　ズポズポってするの…もうやめ……ぁ…また…膨らんで…	PRINTFORM 　ズポズポってするの…もうやめ……ぁ…また…膨らんで…
PRINTFORMW 　やっやめなさい…ってば……ッ！！　まっまたっ……」	PRINTFORMW 　やっやめなさい…ってば……ッ！！　まっまたっ……」
PRINTFORMW 「うわ…全身どろどろ……それに…酷い臭い……ぐすん」	PRINTFORMW 「うわ…全身どろどろ……それに…酷い臭い……ぐすん」
PRINTFORMW 　気持ち良過ぎて…もう…何も…考えられ…な…い……」	PRINTFORMW 　気持ち良過ぎて…もう…何も…考えられ…な…い……」
PRINTFORMW 　ごめん…なさい…もう無理……いっそ…素直…に……」	PRINTFORMW 　ごめん…なさい…もう無理……いっそ…素直…に……」
PRINTFORMW 「このままじゃ…なんとかして回復させてあげないと…」	PRINTFORMW 「このままじゃ…なんとかして回復させてあげないと…」
PRINTFORMDW その地道な責めについに屈服させられようとしていた…	PRINTFORMDW その地道な責めについに屈服させられようとしていた…
PRINTFORMW 「あら…気のせいかなんだか身体が軽くなったような…」	PRINTFORMW 「あら…気のせいかなんだか身体が軽くなったような…」
PRINTFORML 「やっ…やめてぇッッ！！！　それは私の…大事な……」	PRINTFORML 「やっ…やめてぇッッ！！！　それは私の…大事な……」
PRINTFORMW 「はぁ…はぁ…もし今のスライムが直撃していたら……」	PRINTFORMW 「はぁ…はぁ…もし今のスライムが直撃していたら……」
PRINTFORMW 「うぅ…やだ…お腹が熱いままで…何か残ってる感じ…」	PRINTFORMW 「うぅ…やだ…お腹が熱いままで…何か残ってる感じ…」
PRINTFORMW 「うぅ…身体が重い…これは…想像もしたくないわね…」	PRINTFORMW 「うぅ…身体が重い…これは…想像もしたくないわね…」
PRINTFORM 「ちょっ？！　や、やめなさい！　そんなと…こ……んぅ…	PRINTFORM 「ちょっ？！　や、やめなさい！　そんなと…こ……んぅ…
PRINTFORM 「んぷっ？！　んくっ！！！！　んっ！！　…んっ…ん…ん	PRINTFORM 「んぷっ？！　んくっ！！！！　んっ！！　…んっ…ん…ん
PRINTFORMW 　……身体が…火照って…もしかして今食べた実が……」	PRINTFORMW 　……身体が…火照って…もしかして今食べた実が……」
PRINTFORMW （ちょ…ちょっとっ！！　これ…うっ動けない……！？）	PRINTFORMW （ちょ…ちょっとっ！！　これ…うっ動けない……！？）
PRINTFORMDL どぷっ！ぶびゅびゅびゅっ！びゅくっ！！びゅくっ！！	PRINTFORMDL どぷっ！ぶびゅびゅびゅっ！びゅくっ！！びゅくっ！！
PRINTFORM 「うふふ…身体から沸き立つ精液の匂いが濃くなって来てる	PRINTFORM 「うふふ…身体から沸き立つ精液の匂いが濃くなって来てる
PRINTFORML 　おちんちんが熱く脈打っちゃってて…集中できない…」	PRINTFORML 　おちんちんが熱く脈打っちゃってて…集中できない…」
PRINTFORMW 「ほんとにまぁ…暢気にぐっすりと眠りこけちゃって…」	PRINTFORMW 「ほんとにまぁ…暢気にぐっすりと眠りこけちゃって…」
PRINTFORM 「こんな場所で寝てたら…別に私が犯しても誤差の範囲よね	PRINTFORM 「こんな場所で寝てたら…別に私が犯しても誤差の範囲よね
PRINTFORM 「ここまでヤられてたら…別に私が犯しても誤差の範囲よね	PRINTFORM 「ここまでヤられてたら…別に私が犯しても誤差の範囲よね
PRINTFORM 「たくさん射精すれば取れるの…だから…貴女も協力してね	PRINTFORM 「たくさん射精すれば取れるの…だから…貴女も協力してね
PRINTFORM 「ねぇ…%CALLNAME_8_0(ARG:3,1)%	PRINTFORM 「ねぇ…%CALLNAME_8_0(ARG:3,1)%
PRINTFORM 「%CALLNAME_8_0(ARG:3)%の膣内ぁ…	PRINTFORM 「%CALLNAME_8_0(ARG:3)%の膣内ぁ…
PRINTFORM 「ん…%CALLNAME_8_0(ARG:3,1)%…	PRINTFORM 「ん…%CALLNAME_8_0(ARG:3,1)%…
PRINTFORM 　どう…？　私のおまんこで…性欲解消してみるというのは	PRINTFORM 　どう…？　私のおまんこで…性欲解消してみるというのは
PRINTFORM 「おちんちん…胸に擦り付けてるだけでドキドキしちゃう…	PRINTFORM 「おちんちん…胸に擦り付けてるだけでドキドキしちゃう…
PRINTFORM 　辺り一面撒き散らしてマーキングしちゃうのはどうかしら	PRINTFORM 　辺り一面撒き散らしてマーキングしちゃうのはどうかしら
PRINTFORM 　すっごく良かったわ…おかげでこんなに射精しちゃった…	PRINTFORM 　すっごく良かったわ…おかげでこんなに射精しちゃった…
PRINTFORMW 「はぁ…貴女に抱かれている暇があったら自分で探すわ」	PRINTFORMW 「はぁ…貴女に抱かれている暇があったら自分で探すわ」
PRINTFORM 　せーえきいっぱい射精してあげる……受け取ってぇッッッ	PRINTFORM 　せーえきいっぱい射精してあげる……受け取ってぇッッッ
PRINTFORMW 「……ちょっと、大丈夫？　…よかった、まだ息は……」	PRINTFORMW 「……ちょっと、大丈夫？　…よかった、まだ息は……」
PRINTFORMW 「…さてさて、どうしてあげようかしらねぇ…くすくす」	PRINTFORMW 「…さてさて、どうしてあげようかしらねぇ…くすくす」
PRINTFORMDL 倒れている人影を見つけ抱き起こしたパチュリーだが、	PRINTFORMDL 倒れている人影を見つけ抱き起こしたパチュリーだが、
PRINTFORMW 「ごめんなさい、こちらも今はちょっと余裕がないの…」	PRINTFORMW 「ごめんなさい、こちらも今はちょっと余裕がないの…」
PRINTFORMW 「この部屋…せめてもう少し綺麗にしてから寝ない…？」	PRINTFORMW 「この部屋…せめてもう少し綺麗にしてから寝ない…？」
PRINTFORML 　いつまでも我慢できるわけじゃないし…いいわよね…」	PRINTFORML 　いつまでも我慢できるわけじゃないし…いいわよね…」
PRINTFORM 「もっ…もう…何も…考えられ……ふぁぁぁあんんんッッッ	PRINTFORM 「もっ…もう…何も…考えられ……ふぁぁぁあんんんッッッ
PRINTFORMW 「助かったわ…え？お酒も？　ありがとう、いただくわ」	PRINTFORMW 「助かったわ…え？お酒も？　ありがとう、いただくわ」
PRINTFORMW 「それにしても…凄く嫌な気配で満ちてるわね、ここ…」	PRINTFORMW 「それにしても…凄く嫌な気配で満ちてるわね、ここ…」
PRINTFORMW 「……ひぅッッ？！　…こ、この服……生きてるっ？！」	PRINTFORMW 「……ひぅッッ？！　…こ、この服……生きてるっ？！」
PRINTFORMW 「…うう…ぬめっとした感触が蠢いていて…気色悪い…」	PRINTFORMW 「…うう…ぬめっとした感触が蠢いていて…気色悪い…」
PRINTFORM 　もう…いきなりそんなぶっといの奥まで突っ込まないで…	PRINTFORM 　もう…いきなりそんなぶっといの奥まで突っ込まないで…
PRINTFORM 　いきなり…なんて…ただでさえおしりは弱いのに……うぅ	PRINTFORM 　いきなり…なんて…ただでさえおしりは弱いのに……うぅ
PRINTFORM 　だ、だめ…にゅるにゅるって中に流し込まれ…んんんぅぅ	PRINTFORM 　だ、だめ…にゅるにゅるって中に流し込まれ…んんんぅぅ
PRINTFORMW 「…ん……？　…え？　…って、何その触手は…っ？！」	PRINTFORMW 「…ん……？　…え？　…って、何その触手は…っ？！」
PRINTFORMDW 敵を指差すと、激しい水流が一直線に敵を目掛けた。	PRINTFORMDW 敵を指差すと、激しい水流が一直線に敵を目掛けた。
PRINTFORMW 「ここは極大魔法を唱えて一気に決めたいところね…」	PRINTFORMW 「ここは極大魔法を唱えて一気に決めたいところね…」
PRINTFORMW 「詠唱にちょっと時間がかかるけど…これで決める！」	PRINTFORMW 「詠唱にちょっと時間がかかるけど…これで決める！」
PRINTFORMDW 風が叫び数え切れないほど無数の弾幕が吹き荒れる。	PRINTFORMDW 風が叫び数え切れないほど無数の弾幕が吹き荒れる。
PRINTFORMDW 巨大な火柱が次々と立ち登り敵陣を突き抜けていく。	PRINTFORMDW 巨大な火柱が次々と立ち登り敵陣を突き抜けていく。
PRINTFORMW 「直接殴るのはあまり得意じゃないのだけど…えいっ」	PRINTFORMW 「直接殴るのはあまり得意じゃないのだけど…えいっ」
PRINTFORM 　だって…こっちを…思いっきりズポズポされたいから…	PRINTFORM 　だって…こっちを…思いっきりズポズポされたいから…
PRINTFORM 　ダメだったら！　目の前に敵が…居るのよっ　くぅんッ	PRINTFORM 　ダメだったら！　目の前に敵が…居るのよっ　くぅんッ
PRINTFORM 「…ねぇ…私のアソコ…もう…こんなになっちゃってるの	PRINTFORM 「…ねぇ…私のアソコ…もう…こんなになっちゃってるの
PRINTFORM 「ねぇ…%CALLNAME:(TARGET)%さまぁ	PRINTFORM 「ねぇ…%CALLNAME:(TARGET)%さまぁ
PRINTFORMDW %ARGS:1%の膣内にぬぷぬぷと納まっていく…	PRINTFORMDW %ARGS:1%の膣内にぬぷぬぷと納まっていく…
PRINTFORML 「やめて…！　この服…私の大事な…ともだちなの…」	PRINTFORML 「やめて…！　この服…私の大事な…ともだちなの…」
PRINTFORMW 「よし…着実にスーツに覆われてる面積が減ってる…」	PRINTFORMW 「よし…着実にスーツに覆われてる面積が減ってる…」
PRINTFORM 「…おっぱいでシて欲しいの？　もう…本当に好きねぇ…	PRINTFORM 「…おっぱいでシて欲しいの？　もう…本当に好きねぇ…
PRINTFORM 　おっぱい重いからってそんなたぷたぷしちゃぁ…んんっ	PRINTFORM 　おっぱい重いからってそんなたぷたぷしちゃぁ…んんっ
PRINTFORM 　そんな入口のトコばっかり…もっと奥まで…欲しいのぉ	PRINTFORM 　そんな入口のトコばっかり…もっと奥まで…欲しいのぉ
PRINTFORM 「んぅ…欲しかったのは…そこじゃ…ないのにぃ…んんっ	PRINTFORM 「んぅ…欲しかったのは…そこじゃ…ないのにぃ…んんっ
PRINTFORM 「もう逃げられないわね……この後…どうなるのかしら…	PRINTFORM 「もう逃げられないわね……この後…どうなるのかしら…
PRINTFORM 「もう邪魔な布は何もないわ…だから…早くちょうだい…	PRINTFORM 「もう邪魔な布は何もないわ…だから…早くちょうだい…
PRINTFORMW 　だめ…手が…止められない…もっと…気持ち良く…」	PRINTFORMW 　だめ…手が…止められない…もっと…気持ち良く…」
PRINTFORMW 「だめ…この服だけは…絶対…手放したくない…ッ！」	PRINTFORMW 「だめ…この服だけは…絶対…手放したくない…ッ！」
PRINTFORMW 「ちょっ…壁から触手が出てくるなんて聞いてないわ」	PRINTFORMW 「ちょっ…壁から触手が出てくるなんて聞いてないわ」
PRINTFORMW 　全部…取り出したはずよね？　なのに…中にまだ…」	PRINTFORMW 　全部…取り出したはずよね？　なのに…中にまだ…」
PRINTFORMW 「それじゃあ…私の能力を強化してもらおうかしら？」	PRINTFORMW 「それじゃあ…私の能力を強化してもらおうかしら？」
PRINTFORMDL びゅくっ！びゅっ！びゅびゅーーーーーーーっ！！！	PRINTFORMDL びゅくっ！びゅっ！びゅびゅーーーーーーーっ！！！
PRINTFORMDL ブピュッ！！ピュッ！ブビュゥゥゥゥゥッッ！！！！	PRINTFORMDL ブピュッ！！ピュッ！ブビュゥゥゥゥゥッッ！！！！
PRINTFORM 「もっとも…気絶しようが続けて搾り取っちゃいますけど	PRINTFORM 「もっとも…気絶しようが続けて搾り取っちゃいますけど
PRINTFORMW 「……あれ……いくら射精しても……取れない……？」	PRINTFORMW 「……あれ……いくら射精しても……取れない……？」
PRINTFORM 「あぁ…もう想像しただけで…こんなになっちゃって…ん	PRINTFORM 「あぁ…もう想像しただけで…こんなになっちゃって…ん
PRINTFORMW 「それにしても…無駄に大きなおっぱいしちゃって…」	PRINTFORMW 「それにしても…無駄に大きなおっぱいしちゃって…」
PRINTFORM 　おちんちん…おっぱいにずっぽり埋まっちゃってるぅ…	PRINTFORM 　おちんちん…おっぱいにずっぽり埋まっちゃってるぅ…
PRINTFORM 　今後私%TACHI()%に生意気な事言えない様にっ	PRINTFORM 　今後私%TACHI()%に生意気な事言えない様にっ
PRINTFORM 「ふふ…それ…おちんちんよね…こんなに固くしちゃって	PRINTFORM 「ふふ…それ…おちんちんよね…こんなに固くしちゃって
PRINTFORMW 「そういう事なら…せっかくだしお願いしようかしら」	PRINTFORMW 「そういう事なら…せっかくだしお願いしようかしら」
PRINTFORMW 「まったくもう…仕方ないわね、これで我慢しなさい」	PRINTFORMW 「まったくもう…仕方ないわね、これで我慢しなさい」
PRINTFORM 「私を拒むの…でもこっちも…おちんぽ我慢できないのよ	PRINTFORM 「私を拒むの…でもこっちも…おちんぽ我慢できないのよ
PRINTFORM 　我ながら随分たくさんスペルマぶちまけちゃったわね…	PRINTFORM 　我ながら随分たくさんスペルマぶちまけちゃったわね…
PRINTFORMW 「はぁ…はぁ…なんとか…引き剥がせたわ……ガクッ」	PRINTFORMW 「はぁ…はぁ…なんとか…引き剥がせたわ……ガクッ」
PRINTFORM 　%CALLNAME_8_0(ARG:0, 1)%…	PRINTFORM 　%CALLNAME_8_0(ARG:0, 1)%…
PRINTFORMW 　あ……わっ私だけイってしまって…ごめんなさい…」	PRINTFORMW 　あ……わっ私だけイってしまって…ごめんなさい…」
PRINTFORMW 「んんっ！　ちょっと…もう少し優しくできないの…」	PRINTFORMW 「んんっ！　ちょっと…もう少し優しくできないの…」
PRINTFORMW 「そういう意図はなかったのだけれど…失礼したわね」	PRINTFORMW 「そういう意図はなかったのだけれど…失礼したわね」
PRINTFORM 「…あぁ…膣内で…びゅくびゅく出すの…ほんと最高……	PRINTFORM 「…あぁ…膣内で…びゅくびゅく出すの…ほんと最高……
PRINTFORMW 　ふふっ、きょとんとして…膣内で射精すと思った？」	PRINTFORMW 　ふふっ、きょとんとして…膣内で射精すと思った？」
PRINTFORMW 　膣内でびくっていってる…もう我慢できないのね…」	PRINTFORMW 　膣内でびくっていってる…もう我慢できないのね…」
PRINTFORM 　満足…してもらえたみたいね。　私も…良かったわよ…	PRINTFORM 　満足…してもらえたみたいね。　私も…良かったわよ…
PRINTFORM 「射精…気持ちいい？　いっぱい…膣内に吐き出してね…	PRINTFORM 「射精…気持ちいい？　いっぱい…膣内に吐き出してね…
PRINTFORMW 「…しっかりしなさ…ひぃぃっっっ？？？？！！！！」	PRINTFORMW 「…しっかりしなさ…ひぃぃっっっ？？？？！！！！」
PRINTFORMW 「……なんでここはこんなモノまで落ちてるのよっ！」	PRINTFORMW 「……なんでここはこんなモノまで落ちてるのよっ！」
PRINTFORMW 「補充用の弾…？　とりあえず確保しておこうかしら」	PRINTFORMW 「補充用の弾…？　とりあえず確保しておこうかしら」
PRINTFORMW 「1時間交代ね。じゃあよろしく頼んだわよ…………」	PRINTFORMW 「1時間交代ね。じゃあよろしく頼んだわよ…………」
PRINTFORMW 「やだ…なんだかまた身体が疼いてきちゃってる…？」	PRINTFORMW 「やだ…なんだかまた身体が疼いてきちゃってる…？」
PRINTFORMW 　なっ、ナカでっ!!　ぐりぐりぐりってっっ！！！」	PRINTFORMW 　なっ、ナカでっ!!　ぐりぐりぐりってっっ！！！」
PRINTFORMDW おもむろに下着の中にその小さな手を滑り込ませた…	PRINTFORMDW おもむろに下着の中にその小さな手を滑り込ませた…
PRINTFORMW 「さて…どうしたものか…小悪魔も見当たらないし…」	PRINTFORMW 「さて…どうしたものか…小悪魔も見当たらないし…」
PRINTFORMW 「おかしいわよ、この大きさは…邪魔なだけなのに…」	PRINTFORMW 「おかしいわよ、この大きさは…邪魔なだけなのに…」
PRINTFORMW 「とりあえず…大人しくなってくれたみたいだけど…」	PRINTFORMW 「とりあえず…大人しくなってくれたみたいだけど…」
PRINTFORM 「あーー…クリちゃん…さわられると…ビビビビってぇ…	PRINTFORM 「あーー…クリちゃん…さわられると…ビビビビってぇ…
PRINTFORM 　えっちなこと…してぇ……きもひよく…なりたひのぉ…	PRINTFORM 　えっちなこと…してぇ……きもひよく…なりたひのぉ…
PRINTFORM 「…や…やだ…何入ってこよう…と…して……んぅぅぅっ	PRINTFORM 「…や…やだ…何入ってこよう…と…して……んぅぅぅっ
PRINTFORMW 「え…スライムの中に染み出してるのは……母乳…？」	PRINTFORMW 「え…スライムの中に染み出してるのは……母乳…？」
PRINTFORMW 「……んん？　…いつの間にか寝ちゃってたのね……」	PRINTFORMW 「……んん？　…いつの間にか寝ちゃってたのね……」
PRINTFORMW 「ん……ふはぁ。中身が美味しいのなら容器くらい…」	PRINTFORMW 「ん……ふはぁ。中身が美味しいのなら容器くらい…」
PRINTFORMW 　こ…腰に力が入らない…けど…しっかり握って…」	PRINTFORMW 　こ…腰に力が入らない…けど…しっかり握って…」
PRINTFORMDW 無数の刃と化した空気が四方八方から襲い掛かる。	PRINTFORMDW 無数の刃と化した空気が四方八方から襲い掛かる。
PRINTFORMDW 激しい炎が敵を巻き込み巨大な火柱が立ち昇った。	PRINTFORMDW 激しい炎が敵を巻き込み巨大な火柱が立ち昇った。
PRINTFORMW 「奮発してあげる！　さぁたっぷり食らいなさい！」	PRINTFORMW 「奮発してあげる！　さぁたっぷり食らいなさい！」
PRINTFORM 「早く…私の手なんかよりもっとイイものを…頂戴よぉ	PRINTFORM 「早く…私の手なんかよりもっとイイものを…頂戴よぉ
PRINTFORM 　お願いだから…その太いので…膣内をかき回してぇ…	PRINTFORM 　お願いだから…その太いので…膣内をかき回してぇ…
PRINTFORMW 「……この触手…マゾなの…？　理解に苦しむわ…」	PRINTFORMW 「……この触手…マゾなの…？　理解に苦しむわ…」
PRINTFORMW 　随分固くなってるわね…ちょっと強めに行くわよ」	PRINTFORMW 　随分固くなってるわね…ちょっと強めに行くわよ」
PRINTFORMDW どうやらストレッチを手伝っているつもりの様だ…	PRINTFORMDW どうやらストレッチを手伝っているつもりの様だ…
PRINTFORM 「%CALLNAME_8_0(ARG:2,1)%…	PRINTFORM 「%CALLNAME_8_0(ARG:2,1)%…
PRINTFORMW 「別に脱がさなくても…できるでしょ？　お願い…」	PRINTFORMW 「別に脱がさなくても…できるでしょ？　お願い…」
PRINTFORMW 「んふぅ…おまんこに欲しいって言ったでしょう？」	PRINTFORMW 「んふぅ…おまんこに欲しいって言ったでしょう？」
PRINTFORM 　やぁ…挿入れられたらどうでもよくなっちゃったぁ…	PRINTFORM 　やぁ…挿入れられたらどうでもよくなっちゃったぁ…
PRINTFORM 「ダメっ！…おちんちんシゴかれたら……うぁぁッッッ	PRINTFORM 「ダメっ！…おちんちんシゴかれたら……うぁぁッッッ
PRINTFORMW 「んきゅっ？！　……ど、どうって事ない…わよ？」	PRINTFORMW 「んきゅっ？！　……ど、どうって事ない…わよ？」
PRINTFORMW 「…油断したわね…私の力で振りほどけるかしら…」	PRINTFORMW 「…油断したわね…私の力で振りほどけるかしら…」
PRINTFORM 「…だ…だめ…イったばかりで……ぁ…吸わない…でっ	PRINTFORM 「…だ…だめ…イったばかりで……ぁ…吸わない…でっ
PRINTFORMW 「あ…………どうしたの？　そんな瞳で見つめて…」	PRINTFORMW 「あ…………どうしたの？　そんな瞳で見つめて…」
PRINTFORMW 「よし…流石のこの服もだいぶ弱ってきたみたいね」	PRINTFORMW 「よし…流石のこの服もだいぶ弱ってきたみたいね」
PRINTFORM 「あ……下着まで破れちゃったのね…つまりこの後は…	PRINTFORM 「あ……下着まで破れちゃったのね…つまりこの後は…
PRINTFORMW 「だめ…このままじゃ…私の裸…見られちゃう……」	PRINTFORMW 「だめ…このままじゃ…私の裸…見られちゃう……」
PRINTFORMW 「…これで少しは動きやすくなるかもしれないわね」	PRINTFORMW 「…これで少しは動きやすくなるかもしれないわね」
PRINTFORM 「んっ…だめ…これ以上引き込まれたら…戻れそうに…	PRINTFORM 「んっ…だめ…これ以上引き込まれたら…戻れそうに…
PRINTFORM 「なにこれ…ベトベトして生臭くて、まるで……んんぅ	PRINTFORM 「なにこれ…ベトベトして生臭くて、まるで……んんぅ
PRINTFORMW 「上からっ？！　このくらいなら…避けられるわっ」	PRINTFORMW 「上からっ？！　このくらいなら…避けられるわっ」
PRINTFORMW （また私…これ着ちゃうの…でも…我慢できない…）	PRINTFORMW （また私…これ着ちゃうの…でも…我慢できない…）
PRINTFORMDL ドビュッ！ビュッ！ビューーーーーーーっっ！！！	PRINTFORMDL ドビュッ！ビュッ！ビューーーーーーーっっ！！！
PRINTFORM 　精液こみ上げてきて……んんぅぅぅふあぁぁぁんッッ	PRINTFORM 　精液こみ上げてきて……んんぅぅぅふあぁぁぁんッッ
PRINTFORM 　%CALLNAME_8_0(ARG:3)%ったら	PRINTFORM 　%CALLNAME_8_0(ARG:3)%ったら
PRINTFORM 「%CALLNAME_8_0(ARG:3,1)%ッ	PRINTFORM 「%CALLNAME_8_0(ARG:3,1)%ッ
PRINTFORM 「それだったら…私の膣内に…たっぷりと射精して頂戴	PRINTFORM 「それだったら…私の膣内に…たっぷりと射精して頂戴
PRINTFORMW 「ほら大人しくしなさい。服が破れちゃうじゃない」	PRINTFORMW 「ほら大人しくしなさい。服が破れちゃうじゃない」
PRINTFORMW 　ねぇ…このままだと…なか…射精しちゃうわよ？」	PRINTFORMW 　ねぇ…このままだと…なか…射精しちゃうわよ？」
PRINTFORM 　くっさいザーメンびゅるびゅるぶちまけちゃうッッッ	PRINTFORM 　くっさいザーメンびゅるびゅるぶちまけちゃうッッッ
PRINTFORMW 「…ふぅ…どうやらここに迷い込んだお仲間の様ね」	PRINTFORMW 「…ふぅ…どうやらここに迷い込んだお仲間の様ね」
PRINTFORMDL 皆がなるべく触れない様にしていた話題だったが、	PRINTFORMDL 皆がなるべく触れない様にしていた話題だったが、
PRINTFORMW 「ふぅ…いつになったら図書館に戻れるのかしら…」	PRINTFORMW 「ふぅ…いつになったら図書館に戻れるのかしら…」
PRINTFORMW 「…ごめんなさい、ここにはそんなものは無いわね」	PRINTFORMW 「…ごめんなさい、ここにはそんなものは無いわね」
PRINTFORMW 「拘束具…？　こんな危険な場所で使うだなんて…」	PRINTFORMW 「拘束具…？　こんな危険な場所で使うだなんて…」
PRINTFORMW 「あ、美鈴。私寝るから、見張りお願いね…………」	PRINTFORMW 「あ、美鈴。私寝るから、見張りお願いね…………」
PRINTFORMW 「私眠るから、悪いけど見張り、よろしく…………」	PRINTFORMW 「私眠るから、悪いけど見張り、よろしく…………」
PRINTFORM 　も…もう少しスイッチを強く……ああぁぁぁぁぁぁぁ	PRINTFORM 　も…もう少しスイッチを強く……ああぁぁぁぁぁぁぁ
PRINTFORMW 「なんだか…今日は調子が悪いわね…身体が重い…」	PRINTFORMW 「なんだか…今日は調子が悪いわね…身体が重い…」
PRINTFORML 「ふぅーーーー………　今のうちに一気にっ！！！」	PRINTFORML 「ふぅーーーー………　今のうちに一気にっ！！！」
PRINTFORM 　ミルク欲しいの…？　それならもっとキツく…んんっ	PRINTFORM 　ミルク欲しいの…？　それならもっとキツく…んんっ
PRINTFORMW 「私が一方的に捕まったままだと…思ってるっ？」	PRINTFORMW 「私が一方的に捕まったままだと…思ってるっ？」
PRINTFORM 「我慢…しなきゃ…そうすれば…もっと気持ち良く…	PRINTFORM 「我慢…しなきゃ…そうすれば…もっと気持ち良く…
PRINTFORMW 　しゅ、集中できるか判らないけど…やってみる」	PRINTFORMW 　しゅ、集中できるか判らないけど…やってみる」
PRINTFORMDW 多数の竜巻が舞い上がり、敵を追い詰めていく。	PRINTFORMDW 多数の竜巻が舞い上がり、敵を追い詰めていく。
PRINTFORM 　好きにしていいって…言ってるでしょ？　早くぅ…	PRINTFORM 　好きにしていいって…言ってるでしょ？　早くぅ…
PRINTFORMW 「お尻だったら…ううん、お尻がいいの…来て…」	PRINTFORMW 「お尻だったら…ううん、お尻がいいの…来て…」
PRINTFORMW 「なんだか疲れたわね。少し横になろうかしら…」	PRINTFORMW 「なんだか疲れたわね。少し横になろうかしら…」
PRINTFORMW 「……どう？　強さはこんなものでいいかしら？」	PRINTFORMW 「……どう？　強さはこんなものでいいかしら？」
PRINTFORM 「%CALLNAME:(TARGET)%さまぁ…	PRINTFORM 「%CALLNAME:(TARGET)%さまぁ…
PRINTFORMW 「……こいつ…何故そんなに着ている物ばかり…」	PRINTFORMW 「……こいつ…何故そんなに着ている物ばかり…」
PRINTFORM 　やめなさい…　女同士で…こんなの……くぅぅんっ	PRINTFORM 　やめなさい…　女同士で…こんなの……くぅぅんっ
PRINTFORM 「……挿入れたい？　…んぅ…………わ・た・し・も	PRINTFORM 「……挿入れたい？　…んぅ…………わ・た・し・も
PRINTFORM 　そう…ほら…私のおっぱい…もっとふにふにして…	PRINTFORM 　そう…ほら…私のおっぱい…もっとふにふにして…
PRINTFORMW 「あぁん…おしりに欲しいって言ったでしょう？」	PRINTFORMW 「あぁん…おしりに欲しいって言ったでしょう？」
PRINTFORM 　びゅびゅーーーってせーえきだひひゃうのぉぉッッ	PRINTFORM 　びゅびゅーーーってせーえきだひひゃうのぉぉッッ
PRINTFORM 「んぷっ！？　んっんーーーーーーーー…っっ　…ん	PRINTFORM 「んぷっ！？　んっんーーーーーーーー…っっ　…ん
PRINTFORM 　これだけ射精されたら…赤ちゃん…できたかしら…	PRINTFORM 　これだけ射精されたら…赤ちゃん…できたかしら…
PRINTFORM 　なっ、膣内の気持ちいいとこっ…全部擦っ…てッッ	PRINTFORM 　なっ、膣内の気持ちいいとこっ…全部擦っ…てッッ
PRINTFORM 「はひ……これ…ぜったい…はらんじゃってるぅ……	PRINTFORM 「はひ……これ…ぜったい…はらんじゃってるぅ……
PRINTFORM 「んんっ？！　なっ、膣内で膨らんで……だ、だめっ	PRINTFORM 「んんっ？！　なっ、膣内で膨らんで……だ、だめっ
PRINTFORMW 「あら…攻撃されたと思ったけど…外れたの…？」	PRINTFORMW 「あら…攻撃されたと思ったけど…外れたの…？」
PRINTFORM 「んもう…いいでしょう？　服なんて着たままでも…	PRINTFORM 「んもう…いいでしょう？　服なんて着たままでも…
PRINTFORM ……せーえき…びゅくびゅくしゃせーしたいのぉ……	PRINTFORM ……せーえき…びゅくびゅくしゃせーしたいのぉ……
PRINTFORM 「…だから…好きにして……そう…ぐちゅぐちゅに…	PRINTFORM 「…だから…好きにして……そう…ぐちゅぐちゅに…
PRINTFORM 　ごめんなさい……私の方が……もう無理みたい……	PRINTFORM 　ごめんなさい……私の方が……もう無理みたい……
PRINTFORMW 　もう…いいの……気持ち良ければ…それで……」	PRINTFORMW 　もう…いいの……気持ち良ければ…それで……」
PRINTFORM 　今、戦ってるんだから…そんなに…群がらな…んっ	PRINTFORM 　今、戦ってるんだから…そんなに…群がらな…んっ
PRINTFORMW 「相手しきれないわね、無視して先を急ぎましょ」	PRINTFORMW 「相手しきれないわね、無視して先を急ぎましょ」
PRINTFORMW 「まぁきっと誰かしら連れて戻ってくるでしょ…」	PRINTFORMW 「まぁきっと誰かしら連れて戻ってくるでしょ…」
PRINTFORM 「さぁ%CALLNAME:(TARGET)%様っ	PRINTFORM 「さぁ%CALLNAME:(TARGET)%様っ
PRINTFORMW 「え…そっちに行くの？　何があるのかしら…？」	PRINTFORMW 「え…そっちに行くの？　何があるのかしら…？」
PRINTFORM 　このウェディングドレス…身体中…幸せになるぅ…	PRINTFORM 　このウェディングドレス…身体中…幸せになるぅ…
PRINTFORMW 　ちょっ…なんでこの蟲達…ん…そこばっかり…」	PRINTFORMW 　ちょっ…なんでこの蟲達…ん…そこばっかり…」
PRINTFORM 　そっそんな…勢いよく吸い上げられたら…あぁぁっ	PRINTFORM 　そっそんな…勢いよく吸い上げられたら…あぁぁっ
PRINTFORM 「でも…自分ひとりででもどうにかしないと…んんっ	PRINTFORM 「でも…自分ひとりででもどうにかしないと…んんっ
PRINTFORM 　もう…ちょっと…で…はああぁぁぁぁぁぁんッッッ	PRINTFORM 　もう…ちょっと…で…はああぁぁぁぁぁぁんッッッ
PRINTFORM 　とびきり濃いの…しゃせーしちゃうぅぅぅぅッッッ	PRINTFORM 　とびきり濃いの…しゃせーしちゃうぅぅぅぅッッッ
PRINTFORMW 　ふぅ…　おちんちん取れちゃったの…残念ね…」	PRINTFORMW 　ふぅ…　おちんちん取れちゃったの…残念ね…」
PRINTFORM 　%CALLNAME_8_0(ARG:3,1)%	PRINTFORM 　%CALLNAME_8_0(ARG:3,1)%
PRINTFORMW 「そんな…だ、ダメよ！？　そこ挿入れちゃ……」	PRINTFORMW 「そんな…だ、ダメよ！？　そこ挿入れちゃ……」
PRINTFORM 　%CALLNAME_8_0(ARG:0)%ッッ	PRINTFORM 　%CALLNAME_8_0(ARG:0)%ッッ
PRINTFORMW 　…もう十分よね、そろそろ止めないと体力が…」	PRINTFORMW 　…もう十分よね、そろそろ止めないと体力が…」
PRINTFORMW 「……魔理沙っ？！　随分こっぴどくやられ……」	PRINTFORMW 「……魔理沙っ？！　随分こっぴどくやられ……」
PRINTFORMW 「もう、どうせ無理して突撃でもしたんでしょ…」	PRINTFORMW 「もう、どうせ無理して突撃でもしたんでしょ…」
PRINTFORMW 「この種は…飲めば基礎能力を上げてくれるはず」	PRINTFORMW 「この種は…飲めば基礎能力を上げてくれるはず」
PRINTFORMW 「ここしばらく体調が悪いけど…もしかして……」	PRINTFORMW 「ここしばらく体調が悪いけど…もしかして……」
PRINTFORMW 　ちくび…やめ…え…私の胸から…おっぱい？！」	PRINTFORMW 　ちくび…やめ…え…私の胸から…おっぱい？！」
PRINTFORMW 「いつ敵が襲ってくるか分からないわ、慎重に…」	PRINTFORMW 「いつ敵が襲ってくるか分からないわ、慎重に…」
PRINTFORML 「そうね、脱いじゃおうかしら……（ドキドキ）」	PRINTFORML 「そうね、脱いじゃおうかしら……（ドキドキ）」
PRINTFORM 　これでまたしばらく…この服のお世話になれるわね	PRINTFORM 　これでまたしばらく…この服のお世話になれるわね
PRINTFORM 　おっぱい張ってるからって…そんな強く吸っちゃッ	PRINTFORM 　おっぱい張ってるからって…そんな強く吸っちゃッ
PRINTFORM 「ちっ、乳首…？　ちょっ…やっ…吸っ、吸っちゃっ	PRINTFORM 「ちっ、乳首…？　ちょっ…やっ…吸っ、吸っちゃっ
PRINTFORM 　…また…服なんかに…たくさんイかされちゃった…	PRINTFORM 　…また…服なんかに…たくさんイかされちゃった…
PRINTFORMW 　ふひぃぃ……お…おわっ…た…みた…いね……」	PRINTFORMW 　ふひぃぃ……お…おわっ…た…みた…いね……」
PRINTFORM 　お、お尻に…ぬりゅぬりゅって入ってきてるぅ……	PRINTFORM 　お、お尻に…ぬりゅぬりゅって入ってきてるぅ……
PRINTFORM 　もっと…膣内に欲しい…もっと…子種を注いでぇ…	PRINTFORM 　もっと…膣内に欲しい…もっと…子種を注いでぇ…
PRINTFORMW 「…っぁ？！　…………ぅぁ………ぁ…ぁ……」	PRINTFORMW 「…っぁ？！　…………ぅぁ………ぁ…ぁ……」
PRINTFORMW 「え…？　私とかどうみても後衛職じゃない…」	PRINTFORMW 「え…？　私とかどうみても後衛職じゃない…」
PRINTFORMW 「えーと、こうやって両手で持って…やぁっ！」	PRINTFORMW 「えーと、こうやって両手で持って…やぁっ！」
PRINTFORMW 「くっ…そう易々とは逃がしてくれないわね…」	PRINTFORMW 「くっ…そう易々とは逃がしてくれないわね…」
PRINTFORMW 「頭……真っ白で……集中……でき…ない……」	PRINTFORMW 「頭……真っ白で……集中……でき…ない……」
PRINTFORM 　…私の恥ずかしいとこ…全部弄って欲しいのっっ	PRINTFORM 　…私の恥ずかしいとこ…全部弄って欲しいのっっ
PRINTFORM 「もう…いつまで私を放っておくつもりなのかしら	PRINTFORM 「もう…いつまで私を放っておくつもりなのかしら
PRINTFORM 「%CALLNAME:(TARGET)%さまぁ	PRINTFORM 「%CALLNAME:(TARGET)%さまぁ
PRINTFORMW 　少し…甘えさせて頂いてもよろしいですか？」	PRINTFORMW 　少し…甘えさせて頂いてもよろしいですか？」
PRINTFORML 「きゃっ！　…あ、こんなボロボロになって…」	PRINTFORML 「きゃっ！　…あ、こんなボロボロになって…」
PRINTFORM 　私のおちんちんで…いっぱいかき回してあげるぅ	PRINTFORM 　私のおちんちんで…いっぱいかき回してあげるぅ
PRINTFORM 　ほら…ずりゅずりゅ挿入っちゃう…んんんんぅぅ	PRINTFORM 　ほら…ずりゅずりゅ挿入っちゃう…んんんんぅぅ
PRINTFORM 　そう…その調子…もっと…気持ち良くさせて……	PRINTFORM 　そう…その調子…もっと…気持ち良くさせて……
PRINTFORMW 「んんぅ…クリちゃんだって言ったでしょう？」	PRINTFORMW 「んんぅ…クリちゃんだって言ったでしょう？」
PRINTFORM 　だ…だめよぉ…今シて欲しいのは…はぁあんっっ	PRINTFORM 　だ…だめよぉ…今シて欲しいのは…はぁあんっっ
PRINTFORM 　すっちゃすっちゃってイヤラシイ音立ててるぅ…	PRINTFORM 　すっちゃすっちゃってイヤラシイ音立ててるぅ…
PRINTFORM 　ああぁぁぁ…んああああぁぁぁぁんんんんッッッ	PRINTFORM 　ああぁぁぁ…んああああぁぁぁぁんんんんッッッ
PRINTFORMW 「うぅ…こんなの…気持ち悪いだけじゃない…」	PRINTFORMW 「うぅ…こんなの…気持ち悪いだけじゃない…」
PRINTFORM 　ナニをされるのか…期待しちゃってるんですよね	PRINTFORM 　ナニをされるのか…期待しちゃってるんですよね
PRINTFORM 「あぁ……これで…もう私は逃げる事もできず……	PRINTFORM 「あぁ……これで…もう私は逃げる事もできず……
PRINTFORMW 「この粘っこくまとわりつく様な霧…まさか…」	PRINTFORMW 「この粘っこくまとわりつく様な霧…まさか…」
PRINTFORMW 「危ないわね、力の弱い私が捕まるわけには…」	PRINTFORMW 「危ないわね、力の弱い私が捕まるわけには…」
PRINTFORM 　もっとおちんぽシコシコするのぉ…ぉ……ぉ……	PRINTFORM 　もっとおちんぽシコシコするのぉ…ぉ……ぉ……
PRINTFORMW 　脚…広げないで……や…やぁ…来ちゃだめ…」	PRINTFORMW 　脚…広げないで……や…やぁ…来ちゃだめ…」
PRINTFORMW 　常に緩やかな刺激が…別に悪くはないけど…」	PRINTFORMW 　常に緩やかな刺激が…別に悪くはないけど…」
PRINTFORM 「部屋中の触手が…身体にまとわりついて…ふぅ…	PRINTFORM 「部屋中の触手が…身体にまとわりついて…ふぅ…
PRINTFORMW 「怪しいものね…こんなところにある泉なんて」	PRINTFORMW 「怪しいものね…こんなところにある泉なんて」
PRINTFORMW 「……なんだか眠気が…あ！　し、しまっ……」	PRINTFORMW 「……なんだか眠気が…あ！　し、しまっ……」
PRINTFORMW 「流石にあの色の水は…近づかない方が無難ね」	PRINTFORMW 「流石にあの色の水は…近づかない方が無難ね」
PRINTFORMW 「…ダメージは無いみたい……ッッッ？？？？」	PRINTFORMW 「…ダメージは無いみたい……ッッッ？？？？」
PRINTFORM 　駄目…なのに…身体が欲しがっちゃって来てる…	PRINTFORM 　駄目…なのに…身体が欲しがっちゃって来てる…
PRINTFORM 「…ちょっ？！　小悪魔…？　貴女なにを…んんっ	PRINTFORM 「…ちょっ？！　小悪魔…？　貴女なにを…んんっ
PRINTFORMW 「く……ようやく目が慣れて…………っ？？？」	PRINTFORMW 「く……ようやく目が慣れて…………っ？？？」
PRINTFORMW 「ほんとにまぁ…こっぴどくヤられちゃって…」	PRINTFORMW 「ほんとにまぁ…こっぴどくヤられちゃって…」
PRINTFORMW 　オスの臭いがこっちにまで漂ってくるわよ…」	PRINTFORMW 　オスの臭いがこっちにまで漂ってくるわよ…」
PRINTFORM 「ねぇ見て、%CALLNAME_8_0(1)%	PRINTFORM 「ねぇ見て、%CALLNAME_8_0(1)%
PRINTFORMW 「…ふぅ　…膣内に……射精しちゃったわね…」	PRINTFORMW 「…ふぅ　…膣内に……射精しちゃったわね…」
PRINTFORM 　膣内のヒダヒダが…おちんちん愛撫してくるぅ…	PRINTFORM 　膣内のヒダヒダが…おちんちん愛撫してくるぅ…
PRINTFORMW 「……もう…からっぽ……先に…休むわね……」	PRINTFORMW 「……もう…からっぽ……先に…休むわね……」
PRINTFORMW 「はぁ…そこまでしてアイテムが欲しいのね。」	PRINTFORMW 「はぁ…そこまでしてアイテムが欲しいのね。」
PRINTFORMW 「どう…満足した？　約束…解ってるわよね？」	PRINTFORMW 「どう…満足した？　約束…解ってるわよね？」
PRINTFORMW 「……レミィ…あなたほどの力があっても……」	PRINTFORMW 「……レミィ…あなたほどの力があっても……」
PRINTFORMDW それはとてもよく母親に似ている愛娘だった。	PRINTFORMDW それはとてもよく母親に似ている愛娘だった。
PRINTFORMW 「……気にしないで。自分でも解ってるから…」	PRINTFORMW 「……気にしないで。自分でも解ってるから…」
PRINTFORMW 「助かるわ、正直手持ちが心許無かったのよね」	PRINTFORMW 「助かるわ、正直手持ちが心許無かったのよね」
PRINTFORMW 「正直、肉体労働担当が居ると本当に助かるわ」	PRINTFORMW 「正直、肉体労働担当が居ると本当に助かるわ」
PRINTFORM 「…なか…ぬるぬるで…ヒダヒダが絡んで…だめっ	PRINTFORM 「…なか…ぬるぬるで…ヒダヒダが絡んで…だめっ
PRINTFORMW 「はぁ…はぁ…どうやら収まってくれた様ね…」	PRINTFORMW 「はぁ…はぁ…どうやら収まってくれた様ね…」
PRINTFORMW 「はぁ……だるくて…眩暈がする…風邪かしら」	PRINTFORMW 「はぁ……だるくて…眩暈がする…風邪かしら」
PRINTFORM 　これ…が…母の喜び…随分と気持ちいいの…ね…	PRINTFORM 　これ…が…母の喜び…随分と気持ちいいの…ね…
PRINTFORMW 「壁や天井一面に…気持ち悪い、焼き払うわよ」	PRINTFORMW 「壁や天井一面に…気持ち悪い、焼き払うわよ」
PRINTFORMW 「さぁいらっしゃい…盛大に迎えてあげるわ♪」	PRINTFORMW 「さぁいらっしゃい…盛大に迎えてあげるわ♪」
PRINTFORM 　…たっぷり…おちんぽみるく搾られちゃった……	PRINTFORM 　…たっぷり…おちんぽみるく搾られちゃった……
PRINTFORM 　クリちゃん痺れて…頭トンじゃうかと思ったわ…	PRINTFORM 　クリちゃん痺れて…頭トンじゃうかと思ったわ…
PRINTFORM 　気持ちいいのも…こうずっと常に続いてると…ん	PRINTFORM 　気持ちいいのも…こうずっと常に続いてると…ん
PRINTFORMW 　なに…？　おちんちんの先に…スライムが…」	PRINTFORMW 　なに…？　おちんちんの先に…スライムが…」
PRINTFORM 「温かい……私の膣内……精液で満たされてる……	PRINTFORM 「温かい……私の膣内……精液で満たされてる……
PRINTFORML 絶対触手になんて負けたりしないパチュリー口上	PRINTFORML 絶対触手になんて負けたりしないパチュリー口上
PRINTFORMW 「……ぁ…………んくっ……はぁ…はぁ……」	PRINTFORMW 「……ぁ…………んくっ……はぁ…はぁ……」
PRINTFORM 　私が…囮になるから…大丈夫…気持ち良いし…	PRINTFORM 　私が…囮になるから…大丈夫…気持ち良いし…
PRINTFORM 「待ってなさい…今一発でおなかいっぱい…あぁ	PRINTFORM 「待ってなさい…今一発でおなかいっぱい…あぁ
PRINTFORMW 「とっておきの魔法…お見舞いしてあげる！」	PRINTFORMW 「とっておきの魔法…お見舞いしてあげる！」
PRINTFORMW 「い…イったばかりで…力が…入らない……」	PRINTFORMW 「い…イったばかりで…力が…入らない……」
PRINTFORMW 　…こんな事…違う…これは手が勝手に……」	PRINTFORMW 　…こんな事…違う…これは手が勝手に……」
PRINTFORM 　むにむにしつつ敏感な先っぽをパックンしてぇ	PRINTFORM 　むにむにしつつ敏感な先っぽをパックンしてぇ
PRINTFORMW 「く…身体の自由が…あの魔眼のせい…！？」	PRINTFORMW 「く…身体の自由が…あの魔眼のせい…！？」
PRINTFORM 　でも…後でちゃんと私も気持ちよくしなさいよ	PRINTFORM 　でも…後でちゃんと私も気持ちよくしなさいよ
PRINTFORMW 　こんな気分じゃ戦えないし…いいでしょ？」	PRINTFORMW 　こんな気分じゃ戦えないし…いいでしょ？」
PRINTFORM 「…私のおちんちん…こんなになっちゃってるの	PRINTFORM 「…私のおちんちん…こんなになっちゃってるの
PRINTFORMW 　……落ち着いて…これくらい避けられる…」	PRINTFORMW 　……落ち着いて…これくらい避けられる…」
PRINTFORMW 「服にダメージ…そう…その手があったわね」	PRINTFORMW 「服にダメージ…そう…その手があったわね」
PRINTFORMW 　これだけ脱がせば十分でしょ…早く直接…」	PRINTFORMW 　これだけ脱がせば十分でしょ…早く直接…」
PRINTFORMW 「…残念だったわね、服にかすっただけよ。」	PRINTFORMW 「…残念だったわね、服にかすっただけよ。」
PRINTFORM 　それなら…私をたっぷり気持ちよくさせなきゃ	PRINTFORM 　それなら…私をたっぷり気持ちよくさせなきゃ
PRINTFORM 　もっと…私と一緒に気持ち良くなりましょう…	PRINTFORM 　もっと…私と一緒に気持ち良くなりましょう…
PRINTFORMW 「くぅん…おっぱいだって言ったでしょう？」	PRINTFORMW 「くぅん…おっぱいだって言ったでしょう？」
PRINTFORM 　そこ…クリトリス完全に勃っちゃってるのぉぉ	PRINTFORM 　そこ…クリトリス完全に勃っちゃってるのぉぉ
PRINTFORMW 　頭…真っ白になって…ぼーっとしちゃう…」	PRINTFORMW 　頭…真っ白になって…ぼーっとしちゃう…」
PRINTFORM 　…こんなに顔が近く…私をどうするつもりなの	PRINTFORM 　…こんなに顔が近く…私をどうするつもりなの
PRINTFORM %CALLNAME:(TARGET)%様っっ	PRINTFORM %CALLNAME:(TARGET)%様っっ
PRINTFORM んんんんんぅぅぅぅぅぅぅぅぅぅ～～～～ッッッ	PRINTFORM んんんんんぅぅぅぅぅぅぅぅぅぅ～～～～ッッッ
PRINTFORM 　おなかの赤ちゃんも…悦んじゃうわよきっと…	PRINTFORM 　おなかの赤ちゃんも…悦んじゃうわよきっと…
PRINTFORMW 　膣内で膨らんで…これ…種付け……っ？！」	PRINTFORMW 　膣内で膨らんで…これ…種付け……っ？！」
PRINTFORMW 「…ゃ…だ……これ…力が吸われて…る……」	PRINTFORMW 「…ゃ…だ……これ…力が吸われて…る……」
PRINTFORMW 「危なっ!!　…そう易々とは食らわないわ」	PRINTFORMW 「危なっ!!　…そう易々とは食らわないわ」
PRINTFORMW 「はぁ…はぁ……よくもやってくれたわね…」	PRINTFORMW 「はぁ…はぁ……よくもやってくれたわね…」
PRINTFORM 　この小さい触手…刺激が弱過ぎてもどかしい…	PRINTFORM 　この小さい触手…刺激が弱過ぎてもどかしい…
PRINTFORM 　もう完全に…あなたと私だけ……身体も心も…	PRINTFORM 　もう完全に…あなたと私だけ……身体も心も…
PRINTFORMW 「もうダメね…完全に魔性に染まっているわ」	PRINTFORMW 「もうダメね…完全に魔性に染まっているわ」
PRINTFORMW 「あ……そうよね、逃げるのも当然よね……」	PRINTFORMW 「あ……そうよね、逃げるのも当然よね……」
PRINTFORMW 「なっなに…？　この光───────……」	PRINTFORMW 「なっなに…？　この光───────……」
PRINTFORMW 「ここは…さっきまで居た場所と違うわね…」	PRINTFORMW 「ここは…さっきまで居た場所と違うわね…」
PRINTFORMDL 祝福の瞬間を今かと待ちわびて蠢いている…	PRINTFORMDL 祝福の瞬間を今かと待ちわびて蠢いている…
PRINTFORMW 「怪しい泉ね…近づかない方が身のためだわ」	PRINTFORMW 「怪しい泉ね…近づかない方が身のためだわ」
PRINTFORMW 「あと少し気づくのが遅かったら…ごくり…」	PRINTFORMW 「あと少し気づくのが遅かったら…ごくり…」
PRINTFORMW 「あぁ…これ…寄生されちゃったみたいね…」	PRINTFORMW 「あぁ…これ…寄生されちゃったみたいね…」
PRINTFORM 　そっそこ…ざらついてるとこ…ゴリゴリ…って	PRINTFORM 　そっそこ…ざらついてるとこ…ゴリゴリ…って
PRINTFORM （ん…んんぅ！？　え…だっ誰！？　やっ…んぅ	PRINTFORM （ん…んんぅ！？　え…だっ誰！？　やっ…んぅ
PRINTFORMDL ぴゅっ！びゅるっ！！びゅるるるるるっっ！	PRINTFORMDL ぴゅっ！びゅるっ！！びゅるるるるるっっ！
PRINTFORM 「私の子宮に…いっぱいどぷどぷ射精しちゃって	PRINTFORM 「私の子宮に…いっぱいどぷどぷ射精しちゃって
PRINTFORM 「これは…徹底的に搾り取らないとダメですねぇ	PRINTFORM 「これは…徹底的に搾り取らないとダメですねぇ
PRINTFORM 「んぅんっ♪　…パチュリーさまのおちんちんっ	PRINTFORM 「んぅんっ♪　…パチュリーさまのおちんちんっ
PRINTFORM 　早く…せーえきぴゅぴゅっって射精したいのぉ	PRINTFORM 　早く…せーえきぴゅぴゅっって射精したいのぉ
PRINTFORM 「アナルセックスというのも…いいものなのね…	PRINTFORM 「アナルセックスというのも…いいものなのね…
PRINTFORM 　イ…イキそう…だけど…腰…止まらない…っっ	PRINTFORM 　イ…イキそう…だけど…腰…止まらない…っっ
PRINTFORM 　性的な攻撃をしようだなんてよく思ったわねっ	PRINTFORM 　性的な攻撃をしようだなんてよく思ったわねっ
PRINTFORMW 「仕方ない、擦ってあげるから感謝しなさい」	PRINTFORMW 「仕方ない、擦ってあげるから感謝しなさい」
PRINTFORMW 「そうね、手で擦ってもらうだけでいいから」	PRINTFORMW 「そうね、手で擦ってもらうだけでいいから」
PRINTFORMW 　どう？服の中で凄い快感だったでしょう？」	PRINTFORMW 　どう？服の中で凄い快感だったでしょう？」
PRINTFORMW 「……うぅ…こんなに汚してくれちゃって…」	PRINTFORMW 「……うぅ…こんなに汚してくれちゃって…」
PRINTFORMW 　…………もう…膣内に…欲しかったのに…」	PRINTFORMW 　…………もう…膣内に…欲しかったのに…」
PRINTFORMW 「…そうね。アイテムが欲しいのだったら…」	PRINTFORMW 「…そうね。アイテムが欲しいのだったら…」
PRINTFORMW 「ほんとに？　いいの？　その…ありがとう」	PRINTFORMW 「ほんとに？　いいの？　その…ありがとう」
PRINTFORMW 「ありがとう咲夜、これでまともに戦えそう」	PRINTFORMW 「ありがとう咲夜、これでまともに戦えそう」
PRINTFORMW 「交渉成立、頑張ってここを抜け出しましょ」	PRINTFORMW 「交渉成立、頑張ってここを抜け出しましょ」
PRINTFORMW 「これは…弾として撃ち出せるアイテムね。」	PRINTFORMW 「これは…弾として撃ち出せるアイテムね。」
PRINTFORMW 「疲れたわね…少し休みましょうか…………」	PRINTFORMW 「疲れたわね…少し休みましょうか…………」
PRINTFORMW 「…これは…なにか仕込まれたみたいね……」	PRINTFORMW 「…これは…なにか仕込まれたみたいね……」
PRINTFORMW 「けふっ？！　うぇ…げほっ！げほっ！！！」	PRINTFORMW 「けふっ？！　うぇ…げほっ！げほっ！！！」
PRINTFORM 　あ…焦らない…で…今、おっぱい…はぁあんっ	PRINTFORM 　あ…焦らない…で…今、おっぱい…はぁあんっ
PRINTFORMW 「さて、この部屋に何か使えるものは、と…」	PRINTFORMW 「さて、この部屋に何か使えるものは、と…」
PRINTFORMW 「…少し…胸の大きさが元に戻ってきてる？」	PRINTFORMW 「…少し…胸の大きさが元に戻ってきてる？」
PRINTFORMW 　…移動中なんだから大人しくしてなさいよ」	PRINTFORMW 　…移動中なんだから大人しくしてなさいよ」
PRINTFORM 「いっぱい…膣内射精されると…心が満たされる	PRINTFORM 「いっぱい…膣内射精されると…心が満たされる
PRINTFORM 　ちょっと揺れただけで…おっぱい感じちゃう…	PRINTFORM 　ちょっと揺れただけで…おっぱい感じちゃう…
PRINTFORMW 「マジックアイテムの扱いなら任せなさい」	PRINTFORMW 「マジックアイテムの扱いなら任せなさい」
PRINTFORMW 「土金符『エメラルドメガロポリス』！！」	PRINTFORMW 「土金符『エメラルドメガロポリス』！！」
PRINTFORMW 「土水符『ノエキアンデリュージュ』！！」	PRINTFORMW 「土水符『ノエキアンデリュージュ』！！」
PRINTFORMW 「水＆火符『フロギスティックレイン』！」	PRINTFORMW 「水＆火符『フロギスティックレイン』！」
PRINTFORMDW 舌を使い竿全体に唾液を馴染ませていく…	PRINTFORMDW 舌を使い竿全体に唾液を馴染ませていく…
PRINTFORM 「もう…喘息なんだから少しは大事にしてよね	PRINTFORM 「もう…喘息なんだから少しは大事にしてよね
PRINTFORM 「いたい…けど…なんで…身体が…火照って…	PRINTFORM 「いたい…けど…なんで…身体が…火照って…
PRINTFORML 「だめ…この服…あなた達の仲間なのよ…」	PRINTFORML 「だめ…この服…あなた達の仲間なのよ…」
PRINTFORM 　せつないの…も、もう…挿入れちゃいたい…	PRINTFORM 　せつないの…も、もう…挿入れちゃいたい…
PRINTFORM 「自分の意思で…動いてるわけじゃないのにっ	PRINTFORM 「自分の意思で…動いてるわけじゃないのにっ
PRINTFORMW 「んぅぅ…どこでもいいって言ったけど…」	PRINTFORMW 「んぅぅ…どこでもいいって言ったけど…」
PRINTFORM 　違うのぉ…女の子なんだから…おちんぽはぁ	PRINTFORM 　違うのぉ…女の子なんだから…おちんぽはぁ
PRINTFORM 　素直になったら…いいじゃないこれ…ぅんっ	PRINTFORM 　素直になったら…いいじゃないこれ…ぅんっ
PRINTFORM 　だ…だめ…気をしっかり…持たな…あぁんっ	PRINTFORM 　だ…だめ…気をしっかり…持たな…あぁんっ
PRINTFORM 　悪くないわ、少し強引に抱き寄せられるのも	PRINTFORM 　悪くないわ、少し強引に抱き寄せられるのも
PRINTFORM 「あ……もっとキツく捕まえて……そして……	PRINTFORM 「あ……もっとキツく捕まえて……そして……
PRINTFORM 「子宮のナカで…たっぷり味わって下さいっっ	PRINTFORM 「子宮のナカで…たっぷり味わって下さいっっ
PRINTFORM 　こんなだされたら…赤ちゃんできちゃぅ……	PRINTFORM 　こんなだされたら…赤ちゃんできちゃぅ……
PRINTFORM 　降りてきて…種付け受け入れちゃうっっッッ	PRINTFORM 　降りてきて…種付け受け入れちゃうっっッッ
PRINTFORMW 「やぁ……焦らしちゃ……イかせてぇ……」	PRINTFORMW 「やぁ……焦らしちゃ……イかせてぇ……」
PRINTFORMW 「…いいわよ、服くらい後でまた着れば…」	PRINTFORMW 「…いいわよ、服くらい後でまた着れば…」
PRINTFORMW 　あ……私のおなかで……脈づいてる……」	PRINTFORMW 　あ……私のおなかで……脈づいてる……」
PRINTFORMW 　はぁ…はぁ……お腹の中…これって……」	PRINTFORMW 　はぁ…はぁ……お腹の中…これって……」
PRINTFORMW 「ここは一体…　え？　私達の結婚式場？」	PRINTFORMW 「ここは一体…　え？　私達の結婚式場？」
PRINTFORMW 　なんで壁から…だめ…早く離れないと…」	PRINTFORMW 　なんで壁から…だめ…早く離れないと…」
PRINTFORMW 「っ？　…落とし穴とは油断ならないわね」	PRINTFORMW 「っ？　…落とし穴とは油断ならないわね」
PRINTFORM 　やっぱりこの服じゃないと落ち着かないわ…	PRINTFORM 　やっぱりこの服じゃないと落ち着かないわ…
PRINTFORM 　もう、せーえきで…おなかのなかいっぱい…	PRINTFORM 　もう、せーえきで…おなかのなかいっぱい…
PRINTFORMW 「あ…耳が…尻尾も…引っ込んだみたい？」	PRINTFORMW 「あ…耳が…尻尾も…引っ込んだみたい？」
PRINTFORMW 「甘くて美味しい…！　疲れが取れるわね」	PRINTFORMW 「甘くて美味しい…！　疲れが取れるわね」
PRINTFORMDW 何度も何度もペニスを激しく脈動させた…	PRINTFORMDW 何度も何度もペニスを激しく脈動させた…
PRINTFORMW 「これは……色々と邪魔なのよね…その…」	PRINTFORMW 「これは……色々と邪魔なのよね…その…」
PRINTFORM 「ねぇ…おちんちんが…早く精液出したいって	PRINTFORM 「ねぇ…おちんちんが…早く精液出したいって
PRINTFORM 「あらあら…我慢したって無駄だというのに…	PRINTFORM 「あらあら…我慢したって無駄だというのに…
PRINTFORMD %CALLNAME:(TARGET)%は	PRINTFORMD %CALLNAME:(TARGET)%は
PRINTFORMW 「倒れて…動けないのよね……（ごくり）」	PRINTFORMW 「倒れて…動けないのよね……（ごくり）」
PRINTFORM 　私のおちんちん…こんなになっちゃってるの	PRINTFORM 　私のおちんちん…こんなになっちゃってるの
PRINTFORM 　せーえきびゅくびゅくしてあげるんだからぁ	PRINTFORM 　せーえきびゅくびゅくしてあげるんだからぁ
PRINTFORMW 「い、いいわよ、別に私に構わないでも…」	PRINTFORMW 「い、いいわよ、別に私に構わないでも…」
PRINTFORMW 「くっ…動けない……どうして触手が！？」	PRINTFORMW 「くっ…動けない……どうして触手が！？」
PRINTFORMW 　……え…私が寝てる間に何をしようと…」	PRINTFORMW 　……え…私が寝てる間に何をしようと…」
PRINTFORMW 　おちんちん取れちゃった…と思ったら…」	PRINTFORMW 　おちんちん取れちゃった…と思ったら…」
PRINTFORMW 「ねぇ…私の…その…全然治まらなくて…」	PRINTFORMW 「ねぇ…私の…その…全然治まらなくて…」
PRINTFORMW 「賢明ね。それじゃ早速…始めましょう…」	PRINTFORMW 「賢明ね。それじゃ早速…始めましょう…」
PRINTFORMW 「くすくすっ　そう…そんな事があったの」	PRINTFORMW 「くすくすっ　そう…そんな事があったの」
PRINTFORMW 「これがあれば…スペルの威力が増すわね」	PRINTFORMW 「これがあれば…スペルの威力が増すわね」
PRINTFORMW 「私、先に寝るから…頼んだわよ…………」	PRINTFORMW 「私、先に寝るから…頼んだわよ…………」
PRINTFORMDW いつもの様に自ら身体をまさぐり始めた…	PRINTFORMDW いつもの様に自ら身体をまさぐり始めた…
PRINTFORMW 　手が…止まらない…こんな場所で…私…」	PRINTFORMW 　手が…止まらない…こんな場所で…私…」
PRINTFORM 「これを…お尻に…ん…んぅぅ…だっ、だめっ	PRINTFORM 「これを…お尻に…ん…んぅぅ…だっ、だめっ
PRINTFORM 　無理…よ…こんな…あああぁぁぁんっっっっ	PRINTFORM 　無理…よ…こんな…あああぁぁぁんっっっっ
PRINTFORMW 　身体が…疼く…どこかで鎮めないと……」	PRINTFORMW 　身体が…疼く…どこかで鎮めないと……」
PRINTFORMW 「……居る……こっちに近寄ってきてる…」	PRINTFORMW 「……居る……こっちに近寄ってきてる…」
PRINTFORM 「しまっ…たわ…変に刺激したから……んんっ	PRINTFORM 「しまっ…たわ…変に刺激したから……んんっ
PRINTFORM 　…だから…おっぱいなんて…出ない…のに…	PRINTFORM 　…だから…おっぱいなんて…出ない…のに…
PRINTFORMDL 周囲一面に自分の体液を撒き散らした中で	PRINTFORMDL 周囲一面に自分の体液を撒き散らした中で
PRINTFORM 　クリのとこ…じゅるじゅる蠢いてる…んんぅ	PRINTFORM 　クリのとこ…じゅるじゅる蠢いてる…んんぅ
PRINTFORMW 「ん…これ…スライムが入ってきてない？」	PRINTFORMW 「ん…これ…スライムが入ってきてない？」
PRINTFORMW 「くぅ………べとべとして気持ち悪い……」	PRINTFORMW 「くぅ………べとべとして気持ち悪い……」
PRINTFORMW 　なんだか良い気分になっちゃったわね…」	PRINTFORMW 　なんだか良い気分になっちゃったわね…」
PRINTFORMW 　ちょっ…ちょっと…後ろで休ませて…」	PRINTFORMW 　ちょっ…ちょっと…後ろで休ませて…」
PRINTFORMW 「火水符『フロギスティックピラー』！」	PRINTFORMW 「火水符『フロギスティックピラー』！」
PRINTFORM 　この気持ち良いの…ずっと…耐えなきゃ…	PRINTFORM 　この気持ち良いの…ずっと…耐えなきゃ…
PRINTFORM 　きもちよくされたくて…しかたないのっっ	PRINTFORM 　きもちよくされたくて…しかたないのっっ
PRINTFORM 「仕方ないわね…ほら…好きにしていいわよ	PRINTFORM 「仕方ないわね…ほら…好きにしていいわよ
PRINTFORMW 「ちょっ…？！　いいわよ、服くらい…」	PRINTFORMW 「ちょっ…？！　いいわよ、服くらい…」
PRINTFORM 　ほら…もっと腰使って気持ちよくしなさい	PRINTFORM 　ほら…もっと腰使って気持ちよくしなさい
PRINTFORM 「おちんちんもっと！　ずぷずぷさせてぇッ	PRINTFORM 「おちんちんもっと！　ずぷずぷさせてぇッ
PRINTFORM 　こんなにぐちょぐちょに涎垂らしちゃって	PRINTFORM 　こんなにぐちょぐちょに涎垂らしちゃって
PRINTFORM 　どう…？　こうすると…私も気持ちいいの	PRINTFORM 　どう…？　こうすると…私も気持ちいいの
PRINTFORM 　おまんこの中…幸せで満たされちゃってる	PRINTFORM 　おまんこの中…幸せで満たされちゃってる
PRINTFORM 　私だったらいつだって…貴方の側に居るわ	PRINTFORM 　私だったらいつだって…貴方の側に居るわ
PRINTFORM 「んーん、私が欲しいのはそうじゃなくて…	PRINTFORM 「んーん、私が欲しいのはそうじゃなくて…
PRINTFORM 　あなた…ちょっと……やり過ぎ……よ……	PRINTFORM 　あなた…ちょっと……やり過ぎ……よ……
PRINTFORMW 「やめ…これ以上…顔を近づけないで！」	PRINTFORMW 「やめ…これ以上…顔を近づけないで！」
PRINTFORMW 「…こ、これは本格的に…ピンチだわ…」	PRINTFORMW 「…こ、これは本格的に…ピンチだわ…」
PRINTFORMW 「チャンスね！　一気に畳み掛けるわよ」	PRINTFORMW 「チャンスね！　一気に畳み掛けるわよ」
PRINTFORMW 「ふぅ…この泉なんだか癒されるわ……」	PRINTFORMW 「ふぅ…この泉なんだか癒されるわ……」
PRINTFORMW 「…あ…反射的に避けちゃったけど……」	PRINTFORMW 「…あ…反射的に避けちゃったけど……」
PRINTFORM 　だめっ…そっ、そんなに吸い付い…ちゃっ	PRINTFORM 　だめっ…そっ、そんなに吸い付い…ちゃっ
PRINTFORM 「え…こ…この蟲…やだっ、離れな…んんっ	PRINTFORM 「え…こ…この蟲…やだっ、離れな…んんっ
PRINTFORMW 　んんっーーーーーーーーーーー………」	PRINTFORMW 　んんっーーーーーーーーーーー………」
PRINTFORMW 「ぜー…っ　ぜー…っ　た…助かった…」	PRINTFORMW 「ぜー…っ　ぜー…っ　た…助かった…」
PRINTFORMD %CALLNAME:(ARG:0)%は	PRINTFORMD %CALLNAME:(ARG:0)%は
PRINTFORMDW 身を震わせながら白濁液をぶちまけた…	PRINTFORMDW 身を震わせながら白濁液をぶちまけた…
PRINTFORM 　いいんですよ…我慢したって無駄ですから	PRINTFORM 　いいんですよ…我慢したって無駄ですから
PRINTFORMW 「起きない…随分深く寝てるみたいね…」	PRINTFORMW 「起きない…随分深く寝てるみたいね…」
PRINTFORMW 　私のおっぱい…気持ちいいでしょう？」	PRINTFORMW 　私のおっぱい…気持ちいいでしょう？」
PRINTFORM 　そんなにしたら…すぐ射精ちゃうわよぉ…	PRINTFORM 　そんなにしたら…すぐ射精ちゃうわよぉ…
PRINTFORM 　おちんちん…ずりゅずりゅされてるぅっっ	PRINTFORM 　おちんちん…ずりゅずりゅされてるぅっっ
PRINTFORM 　お尻を貫かれるのも気持ち良いでしょうっ	PRINTFORM 　お尻を貫かれるのも気持ち良いでしょうっ
PRINTFORM 　お尻に力を入れて…しっかり締めなさいっ	PRINTFORM 　お尻に力を入れて…しっかり締めなさいっ
PRINTFORM 　零れない様に…おっぱいで押さえなさいっ	PRINTFORM 　零れない様に…おっぱいで押さえなさいっ
PRINTFORM 　この事実を…しっかり受け止めなさいッッ	PRINTFORM 　この事実を…しっかり受け止めなさいッッ
PRINTFORM 　おちんぽから濃～いせーえきの良いにおい	PRINTFORM 　おちんぽから濃～いせーえきの良いにおい
PRINTFORMW 「それ…射精しないと治らないのよね…」	PRINTFORMW 「それ…射精しないと治らないのよね…」
PRINTFORM 　熱いの…びゅくびゅくたくさん射精してね	PRINTFORM 　熱いの…びゅくびゅくたくさん射精してね
PRINTFORM 「おくちで…しゃぶってあげちゃおうかしら	PRINTFORM 「おくちで…しゃぶってあげちゃおうかしら
PRINTFORMW 「きゃっ？！　や…やめて……服が……」	PRINTFORMW 「きゃっ？！　や…やめて……服が……」
PRINTFORM 　体中…熱いの…ぶちまけられちゃった……	PRINTFORM 　体中…熱いの…ぶちまけられちゃった……
PRINTFORMW 　すぐに孕ませて終わらせてあげる……」	PRINTFORMW 　すぐに孕ませて終わらせてあげる……」
PRINTFORMW 　ありがとう、おかげで落ち着いたわ…」	PRINTFORMW 　ありがとう、おかげで落ち着いたわ…」
PRINTFORMW 「そう…なら別にいいわ。交渉決裂ね。」	PRINTFORMW 「そう…なら別にいいわ。交渉決裂ね。」
PRINTFORM 「ふふっ…『もうイく！』って顔してるわね	PRINTFORM 「ふふっ…『もうイく！』って顔してるわね
PRINTFORM 　やぁ…もっ、もう…何も考えられな…い…	PRINTFORM 　やぁ…もっ、もう…何も考えられな…い…
PRINTFORM 　満足…してもらえたみたいで…よかったわ	PRINTFORM 　満足…してもらえたみたいで…よかったわ
PRINTFORM （……久しぶりに…ママの身体に甘えたいな	PRINTFORM （……久しぶりに…ママの身体に甘えたいな
PRINTFORMW 「……ほら、こぁ。いつまで寝てるの。」	PRINTFORMW 「……ほら、こぁ。いつまで寝てるの。」
PRINTFORMW 　お…おっぱい…触ってるとなんだか…」	PRINTFORMW 　お…おっぱい…触ってるとなんだか…」
PRINTFORM 「やっ、やっぱり、この子も吸い付い…てっ	PRINTFORM 「やっ、やっぱり、この子も吸い付い…てっ
PRINTFORM 「ぜー………　ぜー………　…ぅ…ぅぅ……	PRINTFORM 「ぜー………　ぜー………　…ぅ…ぅぅ……
PRINTFORM 「こんな場所で…挿入れられて…こっ、声っ	PRINTFORM 「こんな場所で…挿入れられて…こっ、声っ
PRINTFORM 　しきゅーのなか…たぷたぷ…ひってふ……	PRINTFORM 　しきゅーのなか…たぷたぷ…ひってふ……
PRINTFORMW 　本当に胸とか大きいと邪魔なだけね…」	PRINTFORMW 　本当に胸とか大きいと邪魔なだけね…」
PRINTFORMW 　だ…だめ…きちんと狙いをつけて…」	PRINTFORMW 　だ…だめ…きちんと狙いをつけて…」
PRINTFORMW 「…っ…………ぅぅ…………ぅ………」	PRINTFORMW 「…っ…………ぅぅ…………ぅ………」
PRINTFORMW 「…ひぅっ！…………ぅぅ……………」	PRINTFORMW 「…ひぅっ！…………ぅぅ……………」
PRINTFORMW 「今こちらから仕掛けるのは不利ね…」	PRINTFORMW 「今こちらから仕掛けるのは不利ね…」
PRINTFORMW 「火金符『セントエルモピラー』！！」	PRINTFORMW 「火金符『セントエルモピラー』！！」
PRINTFORMW 「いいわ、今日は調子も悪くないし…」	PRINTFORMW 「いいわ、今日は調子も悪くないし…」
PRINTFORMW 「月＆木符『サテライトヒマワリ』！」	PRINTFORMW 「月＆木符『サテライトヒマワリ』！」
PRINTFORMW 　早く…抜け出さないと…まずいわ…」	PRINTFORMW 　早く…抜け出さないと…まずいわ…」
PRINTFORM 　これ…私も少し…気持ちいいから好きよ	PRINTFORM 　これ…私も少し…気持ちいいから好きよ
PRINTFORMW 「もう…別に服なんて狙わなくても…」	PRINTFORMW 「もう…別に服なんて狙わなくても…」
PRINTFORM 　残ってるの下着だけになっちゃったぁ…	PRINTFORM 　残ってるの下着だけになっちゃったぁ…
PRINTFORM 優しく締め付けられちゃって…はぅぅ～～	PRINTFORM 優しく締め付けられちゃって…はぅぅ～～
PRINTFORM 「もう…私の方から挿入れちゃうんだから	PRINTFORM 「もう…私の方から挿入れちゃうんだから
PRINTFORMW 　ほら…全部挿入ったわよ…お尻に…」	PRINTFORMW 　ほら…全部挿入ったわよ…お尻に…」
PRINTFORM 　ねぇ…もっと膣内まで…激しくしてぇ…	PRINTFORM 　ねぇ…もっと膣内まで…激しくしてぇ…
PRINTFORMW 「んんぅ…おちんちんがいいのにぃ…」	PRINTFORMW 「んんぅ…おちんちんがいいのにぃ…」
PRINTFORM 「違う…そっちじゃ…くっクリちゃん…っ	PRINTFORM 「違う…そっちじゃ…くっクリちゃん…っ
PRINTFORM 「……ぁ…こ…これ……感じ過ぎるぅ……	PRINTFORM 「……ぁ…こ…これ……感じ過ぎるぅ……
PRINTFORM 「…い…今…目の前が…チカチカって……	PRINTFORM 「…い…今…目の前が…チカチカって……
PRINTFORMDW 『この身体、しばらく借りるわよ♪』	PRINTFORMDW 『この身体、しばらく借りるわよ♪』
PRINTFORM 　お腹の赤ちゃんも…せーえき悦んでる…	PRINTFORM 　お腹の赤ちゃんも…せーえき悦んでる…
PRINTFORMW 「うぅ…なか…赤ちゃん居るのに……」	PRINTFORMW 「うぅ…なか…赤ちゃん居るのに……」
PRINTFORMW 「く……服…破れてきちゃったわね…」	PRINTFORMW 「く……服…破れてきちゃったわね…」
PRINTFORM 「戦ってるのに…ぐちゅぐちゅしちゃ…ッ	PRINTFORM 「戦ってるのに…ぐちゅぐちゅしちゃ…ッ
PRINTFORMDW 子宮めがけて激しく注挿を繰り返した	PRINTFORMDW 子宮めがけて激しく注挿を繰り返した
PRINTFORMW 　ぬるぬる絡んで…やめ…そこは……」	PRINTFORMW 　ぬるぬる絡んで…やめ…そこは……」
PRINTFORMW 「ガスっ！？　みんな口を塞いでっ！」	PRINTFORMW 「ガスっ！？　みんな口を塞いでっ！」
PRINTFORM 　こらっ、おっぱい…離れなさ…ふぁんっ	PRINTFORM 　こらっ、おっぱい…離れなさ…ふぁんっ
PRINTFORM 　やっぱり…この感覚…癖になっちゃう…	PRINTFORM 　やっぱり…この感覚…癖になっちゃう…
PRINTFORM 　これ…また元気になっちゃったみたい…	PRINTFORM 　これ…また元気になっちゃったみたい…
PRINTFORMW 「わ…私とした事が…ごめんなさい…」	PRINTFORMW 「わ…私とした事が…ごめんなさい…」
PRINTFORM 「そうね…少しくらいいいと思…ぅんんっ	PRINTFORM 「そうね…少しくらいいいと思…ぅんんっ
PRINTFORM 「女の子なのに射精しちゃうんですよねぇ	PRINTFORM 「女の子なのに射精しちゃうんですよねぇ
PRINTFORM 「…ひっ？　ぅくっ…何かこみ上げ…てっ	PRINTFORM 「…ひっ？　ぅくっ…何かこみ上げ…てっ
PRINTFORMW 「そう…貴女…倒れて動けないの……」	PRINTFORMW 「そう…貴女…倒れて動けないの……」
PRINTFORMW 　おしりでされるのもイイでしょう？」	PRINTFORMW 　おしりでされるのもイイでしょう？」
PRINTFORM 　気持ちよくして差し上げられますからっ	PRINTFORM 　気持ちよくして差し上げられますからっ
PRINTFORM 　その証を…膣内に射精してあげるわっっ	PRINTFORM 　その証を…膣内に射精してあげるわっっ
PRINTFORMW 　ギブアンドテイクで…いいわよね？」	PRINTFORMW 　ギブアンドテイクで…いいわよね？」
PRINTFORM 　たっぷたぷして欲しいのかしら、ふふっ	PRINTFORM 　たっぷたぷして欲しいのかしら、ふふっ
PRINTFORM 「やっ…犯されてるのに……くっ…来るっ	PRINTFORM 「やっ…犯されてるのに……くっ…来るっ
PRINTFORMW 「はぁ…はぁ…………満足…した…？」	PRINTFORMW 「はぁ…はぁ…………満足…した…？」
PRINTFORM 　そんなせつなそうな顔されたら…私も…	PRINTFORM 　そんなせつなそうな顔されたら…私も…
PRINTFORM 　いっぱい…溢れちゃうくらい射精してっ	PRINTFORM 　いっぱい…溢れちゃうくらい射精してっ
PRINTFORMW 　いいのよ、遠慮なくイっちゃって…」	PRINTFORMW 　いいのよ、遠慮なくイっちゃって…」
PRINTFORM 　私のせーえき…奥まで塗りこんであげる	PRINTFORM 　私のせーえき…奥まで塗りこんであげる
PRINTFORM 「なんだったら、直に味わってくれても…	PRINTFORM 「なんだったら、直に味わってくれても…
PRINTFORM 　膣内で…何本も蠢いて……ああぁぁッッ	PRINTFORM 　膣内で…何本も蠢いて……ああぁぁッッ
PRINTFORM 　あーーーーーーーーーーーーーー…っっ	PRINTFORM 　あーーーーーーーーーーーーーー…っっ
PRINTFORM 　さっきから…軽くイキっぱなしっ…でっ	PRINTFORM 　さっきから…軽くイキっぱなしっ…でっ
PRINTFORM 　おっ、美味しい？　なら…もっと…やっ	PRINTFORM 　おっ、美味しい？　なら…もっと…やっ
PRINTFORMW 　激しいのはこの辺までにしておくわ」	PRINTFORMW 　激しいのはこの辺までにしておくわ」
PRINTFORM 　…おなかいっぱいになった…みたいね…	PRINTFORM 　…おなかいっぱいになった…みたいね…
PRINTFORMW 　また…服の中がワサワサ動いてる…」	PRINTFORMW 　また…服の中がワサワサ動いてる…」
PRINTFORM 　しゃ、しゃせーしつづけちゃうぅぅッッ	PRINTFORM 　しゃ、しゃせーしつづけちゃうぅぅッッ
PRINTFORM 「やだ…股のところのスライムが…んんっ	PRINTFORM 「やだ…股のところのスライムが…んんっ
PRINTFORMW 「うう…スライムが纏わり付いてる…」	PRINTFORMW 「うう…スライムが纏わり付いてる…」
PRINTFORMW 「月符『サイレントセレナ』！！！」	PRINTFORMW 「月符『サイレントセレナ』！！！」
PRINTFORMW 「火水木金土符『賢者の石』！！！」	PRINTFORMW 「火水木金土符『賢者の石』！！！」
PRINTFORM 　もっと他に気持ちイイ穴…あるでしょ	PRINTFORM 　もっと他に気持ちイイ穴…あるでしょ
PRINTFORM 「ペットの私を…気持ち良くして下さい	PRINTFORM 「ペットの私を…気持ち良くして下さい
PRINTFORMW 　ご主人様のお情けがないと…私…」	PRINTFORMW 　ご主人様のお情けがないと…私…」
PRINTFORM 　私の方の準備は良いから…ほら…来て	PRINTFORM 　私の方の準備は良いから…ほら…来て
PRINTFORMW 　それっ、ぐにっ♪ぐにっ♪　…あ」	PRINTFORMW 　それっ、ぐにっ♪ぐにっ♪　…あ」
PRINTFORM 　今は…こんな事してる場合…じゃっっ	PRINTFORM 　今は…こんな事してる場合…じゃっっ
PRINTFORMW 「く……からだ…が…持たな…い…」	PRINTFORMW 「く……からだ…が…持たな…い…」
PRINTFORMW 「もう…早く脱がせて…楽にして…」	PRINTFORMW 「もう…早く脱がせて…楽にして…」
PRINTFORM 「挿入れさせて…くれるの……んんぅッ	PRINTFORM 「挿入れさせて…くれるの……んんぅッ
PRINTFORM 　もう少し…こっちで愉しみましょう…	PRINTFORM 　もう少し…こっちで愉しみましょう…
PRINTFORM 　欲しかった…けど…つっ…強すぎぃっ	PRINTFORM 　欲しかった…けど…つっ…強すぎぃっ
PRINTFORM 　そこ…キュウぅって……し、シビれ…	PRINTFORM 　そこ…キュウぅって……し、シビれ…
PRINTFORM 　おひりでイっちゃらめなのぉぉぉっっ	PRINTFORM 　おひりでイっちゃらめなのぉぉぉっっ
PRINTFORM 「うそっ…今おっぱいは…くぅぅんッッ	PRINTFORM 「うそっ…今おっぱいは…くぅぅんッッ
PRINTFORM 「いいんですかぁ？　振りほどかなくて	PRINTFORM 「いいんですかぁ？　振りほどかなくて
PRINTFORMW 「も…もう赤ちゃん居るのにぃ……」	PRINTFORMW 「も…もう赤ちゃん居るのにぃ……」
PRINTFORM 「ん…身体中ぬるぬるになっちゃったぁ	PRINTFORM 「ん…身体中ぬるぬるになっちゃったぁ
PRINTFORMW 「……あれ？　何もされなかった？」	PRINTFORMW 「……あれ？　何もされなかった？」
PRINTFORMW 「くっ…もう体力が…持たない……」	PRINTFORMW 「くっ…もう体力が…持たない……」
PRINTFORM 「このまま…わたしを苗床に…して……	PRINTFORM 「このまま…わたしを苗床に…して……
PRINTFORM 「服がもう…でも今はそんな事より……	PRINTFORM 「服がもう…でも今はそんな事より……
PRINTFORMW 「ものの見事に平らになったわね…」	PRINTFORMW 「ものの見事に平らになったわね…」
PRINTFORMW 「はぁ、はぁ…助かった……けど…」	PRINTFORMW 「はぁ、はぁ…助かった……けど…」
PRINTFORMW 「どうです…素敵な場所でしょう…」	PRINTFORMW 「どうです…素敵な場所でしょう…」
PRINTFORM 「おなかの赤ちゃんなら大丈夫だからっ	PRINTFORM 「おなかの赤ちゃんなら大丈夫だからっ
PRINTFORM 　このままびゅくびゅくってしてぇっっ	PRINTFORM 　このままびゅくびゅくってしてぇっっ
PRINTFORMW 「こく…こく……ふぅ、もう大丈夫」	PRINTFORMW 「こく…こく……ふぅ、もう大丈夫」
PRINTFORMW 　……ぁ…ひょっとして今の水……」	PRINTFORMW 　……ぁ…ひょっとして今の水……」
PRINTFORMW 「あと少し気づくのが遅かったら…」	PRINTFORMW 「あと少し気づくのが遅かったら…」
PRINTFORMW 「っ？　みんなっ！飛びのいてっ！」	PRINTFORMW 「っ？　みんなっ！飛びのいてっ！」
PRINTFORMW 「うぅ…はぁ…身体が…疼くの……」	PRINTFORMW 「うぅ…はぁ…身体が…疼くの……」
PRINTFORM 「やっやだ…纏わり付いて……んきゅっ	PRINTFORM 「やっやだ…纏わり付いて……んきゅっ
PRINTFORM 「ちょっ…やめてそこは……んんんっっ	PRINTFORM 「ちょっ…やめてそこは……んんんっっ
PRINTFORMW 「どう考えてもリスクが高過ぎるわ」	PRINTFORMW 「どう考えてもリスクが高過ぎるわ」
PRINTFORM 「まだまだ…たっぷりと頂きますからね	PRINTFORM 「まだまだ…たっぷりと頂きますからね
PRINTFORMW 　もう…おちんちん熱くて限界……」	PRINTFORMW 　もう…おちんちん熱くて限界……」
PRINTFORMW 「熟睡してるわよね……（ごくり）」	PRINTFORMW 「熟睡してるわよね……（ごくり）」
PRINTFORM 　もっと…おちんちんヌポヌポしてぇっ	PRINTFORM 　もっと…おちんちんヌポヌポしてぇっ
PRINTFORM 　もっと…おちんちんズポズポするのぉ	PRINTFORM 　もっと…おちんちんズポズポするのぉ
PRINTFORMW 「あ……それ…困ってるみたいね…」	PRINTFORMW 「あ……それ…困ってるみたいね…」
PRINTFORM 　…寝てたのに……や、やめ…んんッッ	PRINTFORM 　…寝てたのに……や、やめ…んんッッ
PRINTFORMW 「ふぅ…やっと観念したみたいね…」	PRINTFORMW 「ふぅ…やっと観念したみたいね…」
PRINTFORMW 　こ…こんな服着ていなければ……」	PRINTFORMW 　こ…こんな服着ていなければ……」
PRINTFORM 　ナカ……まだドクドク射精てるぅ……	PRINTFORM 　ナカ……まだドクドク射精てるぅ……
PRINTFORM 「あぁ…膣内で…凄く大きくなってる…	PRINTFORM 「あぁ…膣内で…凄く大きくなってる…
PRINTFORMDW そのまま小さな寝息を立て始めた…	PRINTFORMDW そのまま小さな寝息を立て始めた…
PRINTFORMW 「ごめんなさい、今はちょっと……」	PRINTFORMW 「ごめんなさい、今はちょっと……」
PRINTFORMW 「何してるの？　行くわよ、小悪魔」	PRINTFORMW 「何してるの？　行くわよ、小悪魔」
PRINTFORMW 「綺麗な羽…これはフェニックス？」	PRINTFORMW 「綺麗な羽…これはフェニックス？」
PRINTFORM 「はぁ…壁にも床にも…うねうねして…	PRINTFORM 「はぁ…壁にも床にも…うねうねして…
PRINTFORM 　おっぱい…そんなに群がっちゃ…あっ	PRINTFORM 　おっぱい…そんなに群がっちゃ…あっ
PRINTFORM 　あそこに挿れずにクリ…ばっかりッッ	PRINTFORM 　あそこに挿れずにクリ…ばっかりッッ
PRINTFORMW 「……なんだか…寝られないわね…」	PRINTFORMW 「……なんだか…寝られないわね…」
PRINTFORM 　きもちいひの…が…ふぁぁぁぁあぁッ	PRINTFORM 　きもちいひの…が…ふぁぁぁぁあぁッ
PRINTFORMW 「…………もう少し離れていなさい」	PRINTFORMW 「…………もう少し離れていなさい」
PRINTFORMW 「これは脱ごうとするだけ無駄ね…」	PRINTFORMW 「これは脱ごうとするだけ無駄ね…」
PRINTFORM 「ま…まだ…せーえき流れ込んでくる…	PRINTFORM 「ま…まだ…せーえき流れ込んでくる…
PRINTFORMW 　今は…スペルに集中しないと…」	PRINTFORMW 　今は…スペルに集中しないと…」
PRINTFORMW 「だ…だめ…これ以上されたら…」	PRINTFORMW 「だ…だめ…これ以上されたら…」
PRINTFORMW 「日符『ロイヤルフレア』！！！」	PRINTFORMW 「日符『ロイヤルフレア』！！！」
PRINTFORMW 「木符『シルフィホルン上級』！」	PRINTFORMW 「木符『シルフィホルン上級』！」
PRINTFORMW 「ちょっと残弾が心許無いわね…」	PRINTFORMW 「ちょっと残弾が心許無いわね…」
PRINTFORMW 　こんなになってるんだからぁ…」	PRINTFORMW 　こんなになってるんだからぁ…」
PRINTFORMW 「小悪魔…お茶を淹れてきて頂戴」	PRINTFORMW 「小悪魔…お茶を淹れてきて頂戴」
PRINTFORM 　こうして貴方を挟んでいると私も…	PRINTFORM 　こうして貴方を挟んでいると私も…
PRINTFORM 　もっと激しく…交じり合いましょう	PRINTFORM 　もっと激しく…交じり合いましょう
PRINTFORM 　な…膣内のヒダヒダが絡み付いて…	PRINTFORM 　な…膣内のヒダヒダが絡み付いて…
PRINTFORM 「や…おしりに…挿入っちゃ…ぅ…あ	PRINTFORM 「や…おしりに…挿入っちゃ…ぅ…あ
PRINTFORM 　貴方と私のお汁が混ざってぬるぬる	PRINTFORM 　貴方と私のお汁が混ざってぬるぬる
PRINTFORM 　もう全身…気持ちよくなってるの…	PRINTFORM 　もう全身…気持ちよくなってるの…
PRINTFORM 「ずぷぅって挿入って…きたぁぁんっ	PRINTFORM 「ずぷぅって挿入って…きたぁぁんっ
PRINTFORM 「違う…そっちじゃ…おちんちん…っ	PRINTFORM 「違う…そっちじゃ…おちんちん…っ
PRINTFORM 「こ…こんな…の…おかしい…んんっ	PRINTFORM 「こ…こんな…の…おかしい…んんっ
PRINTFORM 　もっと近くで…凄いのちょうだい…	PRINTFORM 　もっと近くで…凄いのちょうだい…
PRINTFORMW 「ちょっ…は、離しなさいよっ！」	PRINTFORMW 「ちょっ…は、離しなさいよっ！」
PRINTFORMW 「気持ち悪いわ、近寄らないでっ」	PRINTFORMW 「気持ち悪いわ、近寄らないでっ」
PRINTFORMW 「……っ？！　……ぅぅ…………」	PRINTFORMW 「……っ？！　……ぅぅ…………」
PRINTFORM 「ぁぁん…離さないで…もっとぉ……	PRINTFORM 「ぁぁん…離さないで…もっとぉ……
PRINTFORMW 　駄目ね…火照りが収まらない…」	PRINTFORMW 　駄目ね…火照りが収まらない…」
PRINTFORMW 「敵っ？！　しまった…体勢が…」	PRINTFORMW 「敵っ？！　しまった…体勢が…」
PRINTFORMW 「ちょっと、置いてかないで……」	PRINTFORMW 「ちょっと、置いてかないで……」
PRINTFORMW 「あら…この壁…通れるじゃない」	PRINTFORMW 「あら…この壁…通れるじゃない」
PRINTFORMW 「敵っ？！　く…油断したわ…っ」	PRINTFORMW 「敵っ？！　く…油断したわ…っ」
PRINTFORMW 「……!!　これは…凄い効能ね」	PRINTFORMW 「……!!　これは…凄い効能ね」
PRINTFORM 　おなかの中…たくさんちょうだい…	PRINTFORM 　おなかの中…たくさんちょうだい…
PRINTFORMW 「はぁ…はぁ……え…身体が…？」	PRINTFORMW 「はぁ…はぁ……え…身体が…？」
PRINTFORM 「ぅぅ…おちんちん膨らんで…るっっ	PRINTFORM 「ぅぅ…おちんちん膨らんで…るっっ
PRINTFORM 　とっ止まらなっ……んんんんッッッ	PRINTFORM 　とっ止まらなっ……んんんんッッッ
PRINTFORMW 「……ん…綺麗にしてあげたわよ」	PRINTFORMW 「……ん…綺麗にしてあげたわよ」
PRINTFORM 　パチュリーさまのご命令でしたらっ	PRINTFORM 　パチュリーさまのご命令でしたらっ
PRINTFORMW 　そんなに私のおちんぽ良いの？」	PRINTFORMW 　そんなに私のおちんぽ良いの？」
PRINTFORM 　もっと…ぎゅうぅぅってしないとっ	PRINTFORM 　もっと…ぎゅうぅぅってしないとっ
PRINTFORM 　お尻の穴なんかで咥え込んじゃって	PRINTFORM 　お尻の穴なんかで咥え込んじゃって
PRINTFORM 　このまま…中に射精しちゃうわよっ	PRINTFORM 　このまま…中に射精しちゃうわよっ
PRINTFORM 　きゅうきゅう締め付けてきてるわよ	PRINTFORM 　きゅうきゅう締め付けてきてるわよ
PRINTFORM 　おちんちん出たり入ったりしてるっ	PRINTFORM 　おちんちん出たり入ったりしてるっ
PRINTFORM 　お口で…精液搾り取られちゃう……	PRINTFORM 　お口で…精液搾り取られちゃう……
PRINTFORMW 　どっちが上の立場か…解った？」	PRINTFORMW 　どっちが上の立場か…解った？」
PRINTFORMW 　ほどいちゃった…のね…残念…」	PRINTFORMW 　ほどいちゃった…のね…残念…」
PRINTFORM 　ナカで大きく膨らんで…こっこれっ	PRINTFORM 　ナカで大きく膨らんで…こっこれっ
PRINTFORM 　じぇったひ…はらんじゃうぅぅっっ	PRINTFORM 　じぇったひ…はらんじゃうぅぅっっ
PRINTFORML 「きっとここには私達の…ふふっ」	PRINTFORML 「きっとここには私達の…ふふっ」
PRINTFORMW 「もしやこの瓶……中身は媚薬？」	PRINTFORMW 「もしやこの瓶……中身は媚薬？」
PRINTFORMW 「気付け薬…これは貴重な品ね。」	PRINTFORMW 「気付け薬…これは貴重な品ね。」
PRINTFORM 「あぁ…大きい波が…近づいて…あっ	PRINTFORM 「あぁ…大きい波が…近づいて…あっ
PRINTFORM 「んんっ……ああああぁぁんんッッッ	PRINTFORM 「んんっ……ああああぁぁんんッッッ
PRINTFORM 　おっぱいミルク…でちゃうぅぅっっ	PRINTFORM 　おっぱいミルク…でちゃうぅぅっっ
PRINTFORMW 「うぐ……あ…が……や…やめ…」	PRINTFORMW 「うぐ……あ…が……や…やめ…」
PRINTFORMW 「ぐずぐずしている暇はないわ！」	PRINTFORMW 「ぐずぐずしている暇はないわ！」
PRINTFORMW 「焦らない…移動中も油断大敵よ」	PRINTFORMW 「焦らない…移動中も油断大敵よ」
PRINTFORMW 「よし、この部屋で迎え撃つわ…」	PRINTFORMW 「よし、この部屋で迎え撃つわ…」
PRINTFORM 　弱いのに…そっ、そこばっかりッッ	PRINTFORM 　弱いのに…そっ、そこばっかりッッ
PRINTFORM 　きもひいいのが…きひゃうのほぉ…	PRINTFORM 　きもひいいのが…きひゃうのほぉ…
PRINTFORMW 「…うん、なかなか美味しいわね」	PRINTFORMW 「…うん、なかなか美味しいわね」
PRINTFORM 「…そんなに…おっぱい…吸っちゃっ	PRINTFORM 「…そんなに…おっぱい…吸っちゃっ
PRINTFORMW 「ぁぅ…………ぁ…ぁ…………」	PRINTFORMW 「ぁぅ…………ぁ…ぁ…………」
PRINTFORMW 「……うくっ、邪魔しないで！」	PRINTFORMW 「……うくっ、邪魔しないで！」
PRINTFORMW 「金土符『ジンジャガスト』！」	PRINTFORMW 「金土符『ジンジャガスト』！」
PRINTFORMW 「めいっぱい魔力を込めて……」	PRINTFORMW 「めいっぱい魔力を込めて……」
PRINTFORM 「力を溜めればなんとか…んきゅぅ	PRINTFORM 「力を溜めればなんとか…んきゅぅ
PRINTFORM 「だめ…もう……ぐちょぐちょにっ	PRINTFORM 「だめ…もう……ぐちょぐちょにっ
PRINTFORM 「ほんと…貴方のって硬いわよね…	PRINTFORM 「ほんと…貴方のって硬いわよね…
PRINTFORMW 「ん…やだ…脱がされちゃう…」	PRINTFORMW 「ん…やだ…脱がされちゃう…」
PRINTFORM 　今…敏感になっちゃってるのぉ…	PRINTFORM 　今…敏感になっちゃってるのぉ…
PRINTFORMW 　するならするで…一思いに…」	PRINTFORMW 　するならするで…一思いに…」
PRINTFORM 「もっと…もっとおしり突いてぇっ	PRINTFORM 「もっと…もっとおしり突いてぇっ
PRINTFORM 　アナル拡がっちゃうぅんっっっっ	PRINTFORM 　アナル拡がっちゃうぅんっっっっ
PRINTFORM 　おっぱいからビリビリぃってぇっ	PRINTFORM 　おっぱいからビリビリぃってぇっ
PRINTFORM 「シビれひゃってへへへへぇぇぇぇ	PRINTFORM 「シビれひゃってへへへへぇぇぇぇ
PRINTFORM 　疼きが止まらなくなっちゃうぅ…	PRINTFORM 　疼きが止まらなくなっちゃうぅ…
PRINTFORM 　しっかり…孕んでくださいっっっ	PRINTFORM 　しっかり…孕んでくださいっっっ
PRINTFORM 「そ…そっちは…ぁ！　くぅ…ん…	PRINTFORM 「そ…そっちは…ぁ！　くぅ…ん…
PRINTFORMW 「…ぁ……力が……吸われ……」	PRINTFORMW 「…ぁ……力が……吸われ……」
PRINTFORM 「ここまで…耐えてきたけど…んッ	PRINTFORM 「ここまで…耐えてきたけど…んッ
PRINTFORMW 「…嬉しいです！　ご主人様…」	PRINTFORMW 「…嬉しいです！　ご主人様…」
PRINTFORM 「ふふっ…二人っきりの結婚式ね…	PRINTFORM 「ふふっ…二人っきりの結婚式ね…
PRINTFORMW 「はぁ…驚かさないで欲しいわ」	PRINTFORMW 「はぁ…驚かさないで欲しいわ」
PRINTFORMW 「…え？　きゃぁぁぁ…………」	PRINTFORMW 「…え？　きゃぁぁぁ…………」
PRINTFORM 　おしり…まだヒクヒクいってる…	PRINTFORM 　おしり…まだヒクヒクいってる…
PRINTFORMW 　やったわね…これで全部よ…」	PRINTFORMW 　やったわね…これで全部よ…」
PRINTFORMW 「上っ？！　みんな避けてっ！」	PRINTFORMW 「上っ？！　みんな避けてっ！」
PRINTFORM 　すぐ…美味しい精液あげるから…	PRINTFORM 　すぐ…美味しい精液あげるから…
PRINTFORMW 　やぁ…この蟲…吸い付いて…」	PRINTFORMW 　やぁ…この蟲…吸い付いて…」
PRINTFORM 　私の身体中…ぬるぬるで覆ってぇ	PRINTFORM 　私の身体中…ぬるぬるで覆ってぇ
PRINTFORMW 　やっと…落ち着いてくれた…」	PRINTFORMW 　やっと…落ち着いてくれた…」
PRINTFORM 「んくっ…やっ、そんな奥…までっ	PRINTFORM 「んくっ…やっ、そんな奥…までっ
PRINTFORM 　そっ…そこは入れる穴じゃな…っ	PRINTFORM 　そっ…そこは入れる穴じゃな…っ
PRINTFORMW 　ちょっと私の相手をしなさい」	PRINTFORMW 　ちょっと私の相手をしなさい」
PRINTFORMDL どくんっ！ドクッ！ドクッ！！	PRINTFORMDL どくんっ！ドクッ！ドクッ！！
PRINTFORMDW 激しく己の欲望を吐き出した…	PRINTFORMDW 激しく己の欲望を吐き出した…
PRINTFORM 　こんなの…出したくないの…にっ	PRINTFORM 　こんなの…出したくないの…にっ
PRINTFORM 　おちんちんイっちゃうぅぅぅっっ	PRINTFORM 　おちんちんイっちゃうぅぅぅっっ
PRINTFORM 　これくらい…いつでも致しますよ	PRINTFORM 　これくらい…いつでも致しますよ
PRINTFORM 　包み込んじゃってるじゃないッッ	PRINTFORM 　包み込んじゃってるじゃないッッ
PRINTFORM 　きゅうきゅう締め付けてくるっっ	PRINTFORM 　きゅうきゅう締め付けてくるっっ
PRINTFORM 　裏の方にも…舌を這わせて…ぅん	PRINTFORM 　裏の方にも…舌を這わせて…ぅん
PRINTFORM 「私も…子宮が疼いて仕方ないの…	PRINTFORM 「私も…子宮が疼いて仕方ないの…
PRINTFORM 　ねぇ…私の胸で包み込んであげる	PRINTFORM 　ねぇ…私の胸で包み込んであげる
PRINTFORM 　そこ…擦り付けないで……くぅ…	PRINTFORM 　そこ…擦り付けないで……くぅ…
PRINTFORM 　そっそんなにキツくしたら…あっ	PRINTFORM 　そっそんなにキツくしたら…あっ
PRINTFORMW 　……ん？　服が絡み付いて…」	PRINTFORMW 　……ん？　服が絡み付いて…」
PRINTFORMW 「……あ…離れ…ちゃった…？」	PRINTFORMW 「……あ…離れ…ちゃった…？」
PRINTFORM 「そんな…全身を撫でられたらぁ…	PRINTFORM 「そんな…全身を撫でられたらぁ…
PRINTFORMW 　ほら…その証拠がこんなに…」	PRINTFORMW 　ほら…その証拠がこんなに…」
PRINTFORMW 　でも…これで…アイテム……」	PRINTFORMW 　でも…これで…アイテム……」
PRINTFORMW 「これは…咲夜の懐中時計？！」	PRINTFORMW 「これは…咲夜の懐中時計？！」
PRINTFORM 　こ、こんなのじゃ…すぐ…ッッッ	PRINTFORM 　こ、こんなのじゃ…すぐ…ッッッ
PRINTFORM 「……ぁ……ぁ…ぁ…………ッッッ	PRINTFORM 「……ぁ……ぁ…ぁ…………ッッッ
PRINTFORM 　やあああぁぁぁぁぁぁぁぁッッッ	PRINTFORM 　やあああぁぁぁぁぁぁぁぁッッッ
PRINTFORM 「別に妊娠したわけじゃ…あぁんっ	PRINTFORM 「別に妊娠したわけじゃ…あぁんっ
PRINTFORMW 「さて、今度の部屋には何が…」	PRINTFORMW 「さて、今度の部屋には何が…」
PRINTFORMW 「はぁーーー…　はぁーーー…」	PRINTFORMW 「はぁーーー…　はぁーーー…」
PRINTFORM 「おまんこ…もっと欲しいのぉ……	PRINTFORM 「おまんこ…もっと欲しいのぉ……
PRINTFORMW 　吸ってくれたら出るかも…♪」	PRINTFORMW 　吸ってくれたら出るかも…♪」
PRINTFORM 　乳首…吸い付いてる…だっだめッ	PRINTFORM 　乳首…吸い付いてる…だっだめッ
PRINTFORM 　なかだしされてイっちゃうっっっ	PRINTFORM 　なかだしされてイっちゃうっっっ
PRINTFORMW 　胸が…まだじんじんしてる…」	PRINTFORMW 　胸が…まだじんじんしてる…」
PRINTFORMW 「ぅぁ……………ぅ…………」	PRINTFORMW 「ぅぁ……………ぅ…………」
PRINTFORMW 「だから前衛なんて無理よ…」	PRINTFORMW 「だから前衛なんて無理よ…」
PRINTFORMW 「ここは一時撤退が良策ね…」	PRINTFORMW 「ここは一時撤退が良策ね…」
PRINTFORMW 「少し威力重視で行くわよ…」	PRINTFORMW 「少し威力重視で行くわよ…」
PRINTFORMW 「せーのっ……たあぁッ！！」	PRINTFORMW 「せーのっ……たあぁッ！！」
PRINTFORM 　私の身体を好きにお使い下さい	PRINTFORM 　私の身体を好きにお使い下さい
PRINTFORM 「足でシテ欲しいの？　…んもぅ	PRINTFORM 「足でシテ欲しいの？　…んもぅ
PRINTFORM 　上手く出来るかわからないわよ	PRINTFORM 　上手く出来るかわからないわよ
PRINTFORMW 　ようやく満足…したのね…」	PRINTFORMW 　ようやく満足…したのね…」
PRINTFORM 　このまま…どうなってもいい…	PRINTFORM 　このまま…どうなってもいい…
PRINTFORMW 　お願いします…私のここ…」	PRINTFORMW 　お願いします…私のここ…」
PRINTFORM 　もうおっぱい全部ぬるぬるよ…	PRINTFORM 　もうおっぱい全部ぬるぬるよ…
PRINTFORM 　腰が勝手に…動いちゃってるっ	PRINTFORM 　腰が勝手に…動いちゃってるっ
PRINTFORM 　こ…これをまた引いて…んんぅ	PRINTFORM 　こ…これをまた引いて…んんぅ
PRINTFORM 　もっと…奥まで…はぁああんっ	PRINTFORM 　もっと…奥まで…はぁああんっ
PRINTFORM 　……ぅん…いいわよ…続けて…	PRINTFORM 　……ぅん…いいわよ…続けて…
PRINTFORM 「お尻じゃなく…て……んくぅ…	PRINTFORM 「お尻じゃなく…て……んくぅ…
PRINTFORM 　もっと…おっぱいイジってぇ…	PRINTFORM 　もっと…おっぱいイジってぇ…
PRINTFORM 　そんなにぐぽぐぽしたらぁぁっ	PRINTFORM 　そんなにぐぽぐぽしたらぁぁっ
PRINTFORM 　か、感じ過ぎ…ちゃって…くっ	PRINTFORM 　か、感じ過ぎ…ちゃって…くっ
PRINTFORMW 　おしりに…何を出して……」	PRINTFORMW 　おしりに…何を出して……」
PRINTFORM 　なっなにか…なかに……ッッッ	PRINTFORM 　なっなにか…なかに……ッッッ
PRINTFORM 　やだ…無視してたけど…これっ	PRINTFORM 　やだ…無視してたけど…これっ
PRINTFORM 「…や…もう…我慢も…限界っっ	PRINTFORM 「…や…もう…我慢も…限界っっ
PRINTFORM 「子宮で受け取って下さいッッッ	PRINTFORM 「子宮で受け取って下さいッッッ
PRINTFORM 　グリグリしちゃっ…子宮…口っ	PRINTFORM 　グリグリしちゃっ…子宮…口っ
PRINTFORMW 「…ほっ。少し落ち着いたわ」	PRINTFORMW 「…ほっ。少し落ち着いたわ」
PRINTFORM 　そう…そこ…もっと……んんっ	PRINTFORM 　そう…そこ…もっと……んんっ
PRINTFORMW 「生憎だけど、他を当たって」	PRINTFORMW 「生憎だけど、他を当たって」
PRINTFORMW 　だっ誰か引き剥がしてぇ…」	PRINTFORMW 　だっ誰か引き剥がしてぇ…」
PRINTFORMW 　今の蟲…絶対何かの毒を…」	PRINTFORMW 　今の蟲…絶対何かの毒を…」
PRINTFORM 「こらっ、そんなところに…んぅ	PRINTFORM 「こらっ、そんなところに…んぅ
PRINTFORM 　そんな絞っちゃ……あぁんッッ	PRINTFORM 　そんな絞っちゃ……あぁんッッ
PRINTFORMW 　もしかして…射…精……？」	PRINTFORMW 　もしかして…射…精……？」
PRINTFORM 　あぁぁ～～～～～～～～ッッッ	PRINTFORM 　あぁぁ～～～～～～～～ッッッ
PRINTFORM 「いやぁ…この感覚……またっっ	PRINTFORM 「いやぁ…この感覚……またっっ
PRINTFORM 　せーえきでちゃうぅぅぅッッッ	PRINTFORM 　せーえきでちゃうぅぅぅッッッ
PRINTFORM 「そんな…大きく上下されたらっ	PRINTFORM 「そんな…大きく上下されたらっ
PRINTFORM 　全部気持ちよくなっちゃうッッ	PRINTFORM 　全部気持ちよくなっちゃうッッ
PRINTFORM 　これからは大人しくするのよっ	PRINTFORM 　これからは大人しくするのよっ
PRINTFORM 「私のこの胸…気になるみたいね	PRINTFORM 「私のこの胸…気になるみたいね
PRINTFORMW 「お願い…じっとしていて…」	PRINTFORMW 「お願い…じっとしていて…」
PRINTFORM 　せーえき射精しちゃうわよっっ	PRINTFORM 　せーえき射精しちゃうわよっっ
PRINTFORMW 「……あら…もういいの…？」	PRINTFORMW 「……あら…もういいの…？」
PRINTFORM 　もう…無理…でっ、でちゃうっ	PRINTFORM 　もう…無理…でっ、でちゃうっ
PRINTFORM 　膣内にドクドク射精してぇッッ	PRINTFORM 　膣内にドクドク射精してぇッッ
PRINTFORM 　いっぱいせーえき注いであげる	PRINTFORM 　いっぱいせーえき注いであげる
PRINTFORMW 「はぁーーー…はぁーーー…」	PRINTFORMW 「はぁーーー…はぁーーー…」
PRINTFORM …そんなに…入っちゃ………ッッ	PRINTFORM …そんなに…入っちゃ………ッッ
PRINTFORM 「乳首でブルブル震えて…はぁ…	PRINTFORM 「乳首でブルブル震えて…はぁ…
PRINTFORM 「…ぁ…あ～～～～～～～～～～	PRINTFORM 「…ぁ…あ～～～～～～～～～～
PRINTFORM 　ぃ…ぃーーーーーーーー…ッッ	PRINTFORM 　ぃ…ぃーーーーーーーー…ッッ
PRINTFORM 　やっ、やっぱり…脱げない…か	PRINTFORM 　やっ、やっぱり…脱げない…か
PRINTFORM 「…おっぱい…きもひいいのぉ…	PRINTFORM 「…おっぱい…きもひいいのぉ…
PRINTFORM 「これからしばらく…よろしくね	PRINTFORM 「これからしばらく…よろしくね
PRINTFORM 　…～～～～～～～～ッッッッッ	PRINTFORM 　…～～～～～～～～ッッッッッ
PRINTFORM 　か、身体が…感じ過ぎちゃう…	PRINTFORM 　か、身体が…感じ過ぎちゃう…
PRINTFORM 「びゅるびゅるびゅるってッッッ	PRINTFORM 「びゅるびゅるびゅるってッッッ
PRINTFORM 　スライムが染み込んできてるっ	PRINTFORM 　スライムが染み込んできてるっ
PRINTFORM 　膣内にたっぷり注ぎ込まれて…	PRINTFORM 　膣内にたっぷり注ぎ込まれて…
PRINTFORM 「いいわ、今日は調子も…ぁ…	PRINTFORM 「いいわ、今日は調子も…ぁ…
PRINTFORMW 「これを使うのもいいわね」	PRINTFORMW 「これを使うのもいいわね」
PRINTFORM 　らめ…これ…ひじょうわぁ…	PRINTFORM 　らめ…これ…ひじょうわぁ…
PRINTFORM 「耐える…耐えるの…あぁんっ	PRINTFORM 「耐える…耐えるの…あぁんっ
PRINTFORMW 　…ちゅぷ……ちゅぷ……」	PRINTFORMW 　…ちゅぷ……ちゅぷ……」
PRINTFORM 「お願い…私を気持ち良くして	PRINTFORM 「お願い…私を気持ち良くして
PRINTFORM 　もっと…激しくして…ちゅぅ	PRINTFORM 　もっと…激しくして…ちゅぅ
PRINTFORMW 　もっと優しく…してぇ…」	PRINTFORMW 　もっと優しく…してぇ…」
PRINTFORMW 　そ…そうじゃなくてぇ…」	PRINTFORMW 　そ…そうじゃなくてぇ…」
PRINT 「ぐ…は……はぁーーー…はぁーーー…	PRINT 「ぐ…は……はぁーーー…はぁーーー…
PRINTFORM 　そっそう…んんんぅぅぅっっ	PRINTFORM 　そっそう…んんんぅぅぅっっ
PRINTFORM 　ま…まだ…精液あげないわよ	PRINTFORM 　ま…まだ…精液あげないわよ
PRINTFORM 　奥…ぐりぐりさせないでぇ…	PRINTFORM 　奥…ぐりぐりさせないでぇ…
PRINTFORM 　貴方が動かないなら私が…ッ	PRINTFORM 　貴方が動かないなら私が…ッ
PRINTFORM 　おまんこズポズポでいいわっ	PRINTFORM 　おまんこズポズポでいいわっ
PRINTFORM 「やぁ…そっちは…くぅぅぅぅ	PRINTFORM 「やぁ…そっちは…くぅぅぅぅ
PRINTFORM 　イっひゃうからぁぁぁっっっ	PRINTFORM 　イっひゃうからぁぁぁっっっ
PRINTFORMW 「く……気色悪い真似を…」	PRINTFORMW 「く……気色悪い真似を…」
PRINTFORM 　もう…これ以上…されたらっ	PRINTFORM 　もう…これ以上…されたらっ
PRINTFORM 　あああぁぁぁぁぁんんんッッ	PRINTFORM 　あああぁぁぁぁぁんんんッッ
PRINTFORMW 「……あ…おっぱいが…？」	PRINTFORMW 「……あ…おっぱいが…？」
PRINTFORM 　いっぱいでてりゅぅぅぅっっ	PRINTFORM 　いっぱいでてりゅぅぅぅっっ
PRINTFORM 　膣内の奥…押し付けちゃっっ	PRINTFORM 　膣内の奥…押し付けちゃっっ
PRINTFORM 「んんっ…種付け…されてるっ	PRINTFORM 「んんっ…種付け…されてるっ
PRINTFORM …なか…は……ふぁあぁぁっっ	PRINTFORM …なか…は……ふぁあぁぁっっ
PRINTFORM 　こんなに糸引いちゃってる…	PRINTFORM 　こんなに糸引いちゃってる…
PRINTFORM 　こんなにたくさん……んん…	PRINTFORM 　こんなにたくさん……んん…
PRINTFORMW 「あら…服…無事みたいね」	PRINTFORMW 「あら…服…無事みたいね」
PRINTFORMW 「だ…だめ…動けない……」	PRINTFORMW 「だ…だめ…動けない……」
PRINTFORMW 　やぁ…こみ上げ…て……」	PRINTFORMW 　やぁ…こみ上げ…て……」
PRINTFORM 　わらひ…しあわせれしゅぅ…	PRINTFORM 　わらひ…しあわせれしゅぅ…
PRINTFORMW 「なんだか不思議な味ね…」	PRINTFORMW 「なんだか不思議な味ね…」
PRINTFORM 「しょっ…触手っ？！　んぅ…	PRINTFORM 「しょっ…触手っ？！　んぅ…
PRINTFORMW 「…ぅ…瞼が…重…い……」	PRINTFORMW 「…ぅ…瞼が…重…い……」
PRINTFORMW 「はぁ……今日は厄日ね…」	PRINTFORMW 「はぁ……今日は厄日ね…」
PRINTFORM 　おっぱい吸い付いちゃ…あっ	PRINTFORM 　おっぱい吸い付いちゃ…あっ
PRINTFORM 　この蟲…ほんと上手…んふぅ	PRINTFORM 　この蟲…ほんと上手…んふぅ
PRINTFORMW 　くっ口の中で…ううっ…」	PRINTFORMW 　くっ口の中で…ううっ…」
PRINTFORM 　今、飲まされたのは…んんっ	PRINTFORM 　今、飲まされたのは…んんっ
PRINTFORM 　そんなにくりくりしちゃっっ	PRINTFORM 　そんなにくりくりしちゃっっ
PRINTFORM 　もう、せっかちなんだから…	PRINTFORM 　もう、せっかちなんだから…
PRINTFORM 　おちんぽみるく登ってきたっ	PRINTFORM 　おちんぽみるく登ってきたっ
PRINTFORM 「どうですか…パチュリーさま	PRINTFORM 「どうですか…パチュリーさま
PRINTFORM 　淫魔のテクニック…流石だわ	PRINTFORM 　淫魔のテクニック…流石だわ
PRINTFORM 　お願い…私にいっぱいかけて	PRINTFORM 　お願い…私にいっぱいかけて
PRINTFORM 「いいわよ、私が抜いてあげる	PRINTFORM 「いいわよ、私が抜いてあげる
PRINTFORMW 　…あ、起きちゃったの？」	PRINTFORMW 　…あ、起きちゃったの？」
PRINTFORMW 「……ねぇ、これ…見て…」	PRINTFORMW 「……ねぇ、これ…見て…」
PRINTFORMW 　ひ…卑怯よ…こんなの…」	PRINTFORMW 　ひ…卑怯よ…こんなの…」
PRINTFORM 「…服が…うねうねが全身を…	PRINTFORM 「…服が…うねうねが全身を…
PRINTFORM 　しゃせーひちゃらめぇっっっ	PRINTFORM 　しゃせーひちゃらめぇっっっ
PRINTFORMW 　まだまだ…終わらないわ」	PRINTFORMW 　まだまだ…終わらないわ」
PRINTFORM 　びゅるるって射精ちゃうっっ	PRINTFORM 　びゅるるって射精ちゃうっっ
PRINTFORMW 「…なんだか熱い……ん…」	PRINTFORMW 「…なんだか熱い……ん…」
PRINTFORM …イっちゃうの…んぅんッッッ	PRINTFORM …イっちゃうの…んぅんッッッ
PRINTFORM 「…ふぁ……ぁ……ぁぁ………	PRINTFORM 「…ふぁ……ぁ……ぁぁ………
PRINTFORMW 　早く…静かな場所で……」	PRINTFORMW 　早く…静かな場所で……」
PRINTFORMW 「今度はこっちの部屋ね！」	PRINTFORMW 「今度はこっちの部屋ね！」
PRINTFORM 　まっ…また暴れ…んああッッ	PRINTFORM 　まっ…また暴れ…んああッッ
PRINTFORM 　…たっぷり…注がれちゃった	PRINTFORM 　…たっぷり…注がれちゃった
PRINTFORM 　だめ…膣内に射精しちゃ…あ	PRINTFORM 　だめ…膣内に射精しちゃ…あ
PRINTFORM 　みんなが…起きちゃう…んぅ	PRINTFORM 　みんなが…起きちゃう…んぅ
PRINTFORM 　ごくごく…音…立てないでぇ	PRINTFORM 　ごくごく…音…立てないでぇ
PRINTFORM 「ぁ…………ぁ…ぁ…………	PRINTFORM 「ぁ…………ぁ…ぁ…………
PRINTFORM 「ぅ……………ぁぅ…………	PRINTFORM 「ぅ……………ぁぅ…………
PRINTFORMW 「ほら、足元がお留守よ」	PRINTFORMW 「ほら、足元がお留守よ」
PRINTFORMW 「私に近寄らないでっ！」	PRINTFORMW 「私に近寄らないでっ！」
PRINTFORMW 「降参よ…………んっ…」	PRINTFORMW 「降参よ…………んっ…」
PRINTFORMW 　もっと強く抱いて……」	PRINTFORMW 　もっと強く抱いて……」
PRINTFORM 「ほら…おっぱい弄ってっっ	PRINTFORM 「ほら…おっぱい弄ってっっ
PRINTFORM 　…私もなるべく頑張るけど	PRINTFORM 　…私もなるべく頑張るけど
PRINTFORM 　戦闘中…だけど…あぁんっ	PRINTFORM 　戦闘中…だけど…あぁんっ
PRINTFORMW 「うぅ……も…もう……」	PRINTFORMW 「うぅ……も…もう……」
PRINTFORM 　そんな締め付けられたらッ	PRINTFORM 　そんな締め付けられたらッ
PRINTFORM 「おしりね、わかった…んぅ	PRINTFORM 「おしりね、わかった…んぅ
PRINTFORM 　先が擦れて…私も…いいの	PRINTFORM 　先が擦れて…私も…いいの
PRINTFORM 　カリが擦れて…んぁぁんっ	PRINTFORM 　カリが擦れて…んぁぁんっ
PRINTFORM 　ゴツゴツ当たってるっっっ	PRINTFORM 　ゴツゴツ当たってるっっっ
PRINTFORM 　お願い…もっと奥までぇ…	PRINTFORM 　お願い…もっと奥までぇ…
PRINTFORM 「うぅん…もっとコスってぇ	PRINTFORM 「うぅん…もっとコスってぇ
PRINTFORM 　ひゃああああぁんんッッッ	PRINTFORM 　ひゃああああぁんんッッッ
PRINTFORM 　それいじょうひチゃッッッ	PRINTFORM 　それいじょうひチゃッッッ
PRINTFORMW 　はぁ…気持ち…いい…」	PRINTFORMW 　はぁ…気持ち…いい…」
PRINTFORM 　い…今の…すごかったわ…	PRINTFORM 　い…今の…すごかったわ…
PRINTFORM 　またイっちゃ………ぁッッ	PRINTFORM 　またイっちゃ………ぁッッ
PRINTFORM 　…されちゃうぅ……っっっ	PRINTFORM 　…されちゃうぅ……っっっ
PRINTFORM 　びゅくびゅくでてりゅぅっ	PRINTFORM 　びゅくびゅくでてりゅぅっ
PRINTFORM 　それに…この臭い……はぁ	PRINTFORM 　それに…この臭い……はぁ
PRINTFORM 「ん…いっぱい…出したのね	PRINTFORM 「ん…いっぱい…出したのね
PRINTFORM 　…はぁ…すっごく濃いのね	PRINTFORM 　…はぁ…すっごく濃いのね
PRINTFORMW 「…解放…されたの…？」	PRINTFORMW 「…解放…されたの…？」
PRINTFORM …そんなに…ぎゅうって……	PRINTFORM …そんなに…ぎゅうって……
PRINTFORMW 「…ふぅ、生き返るわね」	PRINTFORMW 「…ふぅ、生き返るわね」
PRINTFORM 　いきなりなんて…そんな…	PRINTFORM 　いきなりなんて…そんな…
PRINTFORM 　う、うそっ…やめ…っっっ	PRINTFORM 　う、うそっ…やめ…っっっ
PRINTFORM 　乳首ッ…そんな吸っちゃッ	PRINTFORM 　乳首ッ…そんな吸っちゃッ
PRINTFORM 　奥に…たっぷりくださぁい	PRINTFORM 　奥に…たっぷりくださぁい
PRINTFORM 「ふは…これ…ら、らめぇ…	PRINTFORM 「ふは…これ…ら、らめぇ…
PRINTFORM 　せーえき…射精したいのっ	PRINTFORM 　せーえき…射精したいのっ
PRINTFORM 　すごい…いっぱいでてる…	PRINTFORM 　すごい…いっぱいでてる…
PRINTFORM 　どうですパチュリーさまっ	PRINTFORM 　どうですパチュリーさまっ
PRINTFORM 　喉の奥に…射精すわよっっ	PRINTFORM 　喉の奥に…射精すわよっっ
PRINTFORM 　先っぽ舐めちゃ…あぁんっ	PRINTFORM 　先っぽ舐めちゃ…あぁんっ
PRINTFORM 　男受けしそうな胸をしてっ	PRINTFORM 　男受けしそうな胸をしてっ
PRINTFORM 　ギンギンに固くしちゃって	PRINTFORM 　ギンギンに固くしちゃって
PRINTFORMW 　それなら…こうして…」	PRINTFORMW 　それなら…こうして…」
PRINTFORM 「ヤりやすい姿になったわね	PRINTFORM 「ヤりやすい姿になったわね
PRINTFORMW 　だめ…げんか…い……」	PRINTFORMW 　だめ…げんか…い……」
PRINTFORM 　いま…しゃせーされたらぁ	PRINTFORM 　いま…しゃせーされたらぁ
PRINTFORM 「そっそんなに…されたらっ	PRINTFORM 「そっそんなに…されたらっ
PRINTFORMW 　いいわ…そのまま……」	PRINTFORMW 　いいわ…そのまま……」
PRINTFORM 　たくさん…射精したのね…	PRINTFORM 　たくさん…射精したのね…
PRINTFORM 　ん…もう少し…このまま…	PRINTFORM 　ん…もう少し…このまま…
PRINTFORMW 　こっ、これっ…癖に…」	PRINTFORMW 　こっ、これっ…癖に…」
PRINTFORM 　あーーーーーーーー～～…	PRINTFORM 　あーーーーーーーー～～…
PRINTFORM 　ひぅっ………………っっっ	PRINTFORM 　ひぅっ………………っっっ
PRINTFORM 　んあぁぁぁあああぁぁっっ	PRINTFORM 　んあぁぁぁあああぁぁっっ
PRINTFORM 　ぁあぁぁんんんんんっっっ	PRINTFORM 　ぁあぁぁんんんんんっっっ
PRINTFORM 　ほっ…ほらっ！零してるっ	PRINTFORM 　ほっ…ほらっ！零してるっ
PRINTFORM 　ずぶずぶって挿入って…あ	PRINTFORM 　ずぶずぶって挿入って…あ
PRINTFORM 　抑えられ…はあぁぁんっっ	PRINTFORM 　抑えられ…はあぁぁんっっ
PRINTFORMW 　……終わっ…た……？」	PRINTFORMW 　……終わっ…た……？」
PRINTFORM 　全部搾られちゃうぅぅッッ	PRINTFORM 　全部搾られちゃうぅぅッッ
PRINTFORM 　子宮が…悦んじゃってる…	PRINTFORM 　子宮が…悦んじゃってる…
PRINTFORM 　そんなに…すっ…吸っちゃ	PRINTFORM 　そんなに…すっ…吸っちゃ
PRINTFORM 　こ、声が出ちゃ……んんっ	PRINTFORM 　こ、声が出ちゃ……んんっ
PRINTFORML 各種追加パッチ導入を推奨	PRINTFORML 各種追加パッチ導入を推奨
PRINTFORM 　ぁーーーーーーーーっっ	PRINTFORM 　ぁーーーーーーーーっっ
PRINTFORM 　…………ぁぁ……………	PRINTFORM 　…………ぁぁ……………
PRINTFORM 「おっぱい触っちゃいや…	PRINTFORM 「おっぱい触っちゃいや…
PRINTFORM 「ほら、今度は貴方の番よ	PRINTFORM 「ほら、今度は貴方の番よ
PRINTFORM 　それじゃ…挿入れるわね	PRINTFORM 　それじゃ…挿入れるわね
PRINTFORM 　…痛いだけ…なの…に…	PRINTFORM 　…痛いだけ…なの…に…
PRINTFORM 　身体が…反応しちゃうっ	PRINTFORM 　身体が…反応しちゃうっ
PRINTFORM 　やっぱり…おちんちんっ	PRINTFORM 　やっぱり…おちんちんっ
PRINTFORM 　やっぱり…クリちゃんっ	PRINTFORM 　やっぱり…クリちゃんっ
PRINTFORM 　おまんこもっと弄ってぇ	PRINTFORM 　おまんこもっと弄ってぇ
PRINTFORM 「お尻は違ぅ……ぅぅん…	PRINTFORM 「お尻は違ぅ……ぅぅん…
PRINTFORM 　イジられたら……ひぅっ	PRINTFORM 　イジられたら……ひぅっ
PRINTFORMW 　そして…膣内に……」	PRINTFORMW 　そして…膣内に……」
PRINTFORM 　そんな激しくされたらっ	PRINTFORM 　そんな激しくされたらっ
PRINTFORM 　ぁふあぁぁぁぁぁッッッ	PRINTFORM 　ぁふあぁぁぁぁぁッッッ
PRINTFORM 　せーえきだされたらッッ	PRINTFORM 　せーえきだされたらッッ
PRINTFORM 　せーえきらめぇぇッッッ	PRINTFORM 　せーえきらめぇぇッッッ
PRINTFORM 「…んんっ…ひぁあぁっっ	PRINTFORM 「…んんっ…ひぁあぁっっ
PRINTFORM 「ちょ…んっ！？　んむっ	PRINTFORM 「ちょ…んっ！？　んむっ
PRINTFORM 　あ♪　あ♪　……ッッッ	PRINTFORM 　あ♪　あ♪　……ッッッ
PRINTFORM 「はうぅ…どぷどぷってッ	PRINTFORM 「はうぅ…どぷどぷってッ
PRINTFORM 「まっまたナカで出てっっ	PRINTFORM 「まっまたナカで出てっっ
PRINTFORM 　キュぅぅぅんってッッッ	PRINTFORM 　キュぅぅぅんってッッッ
PRINTFORM 　戦ってるのに…おしりッ	PRINTFORM 　戦ってるのに…おしりッ
PRINTFORM 　そんなに入らなッ…あっ	PRINTFORM 　そんなに入らなッ…あっ
PRINTFORM 　もっと…強く抱きしめて	PRINTFORM 　もっと…強く抱きしめて
PRINTFORM 「…ぇ……身体が……ん…	PRINTFORM 「…ぇ……身体が……ん…
PRINTFORMW 「冷たくて美味しい…」	PRINTFORMW 「冷たくて美味しい…」
PRINTFORMW 「……フッ、行くわよ」	PRINTFORMW 「……フッ、行くわよ」
PRINTFORM 「むっ…蟲達が……んんっ	PRINTFORM 「むっ…蟲達が……んんっ
PRINTFORMW 　身体が…火照って…」	PRINTFORMW 　身体が…火照って…」
PRINTFORM 　おちんちん…先っぽッッ	PRINTFORM 　おちんちん…先っぽッッ
PRINTFORM 「んんんっっ？！　んんっ	PRINTFORM 「んんんっっ？！　んんっ
PRINTFORM 　やぁ…塗りこまないでぇ	PRINTFORM 　やぁ…塗りこまないでぇ
PRINTFORM 　やっやめなさ…んぅッッ	PRINTFORM 　やっやめなさ…んぅッッ
PRINTFORM 　ぶびゅるるぅ～～～って	PRINTFORM 　ぶびゅるるぅ～～～って
PRINTFORMW 「…………（ごくり）」	PRINTFORMW 「…………（ごくり）」
PRINTFORM 　どうです？　私の膣内は	PRINTFORM 　どうです？　私の膣内は
PRINTFORM 　いいわ…そ…その調子…	PRINTFORM 　いいわ…そ…その調子…
PRINTFORM 　もう…イっちゃいそう…	PRINTFORM 　もう…イっちゃいそう…
PRINTFORM 「んむ……んぷ……んはぁ	PRINTFORM 「んむ……んぷ……んはぁ
PRINTFORM 　全部受け止めなさいっっ	PRINTFORM 　全部受け止めなさいっっ
PRINTFORM 　教え込んであげるからっ	PRINTFORM 　教え込んであげるからっ
PRINTFORM 　濃～い精液あげるからっ	PRINTFORM 　濃～い精液あげるからっ
PRINTFORM 「どうせだったら…くすっ	PRINTFORM 「どうせだったら…くすっ
PRINTFORMW 　ほら…全て任せて…」	PRINTFORMW 　ほら…全て任せて…」
PRINTFORMW 　さぁ覚悟しなさい…」	PRINTFORMW 　さぁ覚悟しなさい…」
PRINTFORMW 「うう……ぐすっ……」	PRINTFORMW 「うう……ぐすっ……」
PRINTFORM 　あかひゃん…いるのにっ	PRINTFORM 　あかひゃん…いるのにっ
PRINTFORM 「そっそんなにキツく…っ	PRINTFORM 「そっそんなにキツく…っ
PRINTFORM 　全身で受け止めてっっっ	PRINTFORM 　全身で受け止めてっっっ
PRINTFORM 　膣内に…ちょうだいッッ	PRINTFORM 　膣内に…ちょうだいッッ
PRINTFORM 　膣内にっ…ちょうだいっ	PRINTFORM 　膣内にっ…ちょうだいっ
PRINTFORM 　んーーーーーーーー…ッ	PRINTFORM 　んーーーーーーーー…ッ
PRINTFORM 　アクメ来ちゃうッッッッ	PRINTFORM 　アクメ来ちゃうッッッッ
PRINTFORM 　っあ～～～～～～～っっ	PRINTFORM 　っあ～～～～～～～っっ
PRINTFORM 　これ以上…したら…あッ	PRINTFORM 　これ以上…したら…あッ
PRINTFORM 　もっと…ゆっく…りっっ	PRINTFORM 　もっと…ゆっく…りっっ
PRINTFORM 「なに…を……やめ…ぁ…	PRINTFORM 「なに…を……やめ…ぁ…
PRINTFORM 「やだ…中で動いて…んっ	PRINTFORM 「やだ…中で動いて…んっ
PRINTFORM 　あああぁぁぁ……ッッッ	PRINTFORM 　あああぁぁぁ……ッッッ
PRINTFORM 　寝てるん…だから…ぁん	PRINTFORM 　寝てるん…だから…ぁん
PRINTFORM 「………ぅぁ…………ぁ	PRINTFORM 「………ぅぁ…………ぁ
PRINTFORMW 「そこまでよっ！！」	PRINTFORMW 「そこまでよっ！！」
PRINTFORM 「…れろ…んぷ……んぅ	PRINTFORM 「…れろ…んぷ……んぅ
PRINTFORMW 　エッチなところ…」	PRINTFORMW 　エッチなところ…」
PRINTFORM 　もう待ち切れないの…	PRINTFORM 　もう待ち切れないの…
PRINTFORM 　もっと…もっとシてぇ	PRINTFORM 　もっと…もっとシてぇ
PRINTFORM 　もう…我慢できません	PRINTFORM 　もう…我慢できません
PRINTFORM 　精液…欲しいんでしょ	PRINTFORM 　精液…欲しいんでしょ
PRINTFORM 　ふぅぅーーーーーー…	PRINTFORM 　ふぅぅーーーーーー…
PRINTFORM 　おしりの中…いっぱい	PRINTFORM 　おしりの中…いっぱい
PRINTFORM 「まだ…挿入れちゃ駄目	PRINTFORM 「まだ…挿入れちゃ駄目
PRINTFORM 　やっぱり…おっぱいっ	PRINTFORM 　やっぱり…おっぱいっ
PRINTFORM 　おちんちんでいいわっ	PRINTFORM 　おちんちんでいいわっ
PRINTFORM 　クリちゃんでいいわっ	PRINTFORM 　クリちゃんでいいわっ
PRINTFORM 　やっぱり…おまんこっ	PRINTFORM 　やっぱり…おまんこっ
PRINTFORM 「おマメはいいか…らっ	PRINTFORM 「おマメはいいか…らっ
PRINTFORM 「あああぁあぁぁはッッ	PRINTFORM 「あああぁあぁぁはッッ
PRINTFORM 　ちくびイっひゃふっっ	PRINTFORM 　ちくびイっひゃふっっ
PRINTFORM 　ふあああああぁぁぁっ	PRINTFORM 　ふあああああぁぁぁっ
PRINTFORM 　頭…ぼーっとなって…	PRINTFORM 　頭…ぼーっとなって…
PRINTFORM 「…ふぁぁああんッッッ	PRINTFORM 「…ふぁぁああんッッッ
PRINTFORM …降りて…きちゃうっっ	PRINTFORM …降りて…きちゃうっっ
PRINTFORM 　びゅくびゅくってッッ	PRINTFORM 　びゅくびゅくってッッ
PRINTFORM 　一際太くなってッッッ	PRINTFORM 　一際太くなってッッッ
PRINTFORM 　イっちゃうぅぅッッッ	PRINTFORM 　イっちゃうぅぅッッッ
PRINTFORM 「ちょっ…待っ…んんっ	PRINTFORM 「ちょっ…待っ…んんっ
PRINTFORMW 　焦らさないで……」	PRINTFORMW 　焦らさないで……」
PRINTFORMW 「もう……だめ……」	PRINTFORMW 「もう……だめ……」
PRINTFORMW 「痛っ……はっ？！」	PRINTFORMW 「痛っ……はっ？！」
PRINTFORM 　やっ…あ…………ッッ	PRINTFORM 　やっ…あ…………ッッ
PRINTFORMW 「せめて私の手で…」	PRINTFORMW 「せめて私の手で…」
PRINTFORM 「ご主人様の赤ちゃんっ	PRINTFORM 「ご主人様の赤ちゃんっ
PRINTFORMW 　だめ…なのにぃ…」	PRINTFORMW 　だめ…なのにぃ…」
PRINTFORM 　流れ込んで来てるッッ	PRINTFORM 　流れ込んで来てるッッ
PRINTFORM 　さっさとイって下さい	PRINTFORM 　さっさとイって下さい
PRINTFORM 「ぁ…いや…こ…これっ	PRINTFORM 「ぁ…いや…こ…これっ
PRINTFORM 　そんな…の……んんっ	PRINTFORM 　そんな…の……んんっ
PRINTFORM 　びゅるびゅるしたいッ	PRINTFORM 　びゅるびゅるしたいッ
PRINTFORM 「まだまだイけますよね	PRINTFORM 「まだまだイけますよね
PRINTFORM 　淫魔の膣肉のお味は…	PRINTFORM 　淫魔の膣肉のお味は…
PRINTFORM 　突き上げてあげるッッ	PRINTFORM 　突き上げてあげるッッ
PRINTFORM 　もっと…腰…使ってぇ	PRINTFORM 　もっと…腰…使ってぇ
PRINTFORM 　妊娠の心配も無いしっ	PRINTFORM 　妊娠の心配も無いしっ
PRINTFORM 　もっと口をすぼめてっ	PRINTFORM 　もっと口をすぼめてっ
PRINTFORM 　全部飲み込みなさいッ	PRINTFORM 　全部飲み込みなさいッ
PRINTFORM 　モンスターのくせにっ	PRINTFORM 　モンスターのくせにっ
PRINTFORMW 　膣内で…いいの？」	PRINTFORMW 　膣内で…いいの？」
PRINTFORM 　一緒に…イキましょう	PRINTFORM 　一緒に…イキましょう
PRINTFORM 　私…もっ、もう…イっ	PRINTFORM 　私…もっ、もう…イっ
PRINTFORMW 「……魔理沙っ？！」	PRINTFORMW 「……魔理沙っ？！」
PRINTFORM 　～～～～～～～ッッッ	PRINTFORM 　～～～～～～～ッッッ
PRINTFORM なっひゃ…って…イクっ	PRINTFORM なっひゃ…って…イクっ
PRINTFORM 　───────…ッッ	PRINTFORM 　───────…ッッ
PRINTFORM イっちゃ…────…ッ	PRINTFORM イっちゃ…────…ッ
PRINTFORM 「だめ…耐えられな…っ	PRINTFORM 「だめ…耐えられな…っ
PRINTFORM 　はぁんんんんんっっっ	PRINTFORM 　はぁんんんんんっっっ
PRINTFORM 「…はひ…ぃ………ぃ…	PRINTFORM 「…はひ…ぃ………ぃ…
PRINTFORM 　おっぱいばっかりッッ	PRINTFORM 　おっぱいばっかりッッ
PRINTFORM 　そんな…に…しちゃっ	PRINTFORM 　そんな…に…しちゃっ
PRINTFORM 　おねがひ…もっとぉ…	PRINTFORM 　おねがひ…もっとぉ…
PRINTFORM 　先っぽもだめぇぇぇっ	PRINTFORM 　先っぽもだめぇぇぇっ
PRINTFORM 　自分のおちんちんにっ	PRINTFORM 　自分のおちんちんにっ
PRINTFORMW 　逃げ…なきゃ…」	PRINTFORMW 　逃げ…なきゃ…」
PRINTFORMW 「燃え尽きなさい」	PRINTFORMW 「燃え尽きなさい」
PRINTFORMW 「これでどうっ！」	PRINTFORMW 「これでどうっ！」
PRINTFORM 　何を言っているのよ	PRINTFORM 　何を言っているのよ
PRINTFORM 「目…瞑って………ん	PRINTFORM 「目…瞑って………ん
PRINTFORMW 「……ッッ！！！」	PRINTFORMW 「……ッッ！！！」
PRINTFORM 　こらっ！暴れないの	PRINTFORM 　こらっ！暴れないの
PRINTFORM 　我慢…できな…ッッ	PRINTFORM 　我慢…できな…ッッ
PRINTFORM 「や…いやぁ……んぅ	PRINTFORM 「や…いやぁ……んぅ
PRINTFORM 　全部飲み込んだわ…	PRINTFORM 　全部飲み込んだわ…
PRINTFORM 　挿入っ…ちゃったぁ	PRINTFORM 　挿入っ…ちゃったぁ
PRINTFORM 「そこじゃなくて…ん	PRINTFORM 「そこじゃなくて…ん
PRINTFORM 　やっぱり…おしりっ	PRINTFORM 　やっぱり…おしりっ
PRINTFORM 　お尻の穴でいいわっ	PRINTFORM 　お尻の穴でいいわっ
PRINTFORM 　おっぱいでいいわっ	PRINTFORM 　おっぱいでいいわっ
PRINTFORM 　もっとほじってぇっ	PRINTFORM 　もっとほじってぇっ
PRINTFORM 「胸じゃな…ああんっ	PRINTFORM 「胸じゃな…ああんっ
PRINTFORM 　そこはダメ…よぉ…	PRINTFORM 　そこはダメ…よぉ…
PRINTFORM 「ひゃああぁぁんッッ	PRINTFORM 「ひゃああぁぁんッッ
PRINTFORM 　むっ、むりっ…いっ	PRINTFORM 　むっ、むりっ…いっ
PRINTFORM そんな…したら…らっ	PRINTFORM そんな…したら…らっ
PRINTFORM 　そう…そこ…もっと	PRINTFORM 　そう…そこ…もっと
PRINTFORM 　ビリビリ…きちゃっ	PRINTFORM 　ビリビリ…きちゃっ
PRINTFORM 　イキっ…ますよッッ	PRINTFORM 　イキっ…ますよッッ
PRINTFORM 　ふ、ふといの…がっ	PRINTFORM 　ふ、ふといの…がっ
PRINTFORM 「一番奥っ…おくッッ	PRINTFORM 「一番奥っ…おくッッ
PRINTFORM 「ふふ…焦らないで…	PRINTFORM 「ふふ…焦らないで…
PRINTFORM 　もっとぉ……シてぇ	PRINTFORM 　もっとぉ……シてぇ
PRINTFORMW 「やだ…服が……」	PRINTFORMW 「やだ…服が……」
PRINTFORM 　おしり……そんなぁ	PRINTFORM 　おしり……そんなぁ
PRINTFORMW 「むきゅぅぅ……」	PRINTFORMW 「むきゅぅぅ……」
PRINTFORM 　あっつい…せーえき	PRINTFORM 　あっつい…せーえき
PRINTFORM 　ま、待って！　でっ	PRINTFORM 　ま、待って！　でっ
PRINTFORM 　射精しちゃうっっっ	PRINTFORM 　射精しちゃうっっっ
PRINTFORM 　死なないで下さいよ	PRINTFORM 　死なないで下さいよ
PRINTFORM 　我慢…できない……	PRINTFORM 　我慢…できない……
PRINTFORM 「そう…もっとしてぇ	PRINTFORM 「そう…もっとしてぇ
PRINTFORM 　ぢゅぷぢゅぷってッ	PRINTFORM 　ぢゅぷぢゅぷってッ
PRINTFORM 　悪い事してたのはっ	PRINTFORM 　悪い事してたのはっ
PRINTFORM 　ぴちゃ…むちゅぅ…	PRINTFORM 　ぴちゃ…むちゅぅ…
PRINTFORM 　だっ、射精すわよっ	PRINTFORM 　だっ、射精すわよっ
PRINTFORM 　ごっごめんなさいっ	PRINTFORM 　ごっごめんなさいっ
PRINTFORM 「もう…イっちゃう…	PRINTFORM 「もう…イっちゃう…
PRINTFORM 　私も…イキそうなの	PRINTFORM 　私も…イキそうなの
PRINTFORM 　っ～～～～～ッッッ	PRINTFORM 　っ～～～～～ッッッ
PRINTFORM 　イかせてぇぇぇっっ	PRINTFORM 　イかせてぇぇぇっっ
PRINTFORM 「そんなにされたらっ	PRINTFORM 「そんなにされたらっ
PRINTFORM 「んぅ…やっやらぁ…	PRINTFORM 「んぅ…やっやらぁ…
PRINTFORM 「…ぁ…ぅぁ…熱ぅぃ	PRINTFORM 「…ぁ…ぅぁ…熱ぅぃ
PRINTFORML 「……（ごくり）」	PRINTFORML 「……（ごくり）」
PRINTFORMW 「……レミィ？！」	PRINTFORMW 「……レミィ？！」
PRINTFORM 　きっと寝てる間中…	PRINTFORM 　きっと寝てる間中…
PRINTFORM 　我慢……するのッッ	PRINTFORM 　我慢……するのッッ
PRINTFORM 　そのま…ま……はっ	PRINTFORM 　そのま…ま……はっ
PRINTFORM 　まだイキたく…ッッ	PRINTFORM 　まだイキたく…ッッ
PRINTFORMW 　……ぁ…ぅ……」	PRINTFORMW 　……ぁ…ぅ……」
PRINTFORM 「この子…何を……ん	PRINTFORM 「この子…何を……ん
PRINTFORM 　そんな吸っちゃっっ	PRINTFORM 　そんな吸っちゃっっ
PRINTFORM 　ちくび噛んじゃッッ	PRINTFORM 　ちくび噛んじゃッッ
PRINTFORM 　強…過ぎ───っっ	PRINTFORM 　強…過ぎ───っっ
PRINTFORMW 「次、急ぐわよ！」	PRINTFORMW 「次、急ぐわよ！」
PRINTFORMW 「…………なによ」	PRINTFORMW 「…………なによ」
PRINTFORM 　いっ…いっぱいッッ	PRINTFORM 　いっ…いっぱいッッ
PRINTFORM 　こんなの……むりッ	PRINTFORM 　こんなの……むりッ
PRINTFORM 　何も出ない…わよっ	PRINTFORM 　何も出ない…わよっ
PRINTFORM 　あ…で、出ちゃうっ	PRINTFORM 　あ…で、出ちゃうっ
PRINTFORM 　びゅるーーーーって	PRINTFORM 　びゅるーーーーって
PRINTFORM 　おっぱいの…とこッ	PRINTFORM 　おっぱいの…とこッ
PRINTFORM 　おちんちんに…やっ	PRINTFORM 　おちんちんに…やっ
PRINTFORM 　もういっぱいよぉ…	PRINTFORM 　もういっぱいよぉ…
PRINTFORMW 「切り刻めっ！」	PRINTFORMW 「切り刻めっ！」
PRINTFORM 　そっそこはぁ……	PRINTFORM 　そっそこはぁ……
PRINTFORM 　見て…私の…んぅ	PRINTFORM 　見て…私の…んぅ
PRINTFORM 「もう…ら…らめぇ	PRINTFORM 「もう…ら…らめぇ
PRINTFORMW 「……ッッ！？」	PRINTFORMW 「……ッッ！？」
PRINTFORM 　びくびくしてる…	PRINTFORM 　びくびくしてる…
PRINTFORMW 「……くっ！！」	PRINTFORMW 「……くっ！！」
PRINTFORM 「くぅ…んんんッッ	PRINTFORM 「くぅ…んんんッッ
PRINTFORM 　戦闘中…よ…やっ	PRINTFORM 　戦闘中…よ…やっ
PRINTFORMW 　油断したわ…」	PRINTFORMW 　油断したわ…」
PRINTFORM 　挿入れさせてぇッ	PRINTFORM 　挿入れさせてぇッ
PRINTFORM 　きゅぅぅぅ…って	PRINTFORM 　きゅぅぅぅ…って
PRINTFORM 　おっぱいですよー	PRINTFORM 　おっぱいですよー
PRINTFORM 　おしり来たぁ～っ	PRINTFORM 　おしり来たぁ～っ
PRINTFORM そこ…きゅうっって	PRINTFORM そこ…きゅうっって
PRINTFORM 　ぐっぽぐっぽって	PRINTFORM 　ぐっぽぐっぽって
PRINTFORM 　ひぃぃぃんッッッ	PRINTFORM 　ひぃぃぃんッッッ
PRINTFORM 　激しっ…んはぁっ	PRINTFORM 　激しっ…んはぁっ
PRINTFORM 「え…胸……んぁ…	PRINTFORM 「え…胸……んぁ…
PRINTFORM 「ぐちゅぐちゅって	PRINTFORM 「ぐちゅぐちゅって
PRINTFORM 　たへられ…ふぁっ	PRINTFORM 　たへられ…ふぁっ
PRINTFORM 　そんなにひひゃっ	PRINTFORM 　そんなにひひゃっ
PRINTFORM 「そんなひたらっっ	PRINTFORM 「そんなひたらっっ
PRINTFORM 周りばっかり弄らっ	PRINTFORM 周りばっかり弄らっ
PRINTFORMW 「……っっ？！」	PRINTFORMW 「……っっ？！」
PRINTFORM 「私の精液…でッッ	PRINTFORM 「私の精液…でッッ
PRINTFORM 　貴方の子種が…ッ	PRINTFORM 　貴方の子種が…ッ
PRINTFORM 　ゴツゴツしちゃッ	PRINTFORM 　ゴツゴツしちゃッ
PRINTFORMW 「……敵っ？！」	PRINTFORMW 「……敵っ？！」
PRINTFORM 「…けほっ　…はぁ	PRINTFORM 「…けほっ　…はぁ
PRINTFORM 　はあぁぁあぁんっ	PRINTFORM 　はあぁぁあぁんっ
PRINTFORM 　パチュリーさまぁ	PRINTFORM 　パチュリーさまぁ
PRINTFORM 　いかが…ですかっ	PRINTFORM 　いかが…ですかっ
PRINTFORM 突いてあげるわッッ	PRINTFORM 突いてあげるわッッ
PRINTFORM 　これじゃ…すぐっ	PRINTFORM 　これじゃ…すぐっ
PRINTFORM 　イっちゃいそう…	PRINTFORM 　イっちゃいそう…
PRINTFORM 　気持ちいいトコっ	PRINTFORM 　気持ちいいトコっ
PRINTFORM 　おしりでだって…	PRINTFORM 　おしりでだって…
PRINTFORM 　このまま続けて…	PRINTFORM 　このまま続けて…
PRINTFORM 　激しく動くけどっ	PRINTFORM 　激しく動くけどっ
PRINTFORM 　より興奮するのっ	PRINTFORM 　より興奮するのっ
PRINTFORM 「これ…咥えて…ん	PRINTFORM 「これ…咥えて…ん
PRINTFORM 　ぢゅぽぢゅぽって	PRINTFORM 　ぢゅぽぢゅぽって
PRINTFORM 　はぁ…………んっ	PRINTFORM 　はぁ…………んっ
PRINTFORM 　ちゅぷ……んんっ	PRINTFORM 　ちゅぷ……んんっ
PRINTFORM 　もっと……んんぅ	PRINTFORM 　もっと……んんぅ
PRINTFORM 　くちゅ…くちゅ…	PRINTFORM 　くちゅ…くちゅ…
PRINTFORM 　乱暴に…されてっ	PRINTFORM 　乱暴に…されてっ
PRINTFORM 　あっ…らっらめぇ	PRINTFORM 　あっ…らっらめぇ
PRINTFORM 　き…来ひゃっ……	PRINTFORM 　き…来ひゃっ……
PRINTFORM 　……キちゃうッッ	PRINTFORM 　……キちゃうッッ
PRINTFORM 　いいわよ…来て…	PRINTFORM 　いいわよ…来て…
PRINTFORM 　ほっ…欲しいの？	PRINTFORM 　ほっ…欲しいの？
PRINTFORM 　そんな…したらっ	PRINTFORM 　そんな…したらっ
PRINTFORMW 　…終わ…り？」	PRINTFORMW 　…終わ…り？」
PRINTFORM 「あああぁぁっっッ	PRINTFORM 「あああぁぁっっッ
PRINTFORM 　ぅぅん………っっ	PRINTFORM 　ぅぅん………っっ
PRINTFORM 　わらひイきたく…	PRINTFORM 　わらひイきたく…
PRINTFORM 「あーーーーーー…	PRINTFORM 「あーーーーーー…
PRINTFORM 　イグゥぅぅぅッッ	PRINTFORM 　イグゥぅぅぅッッ
PRINTFORM 　……………ッッッ	PRINTFORM 　……………ッッッ
PRINTFORM 「やっ…何か来るっ	PRINTFORM 「やっ…何か来るっ
PRINTFORM 　…ぁ…ぁ…………	PRINTFORM 　…ぁ…ぁ…………
PRINTFORM 「…ぁ…ぁ……ぁ…	PRINTFORM 「…ぁ…ぁ……ぁ…
PRINTFORM 「そこ吸っちゃ…あ	PRINTFORM 「そこ吸っちゃ…あ
PRINTFORM 　ああああぁんっっ	PRINTFORM 　ああああぁんっっ
PRINTFORM 「あーーーーー……	PRINTFORM 「あーーーーー……
PRINTFORMW 「んんんっ？！」	PRINTFORMW 「んんんっ？！」
PRINTFORM 「この感触は…んぅ	PRINTFORM 「この感触は…んぅ
PRINTFORM 　私のっ？！　んっ	PRINTFORM 　私のっ？！　んっ
PRINTFORM 　吸い上げたらッッ	PRINTFORM 　吸い上げたらッッ
PRINTFORM 「搾られちゃうッッ	PRINTFORM 「搾られちゃうッッ
PRINTFORM 「……ぁ……かはぁ	PRINTFORM 「……ぁ……かはぁ
PRINTFORMW 　なにこれぇ…」	PRINTFORMW 　なにこれぇ…」
PRINTFORM 　そこは入っちゃっ	PRINTFORM 　そこは入っちゃっ
PRINTFORM 「や…やめなさい…	PRINTFORM 「や…やめなさい…
PRINTFORM 　はぁ……………	PRINTFORM 　はぁ……………
PRINTFORMW 「邪魔よっ！」	PRINTFORMW 「邪魔よっ！」
PRINTFORMW 「……ッ！？」	PRINTFORMW 「……ッ！？」
PRINTFORM 「んぷっ…　んっ	PRINTFORM 「んぷっ…　んっ
PRINTFORM 　…はぁーーーー	PRINTFORM 　…はぁーーーー
PRINTFORM 「ん…ふーーー…	PRINTFORM 「ん…ふーーー…
PRINTFORM 　そんなに…腰っ	PRINTFORM 　そんなに…腰っ
PRINTFORM 「やめて…くぅん	PRINTFORM 「やめて…くぅん
PRINTFORM 「これは…んんっ	PRINTFORM 「これは…んんっ
PRINTFORM 　してる…わけっ	PRINTFORM 　してる…わけっ
PRINTFORM 　く……ぅぅんッ	PRINTFORM 　く……ぅぅんッ
PRINTFORM 　んんんんんぁッ	PRINTFORM 　んんんんんぁッ
PRINTFORM 　欲しかったのっ	PRINTFORM 　欲しかったのっ
PRINTFORM 　そ…そう…そこ	PRINTFORM 　そ…そう…そこ
PRINTFORM 「ふぁぁぁあっっ	PRINTFORM 「ふぁぁぁあっっ
PRINTFORM 「おちんぽは…っ	PRINTFORM 「おちんぽは…っ
PRINTFORM 　やっ、やめ…ぇ	PRINTFORM 　やっ、やめ…ぇ
PRINTFORM 　ぐぽぐぽしてっ	PRINTFORM 　ぐぽぐぽしてっ
PRINTFORM 「あぁあああぁ…	PRINTFORM 「あぁあああぁ…
PRINTFORM 　すぐイっちゃう	PRINTFORM 　すぐイっちゃう
PRINTFORM 　らめらめらめっ	PRINTFORM 　らめらめらめっ
PRINTFORM 「だひひゃうっっ	PRINTFORM 「だひひゃうっっ
PRINTFORM 　んんんんんッッ	PRINTFORM 　んんんんんッッ
PRINTFORM 　されたらぁッッ	PRINTFORM 　されたらぁッッ
PRINTFORM イっちゃうからッ	PRINTFORM イっちゃうからッ
PRINTFORM 　ちょうだいッッ	PRINTFORM 　ちょうだいッッ
PRINTFORM 「はあぁぁんッッ	PRINTFORM 「はあぁぁんッッ
PRINTFORM 　ら…らめ…ッッ	PRINTFORM 　ら…らめ…ッッ
PRINTFORM 　乳首キちゃぅ…	PRINTFORM 　乳首キちゃぅ…
PRINTFORMW 「小悪魔…？」	PRINTFORMW 「小悪魔…？」
PRINTFORM 「奥っ…おくッッ	PRINTFORM 「奥っ…おくッッ
PRINTFORM 　開いちゃうっ…	PRINTFORM 　開いちゃうっ…
PRINTFORM 　でっ出ちゃう…	PRINTFORM 　でっ出ちゃう…
PRINTFORM 「蟲が……んんっ	PRINTFORM 「蟲が……んんっ
PRINTFORM 　敏感なのッッッ	PRINTFORM 　敏感なのッッッ
PRINTFORM 　強過ぎるッッッ	PRINTFORM 　強過ぎるッッッ
PRINTFORM 「この臭い…はぁ	PRINTFORM 「この臭い…はぁ
PRINTFORM 　ああぁぁっっっ	PRINTFORM 　ああぁぁっっっ
PRINTFORM 「はぁぁぁぁぁ…	PRINTFORM 「はぁぁぁぁぁ…
PRINTFORMDW つん、つん…	PRINTFORMDW つん、つん…
PRINTFORMW （ごくり……）	PRINTFORMW （ごくり……）
PRINTFORM 　もっと激しくっ	PRINTFORM 　もっと激しくっ
PRINTFORM 　動いてるわよっ	PRINTFORM 　動いてるわよっ
PRINTFORM 　ぎゅうってッッ	PRINTFORM 　ぎゅうってッッ
PRINTFORM 　これはこれでっ	PRINTFORM 　これはこれでっ
PRINTFORM 　根元の…トコっ	PRINTFORM 　根元の…トコっ
PRINTFORM 　もっとしてぇ…	PRINTFORM 　もっとしてぇ…
PRINTFORM 「だったら…んっ	PRINTFORM 「だったら…んっ
PRINTFORM 「こんな貧相なっ	PRINTFORM 「こんな貧相なっ
PRINTFORM 　い…イクわよっ	PRINTFORM 　い…イクわよっ
PRINTFORM 　くちゅ…ちゅっ	PRINTFORM 　くちゅ…ちゅっ
PRINTFORM 　～～～～～ッッ	PRINTFORM 　～～～～～ッッ
PRINTFORM 「射精しちゃうっ	PRINTFORM 「射精しちゃうっ
PRINTFORM 「…はあぁぁ……	PRINTFORM 「…はあぁぁ……
PRINTFORM 「でっ射精るわっ	PRINTFORM 「でっ射精るわっ
PRINTFORM 　激しっ…過ぎっ	PRINTFORM 　激しっ…過ぎっ
PRINTFORM 　もっもうッッッ	PRINTFORM 　もっもうッッッ
PRINTFORM 「あああぁぁぁっ	PRINTFORM 「あああぁぁぁっ
PRINTFORM 「はああぁぁぁ…	PRINTFORM 「はああぁぁぁ…
PRINTFORMW 「……はぁ。」	PRINTFORMW 「……はぁ。」
PRINTFORM 「…………ひぅっ	PRINTFORM 「…………ひぅっ
PRINTFORM 　…んぅっっ……	PRINTFORM 　…んぅっっ……
PRINTFORM 「……ぃ…ぃッッ	PRINTFORM 「……ぃ…ぃッッ
PRINTFORM 　でない…とッッ	PRINTFORM 　でない…とッッ
PRINTFORM 　止まらないのっ	PRINTFORM 　止まらないのっ
PRINTFORM 「だっ…ダメっっ	PRINTFORM 「だっ…ダメっっ
PRINTFORM 　おっ…しりッッ	PRINTFORM 　おっ…しりッッ
PRINTFORM 「ひあああぁぁっ	PRINTFORM 「ひあああぁぁっ
PRINTFORM 　擦らないでッッ	PRINTFORM 　擦らないでッッ
PRINTFORM 　そこ弱いのっっ	PRINTFORM 　そこ弱いのっっ
PRINTFORM 　たえられないッ	PRINTFORM 　たえられないッ
PRINTFORM 「あぁ…もっとぉ	PRINTFORM 「あぁ…もっとぉ
PRINTFORM 　吸ったらぁッッ	PRINTFORM 　吸ったらぁッッ
PRINTFORM 「これ…自分のっ	PRINTFORM 「これ…自分のっ
PRINTFORM 止めぇぇェッッッ	PRINTFORM 止めぇぇェッッッ
PRINTFORM 「あぁんんんッッ	PRINTFORM 「あぁんんんッッ
PRINTFORM 「………ぅぅ…	PRINTFORM 「………ぅぅ…
PRINTFORM 　………んぅ…	PRINTFORM 　………んぅ…
PRINTFORM 「ぁーーーー…	PRINTFORM 「ぁーーーー…
PRINTFORMW 「それっ！」	PRINTFORMW 「それっ！」
PRINTFORM ……だ…駄目…	PRINTFORM ……だ…駄目…
PRINTFORM 「お尻はダメ…	PRINTFORM 「お尻はダメ…
PRINTFORM 「ご主人様ぁ…	PRINTFORM 「ご主人様ぁ…
PRINTFORM 「…嫌だもぅっ	PRINTFORM 「…嫌だもぅっ
PRINTFORM 　ちゅ…んむ…	PRINTFORM 　ちゅ…んむ…
PRINT 「んくっ…これくらい…	PRINT 「んくっ…これくらい…
PRINTFORM 「く…ぅんんん	PRINTFORM 「く…ぅんんん
PRINTFORM 動かさないでぇ	PRINTFORM 動かさないでぇ
PRINTFORM 　…くはぁぁぁ	PRINTFORM 　…くはぁぁぁ
PRINTFORM 　私の意志でっ	PRINTFORM 　私の意志でっ
PRINTFORM 　おちんちんっ	PRINTFORM 　おちんちんっ
PRINTFORM 　クリちゃんっ	PRINTFORM 　クリちゃんっ
PRINTFORM 「くぅ…んんぅ	PRINTFORM 「くぅ…んんぅ
PRINTFORM 「はぁぁんっっ	PRINTFORM 「はぁぁんっっ
PRINTFORM 「ああぁぁんっ	PRINTFORM 「ああぁぁんっ
PRINTFORM 　いっいいわ…	PRINTFORM 　いっいいわ…
PRINTFORM 「わたしだけっ	PRINTFORM 「わたしだけっ
PRINTFORM 　らめなのぉっ	PRINTFORM 　らめなのぉっ
PRINTFORM 　おちんぽッッ	PRINTFORM 　おちんぽッッ
PRINTFORM 　わらひまたっ	PRINTFORM 　わらひまたっ
PRINTFORM 　クっクリッッ	PRINTFORM 　クっクリッッ
PRINTFORM 　わらヒッッッ	PRINTFORM 　わらヒッッッ
PRINTFORM 　くるし…いっ	PRINTFORM 　くるし…いっ
PRINTFORMW もうっ……」	PRINTFORMW もうっ……」
PRINTFORM 　解ってますよ	PRINTFORM 　解ってますよ
PRINTFORM 「どうしたの？	PRINTFORM 「どうしたの？
PRINTFORM 「あぁぁんんっ	PRINTFORM 「あぁぁんんっ
PRINTFORM 　しっ…子宮っ	PRINTFORM 　しっ…子宮っ
PRINTFORM 　た、種付けっ	PRINTFORM 　た、種付けっ
PRINTFORM 「そうっ…なっ	PRINTFORM 「そうっ…なっ
PRINTFORM 　膨らん…でっ	PRINTFORM 　膨らん…でっ
PRINTFORM 　わっわたしっ	PRINTFORM 　わっわたしっ
PRINTFORM 　そっそんなっ	PRINTFORM 　そっそんなっ
PRINTFORM 　ふぁぁぁっっ	PRINTFORM 　ふぁぁぁっっ
PRINTFORM 　…わた…しッ	PRINTFORM 　…わた…しッ
PRINTFORM 「らっらめぇっ	PRINTFORM 「らっらめぇっ
PRINTFORM 　ひぁぁぁぁっ	PRINTFORM 　ひぁぁぁぁっ
PRINTFORM 「…ひぅッッッ	PRINTFORM 「…ひぅッッッ
PRINTFORM 「こっ、こらっ	PRINTFORM 「こっ、こらっ
PRINTFORM 「あ…ここは…	PRINTFORM 「あ…ここは…
PRINTFORM 「やめ…んんっ	PRINTFORM 「やめ…んんっ
PRINTFORM 　強…過ぎっっ	PRINTFORM 　強…過ぎっっ
PRINTFORM 　クっ、クリっ	PRINTFORM 　クっ、クリっ
PRINTFORM 　だ…だめぇ…	PRINTFORM 　だ…だめぇ…
PRINTFORM 射精来ちゃうっ	PRINTFORM 射精来ちゃうっ
PRINTFORM 「射精させてっ	PRINTFORM 「射精させてっ
PRINTFORM そんな激しくっ	PRINTFORM そんな激しくっ
PRINTFORM 　くぅぅぅんっ	PRINTFORM 　くぅぅぅんっ
PRINTFORM 　しちゃってっ	PRINTFORM 　しちゃってっ
PRINTFORM 　擦り付けるっ	PRINTFORM 　擦り付けるっ
PRINTFORM 　擦れてるッッ	PRINTFORM 　擦れてるッッ
PRINTFORM 「はぁ…いい…	PRINTFORM 「はぁ…いい…
PRINTFORM 　射精すからっ	PRINTFORM 　射精すからっ
PRINTFORM 　たっぷりとっ	PRINTFORM 　たっぷりとっ
PRINTFORM 「この触手ねっ	PRINTFORM 「この触手ねっ
PRINTFORM 　臭ってるわよ	PRINTFORM 　臭ってるわよ
PRINTFORMW 「…………」	PRINTFORMW 「…………」
PRINTFORM 　んむ…んっ…	PRINTFORM 　んむ…んっ…
PRINTFORM 　んぷ…んはぁ	PRINTFORM 　んぷ…んはぁ
PRINTFORM 　もっ…もうッ	PRINTFORM 　もっ…もうッ
PRINTFORM 「…はぁ～～～	PRINTFORM 「…はぁ～～～
PRINTFORM 「あ…ぁあ…っ	PRINTFORM 「あ…ぁあ…っ
PRINTFORMDW ドチャリ…	PRINTFORMDW ドチャリ…
PRINTFORM 「らっらめぇッ	PRINTFORM 「らっらめぇッ
PRINTFORM 「はぁーーー…	PRINTFORM 「はぁーーー…
PRINTFORM 　らっ…らめっ	PRINTFORM 　らっ…らめっ
PRINTFORM 　お…お願いっ	PRINTFORM 　お…お願いっ
PRINTFORM 「ふあぁぁ……	PRINTFORM 「ふあぁぁ……
PRINTFORM 「あっ…熱いっ	PRINTFORM 「あっ…熱いっ
PRINTFORM 　はぁーーー…	PRINTFORM 　はぁーーー…
PRINTFORML 「ごくり…」	PRINTFORML 「ごくり…」
PRINTFORM 　まっ…またっ	PRINTFORM 　まっ…またっ
PRINTFORM もう…やめっっ	PRINTFORM もう…やめっっ
PRINTFORM イってばかりっ	PRINTFORM イってばかりっ
PRINTFORM 　…のに…っっ	PRINTFORM 　…のに…っっ
PRINTFORM 　らめらめぇっ	PRINTFORM 　らめらめぇっ
PRINTFORM 　まっひろにっ	PRINTFORM 　まっひろにっ
PRINTFORM 　暴れ…ちゃっ	PRINTFORM 　暴れ…ちゃっ
PRINTFORM 「んんんんんっ	PRINTFORM 「んんんんんっ
PRINTFORM 「やっやめッッ	PRINTFORM 「やっやめッッ
PRINTFORM 　カリのとこっ	PRINTFORM 　カリのとこっ
PRINTFORM 　奥の…そこっ	PRINTFORM 　奥の…そこっ
PRINTFORM 　んんぅ………	PRINTFORM 　んんぅ………
PRINTFORM 「…ん…くはぁ	PRINTFORM 「…ん…くはぁ
PRINTFORM 「…………んぅ	PRINTFORM 「…………んぅ
PRINTFORM 「……ぅぅんっ	PRINTFORM 「……ぅぅんっ
PRINTFORM 　これ…私のっ	PRINTFORM 　これ…私のっ
PRINTFORM 　びくびくって	PRINTFORM 　びくびくって
PRINTFORM 「ふぃぃィッッ	PRINTFORM 「ふぃぃィッッ
PRINTFORM 「んんんぅぅっ	PRINTFORM 「んんんぅぅっ
PRINTFORM 「ふあぁぁぁ…	PRINTFORM 「ふあぁぁぁ…
PRINTFORM 「んんんぅ……	PRINTFORM 「んんんぅ……
PRINTFORM 　幸せな気分…	PRINTFORM 　幸せな気分…
PRINTFORM 「…ふぁ……	PRINTFORM 「…ふぁ……
PRINTFORMW 　ぁ……」	PRINTFORMW 　ぁ……」
PRINTFORM あ～～～～～	PRINTFORM あ～～～～～
PRINTFORMW 「はっ！」	PRINTFORMW 「はっ！」
PRINTFORMW 「やっ！」	PRINTFORMW 「やっ！」
PRINTFORMW 「ふっ！」	PRINTFORMW 「ふっ！」
PRINTFORM 　ぢゅるるっ	PRINTFORM 　ぢゅるるっ
PRINTFORM 「ん…んぅっ	PRINTFORM 「ん…んぅっ
PRINTFORM 　そこ…んッ	PRINTFORM 　そこ…んッ
PRINTFORM 　あぁぁんっ	PRINTFORM 　あぁぁんっ
PRINTFORM 「くすくす…	PRINTFORM 「くすくす…
PRINTFORM 「はっ早くっ	PRINTFORM 「はっ早くっ
PRINTFORM 　おちんぽっ	PRINTFORM 　おちんぽっ
PRINTFORM 「やめ…てぇ	PRINTFORM 「やめ…てぇ
PRINTFORM 　いきなりッ	PRINTFORM 　いきなりッ
PRINTFORM 「…はぁぁぁ	PRINTFORM 「…はぁぁぁ
PRINTFORM 「んあああっ	PRINTFORM 「んあああっ
PRINTFORM 　おっ奥っっ	PRINTFORM 　おっ奥っっ
PRINTFORM 「くぅぅんっ	PRINTFORM 「くぅぅんっ
PRINTFORM 　そっそこ…	PRINTFORM 　そっそこ…
PRINTFORM 　あぁッッッ	PRINTFORM 　あぁッッッ
PRINTFORM 「ふああぁっ	PRINTFORM 「ふああぁっ
PRINTFORM 　こんなのっ	PRINTFORM 　こんなのっ
PRINTFORM 「んんんっっ	PRINTFORM 「んんんっっ
PRINTFORM 　無理ッッッ	PRINTFORM 　無理ッッッ
PRINTFORM 「ふひゃぁ…	PRINTFORM 「ふひゃぁ…
PRINTFORM じれったいっ	PRINTFORM じれったいっ
PRINTFORM 「あぁあッッ	PRINTFORM 「あぁあッッ
PRINTFORM 　またぁッッ	PRINTFORM 　またぁッッ
PRINTFORM 「ふぁぁ……	PRINTFORM 「ふぁぁ……
PRINTFORM 　はぁん……	PRINTFORM 　はぁん……
PRINTFORM 「ふぁ…あ…	PRINTFORM 「ふぁ…あ…
PRINTFORM 「んんんッッ	PRINTFORM 「んんんッッ
PRINTFORM 「や…やぁ…	PRINTFORM 「や…やぁ…
PRINTFORM 「ふぁあっっ	PRINTFORM 「ふぁあっっ
PRINTFORM 　射精るッッ	PRINTFORM 　射精るッッ
PRINTFORM 　……ふはぁ	PRINTFORM 　……ふはぁ
PRINTFORM 　射精してっ	PRINTFORM 　射精してっ
PRINTFORM 「んあぁぁっ	PRINTFORM 「んあぁぁっ
PRINTFORM …し、子宮っ	PRINTFORM …し、子宮っ
PRINTFORM 　お願…ひっ	PRINTFORM 　お願…ひっ
PRINTFORM 「ふぁ…ぁ…	PRINTFORM 「ふぁ…ぁ…
PRINTFORM 「…くぅ…っ	PRINTFORM 「…くぅ…っ
PRINTFORM 　孕むからっ	PRINTFORM 　孕むからっ
PRINTFORM 「は…早くぅ	PRINTFORM 「は…早くぅ
PRINTFORM 「はーーーっ	PRINTFORM 「はーーーっ
PRINTFORM 　はーーーっ	PRINTFORM 　はーーーっ
PRINTFORM 　おっお尻っ	PRINTFORM 　おっお尻っ
PRINTFORM 　おっぱいっ	PRINTFORM 　おっぱいっ
PRINTFORM 「んんぅっっ	PRINTFORM 「んんぅっっ
PRINTFORM 　なっ何かっ	PRINTFORM 　なっ何かっ
PRINTFORM ダメなのよっ	PRINTFORM ダメなのよっ
PRINTFORM 　見ないで…	PRINTFORM 　見ないで…
PRINTFORM 「くすくすっ	PRINTFORM 「くすくすっ
PRINTFORM 　ぴゅぴゅっ	PRINTFORM 　ぴゅぴゅっ
PRINTFORM 「だっだめっ	PRINTFORM 「だっだめっ
PRINTFORM 　でちゃうっ	PRINTFORM 　でちゃうっ
PRINTFORM 　出ちゃうっ	PRINTFORM 　出ちゃうっ
PRINTFORM 「んぅぅ……	PRINTFORM 「んぅぅ……
PRINTFORM 　あああああ	PRINTFORM 　あああああ
PRINTFORM 「でちゃうっ	PRINTFORM 「でちゃうっ
PRINTFORM 「んんぅ～～	PRINTFORM 「んんぅ～～
PRINTFORM 「あはははっ	PRINTFORM 「あはははっ
PRINTFORM 「はーーー…	PRINTFORM 「はーーー…
PRINTFORM 　はーーー…	PRINTFORM 　はーーー…
PRINTFORM 　すっごいっ	PRINTFORM 　すっごいっ
PRINTFORM 　だけでもっ	PRINTFORM 　だけでもっ
PRINTFORM 「す…凄いっ	PRINTFORM 「す…凄いっ
PRINTFORM 　そ、そうッ	PRINTFORM 　そ、そうッ
PRINTFORM 　激しくッッ	PRINTFORM 　激しくッッ
PRINTFORM 「まったくっ	PRINTFORM 「まったくっ
PRINTFORM 　その胸でっ	PRINTFORM 　その胸でっ
PRINTFORM 「この口にっ	PRINTFORM 「この口にっ
PRINTFORM 　…ちゅぶっ	PRINTFORM 　…ちゅぶっ
PRINTFORM 　んちゅぅ…	PRINTFORM 　んちゅぅ…
PRINTFORM 「……んはっ	PRINTFORM 「……んはっ
PRINTFORM 「ああぁんっ	PRINTFORM 「ああぁんっ
PRINTFORM 　…こんなっ	PRINTFORM 　…こんなっ
PRINTFORM 「くぅ…ぅん	PRINTFORM 「くぅ…ぅん
PRINTFORM 「そっ、そう	PRINTFORM 「そっ、そう
PRINTFORM 　わっ、私…	PRINTFORM 　わっ、私…
PRINTFORMDW ぽふんっ	PRINTFORMDW ぽふんっ
PRINTFORM 「私…もッッ	PRINTFORM 「私…もッッ
PRINTFORM 「ん…んぅ…	PRINTFORM 「ん…んぅ…
PRINTFORM 「んんんぅ…	PRINTFORM 「んんんぅ…
PRINTFORM 「ふぁぁぁ…	PRINTFORM 「ふぁぁぁ…
PRINTFORM 　連続でッッ	PRINTFORM 　連続でッッ
PRINTFORM 　こんな…っ	PRINTFORM 　こんな…っ
PRINTFORM 「あーーー…	PRINTFORM 「あーーー…
PRINTFORM 　～～～～ッ	PRINTFORM 　～～～～ッ
PRINTFORM 「…………ぅ	PRINTFORM 「…………ぅ
PRINTFORM 　ぅぅ………	PRINTFORM 　ぅぅ………
PRINTFORM 　やあぁぁぁ	PRINTFORM 　やあぁぁぁ
PRINTFORM 　んあぁぁッ	PRINTFORM 　んあぁぁッ
PRINTFORM 　…ん…はぁ	PRINTFORM 　…ん…はぁ
PRINTFORM 「……ん……	PRINTFORM 「……ん……
PRINTFORM 「……ぅ…ん	PRINTFORM 「……ぅ…ん
PRINTFORM 　えっ、えっ	PRINTFORM 　えっ、えっ
PRINTFORM 「んはぁぁっ	PRINTFORM 「んはぁぁっ
PRINTFORM 「せーえきっ	PRINTFORM 「せーえきっ
PRINTFORM 「ん…ふぅ…	PRINTFORM 「ん…ふぅ…
﻿PRINTFORM 「くふぅ…	PRINTFORM 「くふぅ…
PRINTFORM 「あ～～～	PRINTFORM 「あ～～～
PRINTFORM 「…んんっ	PRINTFORM 「…んんっ
PRINTFORM 「…んはぁ	PRINTFORM 「…んはぁ
PRINTFORM 「ぅん……	PRINTFORM 「ぅん……
PRINTFORM 「くぅん…	PRINTFORM 「くぅん…
PRINTFORM 「んんぅ…	PRINTFORM 「んんぅ…
PRINTFORM 　…んはぁ	PRINTFORM 　…んはぁ
PRINTFORM 　美味し…	PRINTFORM 　美味し…
PRINTFORM 「んむぅッ	PRINTFORM 「んむぅッ
PRINTFORM 　んぶゅっ	PRINTFORM 　んぶゅっ
PRINTFORMD ぬちゅっ	PRINTFORMD ぬちゅっ
PRINTFORMD 　ぬぶっ	PRINTFORMD 　ぬぶっ
PRINTFORMDW ぬぶっ	PRINTFORMDW ぬぶっ
PRINTFORM 　はぁぁぁ	PRINTFORM 　はぁぁぁ
PRINTFORM 「や…んっ	PRINTFORM 「や…んっ
PRINTFORM 　ふはぁ…	PRINTFORM 　ふはぁ…
PRINTFORM 　ふはんっ	PRINTFORM 　ふはんっ
PRINTFORM 「あらあら	PRINTFORM 「あらあら
PRINTFORM 「うふふ…	PRINTFORM 「うふふ…
PRINTFORM 「くぅ…ん	PRINTFORM 「くぅ…ん
PRINTFORM 　…んふぅ	PRINTFORM 　…んふぅ
PRINTFORM 　もっとぉ	PRINTFORM 　もっとぉ
PRINTFORM 「くぅんッ	PRINTFORM 「くぅんッ
PRINTFORM 　いいわ…	PRINTFORM 　いいわ…
PRINTFORM 　んはぁ…	PRINTFORM 　んはぁ…
PRINTFORM 「くふふっ	PRINTFORM 「くふふっ
PRINTFORM 「…んふぅ	PRINTFORM 「…んふぅ
PRINTFORM 「ん…はっ	PRINTFORM 「ん…はっ
PRINTFORM 「ああんっ	PRINTFORM 「ああんっ
PRINTFORM 　激…しッ	PRINTFORM 　激…しッ
PRINTFORM 「はぁ……	PRINTFORM 「はぁ……
PRINTFORM 「おしりっ	PRINTFORM 「おしりっ
PRINTFORM 「やぁん…	PRINTFORM 「やぁん…
PRINTFORM 「んふぅ…	PRINTFORM 「んふぅ…
PRINTFORM 「ふぅ…ん	PRINTFORM 「ふぅ…ん
PRINTFORM 「あぁんっ	PRINTFORM 「あぁんっ
PRINTFORM 　ぁんっ…	PRINTFORM 　ぁんっ…
PRINTFORM 「…んんぅ	PRINTFORM 「…んんぅ
PRINTFORM 「んもぅ…	PRINTFORM 「んもぅ…
PRINTFORM 　はぁん…	PRINTFORM 　はぁん…
PRINTFORM 「くぅんっ	PRINTFORM 「くぅんっ
PRINTFORM 　おひりっ	PRINTFORM 　おひりっ
PRINTFORM 「らめよぉ	PRINTFORM 「らめよぉ
PRINTFORM 　わらひっ	PRINTFORM 　わらひっ
PRINTFORM 「んきゅっ	PRINTFORM 「んきゅっ
PRINTFORM 「んぅ……	PRINTFORM 「んぅ……
PRINTFORM 「ひぁっっ	PRINTFORM 「ひぁっっ
PRINTFORM 　らめぇっ	PRINTFORM 　らめぇっ
PRINTFORM 　や…やぁ	PRINTFORM 　や…やぁ
PRINTFORM 　早く…っ	PRINTFORM 　早く…っ
PRINTFORM 「あぁんッ	PRINTFORM 「あぁんッ
PRINTFORM 「お、奥っ	PRINTFORM 「お、奥っ
PRINTFORM 「んんあっ	PRINTFORM 「んんあっ
PRINTFORM 「あぁぁっ	PRINTFORM 「あぁぁっ
PRINTFORM 　…ん…ん	PRINTFORM 　…ん…ん
PRINTFORM 「もっとぉ	PRINTFORM 「もっとぉ
PRINTFORM 「ふぁぁ…	PRINTFORM 「ふぁぁ…
PRINTFORM 「ぁ…ぁ…	PRINTFORM 「ぁ…ぁ…
PRINTFORM 　んんぅっ	PRINTFORM 　んんぅっ
PRINTFORM 「…ちょッ	PRINTFORM 「…ちょッ
PRINTFORM 　んぅ…ッ	PRINTFORM 　んぅ…ッ
PRINTFORM 　…っはぁ	PRINTFORM 　…っはぁ
PRINTFORM 　だめッッ	PRINTFORM 　だめッッ
PRINTFORM 「んくぅ…	PRINTFORM 「んくぅ…
PRINTFORM 「うぅん…	PRINTFORM 「うぅん…
PRINTFORM 「ふあぁ…	PRINTFORM 「ふあぁ…
PRINTFORM 「ふぅ……	PRINTFORM 「ふぅ……
PRINTFORM 「ぅぅ……	PRINTFORM 「ぅぅ……
PRINTFORM 　そんなっ	PRINTFORM 　そんなっ
PRINTFORM 「…はふぅ	PRINTFORM 「…はふぅ
PRINTFORM 「はうぅっ	PRINTFORM 「はうぅっ
PRINTFORM 「小悪魔…	PRINTFORM 「小悪魔…
PRINTFORM 「ほらほら	PRINTFORM 「ほらほら
PRINTFORM 　…ぉあっ	PRINTFORM 　…ぉあっ
PRINTFORM 　射精るっ	PRINTFORM 　射精るっ
PRINTFORM 「……あぁ	PRINTFORM 「……あぁ
PRINTFORM 　下からっ	PRINTFORM 　下からっ
PRINTFORM 　すぐにっ	PRINTFORM 　すぐにっ
PRINTFORM 「ふはぁ…	PRINTFORM 「ふはぁ…
PRINTFORM 　こんなっ	PRINTFORM 　こんなっ
PRINTFORM 　大きなっ	PRINTFORM 　大きなっ
PRINTFORM 　完全にっ	PRINTFORM 　完全にっ
PRINTFORM 「んぅぅ…	PRINTFORM 「んぅぅ…
PRINTFORM いいわよっ	PRINTFORM いいわよっ
PRINTFORM 「んぅぅぅ	PRINTFORM 「んぅぅぅ
PRINTFORM 　わよねっ	PRINTFORM 　わよねっ
PRINTFORM 「…ふはぁ	PRINTFORM 「…ふはぁ
PRINTFORM 　ちゅぱっ	PRINTFORM 　ちゅぱっ
PRINTFORM 　はぁぁ…	PRINTFORM 　はぁぁ…
PRINTFORM 「……はぁ	PRINTFORM 「……はぁ
PRINTFORM 「……んっ	PRINTFORM 「……んっ
PRINTFORM 「くすくす	PRINTFORM 「くすくす
PRINTFORM 「ふふっ…	PRINTFORM 「ふふっ…
PRINTFORM 「……ぁ…	PRINTFORM 「……ぁ…
PRINTFORM 「あぁっ…	PRINTFORM 「あぁっ…
PRINTFORM 　わかった	PRINTFORM 　わかった
PRINTFORM 　わっ私っ	PRINTFORM 　わっ私っ
PRINTFORM 　私…のっ	PRINTFORM 　私…のっ
PRINTFORM 「…ふぁぁ	PRINTFORM 「…ふぁぁ
PRINTFORM 「ひあぁっ	PRINTFORM 「ひあぁっ
PRINTFORM 「んんぅっ	PRINTFORM 「んんぅっ
PRINTFORM 「ふぁぁっ	PRINTFORM 「ふぁぁっ
PRINTFORM 　…来てッ	PRINTFORM 　…来てッ
PRINTFORM 「はぁー…	PRINTFORM 「はぁー…
PRINTFORM 　はぁー…	PRINTFORM 　はぁー…
PRINTFORM 「はぁん…	PRINTFORM 「はぁん…
PRINTFORM 「…ふふっ	PRINTFORM 「…ふふっ
PRINTFORM 「…ぁ…ぁ	PRINTFORM 「…ぁ…ぁ
PRINTFORM 　おしりッ	PRINTFORM 　おしりッ
PRINTFORM 　乳首にっ	PRINTFORM 　乳首にっ
PRINTFORM またすぐっ	PRINTFORM またすぐっ
PRINTFORM 「……ぅぁ	PRINTFORM 「……ぅぁ
PRINTFORM 「…はひっ	PRINTFORM 「…はひっ
PRINTFORM 　あたまっ	PRINTFORM 　あたまっ
PRINTFORM 　やめてっ	PRINTFORM 　やめてっ
PRINTFORM 「んんんっ	PRINTFORM 「んんんっ
PRINTFORM ～～～ッッ	PRINTFORM ～～～ッッ
PRINTFORM 　クリはっ	PRINTFORM 　クリはっ
PRINTFORM 「……ふふ	PRINTFORM 「……ふふ
PRINTFORM 　あぁぁぁ	PRINTFORM 　あぁぁぁ
PRINTFORM 「ぅ…ふぅ	PRINTFORM 「ぅ…ふぅ
PRINTFORM 「ひうんっ	PRINTFORM 「ひうんっ
PRINTFORM 「はひぃ…	PRINTFORM 「はひぃ…
PRINTFORM 「…ゃ…ぁ	PRINTFORM 「…ゃ…ぁ
PRINTFORM 「あぁ…	PRINTFORM 「あぁ…
PRINTFORM 「ふぁ…	PRINTFORM 「ふぁ…
PRINTFORM 「ぜー…	PRINTFORM 「ぜー…
PRINTFORM 　ぜー…	PRINTFORM 　ぜー…
PRINTFORM 「はぁ…	PRINTFORM 「はぁ…
PRINTFORM 　はぁ…	PRINTFORM 　はぁ…
PRINTFORM 「…はぁ	PRINTFORM 「…はぁ
PRINTFORM 「んぅ…	PRINTFORM 「んぅ…
PRINTFORM 「ねぇ…	PRINTFORM 「ねぇ…
PRINTFORM 　ふはぁ	PRINTFORM 　ふはぁ
PRINTFORM 　んぶっ	PRINTFORM 　んぶっ
PRINTFORM 「……ん	PRINTFORM 「……ん
PRINTFORM 「んんっ	PRINTFORM 「んんっ
PRINTFORM 「ふぅ…	PRINTFORM 「ふぅ…
PRINTFORM 　やめっ	PRINTFORM 　やめっ
PRINTFORM 　んんっ	PRINTFORM 　んんっ
PRINTFORM 「ふぅっ	PRINTFORM 「ふぅっ
PRINTFORM 　ふはっ	PRINTFORM 　ふはっ
PRINTFORM 　ふぁ…	PRINTFORM 　ふぁ…
PRINTFORM 　ぁんっ	PRINTFORM 　ぁんっ
PRINTFORM 「んふっ	PRINTFORM 「んふっ
PRINTFORM 「あぁん	PRINTFORM 「あぁん
PRINTFORM 「んん…	PRINTFORM 「んん…
PRINTFORM 「ほらっ	PRINTFORM 「ほらっ
PRINTFORM 「ん…ぅ	PRINTFORM 「ん…ぅ
PRINTFORM 　そう…	PRINTFORM 　そう…
PRINTFORM 　もう…	PRINTFORM 　もう…
PRINTFORM 「ほぉら	PRINTFORM 「ほぉら
PRINTFORM 「…んぅ	PRINTFORM 「…んぅ
PRINTFORM 　くはっ	PRINTFORM 　くはっ
PRINTFORM 　じゃっ	PRINTFORM 　じゃっ
PRINTFORM 　あぁっ	PRINTFORM 　あぁっ
PRINTFORM 「くはぁ	PRINTFORM 「くはぁ
PRINTFORM 「んふぅ	PRINTFORM 「んふぅ
PRINTFORM 　来たっ	PRINTFORM 　来たっ
PRINTFORM 　そうっ	PRINTFORM 　そうっ
PRINTFORM おしりっ	PRINTFORM おしりっ
PRINTFORM ちくびっ	PRINTFORM ちくびっ
PRINTFORM 「やぁん	PRINTFORM 「やぁん
PRINTFORM 「あぁっ	PRINTFORM 「あぁっ
PRINTFORM 　いいっ	PRINTFORM 　いいっ
PRINTFORM 「…やッ	PRINTFORM 「…やッ
PRINTFORM 「ふはっ	PRINTFORM 「ふはっ
PRINTFORM 　いまっ	PRINTFORM 　いまっ
PRINTFORM 　んはっ	PRINTFORM 　んはっ
PRINTFORM 　らめっ	PRINTFORM 　らめっ
PRINTFORM 　ふぅ…	PRINTFORM 　ふぅ…
PRINTFORM 「ぁ…ん	PRINTFORM 「ぁ…ん
PRINTFORM 　…はぁ	PRINTFORM 　…はぁ
PRINTFORM 「…んっ	PRINTFORM 「…んっ
PRINTFORM 「でるっ	PRINTFORM 「でるっ
PRINTFORM 　ん…っ	PRINTFORM 　ん…っ
PRINTFORM 　…んぅ	PRINTFORM 　…んぅ
PRINTFORM 　…ぅん	PRINTFORM 　…ぅん
PRINTFORM 膣内でっ	PRINTFORM 膣内でっ
PRINTFORM 　ふぁっ	PRINTFORM 　ふぁっ
PRINTFORM 　ナカっ	PRINTFORM 　ナカっ
PRINTFORM 　膣内っ	PRINTFORM 　膣内っ
PRINTFORM 「…んん	PRINTFORM 「…んん
PRINTFORM 「ふぁっ	PRINTFORM 「ふぁっ
PRINTFORM 「ぁぁ…	PRINTFORM 「ぁぁ…
PRINTFORM 　あぁッ	PRINTFORM 　あぁッ
PRINTFORM 　私のっ	PRINTFORM 　私のっ
PRINTFORM 想いをっ	PRINTFORM 想いをっ
PRINTFORM 「はぁん	PRINTFORM 「はぁん
PRINTFORM 「んっ…	PRINTFORM 「んっ…
PRINTFORM 「んはぁ	PRINTFORM 「んはぁ
PRINTFORM 「ひぁっ	PRINTFORM 「ひぁっ
PRINTFORM 「んくっ	PRINTFORM 「んくっ
PRINTFORM 「ひうっ	PRINTFORM 「ひうっ
PRINTFORM 「ん…っ	PRINTFORM 「ん…っ
PRINTFORM 「んふ…	PRINTFORM 「んふ…
PRINTFORM 　ほぉら	PRINTFORM 　ほぉら
PRINTFORM 　もうっ	PRINTFORM 　もうっ
PRINTFORM 　だめっ	PRINTFORM 　だめっ
PRINTFORM 　ほらっ	PRINTFORM 　ほらっ
PRINTFORM 　来た…	PRINTFORM 　来た…
PRINTFORM 「来たっ	PRINTFORM 「来たっ
PRINTFORM 「あはは	PRINTFORM 「あはは
PRINTFORM 「あんっ	PRINTFORM 「あんっ
PRINTFORM 　あんっ	PRINTFORM 　あんっ
PRINTFORM 　私もっ	PRINTFORM 　私もっ
PRINTFORM 「んはっ	PRINTFORM 「んはっ
PRINTFORM 　はぁっ	PRINTFORM 　はぁっ
PRINTFORM くぅんっ	PRINTFORM くぅんっ
PRINTFORM 貴女もっ	PRINTFORM 貴女もっ
PRINTFORM 「んぅぅ	PRINTFORM 「んぅぅ
PRINTFORM やだぁ…	PRINTFORM やだぁ…
PRINTFORM 　裏のっ	PRINTFORM 　裏のっ
PRINTFORM 　どうっ	PRINTFORM 　どうっ
PRINTFORM 　そこ…	PRINTFORM 　そこ…
PRINTFORM 「くふっ	PRINTFORM 「くふっ
PRINTFORM 　音がっ	PRINTFORM 　音がっ
PRINTFORM 　んぅッ	PRINTFORM 　んぅッ
PRINTFORM 　胸でっ	PRINTFORM 　胸でっ
PRINTFORM 「んぅっ	PRINTFORM 「んぅっ
PRINTFORM 　んふっ	PRINTFORM 　んふっ
PRINTFORM 「…んふ	PRINTFORM 「…んふ
PRINTFORM 「くすっ	PRINTFORM 「くすっ
PRINTFORM 「ほ～ら	PRINTFORM 「ほ～ら
PRINTFORM 　んっ…	PRINTFORM 　んっ…
PRINTFORM 「んむっ	PRINTFORM 「んむっ
PRINTFORM 　ちゅっ	PRINTFORM 　ちゅっ
PRINTFORM 「ちゅ…	PRINTFORM 「ちゅ…
PRINTFORM 「…うふ	PRINTFORM 「…うふ
PRINTFORM 「…ふぁ	PRINTFORM 「…ふぁ
PRINTFORM 　またっ	PRINTFORM 　またっ
PRINTFORM 「らめっ	PRINTFORM 「らめっ
PRINTFORM 「んんぅ	PRINTFORM 「んんぅ
PRINTFORM 　くすっ	PRINTFORM 　くすっ
PRINTFORM 　だめッ	PRINTFORM 　だめッ
PRINTFORM 「はぁっ	PRINTFORM 「はぁっ
PRINTFORM 「ひはっ	PRINTFORM 「ひはっ
PRINTFORM 　……ぁ	PRINTFORM 　……ぁ
PRINTFORM わらひっ	PRINTFORM わらひっ
PRINTFORM 「やぁ…	PRINTFORM 「やぁ…
PRINTFORM 「イクっ	PRINTFORM 「イクっ
PRINTFORM 　イクっ	PRINTFORM 　イクっ
PRINTFORM 「ひぐっ	PRINTFORM 「ひぐっ
PRINTFORM 　やだっ	PRINTFORM 　やだっ
PRINTFORM 「…ふぅ	PRINTFORM 「…ふぅ
PRINTFORM 　なかっ	PRINTFORM 　なかっ
PRINTFORM 　これッ	PRINTFORM 　これッ
PRINTFORM 　むりッ	PRINTFORM 　むりッ
PRINTFORM 「くぅ…	PRINTFORM 「くぅ…
PRINTFORM 「ん……	PRINTFORM 「ん……
PRINTFORM 「ええっ	PRINTFORM 「ええっ
PRINTFORM 　うそっ	PRINTFORM 　うそっ
PRINTFORM これッッ	PRINTFORM これッッ
PRINTFORM 　びゅっ	PRINTFORM 　びゅっ
PRINTFORM 　…ぁ	PRINTFORM 　…ぁ
PRINTFORM 　あっ	PRINTFORM 　あっ
PRINTFORM 「…ぁ	PRINTFORM 「…ぁ
PRINTFORM 「はぁ	PRINTFORM 「はぁ
PRINTFORM 　はぁ	PRINTFORM 　はぁ
PRINTFORM 「ん…	PRINTFORM 「ん…
PRINTFORM 「んん	PRINTFORM 「んん
PRINTFORM 　んっ	PRINTFORM 　んっ
PRINTFORM 　んむ	PRINTFORM 　んむ
PRINTFORM 「ふっ	PRINTFORM 「ふっ
PRINT 「ん…きゅぅ…	PRINT 「ん…きゅぅ…
PRINTFORM 　はっ	PRINTFORM 　はっ
PRINTFORM 「あっ	PRINTFORM 「あっ
PRINTFORM 　すっ	PRINTFORM 　すっ
PRINTFORM 凄いっ	PRINTFORM 凄いっ
PRINTFORM 「んっ	PRINTFORM 「んっ
PRINTFORM 　やっ	PRINTFORM 　やっ
PRINTFORM 「そっ	PRINTFORM 「そっ
PRINTFORM 「やッ	PRINTFORM 「やッ
PRINTFORM 　…あ	PRINTFORM 　…あ
PRINTFORM 「んふ	PRINTFORM 「んふ
PRINTFORM 　ふぅ	PRINTFORM 　ふぅ
PRINTFORM 　いッ	PRINTFORM 　いッ
PRINTFORM 「んぅ	PRINTFORM 「んぅ
PRINTFORM 　おっ	PRINTFORM 　おっ
PRINTFORM 　ちっ	PRINTFORM 　ちっ
PRINTFORM 　そっ	PRINTFORM 　そっ
PRINTFORM 「すっ	PRINTFORM 「すっ
PRINTFORM そうっ	PRINTFORM そうっ
PRINTFORM 「らっ	PRINTFORM 「らっ
PRINTFORM 　まっ	PRINTFORM 　まっ
PRINTFORM 「やっ	PRINTFORM 「やっ
PRINTFORM 「イっ	PRINTFORM 「イっ
PRINTFORM 　もっ	PRINTFORM 　もっ
PRINTFORM 　ぁ…	PRINTFORM 　ぁ…
PRINTFORM 「…あ	PRINTFORM 「…あ
PRINTFORM 「ぁ…	PRINTFORM 「ぁ…
PRINTFORM 　イっ	PRINTFORM 　イっ
PRINTFORM なかっ	PRINTFORM なかっ
PRINTFORM 「なっ	PRINTFORM 「なっ
PRINTFORM 「だっ	PRINTFORM 「だっ
PRINTFORM 　あッ	PRINTFORM 　あッ
PRINTFORM 「だッ	PRINTFORM 「だッ
PRINTFORM 「…ん	PRINTFORM 「…ん
PRINTFORM 　…ん	PRINTFORM 　…ん
PRINTFORM 「おっ	PRINTFORM 「おっ
PRINTFORM 「むっ	PRINTFORM 「むっ
PRINTFORM 　胸っ	PRINTFORM 　胸っ
PRINTFORM 　だっ	PRINTFORM 　だっ
PRINTFORM 「あ…	PRINTFORM 「あ…
PRINTFORM 「はっ	PRINTFORM 「はっ
PRINTFORM 早くっ	PRINTFORM 早くっ
PRINTFORM …はぁ	PRINTFORM …はぁ
PRINTFORM 　どっ	PRINTFORM 　どっ
PRINTFORM 　こっ	PRINTFORM 　こっ
PRINTFORM 　腰っ	PRINTFORM 　腰っ
PRINTFORM 　ふっ	PRINTFORM 　ふっ
PRINTFORM 「どっ	PRINTFORM 「どっ
PRINTFORM 　んぅ	PRINTFORM 　んぅ
PRINTFORM 「いっ	PRINTFORM 「いっ
PRINTFORM 　ほっ	PRINTFORM 　ほっ
PRINTFORM ほらっ	PRINTFORM ほらっ
PRINTFORMW 　」	PRINTFORMW 　」
PRINTFORM 　あ…	PRINTFORM 　あ…
PRINTFORM 「もっ	PRINTFORM 「もっ
PRINTFORM イクっ	PRINTFORM イクっ
PRINTFORM 　わっ	PRINTFORM 　わっ
PRINTFORM 「まっ	PRINTFORM 「まっ
PRINTFORM じゃっ	PRINTFORM じゃっ
PRINTFORM だめっ	PRINTFORM だめっ
PRINTFORM あッッ	PRINTFORM あッッ
PRINTFORM 「…っ	PRINTFORM 「…っ
PRINTFORM らめ…	PRINTFORM らめ…
PRINTFORM イグっ	PRINTFORM イグっ
PRINTFORM そこっ	PRINTFORM そこっ
PRINTFORM 　はッ	PRINTFORM 　はッ
PRINTFORM 「クっ	PRINTFORM 「クっ
PRINTFORM 「っっ	PRINTFORM 「っっ
PRINTFORM 　こッ	PRINTFORM 　こッ
PRINTFORM びゅっ	PRINTFORM びゅっ
PRINTFORMW 」	PRINTFORMW 」
PRINTFORM 　ん	PRINTFORM 　ん
PRINT 「…ぅ…く…	PRINT 「…ぅ…く…
PRINTFORM あっ	PRINTFORM あっ
PRINTFORM 　あ	PRINTFORM 　あ
PRINTFORM のっ	PRINTFORM のっ
PRINTFORM 　じ	PRINTFORM 　じ
PRINTFORM 「あ	PRINTFORM 「あ
PRINTFORML 」	PRINTFORML 」
PRINTFORM 「ん	PRINTFORM 「ん
PRINTFORM 　ぁ	PRINTFORM 　ぁ
PRINTFORM イっ	PRINTFORM イっ
PRINTFORM あッ	PRINTFORM あッ
PRINTFORM もう	PRINTFORM もう
PRINT 「…っはぁ	PRINT 「…っはぁ
PRINT 「いたっ…	PRINT 「いたっ…
PRINT 「ぐっ…！	PRINT 「ぐっ…！
PRINTFORM あ	PRINTFORM あ
PRINTFORM ん	PRINTFORM ん
PRINT 「…っ！	PRINT 「…っ！
PRINT 「痛っ…	PRINT 「痛っ…
PRINTL	PRINTL
