//口上:

PRINTFORMW 「ふふ、大きなおちんちんが出たり入ったり♪あなたのおっぱいってんるでおマンコみたいね。見てるだけで犯したくなるのも一緒」	PRINTFORMW 「ふふ、大きなおちんちんが出たり入ったり♪あなたのおっぱいってんるでおマンコみたいね。見てるだけで犯したくなるのも一緒」
PRINTFORMW 「ああ♪何の遠慮もいらないっていうのはすごくいいわね♪いくらでも犯せるのよ♪この迷宮も案外悪くないかもしれないわね♪」	PRINTFORMW 「ああ♪何の遠慮もいらないっていうのはすごくいいわね♪いくらでも犯せるのよ♪この迷宮も案外悪くないかもしれないわね♪」
PRINTFORMW 「お嬢様……しばしお待ちくださいね。きっと素敵な触手たちが気持ちよくしてくれますから。あ、私ちょっと探してきますね♪」	PRINTFORMW 「お嬢様……しばしお待ちくださいね。きっと素敵な触手たちが気持ちよくしてくれますから。あ、私ちょっと探してきますね♪」
PRINTFORMW 「このお腹の重い感じは全部お嬢様がナカダシしてくださったザーメンの重さだと考えると、それだけでイってしまいそうで♪」	PRINTFORMW 「このお腹の重い感じは全部お嬢様がナカダシしてくださったザーメンの重さだと考えると、それだけでイってしまいそうで♪」
PRINTFORMW 「ねえ、あなたお屋敷で働きなさいな。私がシタイときは呼ぶからそうしたらあなたはどんな時でもお股を開くの♪素敵でしょ」	PRINTFORMW 「ねえ、あなたお屋敷で働きなさいな。私がシタイときは呼ぶからそうしたらあなたはどんな時でもお股を開くの♪素敵でしょ」
PRINTFORMW 「なによ、このタユンタユンの胸は！許さないわ、こんなおっぱいは私のオナホールにしてどろどろにしたあげるんだから！」	PRINTFORMW 「なによ、このタユンタユンの胸は！許さないわ、こんなおっぱいは私のオナホールにしてどろどろにしたあげるんだから！」
PRINTFORMW 「ああl何するつもり？ナニするつもりなのね♪仕方ないわよねこんな状況じゃ♪やるからには気持よくしてくださいね♪」	PRINTFORMW 「ああl何するつもり？ナニするつもりなのね♪仕方ないわよねこんな状況じゃ♪やるからには気持よくしてくださいね♪」
PRINTFORMW 「ぜいたくを言わせていただければこのまま私のナカで全部精液吐き出していただけると私最高に幸せになれる気がします」	PRINTFORMW 「ぜいたくを言わせていただければこのまま私のナカで全部精液吐き出していただけると私最高に幸せになれる気がします」
PRINTFORMW 「助けて差し上げたいのはやまやまなのですが、このままにしてあなたがどうなるのか見てみたいんです。ごめんなさい♪」	PRINTFORMW 「助けて差し上げたいのはやまやまなのですが、このままにしてあなたがどうなるのか見てみたいんです。ごめんなさい♪」
PRINTFORMW 「その、置いていくわけじゃないのよ……ただ、ここの触手たちがあなたを見てナニをするのかがちょっと気になって」	PRINTFORMW 「その、置いていくわけじゃないのよ……ただ、ここの触手たちがあなたを見てナニをするのかがちょっと気になって」
PRINTFORMW 「そんなにお尻でエッチするのがいいなら今度からずっとこっちでしましょうか？前は玩具でも入れておきましょう」	PRINTFORMW 「そんなにお尻でエッチするのがいいなら今度からずっとこっちでしましょうか？前は玩具でも入れておきましょう」
PRINTFORMW 「ああ♪お腹の中がぐるぐる言ってます♪お嬢様のザーメンでわたしのカラダの中侵略されてしまったみたいです♪」	PRINTFORMW 「ああ♪お腹の中がぐるぐる言ってます♪お嬢様のザーメンでわたしのカラダの中侵略されてしまったみたいです♪」
PRINTFORMW 「ここの魔物は色々な増え方があるんですね……。でもやっぱりお腹で孕んでしっかり生み落してあげたいですわ♪」	PRINTFORMW 「ここの魔物は色々な増え方があるんですね……。でもやっぱりお腹で孕んでしっかり生み落してあげたいですわ♪」
PRINTFORMW 「仕方ないのよ、無理やりされたことよ……生まれてくる仔に罪はないんだから、私は生むわ。他に手もないものね」	PRINTFORMW 「仕方ないのよ、無理やりされたことよ……生まれてくる仔に罪はないんだから、私は生むわ。他に手もないものね」
PRINTFORMW 「大丈夫ですよすぐに気持ちよくなれますから♪とどめはもちろんナカダシ♪癖になるまで離してあげませんから」	PRINTFORMW 「大丈夫ですよすぐに気持ちよくなれますから♪とどめはもちろんナカダシ♪癖になるまで離してあげませんから」
PRINTFORMW 「おまんこ開くとさっきのザーメン零れてきちゃいますね♪このザーメンは誰のですか？それとも触手のですか？」	PRINTFORMW 「おまんこ開くとさっきのザーメン零れてきちゃいますね♪このザーメンは誰のですか？それとも触手のですか？」
PRINTFORMW 「申し訳ありませんお嬢様…出口を見つけたら必ず戻ってまいります。それまでどうかここで隠れていてください」	PRINTFORMW 「申し訳ありませんお嬢様…出口を見つけたら必ず戻ってまいります。それまでどうかここで隠れていてください」
PRINTFORMW 「あら、あなたなの。いつもみたいにちゃちゃっと解決してくださらない？パチュリー様に話し通しておくわよ」	PRINTFORMW 「あら、あなたなの。いつもみたいにちゃちゃっと解決してくださらない？パチュリー様に話し通しておくわよ」
PRINTFORMW 「お嬢様、お顔が汚れてしまいます。こんなことは門番にでもさせますからお嬢様がされることはありません」	PRINTFORMW 「お嬢様、お顔が汚れてしまいます。こんなことは門番にでもさせますからお嬢様がされることはありません」
PRINTFORMW 「ああ、パチュリー様…ここはいったいどこなんでしょうか。裏庭にもこんなものはありませんでしたよね？」	PRINTFORMW 「ああ、パチュリー様…ここはいったいどこなんでしょうか。裏庭にもこんなものはありませんでしたよね？」
PRINTFORMW 「んー、ちょっと嫌がってしまいましたけどなんだか半端な感じです。ねえ、もう一度してくださらない？」	PRINTFORMW 「んー、ちょっと嫌がってしまいましたけどなんだか半端な感じです。ねえ、もう一度してくださらない？」
PRINTFORMW 「この肌がザーメンでどろどろになったらと思うと、それだけでもうおちんちんが大きくなってしまって♪」	PRINTFORMW 「この肌がザーメンでどろどろになったらと思うと、それだけでもうおちんちんが大きくなってしまって♪」
PRINTFORMW 「お嬢様、お手汚れてしまいます。こんなことは門番にでもさせますからお嬢様がされることはありません」	PRINTFORMW 「お嬢様、お手汚れてしまいます。こんなことは門番にでもさせますからお嬢様がされることはありません」
PRINTFORMW 「ほら我慢しないで♪あなたのここもこんなにいやらしい音を立てて私のおまんこ出たり入ったりしてる♪」	PRINTFORMW 「ほら我慢しないで♪あなたのここもこんなにいやらしい音を立てて私のおまんこ出たり入ったりしてる♪」
PRINTFORML 「もうすぐまた生まれるのね……。魔物に孕まされて、ボテ腹になって、生んだ後も責められて……素敵♪」	PRINTFORML 「もうすぐまた生まれるのね……。魔物に孕まされて、ボテ腹になって、生んだ後も責められて……素敵♪」
PRINTFORMW 「全部見えるほうが好きなんですか？私はどちらかと言えば見えるかどうか義理偽Ｒのほうが好きですよ」	PRINTFORMW 「全部見えるほうが好きなんですか？私はどちらかと言えば見えるかどうか義理偽Ｒのほうが好きですよ」
PRINTFORMW 「その、置いていくわけじゃないんですよ……ただ、触手たちが何をするのかがちょっと気になって……」	PRINTFORMW 「その、置いていくわけじゃないんですよ……ただ、触手たちが何をするのかがちょっと気になって……」
PRINTFORMW 「ああ、パチュリー様♪私ですね、ここがとっても気に入りました♪パチュリー様もそう思いますでしょ」	PRINTFORMW 「ああ、パチュリー様♪私ですね、ここがとっても気に入りました♪パチュリー様もそう思いますでしょ」
PRINTFORMW 「大丈夫ですか？魔物にやられてしまったんですね？一体何をされたのかじっくり教えていただけますか」	PRINTFORMW 「大丈夫ですか？魔物にやられてしまったんですね？一体何をされたのかじっくり教えていただけますか」
PRINTFORML (もうこんなに大きくなって……仕方のないことよ、分かってる早く生まないと次の仔を孕めないわ……)	PRINTFORML (もうこんなに大きくなって……仕方のないことよ、分かってる早く生まないと次の仔を孕めないわ……)
PRINTFORML 諦めようとはせず、必死に抗う咲夜だが…とうとう咲夜は触手の迷宮に連れて行かれてしまったのだった…	PRINTFORML 諦めようとはせず、必死に抗う咲夜だが…とうとう咲夜は触手の迷宮に連れて行かれてしまったのだった…
PRINTFORMW 「残念ですわ、私ならそこらの職種にも負けないくらいの気持ち良いことをして差し上げられますのに」	PRINTFORMW 「残念ですわ、私ならそこらの職種にも負けないくらいの気持ち良いことをして差し上げられますのに」
PRINTFORMW 「小さなお口を私のおちんちんでこじ開けてしゃぶりついてもらったらと最近そんな想像ばかりですの」	PRINTFORMW 「小さなお口を私のおちんちんでこじ開けてしゃぶりついてもらったらと最近そんな想像ばかりですの」
PRINTFORMW 「お嬢さまのきれいなお肌……ああ、駄目！汚したい！私のザーメン塗り広げて、私だけのものに……」	PRINTFORMW 「お嬢さまのきれいなお肌……ああ、駄目！汚したい！私のザーメン塗り広げて、私だけのものに……」
PRINTFORMW 「こんなにナカダシされたら、カラダが喜んじゃう♪ナカダシでないとイケないカラダになっちゃう♪」	PRINTFORMW 「こんなにナカダシされたら、カラダが喜んじゃう♪ナカダシでないとイケないカラダになっちゃう♪」
PRINTFORMW 「いいこと、歯は立てちゃ駄目よ。そう……いい感じ♪喉お使いなさい♪もっとすぼめて吸い付くの♪」	PRINTFORMW 「いいこと、歯は立てちゃ駄目よ。そう……いい感じ♪喉お使いなさい♪もっとすぼめて吸い付くの♪」
PRINTFORMW 「あら…あの娘は…。クスッ…本人はガードが固いからこの娘で……ねえ、少し突きあって下さいな？」	PRINTFORMW 「あら…あの娘は…。クスッ…本人はガードが固いからこの娘で……ねえ、少し突きあって下さいな？」
PRINTFORMW (あ、お嬢様……。お嬢様にもここの魔物たちがどれだけ気持ちよくしてくれるか知ってもらわないと)	PRINTFORMW (あ、お嬢様……。お嬢様にもここの魔物たちがどれだけ気持ちよくしてくれるか知ってもらわないと)
PRINTFORMW 「ああ♪すっごく気持ちよかったです♪力を使い果たしてしまいましたけどシかたありませんよね♪」	PRINTFORMW 「ああ♪すっごく気持ちよかったです♪力を使い果たしてしまいましたけどシかたありませんよね♪」
PRINTFORMW 「射精しすぎて力が入らないなんて……でも、気持ちよかったのは確か……いえいえ！いけません！」	PRINTFORMW 「射精しすぎて力が入らないなんて……でも、気持ちよかったのは確か……いえいえ！いけません！」
PRINTFORMW 「あら！あなた初めてだったのかしら♪思い出に残る素敵なロストバージンね♪そうは思わない？」	PRINTFORMW 「あら！あなた初めてだったのかしら♪思い出に残る素敵なロストバージンね♪そうは思わない？」
PRINTFORMW 「いけない…、いけないのに…、皆の期待を裏切ることになるのに…。このままじゃイケないの！」	PRINTFORMW 「いけない…、いけないのに…、皆の期待を裏切ることになるのに…。このままじゃイケないの！」
PRINTFORMW 「ちょうどいいですね、お嬢様。力を抜いてください、私がとっても良くして差し上げますから♪」	PRINTFORMW 「ちょうどいいですね、お嬢様。力を抜いてください、私がとっても良くして差し上げますから♪」
PRINTFORMW 「ではこのキュンキュンおねだりするおまんこにたっぷりと、奥の奥でナカダシさせてもらますね」	PRINTFORMW 「ではこのキュンキュンおねだりするおまんこにたっぷりと、奥の奥でナカダシさせてもらますね」
PRINTFORMW （大きなおっぱいのやつは皆汚す、小さなおっぱいのやつもそのうち大きくなるからやっぱり汚す）	PRINTFORMW （大きなおっぱいのやつは皆汚す、小さなおっぱいのやつもそのうち大きくなるからやっぱり汚す）
PRINTFORMW 「はっ♪はっ♪ああ♪お嬢様のお手は暖かいですね、まるでおまんこに包まれているみたいです♪」	PRINTFORMW 「はっ♪はっ♪ああ♪お嬢様のお手は暖かいですね、まるでおまんこに包まれているみたいです♪」
PRINTFORMW 「気持ちいいのが♪我慢できません♪だめです！抜いて！抜いてください！でないとお嬢様の……」	PRINTFORMW 「気持ちいいのが♪我慢できません♪だめです！抜いて！抜いてください！でないとお嬢様の……」
PRINTFORMW 「あら、あなたなの。いつもみたいにちゃちゃっと解決してくださらない？今度お賽銭入れるわよ」	PRINTFORMW 「あら、あなたなの。いつもみたいにちゃちゃっと解決してくださらない？今度お賽銭入れるわよ」
PRINTFORMW (あ、妹様……。妹様にもここの魔物たちがどれだけ気持ちよくしてくれるか知ってもらわないと)	PRINTFORMW (あ、妹様……。妹様にもここの魔物たちがどれだけ気持ちよくしてくれるか知ってもらわないと)
PRINTFORMW 咲夜は魔物の仔を孕んだかもしれない予感に恐怖を覚えた、かすかに喜びを見出している自分にも。	PRINTFORMW 咲夜は魔物の仔を孕んだかもしれない予感に恐怖を覚えた、かすかに喜びを見出している自分にも。
PRINTFORMW 「お嬢様のちいさなお腹の中を私のザーメンでパンパンにしたいって、そう思ってしまうんです」	PRINTFORMW 「お嬢様のちいさなお腹の中を私のザーメンでパンパンにしたいって、そう思ってしまうんです」
PRINTFORMW 「乱れるあなたを見ていたら私も我慢できなくなってしまいまして、責任、とってくださいね♪」	PRINTFORMW 「乱れるあなたを見ていたら私も我慢できなくなってしまいまして、責任、とってくださいね♪」
PRINTFORMW 「いいわよ…♪このままナカに出してお腹タポタポにして上げるから♪もっと激しくしなさい♪」	PRINTFORMW 「いいわよ…♪このままナカに出してお腹タポタポにして上げるから♪もっと激しくしなさい♪」
PRINTFORMW 「いけないんです……こんなことしちゃ……この迷宮のせいですから……普段なら、こんなこと」	PRINTFORMW 「いけないんです……こんなことしちゃ……この迷宮のせいですから……普段なら、こんなこと」
PRINTFORMW 「ああ！お嬢様♪もう会えないのかと思いました。ここを出たらすぐお茶の用意をいたしますわ」	PRINTFORMW 「ああ！お嬢様♪もう会えないのかと思いました。ここを出たらすぐお茶の用意をいたしますわ」
PRINTFORMW 「その、ちょっと油断してしまいまして……お腹の中でこの子、いえコレがうごくので大変です」	PRINTFORMW 「その、ちょっと油断してしまいまして……お腹の中でこの子、いえコレがうごくので大変です」
PRINTFORMW 完璧で洒落なメイドのまなざしにはかすかに肉欲に溺れた色があった。注意が必要かもしれない。	PRINTFORMW 完璧で洒落なメイドのまなざしにはかすかに肉欲に溺れた色があった。注意が必要かもしれない。
PRINTFORMW ナイフを刺してみようとするも、触手の表面は妙な液体で濡れており、刃が滑ってしまうのだった	PRINTFORMW ナイフを刺してみようとするも、触手の表面は妙な液体で濡れており、刃が滑ってしまうのだった
PRINTFORML 何度もナイフを振り下ろすが、触手に傷はつかない　自分はどんどん部屋の奥へ吸い込まれていく	PRINTFORML 何度もナイフを振り下ろすが、触手に傷はつかない　自分はどんどん部屋の奥へ吸い込まれていく
PRINTFORMW 「これでお嬢様を喜ばせることができると思うと………あら、大きくなってきちゃいました♪」	PRINTFORMW 「これでお嬢様を喜ばせることができると思うと………あら、大きくなってきちゃいました♪」
PRINTFORMW 「その、私も…使わせてもらうわよ。これだけ汚れてるんですから…ちょっと汚れるくらい…」	PRINTFORMW 「その、私も…使わせてもらうわよ。これだけ汚れてるんですから…ちょっと汚れるくらい…」
PRINTFORMW 「お嬢様？本当は起きてるんじゃありませんか？………そうですか、寝たふりのままがいいと」	PRINTFORMW 「お嬢様？本当は起きてるんじゃありませんか？………そうですか、寝たふりのままがいいと」
PRINTFORMW 「もちろん手でもいいのですが、できればナカとかお尻とか……もっと他にもあるんですよ♪」	PRINTFORMW 「もちろん手でもいいのですが、できればナカとかお尻とか……もっと他にもあるんですよ♪」
PRINTFORMW 「ああ、パチュリー様…ここはいったいどこなんでしょうか。なかなかステキな場所ですわね」	PRINTFORMW 「ああ、パチュリー様…ここはいったいどこなんでしょうか。なかなかステキな場所ですわね」
PRINTFORML 「さあ、私のお腹の中で大きくなるのよ♪いずれは私のナカで大きくなってもらうんだから♪」	PRINTFORML 「さあ、私のお腹の中で大きくなるのよ♪いずれは私のナカで大きくなってもらうんだから♪」
PRINTFORMW 咲夜は化け物の仔を妊娠した現実を受け入れるしかなく、絶望の浮かんだ瞳はなにも捉えない。	PRINTFORMW 咲夜は化け物の仔を妊娠した現実を受け入れるしかなく、絶望の浮かんだ瞳はなにも捉えない。
PRINTFORMW 「あは♪やっぱり精液濡れになったおまんこのぬめりは最高ですわ♪もっと突いてあげる♪」	PRINTFORMW 「あは♪やっぱり精液濡れになったおまんこのぬめりは最高ですわ♪もっと突いてあげる♪」
PRINTFORMW 「ああ！イク♪もう、あ、あ！お嬢様の！アナル、ザーメンタンクにしますぅぅぅぅ～！！」	PRINTFORMW 「ああ！イク♪もう、あ、あ！お嬢様の！アナル、ザーメンタンクにしますぅぅぅぅ～！！」
PRINTFORMW 「その、使わせてよね…。無防備に寝てるのが悪いのよ、私の方だって我慢ってものが……」	PRINTFORMW 「その、使わせてよね…。無防備に寝てるのが悪いのよ、私の方だって我慢ってものが……」
PRINTFORMW 「そうよ……頭おさえてるとまるであなたをオナホにしてるみたいね。ちょっとそそるわ♪」	PRINTFORMW 「そうよ……頭おさえてるとまるであなたをオナホにしてるみたいね。ちょっとそそるわ♪」
PRINTFORMW 「ちょっと不安でしたがこの迷宮に落ちてから私のおっぱいも順当に発育しているようで♪」	PRINTFORMW 「ちょっと不安でしたがこの迷宮に落ちてから私のおっぱいも順当に発育しているようで♪」
PRINTFORMW 「その、助けに戻ってきてくれますよね？でないと私、戻れなくなっちゃうかもしれません」	PRINTFORMW 「その、助けに戻ってきてくれますよね？でないと私、戻れなくなっちゃうかもしれません」
PRINTFORMW （お嬢様……柔らかそうなカラダ……抱きしめたい、抱きたい……そして……、私は何を！）	PRINTFORMW （お嬢様……柔らかそうなカラダ……抱きしめたい、抱きたい……そして……、私は何を！）
PRINTFORMW 乳房の先端から滴る白い雫をぬぐいながら咲夜は無言で大きくなった胸と腹をにらみつけた。	PRINTFORMW 乳房の先端から滴る白い雫をぬぐいながら咲夜は無言で大きくなった胸と腹をにらみつけた。
PRINTFORML 紅魔館の最上階から地下まで掃除をやり終えた咲夜は早速次の家事へ手をつけるつもりだった	PRINTFORML 紅魔館の最上階から地下まで掃除をやり終えた咲夜は早速次の家事へ手をつけるつもりだった
PRINTFORMW そのときである　扉が開き、その部屋の中から伸びてきた触手に足を掴まれてしまったのだ！	PRINTFORMW そのときである　扉が開き、その部屋の中から伸びてきた触手に足を掴まれてしまったのだ！
PRINTFORMW 形ばかりの抵抗を示す咲夜だが蕩けた表情はこの後の快楽を待ちわびているのが明らかだ。	PRINTFORMW 形ばかりの抵抗を示す咲夜だが蕩けた表情はこの後の快楽を待ちわびているのが明らかだ。
PRINTFORMW 「ちょうどよかったですわ♪これぐらいのおちんちんがちょうど欲しかったところですの」	PRINTFORMW 「ちょうどよかったですわ♪これぐらいのおちんちんがちょうど欲しかったところですの」
PRINTFORMW 「でも私はただ汚すだけじゃなく気持ちよくして差し上げますから♪安心してください。」	PRINTFORMW 「でも私はただ汚すだけじゃなく気持ちよくして差し上げますから♪安心してください。」
PRINTFORMW 「あ、安心してください♪喉の奥に直接こってりザーメン流し込んで差し上げますから♪」	PRINTFORMW 「あ、安心してください♪喉の奥に直接こってりザーメン流し込んで差し上げますから♪」
PRINTFORMW 「ああ♪もう、我慢できません！このまま！お嬢様のアナルにナカダシさせてください！」	PRINTFORMW 「ああ♪もう、我慢できません！このまま！お嬢様のアナルにナカダシさせてください！」
PRINTFORMW 「ごめんなさいね♪私はひどいことしたくないんだけどこの子がどうしてもっていうの♪」	PRINTFORMW 「ごめんなさいね♪私はひどいことしたくないんだけどこの子がどうしてもっていうの♪」
PRINTFORMW 「びゅる～って、出ちゃいました♪もっとシタイのに…体力尽きるまでシチャいました♪」	PRINTFORMW 「びゅる～って、出ちゃいました♪もっとシタイのに…体力尽きるまでシチャいました♪」
PRINTFORMW 「ああ、パチュリー様、ここの魔物たちは人の精神に働きかける力があるのでしょうか？」	PRINTFORMW 「ああ、パチュリー様、ここの魔物たちは人の精神に働きかける力があるのでしょうか？」
PRINTFORMW （この場所なら、ちょっとエッチなことをしても異変の影響ということにならないかしら）	PRINTFORMW （この場所なら、ちょっとエッチなことをしても異変の影響ということにならないかしら）
PRINTFORMW 咲夜は何とか自分に言い聞かせたが、なぜか笑みが浮かぶのを止めることはできなかった。	PRINTFORMW 咲夜は何とか自分に言い聞かせたが、なぜか笑みが浮かぶのを止めることはできなかった。
PRINTFORMW (誰もいないのなら魔物の仔を生んでも問題はないわよね……それに他の人だってきっと)	PRINTFORMW (誰もいないのなら魔物の仔を生んでも問題はないわよね……それに他の人だってきっと)
PRINTFORML その拍子に自分の懐中時計を落としてしまい、時間を止めることができなくなってしまった	PRINTFORML その拍子に自分の懐中時計を落としてしまい、時間を止めることができなくなってしまった
PRINTFORMW 「あら…初めてなのにこれで終わりでいいの？もっと心イクまでしたいんじゃないの？」	PRINTFORMW 「あら…初めてなのにこれで終わりでいいの？もっと心イクまでしたいんじゃないの？」
PRINTFORMW 「大丈夫ですか、挿入れるところはここですよ。待ちきれなくて疼いてしまうんです♪」	PRINTFORMW 「大丈夫ですか、挿入れるところはここですよ。待ちきれなくて疼いてしまうんです♪」
PRINTFORMW 「お嬢様のおまんこ、もうぐちょぐちょ♪でも咲夜はどんなお嬢様でもお支えします♪」	PRINTFORMW 「お嬢様のおまんこ、もうぐちょぐちょ♪でも咲夜はどんなお嬢様でもお支えします♪」
PRINTFORMW 「もうずいぶんナカダシされているようですので私もナカに射精させてもらいますね♪」	PRINTFORMW 「もうずいぶんナカダシされているようですので私もナカに射精させてもらいますね♪」
PRINTFORMW 「お嬢様……そんなに吸い付かれたら……もう♪出ちゃいます♪ああ……もう、出る♪」	PRINTFORMW 「お嬢様……そんなに吸い付かれたら……もう♪出ちゃいます♪ああ……もう、出る♪」
PRINTFORMW 「イクならイクって言ってくれないと、せっかく全力で搾ってあげようと思ってたのに」	PRINTFORMW 「イクならイクって言ってくれないと、せっかく全力で搾ってあげようと思ってたのに」
PRINTFORMW 「その、すみません、ここの触手が捕まえた女の子にナニをするのか興味がありまして」	PRINTFORMW 「その、すみません、ここの触手が捕まえた女の子にナニをするのか興味がありまして」
PRINTFORMW 「ああ！お嬢様♪ようやっとお会いできなした。ここにいる間に会えてよかったですわ」	PRINTFORMW 「ああ！お嬢様♪ようやっとお会いできなした。ここにいる間に会えてよかったですわ」
PRINTFORMW （魔物を孕むなんて……自分の体でなければすぐにナイフを突き立てているところだわ）	PRINTFORMW （魔物を孕むなんて……自分の体でなければすぐにナイフを突き立てているところだわ）
PRINTFORMW 「ああ♪お嬢様♪お嬢様のこのぷにまんはどうしてこんなにも濡れているんですか？」	PRINTFORMW 「ああ♪お嬢様♪お嬢様のこのぷにまんはどうしてこんなにも濡れているんですか？」
PRINTFORMW 「こんなにも私のおちんぽを待ちわびているのなら期待に答えないといけませんね♪」	PRINTFORMW 「こんなにも私のおちんぽを待ちわびているのなら期待に答えないといけませんね♪」
PRINTFORMW 「お嬢様のアツアツトロトロのお口はもうおまんこと同じくらい名器なんですから♪」	PRINTFORMW 「お嬢様のアツアツトロトロのお口はもうおまんこと同じくらい名器なんですから♪」
PRINTFORMW 「ちょっと嫉妬してしまいました。だからそう、これはお仕置き、お仕置きなんです」	PRINTFORMW 「ちょっと嫉妬してしまいました。だからそう、これはお仕置き、お仕置きなんです」
PRINTFORMW 「ふふ♪お嬢様のアナルからだらだらザーメン零れちゃって、まるでしっぽですね♪」	PRINTFORMW 「ふふ♪お嬢様のアナルからだらだらザーメン零れちゃって、まるでしっぽですね♪」
PRINTFORMW 「気が付いたら自分の口がおマンコ並みの名器にされてたなんて♪なんて…ステキ♪」	PRINTFORMW 「気が付いたら自分の口がおマンコ並みの名器にされてたなんて♪なんて…ステキ♪」
PRINTFORMW 「お尻の中がザーメンでいっぱい♪お尻の穴キュって締めてないと垂れてきちゃう♪」	PRINTFORMW 「お尻の中がザーメンでいっぱい♪お尻の穴キュって締めてないと垂れてきちゃう♪」
PRINTFORMW 「抵抗も出来ないままなすがままに、オナホールみたいにされたことはあるかしら？」	PRINTFORMW 「抵抗も出来ないままなすがままに、オナホールみたいにされたことはあるかしら？」
PRINTFORMW （異形に妊娠させられて私は傷ついているんだから……傷ついているの、いいこと？）	PRINTFORMW （異形に妊娠させられて私は傷ついているんだから……傷ついているの、いいこと？）
PRINTFORMW 繰り返し魔物を産み落とした咲夜の身体は出産の刺激さえ性感に変えてしまっていた。	PRINTFORMW 繰り返し魔物を産み落とした咲夜の身体は出産の刺激さえ性感に変えてしまっていた。
PRINTFORMW 「私がこうやっておちんちんで縁をぬりぬりするとパクパク口を開くんですから♪」	PRINTFORMW 「私がこうやっておちんちんで縁をぬりぬりするとパクパク口を開くんですから♪」
PRINTFORMW 「ああ♪どろどろがぬめって！いつもよりイイ♪あ、お嬢様？気持ちいいですか？」	PRINTFORMW 「ああ♪どろどろがぬめって！いつもよりイイ♪あ、お嬢様？気持ちいいですか？」
PRINTFORMW 「お嬢様のザーメンまみれになったお口を綺麗にして差し上げます。はい、あーん」	PRINTFORMW 「お嬢様のザーメンまみれになったお口を綺麗にして差し上げます。はい、あーん」
PRINTFORMW 「もう！こんなにどろどろに汚して！きれいにする側のことも考えてほしいものね」	PRINTFORMW 「もう！こんなにどろどろに汚して！きれいにする側のことも考えてほしいものね」
PRINTFORMW 「そんな……あなた個々の触手たちと同じじゃない！お尻に、何考えてるのよ！！」	PRINTFORMW 「そんな……あなた個々の触手たちと同じじゃない！お尻に、何考えてるのよ！！」
PRINTFORMW 「あら？壊れちゃったような悲鳴あげちゃって♪いいわ、そのまま壊れちゃって♪」	PRINTFORMW 「あら？壊れちゃったような悲鳴あげちゃって♪いいわ、そのまま壊れちゃって♪」
PRINTFORMW 「私は……いいえ、落ち込むくらいなら助けを連れてくるわ。待っててください！」	PRINTFORMW 「私は……いいえ、落ち込むくらいなら助けを連れてくるわ。待っててください！」
PRINTFORML 「あ、やっぱり目立ちます？そうなんです♪どうやら触手の赤ちゃんらしくって♪」	PRINTFORML 「あ、やっぱり目立ちます？そうなんです♪どうやら触手の赤ちゃんらしくって♪」
PRINTFORMW 「お嬢様♪ここは大変いいところですね♪いっそここに移住してしまいましょう♪」	PRINTFORMW 「お嬢様♪ここは大変いいところですね♪いっそここに移住してしまいましょう♪」
PRINTFORMW 咲夜は魔物の仔を宿したことに嫌悪以外の感情を抱いていることを認めざる得ない。	PRINTFORMW 咲夜は魔物の仔を宿したことに嫌悪以外の感情を抱いていることを認めざる得ない。
PRINTFORMW 「ここの魔物たちは孕んでもすぐに生まれるからヤれない期間が短くて助かるわ～」	PRINTFORMW 「ここの魔物たちは孕んでもすぐに生まれるからヤれない期間が短くて助かるわ～」
PRINTFORMW 「ああ、切ないの！もう戦いなんてどうでもいいから、誰かにナカダシさせて！」	PRINTFORMW 「ああ、切ないの！もう戦いなんてどうでもいいから、誰かにナカダシさせて！」
PRINTFORMW 「お嬢様、その、すみません…。咲夜はおちんちんの誘惑に勝てませんでした…」	PRINTFORMW 「お嬢様、その、すみません…。咲夜はおちんちんの誘惑に勝てませんでした…」
PRINTFORMW （お嬢様のぷにまんパンパンしてこってりザーメンで子宮風船みたいにしても！）	PRINTFORMW （お嬢様のぷにまんパンパンしてこってりザーメンで子宮風船みたいにしても！）
PRINTFORMW 「連続射精でお嬢様のお腹の中全部私のザーメンに置き換えて差し上げますから」	PRINTFORMW 「連続射精でお嬢様のお腹の中全部私のザーメンに置き換えて差し上げますから」
PRINTFORMW 「ああ♪お嬢様の小さいおまんこがわたしのおちんちんにぴったり吸い付いて♪」	PRINTFORMW 「ああ♪お嬢様の小さいおまんこがわたしのおちんちんにぴったり吸い付いて♪」
PRINTFORMW 「その、キスするだけじゃ足りなくなってしまいました。使わせて、下さいね♪」	PRINTFORMW 「その、キスするだけじゃ足りなくなってしまいました。使わせて、下さいね♪」
PRINTFORMW 「あふれてきちゃいました♪お嬢様、あふれた分…またナカダシしてください♪」	PRINTFORMW 「あふれてきちゃいました♪お嬢様、あふれた分…またナカダシしてください♪」
PRINTFORMW 「お嬢様！私のこんなもののためにお嬢様にご負担をかけるわけには……ああ♪」	PRINTFORMW 「お嬢様！私のこんなもののためにお嬢様にご負担をかけるわけには……ああ♪」
PRINTFORMW 「ほら嫌がらない！あなたは負けたのよ♪じっとして言いように使われなさい♪」	PRINTFORMW 「ほら嫌がらない！あなたは負けたのよ♪じっとして言いように使われなさい♪」
PRINTFORMW 「はい♪これなら妊娠してしまうこともありませんからいくらでも出来ますよ♪」	PRINTFORMW 「はい♪これなら妊娠してしまうこともありませんからいくらでも出来ますよ♪」
PRINTFORMW 「ああ、置き去りにされてしまいました……この後私をどうする気なんですか♪」	PRINTFORMW 「ああ、置き去りにされてしまいました……この後私をどうする気なんですか♪」
PRINTFORMW 「パチュリー様、とってもエッチなにおいがしてますよ♪私にも分けてください」	PRINTFORMW 「パチュリー様、とってもエッチなにおいがしてますよ♪私にも分けてください」
PRINTFORMW （この感じからするともう少しかしらね……魔物の仔なんて……全く笑えないわ）	PRINTFORMW （この感じからするともう少しかしらね……魔物の仔なんて……全く笑えないわ）
PRINTFORMW （こんなものを見られるのは絶対に嫌だけど、他の人たちも私のような目に…？）	PRINTFORMW （こんなものを見られるのは絶対に嫌だけど、他の人たちも私のような目に…？）
PRINTFORMW （もう…こんなものであっても生むしかないのね……あきらめたくなるわ、色々）	PRINTFORMW （もう…こんなものであっても生むしかないのね……あきらめたくなるわ、色々）
PRINTFORML 「ああ♪降りてくる♪ああ♪ちゃんと元気に生んであげるから♪早く出てきて♪」	PRINTFORML 「ああ♪降りてくる♪ああ♪ちゃんと元気に生んであげるから♪早く出てきて♪」
PRINTFORMW 「もう最近では定期的に誰かのお尻を犯さないとどうにかなりそうなんです♪」	PRINTFORMW 「もう最近では定期的に誰かのお尻を犯さないとどうにかなりそうなんです♪」
PRINTFORMW 「あふれてきちゃいました♪お嬢様あふれた分、またナカダシしてください♪」	PRINTFORMW 「あふれてきちゃいました♪お嬢様あふれた分、またナカダシしてください♪」
PRINTFORMW 「お嬢様のそれ♪中身がすっからかんになるまで私のお尻に出してください♪」	PRINTFORMW 「お嬢様のそれ♪中身がすっからかんになるまで私のお尻に出してください♪」
PRINTFORMW 「あんまり使って下さらないと……私の方から襲ってしまうかも……なんて♪」	PRINTFORMW 「あんまり使って下さらないと……私の方から襲ってしまうかも……なんて♪」
PRINTFORMW 「あ♪震えてきた♪っ出る？出るの？良いわよ、このまま全部絞ってあげる♪」	PRINTFORMW 「あ♪震えてきた♪っ出る？出るの？良いわよ、このまま全部絞ってあげる♪」
PRINTFORMW 「ああ……こんなことで力を使い果たしてしまうなんて……しっかりシないと」	PRINTFORMW 「ああ……こんなことで力を使い果たしてしまうなんて……しっかりシないと」
PRINTFORMW 「ああ……こんなことで力を使い果たしてしまうなんて……しっかりしないと」	PRINTFORMW 「ああ……こんなことで力を使い果たしてしまうなんて……しっかりしないと」
PRINTFORMW 「パーティーの全滅だけは避けなければ……少し様子を見ていてもイイかしら」	PRINTFORMW 「パーティーの全滅だけは避けなければ……少し様子を見ていてもイイかしら」
PRINTFORMW 「ねえ、あっちの物陰に変なものを見つけたの。ちょっと来てくれないかしら」	PRINTFORMW 「ねえ、あっちの物陰に変なものを見つけたの。ちょっと来てくれないかしら」
PRINTFORMW 「あらあなたもいたのね。いつもみたいにその人形で何とかならないのかしら」	PRINTFORMW 「あらあなたもいたのね。いつもみたいにその人形で何とかならないのかしら」
PRINTFORMW 「ええ、やられましたわ。あなたならたぶん大丈夫でしょうけど、気を付けて」	PRINTFORMW 「ええ、やられましたわ。あなたならたぶん大丈夫でしょうけど、気を付けて」
PRINTFORMW 「大丈夫だった？　丈夫そうなあなたがそう簡単にはやられないでしょうけど」	PRINTFORMW 「大丈夫だった？　丈夫そうなあなたがそう簡単にはやられないでしょうけど」
PRINTFORMW 「…何かに使えそうだから拾うだけよ。別に使ってみたいとは思っていません」	PRINTFORMW 「…何かに使えそうだから拾うだけよ。別に使ってみたいとは思っていません」
PRINTFORML 「…何かに使えそうだから拾うだけよ。別に使ってみたいとは思っていません」	PRINTFORML 「…何かに使えそうだから拾うだけよ。別に使ってみたいとは思っていません」
PRINTFORMW 「私の膣内をずりゅっずりゅって♪だんだん速くなってますよ♪頑張って♪」	PRINTFORMW 「私の膣内をずりゅっずりゅって♪だんだん速くなってますよ♪頑張って♪」
PRINTFORMW 「こうして寄せて…、あっ♪本当におっぱがおまんこみたいになりました♪」	PRINTFORMW 「こうして寄せて…、あっ♪本当におっぱがおまんこみたいになりました♪」
PRINTFORMW 「もう、こんなとこで寝てるのがいけないのよ。おとなしく、使われなさい」	PRINTFORMW 「もう、こんなとこで寝てるのがいけないのよ。おとなしく、使われなさい」
PRINTFORMW 「ああ♪締め付け最高♪ねえ、次は締め付けたままピストンしてくださる？」	PRINTFORMW 「ああ♪締め付け最高♪ねえ、次は締め付けたままピストンしてくださる？」
PRINTFORMW 「私、もうこれをしゃぶっていないとどうにかなってしまいそうなんです♪」	PRINTFORMW 「私、もうこれをしゃぶっていないとどうにかなってしまいそうなんです♪」
PRINTFORMW 「こうしてお尻のひくひくってすると……えっ？なにもういっちゃったの？」	PRINTFORMW 「こうしてお尻のひくひくってすると……えっ？なにもういっちゃったの？」
PRINTFORMW 「その、妹様……私のお腹触ってみます？赤ちゃんに罪はありませんものね」	PRINTFORMW 「その、妹様……私のお腹触ってみます？赤ちゃんに罪はありませんものね」
PRINTFORML 「あら、あなた……。ねえ、変な話なのだけどね……、最近なんか変なのよ」	PRINTFORML 「あら、あなた……。ねえ、変な話なのだけどね……、最近なんか変なのよ」
PRINTFORML 「あはっ♪ここの仔達って生まれてすぐにヤれるようになるから素敵よね♪」	PRINTFORML 「あはっ♪ここの仔達って生まれてすぐにヤれるようになるから素敵よね♪」
PRINTFORMW 「な、何なの？私の体が何か変だわ!ねえ、まさかそんなはずないわよね？」	PRINTFORMW 「な、何なの？私の体が何か変だわ!ねえ、まさかそんなはずないわよね？」
PRINTFORMW 「ああ……ちょっと間に合わなかったかしら…まあそんな時もあるわよね」	PRINTFORMW 「ああ……ちょっと間に合わなかったかしら…まあそんな時もあるわよね」
PRINTFORMW 「こんな場所なんですからずっと正気でいなさいって方が無茶ですよね♪」	PRINTFORMW 「こんな場所なんですからずっと正気でいなさいって方が無茶ですよね♪」
PRINTFORMW 「こんなにトロトロになってるんじゃ、犯されても文句はいえませんね♪」	PRINTFORMW 「こんなにトロトロになってるんじゃ、犯されても文句はいえませんね♪」
PRINTFORMW 「お嬢様のソコを見ているとどうしても、これを入れたくなってしまって」	PRINTFORMW 「お嬢様のソコを見ているとどうしても、これを入れたくなってしまって」
PRINTFORMW 「膣中にだけは出しませんから！射精するときはちゃんと抜きますから！」	PRINTFORMW 「膣中にだけは出しませんから！射精するときはちゃんと抜きますから！」
PRINTFORMW 「こんなにいやらしいカラダなら仕方ないわ、そう仕方のないことなの…」	PRINTFORMW 「こんなにいやらしいカラダなら仕方ないわ、そう仕方のないことなの…」
PRINTFORMW 「このままごしごしして中にびゅってするのがもう、止められないかも♪」	PRINTFORMW 「このままごしごしして中にびゅってするのがもう、止められないかも♪」
PRINTFORMW 「ああ♪素敵です♪お嬢様♪お嬢様のお口はいつだって一番の名器です♪」	PRINTFORMW 「ああ♪素敵です♪お嬢様♪お嬢様のお口はいつだって一番の名器です♪」
PRINTFORMW 「ふふ、胸と言わず体中白く染めてあげるわ♪カラダのナカもそともね♪」	PRINTFORMW 「ふふ、胸と言わず体中白く染めてあげるわ♪カラダのナカもそともね♪」
PRINTFORMW 「もう少し大きく開いてもらえます？そうしないと喉の奥が突けなくて♪」	PRINTFORMW 「もう少し大きく開いてもらえます？そうしないと喉の奥が突けなくて♪」
PRINTFORMW 「お、お嬢様…。前は遠慮しますから、せめて後ろを使わせて下さいませ」	PRINTFORMW 「お、お嬢様…。前は遠慮しますから、せめて後ろを使わせて下さいませ」
PRINTFORMW 「お嬢様、白くどろどろに汚されて♪……とっても目のやり場に困ります」	PRINTFORMW 「お嬢様、白くどろどろに汚されて♪……とっても目のやり場に困ります」
PRINTFORMW 「その、パチュリー様……これをどうにかすることはできないでしょうか」	PRINTFORMW 「その、パチュリー様……これをどうにかすることはできないでしょうか」
PRINTFORMW （小悪魔のカラダ……人間よりずっと気持ちイイって聞いたことがあるわ）	PRINTFORMW （小悪魔のカラダ……人間よりずっと気持ちイイって聞いたことがあるわ）
PRINTFORMW 魔物の仔を妊娠したかもしれないと思うと笑みがこぼれてくる咲夜だった。	PRINTFORMW 魔物の仔を妊娠したかもしれないと思うと笑みがこぼれてくる咲夜だった。
PRINTFORML 「眠ってる間に襲われちゃったりしたら抵抗できないわ、困ったわねえ♪」	PRINTFORML 「眠ってる間に襲われちゃったりしたら抵抗できないわ、困ったわねえ♪」
PRINTFORMW 咲夜は近くにいるかもしれない妖精メイドに助けを呼んでもらおうと叫ぶ！	PRINTFORMW 咲夜は近くにいるかもしれない妖精メイドに助けを呼んでもらおうと叫ぶ！
PRINTFORML （触るだけでイきそうになる…しかもこれ…殿方のアレになっている！？）	PRINTFORML （触るだけでイきそうになる…しかもこれ…殿方のアレになっている！？）
PRINTFORMW 「ちょうどいいザーメンケツマンコがあったので使わせてくださいね♪」	PRINTFORMW 「ちょうどいいザーメンケツマンコがあったので使わせてくださいね♪」
PRINTFORMW 「お尻犯すのが癖になっちゃったみたいなんです。使わせてくださいね」	PRINTFORMW 「お尻犯すのが癖になっちゃったみたいなんです。使わせてくださいね」
PRINTFORMW 「あなたのおまんこは私のもの、１発や２発じゃ済まさないんだから♪」	PRINTFORMW 「あなたのおまんこは私のもの、１発や２発じゃ済まさないんだから♪」
PRINTFORMW 「もう♪こんなに魅力的なお尻、犯したくなるのは当然と言いますか♪」	PRINTFORMW 「もう♪こんなに魅力的なお尻、犯したくなるのは当然と言いますか♪」
PRINTFORMW 「私のこの体はすべてお嬢様のためにあるの！汚さないでちょうだい！」	PRINTFORMW 「私のこの体はすべてお嬢様のためにあるの！汚さないでちょうだい！」
PRINTFORMW 「それらがご所望でしたらいつでも言って下さい♪お待ちしてますから」	PRINTFORMW 「それらがご所望でしたらいつでも言って下さい♪お待ちしてますから」
PRINTFORMW 「はあ♪ああ♪駄目なんです♪この後、ナニされてしまうんでしょう♪」	PRINTFORMW 「はあ♪ああ♪駄目なんです♪この後、ナニされてしまうんでしょう♪」
PRINTFORMW 「寝込みを襲うなんてなんて好都ごぅ……じゃなかった、酷いことを！」	PRINTFORMW 「寝込みを襲うなんてなんて好都ごぅ……じゃなかった、酷いことを！」
PRINTFORMW 「安心して、そんな痛いことはしないから。ただ気持ちイイだけです♪」	PRINTFORMW 「安心して、そんな痛いことはしないから。ただ気持ちイイだけです♪」
PRINTFORMW 「あら、あなたもいたの。なかなか楽しい場所よね♪そう思うでしょ？」	PRINTFORMW 「あら、あなたもいたの。なかなか楽しい場所よね♪そう思うでしょ？」
PRINTFORML 「ええ、ちょっといろいろされちゃいまして……もう慣れちゃいました」	PRINTFORML 「ええ、ちょっといろいろされちゃいまして……もう慣れちゃいました」
PRINTFORML …が、それよりも速く一瞬のうちに部屋の中へと引きずられてしまった…	PRINTFORML …が、それよりも速く一瞬のうちに部屋の中へと引きずられてしまった…
PRINTFORMW 咲夜は解放されたことに気付いている様だが、身動きはとれないらしい…	PRINTFORMW 咲夜は解放されたことに気付いている様だが、身動きはとれないらしい…
PRINTFORMW 「他の人も能力が制限されて困っているみたいだし、何かあるのかもね」	PRINTFORMW 「他の人も能力が制限されて困っているみたいだし、何かあるのかもね」
PRINTFORMW 「本当にそれだけよ！　いやらしいことなんて考えてないんだからね！」	PRINTFORMW 「本当にそれだけよ！　いやらしいことなんて考えてないんだからね！」
PRINTFORMW 「そんなはずがありません。お嬢様はこの世で最も強く、尊い方なのよ」	PRINTFORMW 「そんなはずがありません。お嬢様はこの世で最も強く、尊い方なのよ」
PRINTFORMW 「やめてください！こんなことをしてる場合じゃありませんでしょ！」	PRINTFORMW 「やめてください！こんなことをしてる場合じゃありませんでしょ！」
PRINTFORML ;１８７（タイミング？;中出し展開が確定の場合にでるということか	PRINTFORML ;１８７（タイミング？;中出し展開が確定の場合にでるということか
PRINTFORMW 「だから私がこのチンポの欲望に負けちゃうのも当たり前なんです♪」	PRINTFORMW 「だから私がこのチンポの欲望に負けちゃうのも当たり前なんです♪」
PRINTFORMW 「あら、どうやらわたしのカラダの一部になってしまったようですね」	PRINTFORMW 「あら、どうやらわたしのカラダの一部になってしまったようですね」
PRINTFORMW 「牙に触れないようにズコズコする緊張感もまたたまりませんわ～♪」	PRINTFORMW 「牙に触れないようにズコズコする緊張感もまたたまりませんわ～♪」
PRINTFORMW 「これなら今更ちょっとやそっと増えたところで変わらないですね♪」	PRINTFORMW 「これなら今更ちょっとやそっと増えたところで変わらないですね♪」
PRINTFORMW 「根元まで押し込むと先端が完全に喉の中に入ってしまうんですね♪」	PRINTFORMW 「根元まで押し込むと先端が完全に喉の中に入ってしまうんですね♪」
PRINTFORMW 「お嬢様、駄目ですよ。お嬢様が底までされることはありませんから」	PRINTFORMW 「お嬢様、駄目ですよ。お嬢様が底までされることはありませんから」
PRINTFORMW 「これまでに人にしてきたことと同じことをあなたにもしてあげる♪」	PRINTFORMW 「これまでに人にしてきたことと同じことをあなたにもしてあげる♪」
PRINTFORMW 「ああ！全部ひん剥かれちゃいました！そんなに見ないでください♪」	PRINTFORMW 「ああ！全部ひん剥かれちゃいました！そんなに見ないでください♪」
PRINTFORMW 完璧で洒落なメイドのまなざしにどっぷりと肉欲に溺れた色があった。	PRINTFORMW 完璧で洒落なメイドのまなざしにどっぷりと肉欲に溺れた色があった。
PRINTFORML (無理矢理力づくで妊娠させられたの、これは仕方のないことなのよ)	PRINTFORML (無理矢理力づくで妊娠させられたの、これは仕方のないことなのよ)
PRINTFORMW 咲夜の体は魔物の仔を孕んだことで母乳が出るようになってしまった。	PRINTFORMW 咲夜の体は魔物の仔を孕んだことで母乳が出るようになってしまった。
PRINTFORMW 「そう、残念だわ……もし……、またよければ……一緒に行きましょ」	PRINTFORMW 「そう、残念だわ……もし……、またよければ……一緒に行きましょ」
PRINTFORMW 「こ、こんなに苦しいのにっ、なんで感じてっ……ああぁぁぁぁぁ！」	PRINTFORMW 「こ、こんなに苦しいのにっ、なんで感じてっ……ああぁぁぁぁぁ！」
PRINTFORMW 「お嬢様……申し訳ありません……もう、帰れないかもしれません」	PRINTFORMW 「お嬢様……申し訳ありません……もう、帰れないかもしれません」
PRINTFORMW 「時々これを汚せたらどれだけ幸せだろうかって思っちゃうんです」	PRINTFORMW 「時々これを汚せたらどれだけ幸せだろうかって思っちゃうんです」
PRINTFORMW 「ほらもう少し大きく開けて、そうすると…私がきもちいいから♪」	PRINTFORMW 「ほらもう少し大きく開けて、そうすると…私がきもちいいから♪」
PRINTFORMW 「わかる？こうしてズコズコするとあなたも気持ちいいんでしょ？」	PRINTFORMW 「わかる？こうしてズコズコするとあなたも気持ちいいんでしょ？」
PRINTFORMW 「ああ、あれは…嘘…いえ、まだ寝てるの？せめて、夢で終わって」	PRINTFORMW 「ああ、あれは…嘘…いえ、まだ寝てるの？せめて、夢で終わって」
PRINTFORMW 「あら～そんなところで伸びてると誰かに襲われてしまいますよ♪」	PRINTFORMW 「あら～そんなところで伸びてると誰かに襲われてしまいますよ♪」
PRINTFORMW 「ああ！妹様も！せっかくですからここで一休みといきませんか？」	PRINTFORMW 「ああ！妹様も！せっかくですからここで一休みといきませんか？」
PRINTFORMW 「あら？可愛らしい…。あなたの力でもどうにかできないのですね」	PRINTFORMW 「あら？可愛らしい…。あなたの力でもどうにかできないのですね」
PRINTFORML 「お嬢様、祝福してください♪私、触手のお嫁さんになりました♪」	PRINTFORML 「お嬢様、祝福してください♪私、触手のお嫁さんになりました♪」
PRINTFORMW 咲夜は異形に孕まされたことに大してショックを受けた様子もない。	PRINTFORMW 咲夜は異形に孕まされたことに大してショックを受けた様子もない。
PRINTFORMW 咲夜はこちらの手や体をいやらしく撫で回してくる。注意が必要だ。	PRINTFORMW 咲夜はこちらの手や体をいやらしく撫で回してくる。注意が必要だ。
PRINTFORMW （ここの魔物は人に寄生することがある……もう遅いけど、用心ね）	PRINTFORMW （ここの魔物は人に寄生することがある……もう遅いけど、用心ね）
PRINTFORMW （うん……今動いた。絶望しては駄目、私はまだ生きてる。生きる）	PRINTFORMW （うん……今動いた。絶望しては駄目、私はまだ生きてる。生きる）
PRINTFORMW 咲夜の体は魔物の子供を孕んだことで母乳が滴るようになっていた。	PRINTFORMW 咲夜の体は魔物の子供を孕んだことで母乳が滴るようになっていた。
PRINTFORMW 「ふう、生まれてくる仔の為にもしっかり休まないといけませんね」	PRINTFORMW 「ふう、生まれてくる仔の為にもしっかり休まないといけませんね」
PRINTFORMW があったりなかったりするのは特に意味があるわけではありません。	PRINTFORMW があったりなかったりするのは特に意味があるわけではありません。
PRINTFORMW 「この程度の誘惑に負けるほど、紅魔館のメイドは弱くないのよ！」	PRINTFORMW 「この程度の誘惑に負けるほど、紅魔館のメイドは弱くないのよ！」
PRINTFORMW 寝込みを襲われたことにようやく気付き、慌ててナイフを手に取った	PRINTFORMW 寝込みを襲われたことにようやく気付き、慌ててナイフを手に取った
PRINTFORMW 「いや…今そこ刺激するのは…そ、そんな！　吸われて…イくっ！」	PRINTFORMW 「いや…今そこ刺激するのは…そ、そんな！　吸われて…イくっ！」
PRINTFORMW 「…紅魔館に帰ったらうんと美味しいクッキーを焼いておきますね」	PRINTFORMW 「…紅魔館に帰ったらうんと美味しいクッキーを焼いておきますね」
PRINTFORMW 「…紅魔館に帰ったらうんと美味しいマカロンを作っておきますね」	PRINTFORMW 「…紅魔館に帰ったらうんと美味しいマカロンを作っておきますね」
PRINTFORMW 思わぬ形で処女を散らした咲夜だが動じる様子は全く見られない。	PRINTFORMW 思わぬ形で処女を散らした咲夜だが動じる様子は全く見られない。
PRINTFORMW 「こんなはずじゃ…こんなはずじゃなかったの…返して…私の…」	PRINTFORMW 「こんなはずじゃ…こんなはずじゃなかったの…返して…私の…」
PRINTFORMW 「あ…ぁ…ぁ…♪私の膣内…どろどろ♪やっ！こぼれてきちゃう」	PRINTFORMW 「あ…ぁ…ぁ…♪私の膣内…どろどろ♪やっ！こぼれてきちゃう」
PRINTFORMW （とれてよかったのに、ちょっと寂しい。やだ私、何言ってるの）	PRINTFORMW （とれてよかったのに、ちょっと寂しい。やだ私、何言ってるの）
PRINTFORMW 「気持ちよくして差し上げますから、気持ちよくしてください♪」	PRINTFORMW 「気持ちよくして差し上げますから、気持ちよくしてください♪」
PRINTFORMW 「私がこのおちんちんであなたのお尻を開発して差し上げます♪」	PRINTFORMW 「私がこのおちんちんであなたのお尻を開発して差し上げます♪」
PRINTFORMW 「ああ♪だめって言ったのに♪ナカだけはダメって言ったのに♪」	PRINTFORMW 「ああ♪だめって言ったのに♪ナカだけはダメって言ったのに♪」
PRINTFORMW 「…………こののど越し、熱さ、鼻腔に抜ける香り……合格ね♪」	PRINTFORMW 「…………こののど越し、熱さ、鼻腔に抜ける香り……合格ね♪」
PRINTFORMW 「こうして先端の部分だけすっぽり咥えて……舌でごしごし～♪」	PRINTFORMW 「こうして先端の部分だけすっぽり咥えて……舌でごしごし～♪」
PRINTFORMW 「ぁあ♪捕まってしまいました♪これからどうするんですかァ？」	PRINTFORMW 「ぁあ♪捕まってしまいました♪これからどうするんですかァ？」
PRINTFORMW 「あら、あなたがいるってことはパチュリー様もいるのかしら？」	PRINTFORMW 「あら、あなたがいるってことはパチュリー様もいるのかしら？」
PRINTFORMW 「ああ！妹様！こんなところを出て、すぐお茶にいたしましょう」	PRINTFORMW 「ああ！妹様！こんなところを出て、すぐお茶にいたしましょう」
PRINTFORMW 「きっと素敵な触手が気持ちよくしてくれるわ♪うらやましいわ」	PRINTFORMW 「きっと素敵な触手が気持ちよくしてくれるわ♪うらやましいわ」
PRINTFORML 「ああ、ここにいたのね♪ねえ、ちょっとあっちに来てくれる？」	PRINTFORML 「ああ、ここにいたのね♪ねえ、ちょっとあっちに来てくれる？」
PRINTFORMW 「お嬢様、私は平気です。私は誇り高いお嬢様のメイドですから」	PRINTFORMW 「お嬢様、私は平気です。私は誇り高いお嬢様のメイドですから」
PRINTFORMW 咲夜は徐々に自己主張する腹部に宿る存在に愛着を覚えつつある。	PRINTFORMW 咲夜は徐々に自己主張する腹部に宿る存在に愛着を覚えつつある。
PRINTFORMW 「何？私、まさかまさか！いえ、そんなこと、きっとないはず！」	PRINTFORMW 「何？私、まさかまさか！いえ、そんなこと、きっとないはず！」
PRINTFORMW (お腹の中で何かが動いてる……せめて人の子で感じたかったわ)	PRINTFORMW (お腹の中で何かが動いてる……せめて人の子で感じたかったわ)
PRINTFORMW 「責められっぱなしじゃ体も疲れちゃいます♪メリハリですよ♪」	PRINTFORMW 「責められっぱなしじゃ体も疲れちゃいます♪メリハリですよ♪」
PRINTFORMW 肉色の壁で見えなくなるまで咲夜の双眸からは涙がこぼれていた。	PRINTFORMW 肉色の壁で見えなくなるまで咲夜の双眸からは涙がこぼれていた。
PRINTFORML その扉は表面が妙な艶で覆われており、不気味な色彩を放っていた	PRINTFORML その扉は表面が妙な艶で覆われており、不気味な色彩を放っていた
PRINTFORMW 「…偽者かどうか疑っただけです。争うつもりはありませんので」	PRINTFORMW 「…偽者かどうか疑っただけです。争うつもりはありませんので」
PRINTFORMW 男性器で得られる快楽によって咲夜の腰がガクガクと震えている！	PRINTFORMW 男性器で得られる快楽によって咲夜の腰がガクガクと震えている！
PRINTFORMW 「でも私が辛いときは…ええ、いつも通り頼りにさせてもらうわ」	PRINTFORMW 「でも私が辛いときは…ええ、いつも通り頼りにさせてもらうわ」
PRINTFORMW 「お嬢様…咲夜が傍に居ます。怖いときは手を握ってください…」	PRINTFORMW 「お嬢様…咲夜が傍に居ます。怖いときは手を握ってください…」
PRINTFORMW 「ここの魔物に可愛がられて、たくさんザーメンで汚されて…」	PRINTFORMW 「ここの魔物に可愛がられて、たくさんザーメンで汚されて…」
PRINTFORMW 「ああ、私、お尻に挿入れるの癖になったかもしれないわ…。」	PRINTFORMW 「ああ、私、お尻に挿入れるの癖になったかもしれないわ…。」
PRINTFORMW 「ああ♪お嬢様のアナルがピストンするたびにひくひくって♪」	PRINTFORMW 「ああ♪お嬢様のアナルがピストンするたびにひくひくって♪」
PRINTFORMW 「ああ♪やっぱりいい♪アナルに生ハメ！このまま出すわよ♪」	PRINTFORMW 「ああ♪やっぱりいい♪アナルに生ハメ！このまま出すわよ♪」
PRINTFORMW 「お嬢様のザーメンでカピカピに乾いたらと考えると♪ふふ♪」	PRINTFORMW 「お嬢様のザーメンでカピカピに乾いたらと考えると♪ふふ♪」
PRINTFORMW 「今ここであなたに生ハメ生ナカダシさせてくれれば許すわ♪」	PRINTFORMW 「今ここであなたに生ハメ生ナカダシさせてくれれば許すわ♪」
PRINTFORMW 「これまでにもこうして使われちゃったことはあるのかしら？」	PRINTFORMW 「これまでにもこうして使われちゃったことはあるのかしら？」
PRINTFORMW 「なんだか……とっても親密な関係になれそうな気がするわ♪」	PRINTFORMW 「なんだか……とっても親密な関係になれそうな気がするわ♪」
PRINTFORMW 「あっ、後で……助けに来ていただけると……信じてますから」	PRINTFORMW 「あっ、後で……助けに来ていただけると……信じてますから」
PRINTFORMW 「ちょっと、ブンヤなら出口情報の一つや二つ知ってるでしょ」	PRINTFORMW 「ちょっと、ブンヤなら出口情報の一つや二つ知ってるでしょ」
PRINTFORMW （そうすれば一緒に居る時間も増えて……えっ、私は何を……）	PRINTFORMW （そうすれば一緒に居る時間も増えて……えっ、私は何を……）
PRINTFORMW （嫌よ……孕まされた上、体を言いように弄ばれるなんて……）	PRINTFORMW （嫌よ……孕まされた上、体を言いように弄ばれるなんて……）
PRINTFORMW （まさか私が……変な虫につかれるなんてね…笑えないわ……）	PRINTFORMW （まさか私が……変な虫につかれるなんてね…笑えないわ……）
PRINTFORMW 「何の洒落にもならないわ、化け物を妊娠するなんて……ねえ」	PRINTFORMW 「何の洒落にもならないわ、化け物を妊娠するなんて……ねえ」
PRINTFORMW （お腹……大きくなってきた。本当に妊娠しちゃったのね……）	PRINTFORMW （お腹……大きくなってきた。本当に妊娠しちゃったのね……）
PRINTFORML その部屋の奥からはおぞましい気配と淫靡な匂いが漂ってきた…	PRINTFORML その部屋の奥からはおぞましい気配と淫靡な匂いが漂ってきた…
PRINTFORMW 咲夜は震える体でなんとか敵の弱点と思わしき部位を攻撃した！	PRINTFORMW 咲夜は震える体でなんとか敵の弱点と思わしき部位を攻撃した！
PRINTFORMW 「こんな化け物相手にっ…あぁぁんっ！　あっ！　あうぅ…！」	PRINTFORMW 「こんな化け物相手にっ…あぁぁんっ！　あっ！　あうぅ…！」
PRINTFORMW 「…幻想郷では私達は行方不明扱いになっているのでしょうか」	PRINTFORMW 「…幻想郷では私達は行方不明扱いになっているのでしょうか」
PRINTFORMW 「こ、これっ…どうやって我慢すれば良いのよっ！　あうっ！」	PRINTFORMW 「こ、これっ…どうやって我慢すれば良いのよっ！　あうっ！」
PRINTFORMW 痛みに堪える咲夜だが、同時に未知なる快楽にも襲われている！	PRINTFORMW 痛みに堪える咲夜だが、同時に未知なる快楽にも襲われている！
PRINTFORMW 「…紅魔館に帰ったらうんと美味しいケーキを焼いておくわね」	PRINTFORMW 「…紅魔館に帰ったらうんと美味しいケーキを焼いておくわね」
PRINTFORMW 「ななななななな何よ！　一回やってみたかっただけなのよ！」	PRINTFORMW 「ななななななな何よ！　一回やってみたかっただけなのよ！」
PRINTFORMW 「かなりの知識をお持ちの魔女であるパチュリー様がそんな…」	PRINTFORMW 「かなりの知識をお持ちの魔女であるパチュリー様がそんな…」
PRINTFORMW 「ええ、私がシテあげますからいつでも出していいんですよ」	PRINTFORMW 「ええ、私がシテあげますからいつでも出していいんですよ」
PRINTFORMW 「ああぁ！服がぐちょぐちょって♪この子を刺激しないで♪」	PRINTFORMW 「ああぁ！服がぐちょぐちょって♪この子を刺激しないで♪」
PRINTFORMW 「お嬢様のおっぱいこんなにも膨らんで風船みたいです……」	PRINTFORMW 「お嬢様のおっぱいこんなにも膨らんで風船みたいです……」
PRINTFORMW 「その、使わせてもらうわよ。こんな名器な口が悪いのよ…」	PRINTFORMW 「その、使わせてもらうわよ。こんな名器な口が悪いのよ…」
PRINTFORMW 「こんなものを見せられて私だけ蚊帳の外はないですよね♪」	PRINTFORMW 「こんなものを見せられて私だけ蚊帳の外はないですよね♪」
PRINTFORMW 「どれだけザーメンで汚してもまだ汚したりない気がします」	PRINTFORMW 「どれだけザーメンで汚してもまだ汚したりない気がします」
PRINTFORMW 「そそり立つおちんちん♪これは食べ甲斐がありそうです♪」	PRINTFORMW 「そそり立つおちんちん♪これは食べ甲斐がありそうです♪」
PRINTFORMW 「あら…あなたがこの素敵な空間を作ってくれたのかしら？」	PRINTFORMW 「あら…あなたがこの素敵な空間を作ってくれたのかしら？」
PRINTFORMW 「あなたがこのおふざけの犯人かしら？ちょっと用があるの」	PRINTFORMW 「あなたがこのおふざけの犯人かしら？ちょっと用があるの」
PRINTFORMW 「ふう、返り討ちね…じゃあ、勝者の時間といこうかしら♪」	PRINTFORMW 「ふう、返り討ちね…じゃあ、勝者の時間といこうかしら♪」
PRINTFORMW 咲夜は肉欲に濁った眼でかすかなふくらみの腹部を見つめた。	PRINTFORMW 咲夜は肉欲に濁った眼でかすかなふくらみの腹部を見つめた。
PRINTFORML 咲夜ははっきりわかるほど大きくなった腹部を優しくなでた。	PRINTFORML 咲夜ははっきりわかるほど大きくなった腹部を優しくなでた。
PRINTFORMW （このカラダは……私だけのもの、そのはずだったのに……）	PRINTFORMW （このカラダは……私だけのもの、そのはずだったのに……）
PRINTFORMW 母乳をまき散らす乳房を吸われながら咲夜は喜色を浮かべた。	PRINTFORMW 母乳をまき散らす乳房を吸われながら咲夜は喜色を浮かべた。
PRINTFORMW 「一旦きれいにしますね、またすぐ汚してもらいますけど♪」	PRINTFORMW 「一旦きれいにしますね、またすぐ汚してもらいますけど♪」
PRINTFORMW 「まさか！これは！……これでこんなところとはおさらばよ」	PRINTFORMW 「まさか！これは！……これでこんなところとはおさらばよ」
PRINTFORML 咲夜は魔女の知識を借りようとし、その場から離れようとした	PRINTFORML 咲夜は魔女の知識を借りようとし、その場から離れようとした
PRINTFORMW ナイフを投げつけ、さらにナイフを構えた咲夜が切りかかる！	PRINTFORMW ナイフを投げつけ、さらにナイフを構えた咲夜が切りかかる！
PRINTFORML 「あんんっ！？　あっ、んああぁぁぁぁっ！　あ…あぁ……」	PRINTFORML 「あんんっ！？　あっ、んああぁぁぁぁっ！　あ…あぁ……」
PRINTFORMW 「体制を整えたら戻ってくるから！　だから心配しないで！」	PRINTFORMW 「体制を整えたら戻ってくるから！　だから心配しないで！」
PRINTFORMW 「今は弾幕ごっこしたい気分じゃないので、何もしませんよ」	PRINTFORMW 「今は弾幕ごっこしたい気分じゃないので、何もしませんよ」
PRINTFORML 「ありがとうございます、お嬢様！　お手数おかけします…」	PRINTFORML 「ありがとうございます、お嬢様！　お手数おかけします…」
PRINTFORMW 「いたたた…岩が落ちてくるなんて想像もしてなかったわ…」	PRINTFORMW 「いたたた…岩が落ちてくるなんて想像もしてなかったわ…」
PRINTFORML 「霊夢程とまではいかなくても、けっこう腕前はあるのに…」	PRINTFORML 「霊夢程とまではいかなくても、けっこう腕前はあるのに…」
PRINTFORMW 「申し訳ありません……もうガマンできそうにないんです」	PRINTFORMW 「申し訳ありません……もうガマンできそうにないんです」
PRINTFORMW 「ああ、そんな…びくんびくんって、すごく元気がいい♪」	PRINTFORMW 「ああ、そんな…びくんびくんって、すごく元気がいい♪」
PRINTFORMW 「びくんびくんって♪…気持ちよくなってくれたんですね」	PRINTFORMW 「びくんびくんって♪…気持ちよくなってくれたんですね」
PRINTFORMW 「たぷたぷのおっぱい、前から使ってみたかったんです♪」	PRINTFORMW 「たぷたぷのおっぱい、前から使ってみたかったんです♪」
PRINTFORMW （今ならお嬢様食べ放題……どんな変態的なプレイでも…）	PRINTFORMW （今ならお嬢様食べ放題……どんな変態的なプレイでも…）
PRINTFORMW 「おっぱいでごしごし使われても私が見えていますか～？」	PRINTFORMW 「おっぱいでごしごし使われても私が見えていますか～？」
PRINTFORMW 「もう！出る、出る！アナルにナカダシ～～！！んんぁ！」	PRINTFORMW 「もう！出る、出る！アナルにナカダシ～～！！んんぁ！」
PRINTFORMW 「こんなシャワーもないところなのになんてことするのよ」	PRINTFORMW 「こんなシャワーもないところなのになんてことするのよ」
PRINTFORMW 「お嬢様♪気持ちいいですか♪私も突き上げましょうか♪」	PRINTFORMW 「お嬢様♪気持ちいいですか♪私も突き上げましょうか♪」
PRINTFORMW 「ナニじろじろしてるんですか？見世物じゃありませんよ」	PRINTFORMW 「ナニじろじろしてるんですか？見世物じゃありませんよ」
PRINTFORMW 「私の娘……母娘で禁断の関係…そそるものがあります♪」	PRINTFORMW 「私の娘……母娘で禁断の関係…そそるものがあります♪」
PRINTFORMW 「ふう、何とか逃げられたけど…体が、なにかされたわね」	PRINTFORMW 「ふう、何とか逃げられたけど…体が、なにかされたわね」
PRINTFORMW 「出口を見つけたら気合で時止めして迎えに上がりますわ」	PRINTFORMW 「出口を見つけたら気合で時止めして迎えに上がりますわ」
PRINTFORML 「パチュリー様、お腹の子は男の子かしら、女の子かしら」	PRINTFORML 「パチュリー様、お腹の子は男の子かしら、女の子かしら」
PRINTFORMW （体が寄生されたりするのに慣れちゃうなんて……酷い話）	PRINTFORMW （体が寄生されたりするのに慣れちゃうなんて……酷い話）
PRINTFORMW （うそ……ここの魔物は…まさか孕ませるだけじゃなく…）	PRINTFORMW （うそ……ここの魔物は…まさか孕ませるだけじゃなく…）
PRINTFORMW 咲夜は大きくなった腹部を見つめてうっとりと目を細めた。	PRINTFORMW 咲夜は大きくなった腹部を見つめてうっとりと目を細めた。
PRINTFORMW (もうすぐなのね……、もう少しでまた化け物のママ……)	PRINTFORMW (もうすぐなのね……、もう少しでまた化け物のママ……)
PRINTFORMW 咲夜はごまかしの言葉を並べながら腹部を不安げにさする。	PRINTFORMW 咲夜はごまかしの言葉を並べながら腹部を不安げにさする。
PRINTFORMW （こんなに…私の体、おかしくされるなんて……許さない）	PRINTFORMW （こんなに…私の体、おかしくされるなんて……許さない）
PRINTFORML 「お願いよ……こんなところで一人にしないで……お願い」	PRINTFORML 「お願いよ……こんなところで一人にしないで……お願い」
PRINTFORMW 「ご無事ですか？　ここにいる奴らは一体何なんですか？」	PRINTFORMW 「ご無事ですか？　ここにいる奴らは一体何なんですか？」
PRINTFORMW 「ご無事ですか？　あいつらに何もされていませんよね？」	PRINTFORMW 「ご無事ですか？　あいつらに何もされていませんよね？」
PRINTFORMW 「大丈夫だった？　あいつらに変なことされていない！？」	PRINTFORMW 「大丈夫だった？　あいつらに変なことされていない！？」
PRINTFORMW 「む、難しいのね…別に上手くなりたいとは思わないけど」	PRINTFORMW 「む、難しいのね…別に上手くなりたいとは思わないけど」
PRINTFORML 「ううっ…何か出て…早く終わってよ…ふあっ、んんっ！」	PRINTFORML 「ううっ…何か出て…早く終わってよ…ふあっ、んんっ！」
PRINTFORML 「パチュリー様、もうすぐ出口が見えてくると思います！」	PRINTFORML 「パチュリー様、もうすぐ出口が見えてくると思います！」
PRINTFORML 「フランお嬢様、もうすぐ出口が見えてくると思います！」	PRINTFORML 「フランお嬢様、もうすぐ出口が見えてくると思います！」
PRINTFORML 「幻想郷に着けば医者が居るから、助かると思いますよ…」	PRINTFORML 「幻想郷に着けば医者が居るから、助かると思いますよ…」
PRINTFORML 「あら、これ私のじゃないの！　こんな所にあったのね！」	PRINTFORML 「あら、これ私のじゃないの！　こんな所にあったのね！」
PRINTFORMW 「私はここから出られるのかしら…流石に不安になるわね」	PRINTFORMW 「私はここから出られるのかしら…流石に不安になるわね」
PRINTFORMW 「一気に片付けますよ、汚れ物がたくさんありますから」	PRINTFORMW 「一気に片付けますよ、汚れ物がたくさんありますから」
PRINTFORMW 「ごめんなさい…今は気分じゃなくって。今度誘ってね」	PRINTFORMW 「ごめんなさい…今は気分じゃなくって。今度誘ってね」
PRINTFORMW 「そ、そうよね…当たり前よね…なにしてるのよ…私…」	PRINTFORMW 「そ、そうよね…当たり前よね…なにしてるのよ…私…」
PRINTFORMW 「こんなの………冗談じゃないわよ…こんな、こんな…」	PRINTFORMW 「こんなの………冗談じゃないわよ…こんな、こんな…」
PRINTFORMW 「お嬢様…、今度はお尻の穴を使わせてくださいませ！」	PRINTFORMW 「お嬢様…、今度はお尻の穴を使わせてくださいませ！」
PRINTFORMW 「亀頭のエラは精液を掻きだすためにあるそうなんです」	PRINTFORMW 「亀頭のエラは精液を掻きだすためにあるそうなんです」
PRINTFORMW 「ふふ…♪こんな環境で無防備を晒す方がいけないのよ」	PRINTFORMW 「ふふ…♪こんな環境で無防備を晒す方がいけないのよ」
PRINTFORMW 「あは♪顔にまで飛んで髪にかかってしまいまいたわ♪」	PRINTFORMW 「あは♪顔にまで飛んで髪にかかってしまいまいたわ♪」
PRINTFORMW 「お嬢様のお胸で扱いていただけるなんて夢のようです」	PRINTFORMW 「お嬢様のお胸で扱いていただけるなんて夢のようです」
PRINTFORMW 「ああ…こんな時に敵ですか♪今割とピンチなんです！」	PRINTFORMW 「ああ…こんな時に敵ですか♪今割とピンチなんです！」
PRINTFORMW 「ナニをされていたんですか？私、大変興味あります♪」	PRINTFORMW 「ナニをされていたんですか？私、大変興味あります♪」
PRINTFORML 「あら、そんなに汚されて……イイことあったのかしら」	PRINTFORML 「あら、そんなに汚されて……イイことあったのかしら」
PRINTFORMW 「ふう、動きづらいですがこれも生みの苦しみですわ♪」	PRINTFORMW 「ふう、動きづらいですがこれも生みの苦しみですわ♪」
PRINTFORMW (嘘よね……私……化け物を……。明日になったら……)	PRINTFORMW (嘘よね……私……化け物を……。明日になったら……)
PRINTFORML 「よく見ていてくださいね♪私がまたママになる瞬間を」	PRINTFORML 「よく見ていてくださいね♪私がまたママになる瞬間を」
PRINTFORMW （お腹がもう大きくなってる……ここの生物は異常だわ）	PRINTFORMW （お腹がもう大きくなってる……ここの生物は異常だわ）
PRINTFORMW 咲夜は自分の想像したことを否定できずに助けを求める。	PRINTFORMW 咲夜は自分の想像したことを否定できずに助けを求める。
PRINTFORMW 孕まされた、それも化け物に。そんな妄想が咲夜を襲う。	PRINTFORMW 孕まされた、それも化け物に。そんな妄想が咲夜を襲う。
PRINTFORMW 「ぃぃぃ…！っ…想像してはいたけど…でも、これは！」	PRINTFORMW 「ぃぃぃ…！っ…想像してはいたけど…でも、これは！」
PRINTFORML 触手の力は凄まじく、到底引き剥がせるものではなかった	PRINTFORML 触手の力は凄まじく、到底引き剥がせるものではなかった
PRINTFORMW 「この手の化け物相手に弾幕が役に立ってくれるとはね」	PRINTFORMW 「この手の化け物相手に弾幕が役に立ってくれるとはね」
PRINTFORMW 「…今は時を止められないので回収するのが面倒だけど」	PRINTFORMW 「…今は時を止められないので回収するのが面倒だけど」
PRINTFORMW 「きゃあっ！？　じ、時間さえ止められたらこんな奴…」	PRINTFORMW 「きゃあっ！？　じ、時間さえ止められたらこんな奴…」
PRINTFORMW 「いえ、もちろん戻って来てくださると信じていますよ」	PRINTFORMW 「いえ、もちろん戻って来てくださると信じていますよ」
PRINTFORMW 周りに喘ぎを漏らすまいと、自分の指を口に入れている…	PRINTFORMW 周りに喘ぎを漏らすまいと、自分の指を口に入れている…
PRINTFORML 「自分の腹をかっさばいてやれば子供を殺せるかしら…」	PRINTFORML 「自分の腹をかっさばいてやれば子供を殺せるかしら…」
PRINTFORMW 「申し訳ありませんが、連れていくことは出来ません…」	PRINTFORMW 「申し訳ありませんが、連れていくことは出来ません…」
PRINTFORMW （あのとき私が守っていたらこうはならなかったのに…）	PRINTFORMW （あのとき私が守っていたらこうはならなかったのに…）
PRINTFORMW 「もう勝手にしてください！　私は自力で脱出します！」	PRINTFORMW 「もう勝手にしてください！　私は自力で脱出します！」
PRINTFORML 「信じられない。もう妖夢とは口も聞かないんだから！」	PRINTFORML 「信じられない。もう妖夢とは口も聞かないんだから！」
PRINTFORMW 「お嬢様のおっぱいは流石吸血鬼のおっぱいですわ♪」	PRINTFORMW 「お嬢様のおっぱいは流石吸血鬼のおっぱいですわ♪」
PRINTFORMW 「お嬢様…ああ、もう我慢できません！挿入れますよ」	PRINTFORMW 「お嬢様…ああ、もう我慢できません！挿入れますよ」
PRINTFORMW 「ああ…♪お嬢様のザーメンがこんなにたっぷり…♪」	PRINTFORMW 「ああ…♪お嬢様のザーメンがこんなにたっぷり…♪」
PRINTFORMW 「どうですか？ちゃんと気持ちよくできていますか？」	PRINTFORMW 「どうですか？ちゃんと気持ちよくできていますか？」
PRINTFORMW 「アナルで搾られたいの？好きね♪私も好きだけど♪」	PRINTFORMW 「アナルで搾られたいの？好きね♪私も好きだけど♪」
PRINTFORMW は「;」を左につけるか消すかしたほうがよいでしょう	PRINTFORMW は「;」を左につけるか消すかしたほうがよいでしょう
PRINTFORMW 「や、やりますね♪でもそんなものではないでしょう」	PRINTFORMW 「や、やりますね♪でもそんなものではないでしょう」
PRINTFORMW 「ああ♪捕まっちゃいました♪ナニする気ですかァ？」	PRINTFORMW 「ああ♪捕まっちゃいました♪ナニする気ですかァ？」
PRINTFORMW 「いけない！敵がいるのに！でも、やめられません♪」	PRINTFORMW 「いけない！敵がいるのに！でも、やめられません♪」
PRINTFORMW 「あら、あなたもいたの。お屋敷の守りが薄くなるわ」	PRINTFORMW 「あら、あなたもいたの。お屋敷の守りが薄くなるわ」
PRINTFORMW 「必ず戻ります。それまで少しだけ辛抱してください」	PRINTFORMW 「必ず戻ります。それまで少しだけ辛抱してください」
PRINTFORML 「妹様も早く触手のお母さんになれるといいですね♪」	PRINTFORML 「妹様も早く触手のお母さんになれるといいですね♪」
PRINTFORML 「ええ、ちょっと重いですけど、生みの苦しみです♪」	PRINTFORML 「ええ、ちょっと重いですけど、生みの苦しみです♪」
PRINTFORMW （お嬢様……こんなに汚されて……ドキドキする……）	PRINTFORMW （お嬢様……こんなに汚されて……ドキドキする……）
PRINTFORMW 「ここにキャンプをひろげるわ。手伝ってちょうだい」	PRINTFORMW 「ここにキャンプをひろげるわ。手伝ってちょうだい」
PRINTFORML 「時を止められないからナイフを回収しにくいわねぇ」	PRINTFORML 「時を止められないからナイフを回収しにくいわねぇ」
PRINTFORMW 強度が高く、鋭いナイフの投擲が複数の敵を巻き込む！	PRINTFORMW 強度が高く、鋭いナイフの投擲が複数の敵を巻き込む！
PRINTFORMW 咲夜は嫌がるそぶりを見せることすら出来ないでいる…	PRINTFORMW 咲夜は嫌がるそぶりを見せることすら出来ないでいる…
PRINTFORML 咲夜は攻撃された部位を摩っているが、目は半開きだ…	PRINTFORML 咲夜は攻撃された部位を摩っているが、目は半開きだ…
PRINTFORMW 「一刻も早くこんなところから抜け出したいですわね」	PRINTFORMW 「一刻も早くこんなところから抜け出したいですわね」
PRINTFORMW 咲夜は小さな触手に愛撫されながらも、すぐに眠った…	PRINTFORMW 咲夜は小さな触手に愛撫されながらも、すぐに眠った…
PRINTFORML 「だって、子供がなんてそんな早く出来るわけが…！」	PRINTFORML 「だって、子供がなんてそんな早く出来るわけが…！」
PRINTFORMW 「うっ…あああああぁぁぁぁぁ！　イ、イかされて！」	PRINTFORMW 「うっ…あああああぁぁぁぁぁ！　イ、イかされて！」
PRINTFORMW 「でも私が辛いときは…いえ、なんでもありません…」	PRINTFORMW 「でも私が辛いときは…いえ、なんでもありません…」
PRINTFORMW 「外に出たら医者を呼んであげる。きっと助かるわ！」	PRINTFORMW 「外に出たら医者を呼んであげる。きっと助かるわ！」
PRINTFORML 「あいつらを皆殺しにしてやる！　全滅させてやる！」	PRINTFORML 「あいつらを皆殺しにしてやる！　全滅させてやる！」
PRINTFORMW 「ああ、こんなにも服がきれいになっちゃって……」	PRINTFORMW 「ああ、こんなにも服がきれいになっちゃって……」
PRINTFORMW 「ちょっと、やめてくださいよ、いま体中敏感で…」	PRINTFORMW 「ちょっと、やめてくださいよ、いま体中敏感で…」
PRINTFORMW 「まだまだしてくださるんですよね♪期待してます」	PRINTFORMW 「まだまだしてくださるんですよね♪期待してます」
PRINTFORMW 「そのザーメンしっぽ、もっと太くして上げます♪」	PRINTFORMW 「そのザーメンしっぽ、もっと太くして上げます♪」
PRINTFORMW 「亀頭を喉で磨かれて♪もう、長く…持ちません♪」	PRINTFORMW 「亀頭を喉で磨かれて♪もう、長く…持ちません♪」
PRINTFORMW 「そうね、あなたのお腹がぷっくり膨らむまではね」	PRINTFORMW 「そうね、あなたのお腹がぷっくり膨らむまではね」
PRINTFORMW 「今のあなたの価値はこのお口マンコ位なんだから」	PRINTFORMW 「今のあなたの価値はこのお口マンコ位なんだから」
PRINTFORMW 「ふふ、熱くて太いのがヌリュッ、ヌリュッッて♪」	PRINTFORMW 「ふふ、熱くて太いのがヌリュッ、ヌリュッッて♪」
PRINTFORMW 「ぁアぁ……♪なにか……されて……私のカラダに」	PRINTFORMW 「ぁアぁ……♪なにか……されて……私のカラダに」
PRINTFORMW 「必ず戻るわ。それまでの間、少しだけ待っていて」	PRINTFORMW 「必ず戻るわ。それまでの間、少しだけ待っていて」
PRINTFORMW 咲夜は異形を宿して膨らんだ腹を憂鬱気に見ていた。	PRINTFORMW 咲夜は異形を宿して膨らんだ腹を憂鬱気に見ていた。
PRINTFORMW （なに？私のカラダのなかになにかが……いる!?）	PRINTFORMW （なに？私のカラダのなかになにかが……いる!?）
PRINTFORMW （認めるしかないのね……私、どうなってしまうの）	PRINTFORMW （認めるしかないのね……私、どうなってしまうの）
PRINTFORMW 咲夜は経験上覚えた最も出産しやすい体勢になった。	PRINTFORMW 咲夜は経験上覚えた最も出産しやすい体勢になった。
PRINTFORMW 「すごい！この魔窟中のすべての時間が視えるわ！」	PRINTFORMW 「すごい！この魔窟中のすべての時間が視えるわ！」
PRINTFORMW 「エリクサーって結局使うタイミングがないのよね」	PRINTFORMW 「エリクサーって結局使うタイミングがないのよね」
PRINTFORMW は「;」を左につけるか消すかしたほうがいいです。	PRINTFORMW は「;」を左につけるか消すかしたほうがいいです。
PRINTFORML いつものように館内の家事に従事している十六夜咲夜	PRINTFORML いつものように館内の家事に従事している十六夜咲夜
PRINTFORMW そのときである、館内に見覚えの無い扉があったのだ	PRINTFORMW そのときである、館内に見覚えの無い扉があったのだ
PRINTFORMW 「いや、頭の中浮いて…んんんんんんんんんっ！？」	PRINTFORMW 「いや、頭の中浮いて…んんんんんんんんんっ！？」
PRINTFORMW （こんなのが、気持ち良いはずない…ふああぁっ！）	PRINTFORMW （こんなのが、気持ち良いはずない…ふああぁっ！）
PRINTFORMW 「もっと捕まっていたらどうなっていたのかしら…」	PRINTFORMW 「もっと捕まっていたらどうなっていたのかしら…」
PRINTFORMW 「…戻ってきますから、心配しないでくださいませ」	PRINTFORMW 「…戻ってきますから、心配しないでくださいませ」
PRINTFORMW 「…最初からあなたなんて当てにはしてなかったわ」	PRINTFORMW 「…最初からあなたなんて当てにはしてなかったわ」
PRINTFORML 「こんなのっ…痛すぎて死にそう…はぁ、はぁ……」	PRINTFORML 「こんなのっ…痛すぎて死にそう…はぁ、はぁ……」
PRINTFORMW 「…あぁ、良かった。立てる？　私の肩に掴まって」	PRINTFORMW 「…あぁ、良かった。立てる？　私の肩に掴まって」
PRINTFORML 「お嬢様、もうすぐ出口が見えてくると思います！」	PRINTFORML 「お嬢様、もうすぐ出口が見えてくると思います！」
PRINTFORMW 「勝手にしてなさいよ！　私は自力で脱出するわ！」	PRINTFORMW 「勝手にしてなさいよ！　私は自力で脱出するわ！」
PRINTFORMW 「そんなはずないわ。だって妖夢は剣術が得意で…」	PRINTFORMW 「そんなはずないわ。だって妖夢は剣術が得意で…」
PRINTFORMW 「とてつもなくここに居てはいけない気がする！」	PRINTFORMW 「とてつもなくここに居てはいけない気がする！」
PRINTFORMW 「ああ、こんなにぶっといのを頂けるんですねぇ」	PRINTFORMW 「ああ、こんなにぶっといのを頂けるんですねぇ」
PRINTFORMW 「ちょっと、こんな時にしっかりしてください！」	PRINTFORMW 「ちょっと、こんな時にしっかりしてください！」
PRINTFORMW 望まなぬ形での処女喪失に咲夜は呆然としている。	PRINTFORMW 望まなぬ形での処女喪失に咲夜は呆然としている。
PRINTFORMW 「お嬢様のこのスベスベ肌、本当にきれいですわ」	PRINTFORMW 「お嬢様のこのスベスベ肌、本当にきれいですわ」
PRINTFORMW 「ぷはぁ、お嬢様、満足いただけたでしょうか？」	PRINTFORMW 「ぷはぁ、お嬢様、満足いただけたでしょうか？」
PRINTFORMW 「お嬢様！どこでこんなことを覚えてっ…んっ！」	PRINTFORMW 「お嬢様！どこでこんなことを覚えてっ…んっ！」
PRINTFORMW 「お嬢様を気持ちよくできたのなら文句なしです」	PRINTFORMW 「お嬢様を気持ちよくできたのなら文句なしです」
PRINTFORMW 「ぁぁ、私嬲られてるのね♪なのに……あはっ♪」	PRINTFORMW 「ぁぁ、私嬲られてるのね♪なのに……あはっ♪」
PRINTFORMW 「妹様、妹様は何も心配しなくていいですからね」	PRINTFORMW 「妹様、妹様は何も心配しなくていいですからね」
PRINTFORMW 「他の皆さんにもこの喜びを教えてあげなきゃ♪」	PRINTFORMW 「他の皆さんにもこの喜びを教えてあげなきゃ♪」
PRINTFORMW 魔物の出産を控えた咲夜の顔に悲壮感は全くない。	PRINTFORMW 魔物の出産を控えた咲夜の顔に悲壮感は全くない。
PRINTFORMW （私これまでどのくらい化け物を生んできたの？）	PRINTFORMW （私これまでどのくらい化け物を生んできたの？）
PRINTFORMW 咲夜はむしろ襲われることを期待しているようだ。	PRINTFORMW 咲夜はむしろ襲われることを期待しているようだ。
PRINTFORMW 「　　ザ・ワールド！！　　時よ止まれ！！　　」	PRINTFORMW 「　　ザ・ワールド！！　　時よ止まれ！！　　」
PRINTFORMW 「ふう……こうして落ち着けるのも今の内なのね」	PRINTFORMW 「ふう……こうして落ち着けるのも今の内なのね」
PRINTFORMW 「ちょっと待って！私の服！どうしてくれるのよ」	PRINTFORMW 「ちょっと待って！私の服！どうしてくれるのよ」
PRINTFORMW 「エリクサーって結局使うタイミングがないのよね	PRINTFORMW 「エリクサーって結局使うタイミングがないのよね
PRINTFORML かといって触手とのセックスが好きではありません	PRINTFORML かといって触手とのセックスが好きではありません
PRINTFORMW (頭がぼーっとしてる…このままでは不味いわ…）	PRINTFORMW (頭がぼーっとしてる…このままでは不味いわ…）
PRINTFORMW 咲夜は軽く数本のナイフを指に挟み、投げつけた！	PRINTFORMW 咲夜は軽く数本のナイフを指に挟み、投げつけた！
PRINTFORMW 「体が疼くっ！　でも今は戦いに専念しないと！」	PRINTFORMW 「体が疼くっ！　でも今は戦いに専念しないと！」
PRINTFORML 「大量にナイフを投げるのは得意中の得意ですわ」	PRINTFORML 「大量にナイフを投げるのは得意中の得意ですわ」
PRINTFORMW 「大丈夫だった！？　これって新手の異変なの？」	PRINTFORMW 「大丈夫だった！？　これって新手の異変なの？」
PRINTFORML 「主人に物を強請るなんてメイド失格ですよね…」	PRINTFORML 「主人に物を強請るなんてメイド失格ですよね…」
PRINTFORMW 「早くここを脱出しないとお嬢様に怒られそうね」	PRINTFORMW 「早くここを脱出しないとお嬢様に怒られそうね」
PRINTFORMW (嫌よ…化け物の子供なんて産みたくないのに…)	PRINTFORMW (嫌よ…化け物の子供なんて産みたくないのに…)
PRINTFORML 「いやあぁぁぁぁぁぁぁ！　痛い、痛い、痛い！」	PRINTFORML 「いやあぁぁぁぁぁぁぁ！　痛い、痛い、痛い！」
PRINTFORML 「こうなったら生まれてくる子供を殺してやる…」	PRINTFORML 「こうなったら生まれてくる子供を殺してやる…」
PRINTFORMW 「どうしても調べておきたいことがありまして…」	PRINTFORMW 「どうしても調べておきたいことがありまして…」
PRINTFORMW （私はこの馬鹿げた世界を作った奴を許せない！）	PRINTFORMW （私はこの馬鹿げた世界を作った奴を許せない！）
PRINTFORML 「お嬢様あああああぁぁぁぁぁぁぁぁぁぁぁ～…」	PRINTFORML 「お嬢様あああああぁぁぁぁぁぁぁぁぁぁぁ～…」
PRINTFORML 「だって魔理沙は異変解決もこなしているのに…」	PRINTFORML 「だって魔理沙は異変解決もこなしているのに…」
PRINTFORMW 「今はこの熱いのも私の♪私だけのものです♪」	PRINTFORMW 「今はこの熱いのも私の♪私だけのものです♪」
PRINTFORMW 「ふふふ…♪お嬢様のアナルはエッチですね♪」	PRINTFORMW 「ふふふ…♪お嬢様のアナルはエッチですね♪」
PRINTFORMW 「………いいんですね♪はい、では遠慮なく♪」	PRINTFORMW 「………いいんですね♪はい、では遠慮なく♪」
PRINTFORMW 「お嬢様！お嬢様！腰が、もう止まりません！」	PRINTFORMW 「お嬢様！お嬢様！腰が、もう止まりません！」
PRINTFORMW 「ほらもう！私も腰が！勝手に、止まらない！」	PRINTFORMW 「ほらもう！私も腰が！勝手に、止まらない！」
PRINTFORMW 「やっぱり一番温かくなりたい時はここよね♪」	PRINTFORMW 「やっぱり一番温かくなりたい時はここよね♪」
PRINTFORMW 「使いたくなったらいつでも言って下さいね♪」	PRINTFORMW 「使いたくなったらいつでも言って下さいね♪」
PRINTFORMW 「ふふ♪魔物なのにとってもいやらしいのね♪」	PRINTFORMW 「ふふ♪魔物なのにとってもいやらしいのね♪」
PRINTFORMW 「ほら見てて♪私の太いのが入っていくわよ♪」	PRINTFORMW 「ほら見てて♪私の太いのが入っていくわよ♪」
PRINTFORMW 「あ♪お嬢様のおちんちん、びくびくしてる♪」	PRINTFORMW 「あ♪お嬢様のおちんちん、びくびくしてる♪」
PRINTFORMW （こうして見ると……なかなかそそるわね……）	PRINTFORMW （こうして見ると……なかなかそそるわね……）
PRINTFORMW 「悪いわね……何とか助けを見つけてくるから」	PRINTFORMW 「悪いわね……何とか助けを見つけてくるから」
PRINTFORMW 咲夜は異形を宿した腹部を愛おしそうに撫でた。	PRINTFORMW 咲夜は異形を宿した腹部を愛おしそうに撫でた。
PRINTFORML 「いつぞやの異変の時の様に力をあわせない？」	PRINTFORML 「いつぞやの異変の時の様に力をあわせない？」
PRINTFORMW 「ああ！お嬢様、すぐにお召し物を用意します」	PRINTFORMW 「ああ！お嬢様、すぐにお召し物を用意します」
PRINTFORMW 「あなたの力でもどうにもかならなかったの？」	PRINTFORMW 「あなたの力でもどうにもかならなかったの？」
PRINTFORMW 咲夜の腹は大きく膨らみ歩くのも苦労しそうだ。	PRINTFORMW 咲夜の腹は大きく膨らみ歩くのも苦労しそうだ。
PRINTFORMW （他に紛れ込んだのは今頃どうしてるのかしら）	PRINTFORMW （他に紛れ込んだのは今頃どうしてるのかしら）
PRINTFORMW 咲夜は化け物の子種で孕んだ恐怖に震えている。	PRINTFORMW 咲夜は化け物の子種で孕んだ恐怖に震えている。
PRINTFORMW 「あっ、またこの感じ……また生まれるのね♪」	PRINTFORMW 「あっ、またこの感じ……また生まれるのね♪」
PRINTFORML 「そう慌てないで下さい♪ああ♪乱暴は駄目♪」	PRINTFORML 「そう慌てないで下さい♪ああ♪乱暴は駄目♪」
PRINTFORMW 「っぃ！…想像してはいたけど…でも、これは」	PRINTFORMW 「っぃ！…想像してはいたけど…でも、これは」
PRINTFORMW 咲夜の手の中にあるのはなくしたはずの銀時計！	PRINTFORMW 咲夜の手の中にあるのはなくしたはずの銀時計！
PRINTFORML 「がんばらないと…ここから脱出するために！」	PRINTFORML 「がんばらないと…ここから脱出するために！」
PRINTFORMW （疼く股間のモノが気になって集中できない…）	PRINTFORMW （疼く股間のモノが気になって集中できない…）
PRINTFORMW 戦う意思はあるものの、体力は限界に近い様だ…	PRINTFORMW 戦う意思はあるものの、体力は限界に近い様だ…
PRINTFORMW （何か入れられた！？　それとも気のせい…？）	PRINTFORMW （何か入れられた！？　それとも気のせい…？）
PRINTFORMW 「ご無事でしたか！　お怪我はありませんか？」	PRINTFORMW 「ご無事でしたか！　お怪我はありませんか？」
PRINTFORMW 「お互い大した物は持っていないでしょうし…」	PRINTFORMW 「お互い大した物は持っていないでしょうし…」
PRINTFORMW 「失礼しました…。お気をつけくださいませ…」	PRINTFORMW 「失礼しました…。お気をつけくださいませ…」
PRINTFORML 「酷い空気。それに…その…何か動いているし」	PRINTFORML 「酷い空気。それに…その…何か動いているし」
PRINTFORML 「くあああぁ！？　あっ頭の中っ…飛んっ…！」	PRINTFORML 「くあああぁ！？　あっ頭の中っ…飛んっ…！」
PRINTFORML 「うげぇ！　げほっ、ごほっ！　はぁ…はぁ…」	PRINTFORML 「うげぇ！　げほっ、ごほっ！　はぁ…はぁ…」
PRINTFORML 「こうなったら生まれてくる奴を殺してやる…」	PRINTFORML 「こうなったら生まれてくる奴を殺してやる…」
PRINTFORML 足音を殺し、物陰から周囲の気配を探っている…	PRINTFORML 足音を殺し、物陰から周囲の気配を探っている…
PRINTFORML 「都合よく出口でも見つかると良いんだけど…」	PRINTFORML 「都合よく出口でも見つかると良いんだけど…」
PRINTFORML 「あら、見つからなかったナイフがこんな所に」	PRINTFORML 「あら、見つからなかったナイフがこんな所に」
PRINTFORML 「パチュリー様！？　しっかりしてください！」	PRINTFORML 「パチュリー様！？　しっかりしてください！」
PRINTFORML 「フランお嬢様！？　しっかりしてください！」	PRINTFORML 「フランお嬢様！？　しっかりしてください！」
PRINTFORMW 「でも無理はしないで。私があなたを守るから」	PRINTFORMW 「でも無理はしないで。私があなたを守るから」
PRINTFORMW 「パチュリー様…私を連れて行ってください…」	PRINTFORMW 「パチュリー様…私を連れて行ってください…」
PRINTFORMW 「フランお嬢様…私を連れて行ってください…」	PRINTFORMW 「フランお嬢様…私を連れて行ってください…」
PRINTFORMW 「お願いします…私も一緒に行かせてください」	PRINTFORMW 「お願いします…私も一緒に行かせてください」
PRINTFORMW 「気分が悪そうですね。どうかされましたか？」	PRINTFORMW 「気分が悪そうですね。どうかされましたか？」
PRINTFORMW 「パチュリー様…もう動かない方がいいですね」	PRINTFORMW 「パチュリー様…もう動かない方がいいですね」
PRINTFORMW 「フランお嬢様…もう動かない方がいいですね」	PRINTFORMW 「フランお嬢様…もう動かない方がいいですね」
PRINTFORMW 「私は自力で脱出しますから、ご勝手にどうぞ」	PRINTFORMW 「私は自力で脱出しますから、ご勝手にどうぞ」
PRINTFORMW 「私は自力で脱出しますので、ご勝手にどうぞ」	PRINTFORMW 「私は自力で脱出しますので、ご勝手にどうぞ」
PRINTFORML 「いや、それだけ敵が強いのかもしれないわね」	PRINTFORML 「いや、それだけ敵が強いのかもしれないわね」
PRINTFORML 「お嬢様には何と説明すれば良いのでしょう…」	PRINTFORML 「お嬢様には何と説明すれば良いのでしょう…」
PRINTFORML 「いやあああああぁぁぁぁぁぁぁぁぁぁぁ～…」	PRINTFORML 「いやあああああぁぁぁぁぁぁぁぁぁぁぁ～…」
PRINTFORMW 「こんなに激しいの♪癖になっちゃったわ♪」	PRINTFORMW 「こんなに激しいの♪癖になっちゃったわ♪」
PRINTFORMW 「あなたのここも我慢できないそうですし♪」	PRINTFORMW 「あなたのここも我慢できないそうですし♪」
PRINTFORMW 「お嬢様のおっぱい…薄くてかわいらしい…」	PRINTFORMW 「お嬢様のおっぱい…薄くてかわいらしい…」
PRINTFORMW 「お嬢様、お体綺麗にさせていただきますね」	PRINTFORMW 「お嬢様、お体綺麗にさせていただきますね」
PRINTFORMW 「もう、気はすんだかしら？離してくださる」	PRINTFORMW 「もう、気はすんだかしら？離してくださる」
PRINTFORMW （ナカダシ！お嬢様の中にナカダシしたい！）	PRINTFORMW （ナカダシ！お嬢様の中にナカダシしたい！）
PRINTFORMW 「私で感じて下さってるんですか？光栄です」	PRINTFORMW 「私で感じて下さってるんですか？光栄です」
PRINTFORMW 「ザーメンもお潮も全部飲んであげるから♪」	PRINTFORMW 「ザーメンもお潮も全部飲んであげるから♪」
PRINTFORMW 「ああ！大ピンチです！このままじゃ……♪」	PRINTFORMW 「ああ！大ピンチです！このままじゃ……♪」
PRINTFORMW 「ぁぁ…これ…ナニされてるんでしょうか♪」	PRINTFORMW 「ぁぁ…これ…ナニされてるんでしょうか♪」
PRINTFORMW 「もう私の前に姿を見せないでくれるかしら」	PRINTFORMW 「もう私の前に姿を見せないでくれるかしら」
PRINTFORMW 「私は……貴女のお母さんなんかじゃない！」	PRINTFORMW 「私は……貴女のお母さんなんかじゃない！」
PRINTFORMW 「私はこっちを探しますわ。あなたはそちら」	PRINTFORMW 「私はこっちを探しますわ。あなたはそちら」
PRINTFORMW 咲夜は好色な目で相手の体をじろじろ眺めた。	PRINTFORMW 咲夜は好色な目で相手の体をじろじろ眺めた。
PRINTFORMW 「妹様、皆で、皆でお屋敷に帰りましょうね」	PRINTFORMW 「妹様、皆で、皆でお屋敷に帰りましょうね」
PRINTFORMW 咲夜は小悪魔の肢体を寝目回す様に見つめた。	PRINTFORMW 咲夜は小悪魔の肢体を寝目回す様に見つめた。
PRINTFORMW 「さあお嬢様、私についてきてくださいませ」	PRINTFORMW 「さあお嬢様、私についてきてくださいませ」
PRINTFORMW 「その……申し訳ないです……ごめんなさい」	PRINTFORMW 「その……申し訳ないです……ごめんなさい」
PRINTFORMW （もう、触手に変なのばっかりで嫌になるわ）	PRINTFORMW （もう、触手に変なのばっかりで嫌になるわ）
PRINTFORMW （体の調子がおかしい…ナニカサレタヨウネ）	PRINTFORMW （体の調子がおかしい…ナニカサレタヨウネ）
PRINTFORMW 咲夜の思考は徐々に触手宮に染められていく。	PRINTFORMW 咲夜の思考は徐々に触手宮に染められていく。
PRINTFORMW 「やらないわよ、魔法少女は足を洗ったのよ」	PRINTFORMW 「やらないわよ、魔法少女は足を洗ったのよ」
PRINTFORMW 「これはまさか……いいえ、そんなはずない」	PRINTFORMW 「これはまさか……いいえ、そんなはずない」
PRINTFORML 触手に処女を散らされてもあまり気にしません	PRINTFORML 触手に処女を散らされてもあまり気にしません
PRINTFORMW 「ちょっと様子を見てみることにしましょう」	PRINTFORMW 「ちょっと様子を見てみることにしましょう」
PRINTFORMW 両手にナイフを掴み、次々にナイフを投げた！	PRINTFORMW 両手にナイフを掴み、次々にナイフを投げた！
PRINTFORMW 大量のナイフで敵に大きなダメージを与える！	PRINTFORMW 大量のナイフで敵に大きなダメージを与える！
PRINTFORMW 「そろそろ目の前のを始末しておかないと…」	PRINTFORMW 「そろそろ目の前のを始末しておかないと…」
PRINTFORMW 「お茶は出せませんが、戦闘なら出来ますよ」	PRINTFORMW 「お茶は出せませんが、戦闘なら出来ますよ」
PRINTFORMW 「な、何かが込みあがって来て…出るっ！？」	PRINTFORMW 「な、何かが込みあがって来て…出るっ！？」
PRINTFORMW 咲夜は体を反らし、絶頂の衝撃を堪えている！	PRINTFORMW 咲夜は体を反らし、絶頂の衝撃を堪えている！
PRINTFORMW 絶頂のせいか、咲夜の視界が明滅を繰り返す！	PRINTFORMW 絶頂のせいか、咲夜の視界が明滅を繰り返す！
PRINTFORML （こいつ…私の腹を食い破るつもりなの！？）	PRINTFORML （こいつ…私の腹を食い破るつもりなの！？）
PRINTFORML 物陰から首を出し、周囲の気配を探っている…	PRINTFORML 物陰から首を出し、周囲の気配を探っている…
PRINTFORMW 「どうしても調べておきたいことがあって…」	PRINTFORMW 「どうしても調べておきたいことがあって…」
PRINTFORMW 「妖夢…一緒にここから抜け出しましょう…」	PRINTFORMW 「妖夢…一緒にここから抜け出しましょう…」
PRINTFORMW 「…でも私が辛いときは頼らせて頂きますよ」	PRINTFORMW 「…でも私が辛いときは頼らせて頂きますよ」
PRINTFORMW 「外に出てから医者を呼べば助かりますよ！」	PRINTFORMW 「外に出てから医者を呼べば助かりますよ！」
PRINTFORML 「もうすぐ出口が見えてくるかもしれません」	PRINTFORML 「もうすぐ出口が見えてくるかもしれません」
PRINTFORMW 「パチュリー様…私は後ろを向いておきます」	PRINTFORMW 「パチュリー様…私は後ろを向いておきます」
PRINTFORMW 「フランお嬢様…私は後ろを向いておきます」	PRINTFORMW 「フランお嬢様…私は後ろを向いておきます」
PRINTFORMW 「さようなら！　私は自力で脱出するから！」	PRINTFORMW 「さようなら！　私は自力で脱出するから！」
PRINTFORMW 「あら、これ中々良さそうね。暖かそうだし」	PRINTFORMW 「あら、これ中々良さそうね。暖かそうだし」
PRINTFORML 咲夜はそう固く決意し、ナイフを握り締めた…	PRINTFORML 咲夜はそう固く決意し、ナイフを握り締めた…
PRINTFORML 「このカチューシャ…それに、この服は！？」	PRINTFORML 「このカチューシャ…それに、この服は！？」
PRINTFORMW 「いや！いやよ！うそよね、いやぁ………」	PRINTFORMW 「いや！いやよ！うそよね、いやぁ………」
PRINTFORMW 「ああ♪ダメです♪やめてくださいってば」	PRINTFORMW 「ああ♪ダメです♪やめてくださいってば」
PRINTFORMW 「あっ…すごく熱い♪それにどろどろ…♪」	PRINTFORMW 「あっ…すごく熱い♪それにどろどろ…♪」
PRINTFORMW 「だ、だめ♪またはしたなくイっちゃう♪」	PRINTFORMW 「だ、だめ♪またはしたなくイっちゃう♪」
PRINTFORMW 「先っちょ、入り口、さあ、入れますよ♪」	PRINTFORMW 「先っちょ、入り口、さあ、入れますよ♪」
PRINTFORMW 「すっかり大きくなってしまいましたね♪」	PRINTFORMW 「すっかり大きくなってしまいましたね♪」
PRINTFORMW 「はい、これで満足？今度は自分でしてね」	PRINTFORMW 「はい、これで満足？今度は自分でしてね」
PRINTFORMW 「時止めさえできれば……こんな屈辱……」	PRINTFORMW 「時止めさえできれば……こんな屈辱……」
PRINTFORMW 「ぁあぁああ♪それ……もっと…ぉ……♪」	PRINTFORMW 「ぁあぁああ♪それ……もっと…ぉ……♪」
PRINTFORMW 「繕うのは私なんです！やめてください！」	PRINTFORMW 「繕うのは私なんです！やめてください！」
PRINTFORMW 「まさか！あの敵は！……ありえない……」	PRINTFORMW 「まさか！あの敵は！……ありえない……」
PRINTFORMW 「やったか？……言ってみたかったんです」	PRINTFORMW 「やったか？……言ってみたかったんです」
PRINTFORMW 「見られちゃう……見られちゃったら……」	PRINTFORMW 「見られちゃう……見られちゃったら……」
PRINTFORMW 「あらこんなところで♪…楽しんでいて？」	PRINTFORMW 「あらこんなところで♪…楽しんでいて？」
PRINTFORMW 咲夜は体をもじもじさせながらつぶやいた。	PRINTFORMW 咲夜は体をもじもじさせながらつぶやいた。
PRINTFORMW 「ええ、まさかこんなことになるだなんて」	PRINTFORMW 「ええ、まさかこんなことになるだなんて」
PRINTFORMW 「パチュリー様もこちらにおいででしたか」	PRINTFORMW 「パチュリー様もこちらにおいででしたか」
PRINTFORMW 「さあ妹様、私についてきてくださいませ」	PRINTFORMW 「さあ妹様、私についてきてくださいませ」
PRINTFORMW 寄生した魔物の誕生に咲夜の表情は複雑だ。	PRINTFORMW 寄生した魔物の誕生に咲夜の表情は複雑だ。
PRINTFORMW （まさか……また妊娠したっていうの!?）	PRINTFORMW （まさか……また妊娠したっていうの!?）
PRINTFORMW （ここの魔物の精の強さは尋常じゃないわ）	PRINTFORMW （ここの魔物の精の強さは尋常じゃないわ）
PRINTFORMW 「ああ…おっぱいが…わたしのカラダ……」	PRINTFORMW 「ああ…おっぱいが…わたしのカラダ……」
PRINTFORMW 「奇麗ねえ。そういうものじゃないけれど」	PRINTFORMW 「奇麗ねえ。そういうものじゃないけれど」
PRINTFORMW 「着衣プレイ好きの私としては助かるわ♪」	PRINTFORMW 「着衣プレイ好きの私としては助かるわ♪」
PRINTFORMW 「ちょっと、暑くなってきちゃったかしら」	PRINTFORMW 「ちょっと、暑くなってきちゃったかしら」
PRINTFORMW 「ちょっと……ハードだったかしらね……」	PRINTFORMW 「ちょっと……ハードだったかしらね……」
PRINTFORML あくまでも触手は敵　アヘったりはしません	PRINTFORML あくまでも触手は敵　アヘったりはしません
PRINTFORMW 「エクステンドとかは出来ないのかしら？」	PRINTFORMW 「エクステンドとかは出来ないのかしら？」
PRINTFORMW 「こういう輩には距離を取る方がいいわね」	PRINTFORMW 「こういう輩には距離を取る方がいいわね」
PRINTFORMW 「相手をしてあげる義務はありませんので」	PRINTFORMW 「相手をしてあげる義務はありませんので」
PRINTFORMW 咲夜は十数本のナイフを次々に投げつけた！	PRINTFORMW 咲夜は十数本のナイフを次々に投げつけた！
PRINTFORMW 咲夜は複数のナイフで敵をまとめて貫いた！	PRINTFORMW 咲夜は複数のナイフで敵をまとめて貫いた！
PRINTFORMW 「すぐに体制を立て直して戻ってきます！」	PRINTFORMW 「すぐに体制を立て直して戻ってきます！」
PRINTFORML 「お嬢様ほどの者がお逃げになるなんて…」	PRINTFORML 「お嬢様ほどの者がお逃げになるなんて…」
PRINTFORMW 「館の掃除が全くできなくて困りました…」	PRINTFORMW 「館の掃除が全くできなくて困りました…」
PRINTFORML 「よろしくお願いしますね、パチュリー様」	PRINTFORML 「よろしくお願いしますね、パチュリー様」
PRINTFORMW 「やはり、人数は多い方が安心できますね」	PRINTFORMW 「やはり、人数は多い方が安心できますね」
PRINTFORMW 「近づいてくる奴は私が追い払いますので」	PRINTFORMW 「近づいてくる奴は私が追い払いますので」
PRINTFORML 「ああっ！　いやっ、そこは……っっっ！」	PRINTFORML 「ああっ！　いやっ、そこは……っっっ！」
PRINTFORMW （えっ！？　な、何かがお腹を蹴った！？）	PRINTFORMW （えっ！？　な、何かがお腹を蹴った！？）
PRINTFORML 「状況を打開できるものでも見つかれば…」	PRINTFORML 「状況を打開できるものでも見つかれば…」
PRINTFORML 「妖夢、妖夢！　私の声が聞こえてる！？」	PRINTFORML 「妖夢、妖夢！　私の声が聞こえてる！？」
PRINTFORMW 「ちょっと調べておきたいことがあるの…」	PRINTFORMW 「ちょっと調べておきたいことがあるの…」
PRINTFORMW 「咲夜はもう必要ないということですか…」	PRINTFORMW 「咲夜はもう必要ないということですか…」
PRINTFORMW 「妖夢…どうかした？　気分が悪そうね…」	PRINTFORMW 「妖夢…どうかした？　気分が悪そうね…」
PRINTFORML 「美鈴！　もうすぐ出口が見えてくるわ！」	PRINTFORML 「美鈴！　もうすぐ出口が見えてくるわ！」
PRINTFORML 「妖夢！　もうすぐ出口が見えてくるわ！」	PRINTFORML 「妖夢！　もうすぐ出口が見えてくるわ！」
PRINTFORML 「咲夜はお嬢様が信じられなくなりました」	PRINTFORML 「咲夜はお嬢様が信じられなくなりました」
PRINTFORML 咲夜は服を抱きしめ、その場に泣き崩れた…	PRINTFORML 咲夜は服を抱きしめ、その場に泣き崩れた…
PRINTFORML 「あの妖怪兎でさえ歯が立たないのねぇ…」	PRINTFORML 「あの妖怪兎でさえ歯が立たないのねぇ…」
PRINTFORML 「…そう、誰かがあいつらにやられたのね」	PRINTFORML 「…そう、誰かがあいつらにやられたのね」
PRINTFORMW 「申し訳ありませんが容赦もありません」	PRINTFORMW 「申し訳ありませんが容赦もありません」
PRINTFORMW 「ここなんかいいんじゃないでしょうか」	PRINTFORMW 「ここなんかいいんじゃないでしょうか」
PRINTFORMW 「ねぇ……もっと口を大きく開けて……」	PRINTFORMW 「ねぇ……もっと口を大きく開けて……」
PRINTFORMW 「やんっ、私ですよ！やめてください！」	PRINTFORMW 「やんっ、私ですよ！やめてください！」
PRINTFORMW 「また、気持ちいいのが！だめなのに！」	PRINTFORMW 「また、気持ちいいのが！だめなのに！」
PRINTFORMW 「エッチなにおいがすごいですよお嬢様」	PRINTFORMW 「エッチなにおいがすごいですよお嬢様」
PRINTFORMW 「お嬢様…私もご一緒していいですか？」	PRINTFORMW 「お嬢様…私もご一緒していいですか？」
PRINTFORMW 「もう♪胸と言いますか全身どろどろ♪」	PRINTFORMW 「もう♪胸と言いますか全身どろどろ♪」
PRINTFORMW 「もうしばらく続けさせてくださいね♪」	PRINTFORMW 「もうしばらく続けさせてくださいね♪」
PRINTFORMW 「いきたくなったらいつでもいいからね」	PRINTFORMW 「いきたくなったらいつでもいいからね」
PRINTFORMW はその行の左にある「;」を消しましょう	PRINTFORMW はその行の左にある「;」を消しましょう
PRINTFORMW 「ああ……いやよ、いや……こんな時に」	PRINTFORMW 「ああ……いやよ、いや……こんな時に」
PRINTFORMW 「ぞっとします。近寄らないでください」	PRINTFORMW 「ぞっとします。近寄らないでください」
PRINTFORMW 「ああ、あれは…何度見ても慣れないわ」	PRINTFORMW 「ああ、あれは…何度見ても慣れないわ」
PRINTFORMW 「この迷宮は…どれだけ人を傷つけるの」	PRINTFORMW 「この迷宮は…どれだけ人を傷つけるの」
PRINTFORML 「あら……素敵な相手に出会ったかしら」	PRINTFORML 「あら……素敵な相手に出会ったかしら」
PRINTFORMW 「あらこんなところで…ご機嫌いかが？」	PRINTFORMW 「あらこんなところで…ご機嫌いかが？」
PRINTFORMW （触手に負ければこんな目に……ゴクリ）	PRINTFORMW （触手に負ければこんな目に……ゴクリ）
PRINTFORMW 「そんな……あなたがやられるなんて！」	PRINTFORMW 「そんな……あなたがやられるなんて！」
PRINTFORMW 「ああ、パチュリー様。災難でしたわね」	PRINTFORMW 「ああ、パチュリー様。災難でしたわね」
PRINTFORMW 「ああ、パチュリー様。ご無事でしたか」	PRINTFORMW 「ああ、パチュリー様。ご無事でしたか」
PRINTFORMW 「あなたの力でどうにかならないかしら」	PRINTFORMW 「あなたの力でどうにかならないかしら」
PRINTFORMW 「パチュリー様、魔力は戻りましたか？」	PRINTFORMW 「パチュリー様、魔力は戻りましたか？」
PRINTFORMW 「私……マグロに興味はありませんので」	PRINTFORMW 「私……マグロに興味はありませんので」
PRINTFORML (また、こんな化け物を……なのに……)	PRINTFORML (また、こんな化け物を……なのに……)
PRINTFORMW （私は魔物の仔を妊娠しました…………）	PRINTFORMW （私は魔物の仔を妊娠しました…………）
PRINTFORMW 「また、こんな……屈辱……だわ………」	PRINTFORMW 「また、こんな……屈辱……だわ………」
PRINTFORMW 「今頃他の人はどうしてるのでしょうか」	PRINTFORMW 「今頃他の人はどうしてるのでしょうか」
PRINTFORMW 「星よ……えっと、風の……ええと……」	PRINTFORMW 「星よ……えっと、風の……ええと……」
PRINTFORMW 「あら……目がかすんでよく見えないわ」	PRINTFORMW 「あら……目がかすんでよく見えないわ」
PRINTFORMW 「あら～♪素敵なものがありますねえ♪」	PRINTFORMW 「あら～♪素敵なものがありますねえ♪」
PRINTFORMW 「おいしい……けど、これ何かしら……」	PRINTFORMW 「おいしい……けど、これ何かしら……」
PRINTFORMW 「ぅぅぅ……体がなんだか変な感じだわ」	PRINTFORMW 「ぅぅぅ……体がなんだか変な感じだわ」
PRINTFORMW 「その上……何よこれ……離れなさいよ」	PRINTFORMW 「その上……何よこれ……離れなさいよ」
PRINTFORMW 「この程度の誘惑に負けられません…！」	PRINTFORMW 「この程度の誘惑に負けられません…！」
PRINTFORMW 「今は敵を倒すことを優先するのよ…！」	PRINTFORMW 「今は敵を倒すことを優先するのよ…！」
PRINTFORMW 両手にナイフを掴み、何本も投げつけた！	PRINTFORMW 両手にナイフを掴み、何本も投げつけた！
PRINTFORMW 咲夜は気丈にも十数本のナイフを構えた！	PRINTFORMW 咲夜は気丈にも十数本のナイフを構えた！
PRINTFORMW 「敵を見るのよ咲夜…今は戦わないと…」	PRINTFORMW 「敵を見るのよ咲夜…今は戦わないと…」
PRINTFORML 「お願い、言うことを聞いて…私の体！」	PRINTFORML 「お願い、言うことを聞いて…私の体！」
PRINTFORMW 「防御が間に合わなっ……きゃあっ！？」	PRINTFORMW 「防御が間に合わなっ……きゃあっ！？」
PRINTFORMW 「そ、そこ今…くっ、ううぅんんっ！？」	PRINTFORMW 「そ、そこ今…くっ、ううぅんんっ！？」
PRINTFORMW 「…ひっ！？　な、何か登ってくる！？」	PRINTFORMW 「…ひっ！？　な、何か登ってくる！？」
PRINTFORMW 「…ナイフを直す場所が減ったじゃない」	PRINTFORMW 「…ナイフを直す場所が減ったじゃない」
PRINTFORMW 「んぐっ！　も、もう少し寝かせてよ…」	PRINTFORMW 「んぐっ！　も、もう少し寝かせてよ…」
PRINTFORMW 力の抜けた咲夜の手からナイフが落ちた…	PRINTFORMW 力の抜けた咲夜の手からナイフが落ちた…
PRINTFORMW 「…体制を立て直したら、戻ってきてね」	PRINTFORMW 「…体制を立て直したら、戻ってきてね」
PRINTFORMW 「気になったことはこんなところですわ」	PRINTFORMW 「気になったことはこんなところですわ」
PRINTFORML 「ありがとうございます、パチュリー様」	PRINTFORML 「ありがとうございます、パチュリー様」
PRINTFORML 「ありがとうございます、フランお嬢様」	PRINTFORML 「ありがとうございます、フランお嬢様」
PRINTFORML 「よろしくお願いします、フランお嬢様」	PRINTFORML 「よろしくお願いします、フランお嬢様」
PRINTFORML 「よろしくお願いします、パチュリー様」	PRINTFORML 「よろしくお願いします、パチュリー様」
PRINTFORML 「んくっ…ふーっ、ふーっ…んんーっ！」	PRINTFORML 「んくっ…ふーっ、ふーっ…んんーっ！」
PRINTFORML 「イきたくっ…ないのにっ…あああっ！」	PRINTFORML 「イきたくっ…ないのにっ…あああっ！」
PRINTFORMW (この前怪物に何かを入れられたのね…)	PRINTFORMW (この前怪物に何かを入れられたのね…)
PRINTFORML （時間を止めて移動出来ればいいのに…）	PRINTFORML （時間を止めて移動出来ればいいのに…）
PRINTFORML 咲夜はナイフを手に取り、警戒している！	PRINTFORML 咲夜はナイフを手に取り、警戒している！
PRINTFORMW 「うふふ…あなたの精神力は私のもの♪」	PRINTFORMW 「うふふ…あなたの精神力は私のもの♪」
PRINTFORMW 「これを飲めば…さあもう大丈夫ですよ」	PRINTFORMW 「これを飲めば…さあもう大丈夫ですよ」
PRINTFORMW 「立てますか？　咲夜が支えておきます」	PRINTFORMW 「立てますか？　咲夜が支えておきます」
PRINTFORMW 「妖夢だけでも生きて帰られるのなら…」	PRINTFORMW 「妖夢だけでも生きて帰られるのなら…」
PRINTFORMW 「パチュリー様、気分が悪そうですね…」	PRINTFORMW 「パチュリー様、気分が悪そうですね…」
PRINTFORMW 「フランお嬢様、気分が悪そうですね…」	PRINTFORMW 「フランお嬢様、気分が悪そうですね…」
PRINTFORMW 「お嬢様…もう動かない方がいいですね」	PRINTFORMW 「お嬢様…もう動かない方がいいですね」
PRINTFORML （こ、これって…やっぱり子供なの！？）	PRINTFORML （こ、これって…やっぱり子供なの！？）
PRINTFORML 「お嬢様、どうして！　咲夜は…あぁ…」	PRINTFORML 「お嬢様、どうして！　咲夜は…あぁ…」
PRINTFORML （う、嘘…股間に何か張り付いてる！？）	PRINTFORML （う、嘘…股間に何か張り付いてる！？）
PRINTFORMW 「な、ナカに入ってくるっ！　くうっ！」	PRINTFORMW 「な、ナカに入ってくるっ！　くうっ！」
PRINTFORMW 「だってフランお嬢様は吸血鬼なのに…」	PRINTFORMW 「だってフランお嬢様は吸血鬼なのに…」
PRINTFORML 「悪いけど、使わせていただきましょう」	PRINTFORML 「悪いけど、使わせていただきましょう」
PRINTFORMW 「あ、やっと取れましたね。よかった」	PRINTFORMW 「あ、やっと取れましたね。よかった」
PRINTFORMW 「ねえ、じっとしていてくださいまし」	PRINTFORMW 「ねえ、じっとしていてくださいまし」
PRINTFORMW 「はいお嬢様、おくちあーんですよ♪」	PRINTFORMW 「はいお嬢様、おくちあーんですよ♪」
PRINTFORMW 「お嬢様のお口、使わせてくださいね」	PRINTFORMW 「お嬢様のお口、使わせてくださいね」
PRINTFORMW 「もしものことがあったらどうするの」	PRINTFORMW 「もしものことがあったらどうするの」
PRINTFORMW 「魔物を従えて後宮でも作ろうかしら」	PRINTFORMW 「魔物を従えて後宮でも作ろうかしら」
PRINTFORMW 「ゃ……やめなさいってば……zzz」	PRINTFORMW 「ゃ……やめなさいってば……zzz」
PRINTFORMW 「遅いですねえ、止まって見えますよ」	PRINTFORMW 「遅いですねえ、止まって見えますよ」
PRINTFORMW 「だ、駄目よ！こんなことしてちゃ！」	PRINTFORMW 「だ、駄目よ！こんなことしてちゃ！」
PRINTFORMW 「ふあ！あ！出してしまいました……」	PRINTFORMW 「ふあ！あ！出してしまいました……」
PRINTFORMW 「待って…これは私でも…厳しいわ…」	PRINTFORMW 「待って…これは私でも…厳しいわ…」
PRINTFORMW 「ぃ……ぃぃっ……ぃあぁ」;１２２３	PRINTFORMW 「ぃ……ぃぃっ……ぃあぁ」;１２２３
PRINTFORMW 「ああ！お嬢様、やっと会えました！」	PRINTFORMW 「ああ！お嬢様、やっと会えました！」
PRINTFORMW 「妹様、皆でお屋敷に帰りましょうね」	PRINTFORMW 「妹様、皆でお屋敷に帰りましょうね」
PRINTFORMW 「ああ…おっぱいが…わたしの体……」	PRINTFORMW 「ああ…おっぱいが…わたしの体……」
PRINTFORMW 「こんなとこで寝ることになるなんて」	PRINTFORMW 「こんなとこで寝ることになるなんて」
PRINTFORMW 「少ししたら起こしていいですからね」	PRINTFORMW 「少ししたら起こしていいですからね」
PRINTFORMW 「無理しなきゃ、やってけないのよ！」	PRINTFORMW 「無理しなきゃ、やってけないのよ！」
PRINTFORMW 「こんな時こそ私が頑張らなくちゃね」	PRINTFORMW 「こんな時こそ私が頑張らなくちゃね」
PRINTFORMW 「ちょっとからかい過ぎたでしょうか」	PRINTFORMW 「ちょっとからかい過ぎたでしょうか」
PRINTFORMW 「な、な、ななな！なんですかこれ！」	PRINTFORMW 「な、な、ななな！なんですかこれ！」
PRINTFORMW 「ん、これは……駄目よ、我慢よ……」	PRINTFORMW 「ん、これは……駄目よ、我慢よ……」
PRINTFORMW 「ちょっと……ハードだったわね……」	PRINTFORMW 「ちょっと……ハードだったわね……」
PRINTFORMW （ボムが使えたら逃れられるのに…！）	PRINTFORMW （ボムが使えたら逃れられるのに…！）
PRINTFORMW  （今あいつらに捕まったりしたら…）	PRINTFORMW  （今あいつらに捕まったりしたら…）
PRINTFORML 「生きて…生きて紅魔館へ帰るのよ！」	PRINTFORML 「生きて…生きて紅魔館へ帰るのよ！」
PRINTFORMW 「退治…いえ、駆除してあげますわ！」	PRINTFORMW 「退治…いえ、駆除してあげますわ！」
PRINTFORMW 「う、上手く狙いをつけられない…！」	PRINTFORMW 「う、上手く狙いをつけられない…！」
PRINTFORMW （なんとかナイフを掴めさえすれば…）	PRINTFORMW （なんとかナイフを掴めさえすれば…）
PRINTFORMW 「射精させられてたまるもんですか！」	PRINTFORMW 「射精させられてたまるもんですか！」
PRINTFORMW 「ふ、服ぐらいどうってことないわ！」	PRINTFORMW 「ふ、服ぐらいどうってことないわ！」
PRINTFORMW 「うげぇっ！　きゅ、急に吐き気が…」	PRINTFORMW 「うげぇっ！　きゅ、急に吐き気が…」
PRINTFORMW 「はぁ、はぁ…さ、さあ反撃開始よ…」	PRINTFORMW 「はぁ、はぁ…さ、さあ反撃開始よ…」
PRINTFORMW 「はぁ、はぁ……もう大丈夫かしら？」	PRINTFORMW 「はぁ、はぁ……もう大丈夫かしら？」
PRINTFORMW 咲夜はナイフを専用のポーチに収めた…	PRINTFORMW 咲夜はナイフを専用のポーチに収めた…
PRINTFORMW 「体制を整えたら戻ってきますから！」	PRINTFORMW 「体制を整えたら戻ってきますから！」
PRINTFORMW 「ありがとう。そっちも気を付けてね」	PRINTFORMW 「ありがとう。そっちも気を付けてね」
PRINTFORMW 「いや、これっ、乳首で感じてる！？」	PRINTFORMW 「いや、これっ、乳首で感じてる！？」
PRINTFORMW 「吸われてっ…いやあああぁぁぁっ！」	PRINTFORMW 「吸われてっ…いやあああぁぁぁっ！」
PRINTFORMW (え？　お腹の中？　気のせいよね…)	PRINTFORMW (え？　お腹の中？　気のせいよね…)
PRINTFORML 「出口はまだ見つからないのかしら…」	PRINTFORML 「出口はまだ見つからないのかしら…」
PRINTFORML 「お嬢様、お嬢様！　お気を確かに！」	PRINTFORML 「お嬢様、お嬢様！　お気を確かに！」
PRINTFORMW 「調べておきたいことがありまして…」	PRINTFORMW 「調べておきたいことがありまして…」
PRINTFORMW 「お嬢様によろしくお伝え願います…」	PRINTFORMW 「お嬢様によろしくお伝え願います…」
PRINTFORMW 「お嬢様、いかがなさいましたか…？」	PRINTFORMW 「お嬢様、いかがなさいましたか…？」
PRINTFORML 「パチュリー様、お休みくださいませ」	PRINTFORML 「パチュリー様、お休みくださいませ」
PRINTFORML 「フランお嬢様、お休みくださいませ」	PRINTFORML 「フランお嬢様、お休みくださいませ」
PRINTFORMW 「嘘…パチュリー様、そのお腹って…」	PRINTFORMW 「嘘…パチュリー様、そのお腹って…」
PRINTFORMW 「嘘…フランお嬢様、そのお腹って…」	PRINTFORMW 「嘘…フランお嬢様、そのお腹って…」
PRINTFORMW 「…もう動かない方が良さそうですね」	PRINTFORMW 「…もう動かない方が良さそうですね」
PRINTFORML 「妖夢…怖かったら私の手を握って…」	PRINTFORML 「妖夢…怖かったら私の手を握って…」
PRINTFORMW （こ、これがお嬢様と怪物の子供……）	PRINTFORMW （こ、これがお嬢様と怪物の子供……）
PRINTFORMW 「…幻想郷に帰ったらお話しましょう」	PRINTFORMW 「…幻想郷に帰ったらお話しましょう」
PRINTFORML 「お嬢様には私から伝えておくわね…」	PRINTFORML 「お嬢様には私から伝えておくわね…」
PRINTFORML 「この魔道書…それに、この服は！？」	PRINTFORML 「この魔道書…それに、この服は！？」
PRINTFORML 「お嬢様には私から伝えておきます…」	PRINTFORML 「お嬢様には私から伝えておきます…」
PRINTFORML 「このリボン…それに、この服は！？」	PRINTFORML 「このリボン…それに、この服は！？」
PRINTFORML 「この髪飾り…それに、この服は！？」	PRINTFORML 「この髪飾り…それに、この服は！？」
PRINTFORMW 「早く帰らないとみんな心配します」	PRINTFORMW 「早く帰らないとみんな心配します」
PRINTFORMW 「止まってくれないかしらね…時計」	PRINTFORMW 「止まってくれないかしらね…時計」
PRINTFORMW 「屈辱…だわ……やめなさいってば」	PRINTFORMW 「屈辱…だわ……やめなさいってば」
PRINTFORMW 「びゅるってチンポから精子出る！」	PRINTFORMW 「びゅるってチンポから精子出る！」
PRINTFORMW 「また、この変な感じ…止まって！」	PRINTFORMW 「また、この変な感じ…止まって！」
PRINTFORMW 「さ、両手で持ち上げてください♪」	PRINTFORMW 「さ、両手で持ち上げてください♪」
PRINTFORMW 「見えていませんね♪好都合です♪」	PRINTFORMW 「見えていませんね♪好都合です♪」
PRINTFORMW 「そんな、私のお尻が…私の…酷い」	PRINTFORMW 「そんな、私のお尻が…私の…酷い」
PRINTFORMW 「ああ♪いい肉穴見つけちゃった♪」	PRINTFORMW 「ああ♪いい肉穴見つけちゃった♪」
PRINTFORMW 「ほら♪しーこしこ、しーこしこ♪」	PRINTFORMW 「ほら♪しーこしこ、しーこしこ♪」
PRINTFORMW 「カラダ……うごかないのに……♪」	PRINTFORMW 「カラダ……うごかないのに……♪」
PRINTFORMW 「ああ……いけないのに……でも♪」	PRINTFORMW 「ああ……いけないのに……でも♪」
PRINTFORMW 「ここであきらめるわけには……！」	PRINTFORMW 「ここであきらめるわけには……！」
PRINTFORMW 「ふふ♪もっと楽しませてください」	PRINTFORMW 「ふふ♪もっと楽しませてください」
PRINTFORMW 「私ってば、何してるんですか……」	PRINTFORMW 「私ってば、何してるんですか……」
PRINTFORMW 「あ…もうっ…いえ、まだ…………」	PRINTFORMW 「あ…もうっ…いえ、まだ…………」
PRINTFORMW 「妹様、とても素敵なお姿ですよ♪」	PRINTFORMW 「妹様、とても素敵なお姿ですよ♪」
PRINTFORML 「あら、あなたほどの実力者が……」	PRINTFORML 「あら、あなたほどの実力者が……」
PRINTFORMW 「油断したわ、あなたも気を付けて」	PRINTFORMW 「油断したわ、あなたも気を付けて」
PRINTFORMW 「こちらの方はこんな感じでしたよ」	PRINTFORMW 「こちらの方はこんな感じでしたよ」
PRINTFORMW （まともに動けないなんて…今なら）	PRINTFORMW （まともに動けないなんて…今なら）
PRINTFORMW 「安心してください、私がいますよ」	PRINTFORMW 「安心してください、私がいますよ」
PRINTFORMW 「ああ、痛いです♪やめてください」	PRINTFORMW 「ああ、痛いです♪やめてください」
PRINTFORML (これは許されないことなのよ……)	PRINTFORML (これは許されないことなのよ……)
PRINTFORMW （ひょっとして……私また……!?）	PRINTFORMW （ひょっとして……私また……!?）
PRINTFORMW 「人を…なんだと思ったいるのよ！」	PRINTFORMW 「人を…なんだと思ったいるのよ！」
PRINTFORMW 「人を、なんだと思ったいるのよ！」	PRINTFORMW 「人を、なんだと思ったいるのよ！」
PRINTFORMW 「もう………お屋敷に帰りたい……」	PRINTFORMW 「もう………お屋敷に帰りたい……」
PRINTFORMW 「ちょっと先に休ませてもらうわね」	PRINTFORMW 「ちょっと先に休ませてもらうわね」
PRINTFORMW 「……っ！ちょっと休むべきかしら」	PRINTFORMW 「……っ！ちょっと休むべきかしら」
PRINTFORMW 「慎重に……見つかりませんように」	PRINTFORMW 「慎重に……見つかりませんように」
PRINTFORMW 「う、動き出したのよ……時は……」	PRINTFORMW 「う、動き出したのよ……時は……」
PRINTFORMW 「ガスは私の能力と相性が悪いのよ」	PRINTFORMW 「ガスは私の能力と相性が悪いのよ」
PRINTFORMW （何か手を打たないと危ないわね…）	PRINTFORMW （何か手を打たないと危ないわね…）
PRINTFORMW 「どこかで体を休めたいんだけど…」	PRINTFORMW 「どこかで体を休めたいんだけど…」
PRINTFORMW 咲夜はナイフの柄に手をやっている…	PRINTFORMW 咲夜はナイフの柄に手をやっている…
PRINTFORMW 「こいつ…私を孕ませる気なの！？」	PRINTFORMW 「こいつ…私を孕ませる気なの！？」
PRINTFORMW 「うぐえっ！？　げほっ、ごほっ！」	PRINTFORMW 「うぐえっ！？　げほっ、ごほっ！」
PRINTFORMW 「ぐうっ！？　よくもやったわね…」	PRINTFORMW 「ぐうっ！？　よくもやったわね…」
PRINTFORMW 「ううっ！　お、覚えていなさい…」	PRINTFORMW 「ううっ！　お、覚えていなさい…」
PRINTFORMW 「やあぁっ！　か、体…痺れてっ…」	PRINTFORMW 「やあぁっ！　か、体…痺れてっ…」
PRINTFORMW 「か、体が痺れて力が入らないっ…」	PRINTFORMW 「か、体が痺れて力が入らないっ…」
PRINTFORMW 「い、嫌！　放して、放しなさい！」	PRINTFORMW 「い、嫌！　放して、放しなさい！」
PRINTFORMW 「放しなさい！　切り刻んでやる！」	PRINTFORMW 「放しなさい！　切り刻んでやる！」
PRINTFORMW 「そ、その程度…？　はぁ、はぁ…」	PRINTFORMW 「そ、その程度…？　はぁ、はぁ…」
PRINTFORML 「服が何着あっても足りないわね…」	PRINTFORML 「服が何着あっても足りないわね…」
PRINTFORMW （ナイフが二、三本見つからない…）	PRINTFORMW （ナイフが二、三本見つからない…）
PRINTFORMW 「体制を整えたら戻ってくるから！」	PRINTFORMW 「体制を整えたら戻ってくるから！」
PRINTFORMW 「私を巻き込むのだけはご勘弁を…」	PRINTFORMW 「私を巻き込むのだけはご勘弁を…」
PRINTFORML 「んんっ！　うっ…あぁ…Zzz…」	PRINTFORML 「んんっ！　うっ…あぁ…Zzz…」
PRINTFORMW 咲夜は腰をガクガクと震わせている！	PRINTFORMW 咲夜は腰をガクガクと震わせている！
PRINTFORML 「か、体がっ！　裂けそうに痛い！」	PRINTFORML 「か、体がっ！　裂けそうに痛い！」
PRINTFORMW 「…それに、良い気分ではないわね」	PRINTFORMW 「…それに、良い気分ではないわね」
PRINTFORMW 「危ないときは私がお守り致します」	PRINTFORMW 「危ないときは私がお守り致します」
PRINTFORMW 「…無理はなさらないでくださいね」	PRINTFORMW 「…無理はなさらないでくださいね」
PRINTFORMW 「お願い美鈴…私を連れて行って…」	PRINTFORMW 「お願い美鈴…私を連れて行って…」
PRINTFORMW 「私が周りを警戒していますので…」	PRINTFORMW 「私が周りを警戒していますので…」
PRINTFORMW 「お嬢様、いかがなさいましたか？」	PRINTFORMW 「お嬢様、いかがなさいましたか？」
PRINTFORMW 「美鈴…もう動かない方がいいわね」	PRINTFORMW 「美鈴…もう動かない方がいいわね」
PRINTFORML 「妖夢…もう動かない方がいいわね」	PRINTFORML 「妖夢…もう動かない方がいいわね」
PRINTFORMW 「美鈴…私は後ろを向いておくわね」	PRINTFORMW 「美鈴…私は後ろを向いておくわね」
PRINTFORML （こ、これが妖夢と怪物の子供……）	PRINTFORML （こ、これが妖夢と怪物の子供……）
PRINTFORMW （お嬢様のお背中が遠のいていく…）	PRINTFORMW （お嬢様のお背中が遠のいていく…）
PRINTFORMW 「…後は追いません。お気をつけて」	PRINTFORMW 「…後は追いません。お気をつけて」
PRINTFORML 「魔法冥土！　まじかる☆さくや♪」	PRINTFORML 「魔法冥土！　まじかる☆さくや♪」
PRINTFORMW 「こ、こいつら…くっ、んんんっ！」	PRINTFORMW 「こ、こいつら…くっ、んんんっ！」
PRINTFORMW 「ち、乳首はだめっ！　あぁんっ！」	PRINTFORMW 「ち、乳首はだめっ！　あぁんっ！」
PRINTFORML 「この帽子…それに、この服は！？」	PRINTFORML 「この帽子…それに、この服は！？」
PRINTFORMW 「仮にも武術の達人だというのに…」	PRINTFORMW 「仮にも武術の達人だというのに…」
PRINTFORML （お嬢様、仇は取ります…絶対に！）	PRINTFORML （お嬢様、仇は取ります…絶対に！）
PRINTFORML 「ふ、フランお嬢様！？　まさか…」	PRINTFORML 「ふ、フランお嬢様！？　まさか…」
PRINTFORMW 「…用心しておいた方が良さそうね」	PRINTFORMW 「…用心しておいた方が良さそうね」
PRINTFORML 「この見たことのある服や小物は…」	PRINTFORML 「この見たことのある服や小物は…」
PRINTFORMW 「いいんですか？じゃあ容赦なく」	PRINTFORMW 「いいんですか？じゃあ容赦なく」
PRINTFORMW 「これで、気持ち、イイですか？」	PRINTFORMW 「これで、気持ち、イイですか？」
PRINTFORMW 「うふふ……じっとしてください」	PRINTFORMW 「うふふ……じっとしてください」
PRINTFORMW 「だ、だめぇ！ぁ、ぁああああ！」	PRINTFORMW 「だ、だめぇ！ぁ、ぁああああ！」
PRINTFORMW 「ひぃい！やだ、やめて！ぁあ！」	PRINTFORMW 「ひぃい！やだ、やめて！ぁあ！」
PRINTFORMW 「ああ♪今のもう一度ください♪」	PRINTFORMW 「ああ♪今のもう一度ください♪」
PRINTFORMW 「あ、イク！イク！あ、ぁああ！」	PRINTFORMW 「あ、イク！イク！あ、ぁああ！」
PRINTFORMW 「あ、やっととれた……よかった」	PRINTFORMW 「あ、やっととれた……よかった」
PRINTFORMW 「早くお嬢様を見つけませんと♪」	PRINTFORMW 「早くお嬢様を見つけませんと♪」
PRINTFORMW 「や、駄目！お尻なんて！ああ！」	PRINTFORMW 「や、駄目！お尻なんて！ああ！」
PRINTFORMW 「くっ、私の一部でしょ、何で…」	PRINTFORMW 「くっ、私の一部でしょ、何で…」
PRINTFORMW 「受け止めますから、いくらでも」	PRINTFORMW 「受け止めますから、いくらでも」
PRINTFORMW 「こんなこと……いけないわ……」	PRINTFORMW 「こんなこと……いけないわ……」
PRINTFORMW 「駄目です♪はなしてください♪」	PRINTFORMW 「駄目です♪はなしてください♪」
PRINTFORMW 「うふふ…♪焦らしてあげます♪」	PRINTFORMW 「うふふ…♪焦らしてあげます♪」
PRINTFORMW 「ぁ……まるで吊るし切りです♪」	PRINTFORMW 「ぁ……まるで吊るし切りです♪」
PRINTFORMW （ぅぅ……我慢できそうにないわ）	PRINTFORMW （ぅぅ……我慢できそうにないわ）
PRINTFORMW 「ぁ……ぁあ！……ぃ…」;５９５	PRINTFORMW 「ぁ……ぁあ！……ぃ…」;５９５
PRINTFORMW 「あら、変なところで会ったわね」	PRINTFORMW 「あら、変なところで会ったわね」
PRINTFORMW 「なにか耳寄りな話はあるかしら」	PRINTFORMW 「なにか耳寄りな話はあるかしら」
PRINTFORMW 「貴女がいれば私も楽ができるわ」	PRINTFORMW 「貴女がいれば私も楽ができるわ」
PRINTFORMW (この感じ、また魔物の仔を……)	PRINTFORMW (この感じ、また魔物の仔を……)
PRINTFORMW 「この感じ……またやられたわね」	PRINTFORMW 「この感じ……またやられたわね」
PRINTFORMW 「もう……二度と姿を見せないで」	PRINTFORMW 「もう……二度と姿を見せないで」
PRINTFORMW 「また、こんな……屈辱よ………」	PRINTFORMW 「また、こんな……屈辱よ………」
PRINTFORMW 「また……生んじゃった……ぁぁ」	PRINTFORMW 「また……生んじゃった……ぁぁ」
PRINTFORMW 「今ここを動くことはできないわ」	PRINTFORMW 「今ここを動くことはできないわ」
PRINTFORMW 「や、やめなさい、突かないで！」	PRINTFORMW 「や、やめなさい、突かないで！」
PRINTFORML 「粉微塵にして差し上げましょう」	PRINTFORML 「粉微塵にして差し上げましょう」
PRINTFORMW 咲夜の全方位弾が敵を足止めする！	PRINTFORMW 咲夜の全方位弾が敵を足止めする！
PRINTFORMW 「くうっ、んああああぁぁぁっ！」	PRINTFORMW 「くうっ、んああああぁぁぁっ！」
PRINTFORMW 「駄目っ、もうこれ以上はっ…！」	PRINTFORMW 「駄目っ、もうこれ以上はっ…！」
PRINTFORMW 「もっと手早く片付けたいわねえ」	PRINTFORMW 「もっと手早く片付けたいわねえ」
PRINTFORMW 「このぐらいならまだ直せるわ…」	PRINTFORMW 「このぐらいならまだ直せるわ…」
PRINTFORMW （意識が朦朧としてる…危険だわ）	PRINTFORMW （意識が朦朧としてる…危険だわ）
PRINTFORMW 「お嬢様、申し訳ありません……」	PRINTFORMW 「お嬢様、申し訳ありません……」
PRINTFORMW 「…戻ってくるって信じてるわよ」	PRINTFORMW 「…戻ってくるって信じてるわよ」
PRINTFORMW 「…戻ってくると信じていますよ」	PRINTFORMW 「…戻ってくると信じていますよ」
PRINTFORML 「フランお嬢様、お気をつけて…」	PRINTFORML 「フランお嬢様、お気をつけて…」
PRINTFORMW 「必ず、紅魔館へ帰りましょう！」	PRINTFORMW 「必ず、紅魔館へ帰りましょう！」
PRINTFORMW 「絶対、幻想郷へ帰りましょうね」	PRINTFORMW 「絶対、幻想郷へ帰りましょうね」
PRINTFORMW 「必ず、幻想郷へ帰りましょうね」	PRINTFORMW 「必ず、幻想郷へ帰りましょうね」
PRINTFORMW 「そうですか…いえ、いいんです」	PRINTFORMW 「そうですか…いえ、いいんです」
PRINTFORMW 「お互い余裕はありませんしね…」	PRINTFORMW 「お互い余裕はありませんしね…」
PRINTFORML 「お任せください、フランお嬢様」	PRINTFORML 「お任せください、フランお嬢様」
PRINTFORMW 「…助けっ……んんんんんっ！？」	PRINTFORMW 「…助けっ……んんんんんっ！？」
PRINTFORMW （この前のは気のせいだったの？）	PRINTFORMW （この前のは気のせいだったの？）
PRINTFORML （う、嘘…？　か、感じてる！？）	PRINTFORML （う、嘘…？　か、感じてる！？）
PRINTFORML 「敵の居ない場所で休まないと…」	PRINTFORML 「敵の居ない場所で休まないと…」
PRINTFORML 咲夜はナイフを構えて飛び出した！	PRINTFORML 咲夜はナイフを構えて飛び出した！
PRINTFORMW （こいつ、何を考えているのよ！）	PRINTFORMW （こいつ、何を考えているのよ！）
PRINTFORML 「お、思ってたより痛いかしら…」	PRINTFORML 「お、思ってたより痛いかしら…」
PRINTFORMW 「し、しまった！？　こいつ…！」	PRINTFORMW 「し、しまった！？　こいつ…！」
PRINTFORMW 「強制的にご協力お願いしますね」	PRINTFORMW 「強制的にご協力お願いしますね」
PRINTFORMW 「これを飲んで！　もう大丈夫よ」	PRINTFORMW 「これを飲んで！　もう大丈夫よ」
PRINTFORMW 「お嬢様…是非とも私をお傍に…」	PRINTFORMW 「お嬢様…是非とも私をお傍に…」
PRINTFORMW 「…でも私が辛いときは頼らせて」	PRINTFORMW 「…でも私が辛いときは頼らせて」
PRINTFORMW 「妖夢だけでも、生きて帰って…」	PRINTFORMW 「妖夢だけでも、生きて帰って…」
PRINTFORML 「美鈴、ちょっと休んでいなさい」	PRINTFORML 「美鈴、ちょっと休んでいなさい」
PRINTFORML 「妖夢、ちょっと休んでいなさい」	PRINTFORML 「妖夢、ちょっと休んでいなさい」
PRINTFORMW 「私が周りを警戒おきますから…」	PRINTFORMW 「私が周りを警戒おきますから…」
PRINTFORMW （あれ…？　大丈夫そうですね？）	PRINTFORMW （あれ…？　大丈夫そうですね？）
PRINTFORML （あれ…？　大丈夫そうですね？）	PRINTFORML （あれ…？　大丈夫そうですね？）
PRINTFORMW 「もしかして、そのお腹って……」	PRINTFORMW 「もしかして、そのお腹って……」
PRINTFORMW 「…私は後ろを向いておきますね」	PRINTFORMW 「…私は後ろを向いておきますね」
PRINTFORMW （お嬢様だけでもご無事なら……）	PRINTFORMW （お嬢様だけでもご無事なら……）
PRINTFORML 「妖夢、どうしてなの！　ねぇ！」	PRINTFORML 「妖夢、どうしてなの！　ねぇ！」
PRINTFORML 「…でも時は止められないのねぇ」	PRINTFORML 「…でも時は止められないのねぇ」
PRINTFORML 「こいつら、どこから湧いて…！」	PRINTFORML 「こいつら、どこから湧いて…！」
PRINTFORML 「パチュリー様の！？　まさか…」	PRINTFORML 「パチュリー様の！？　まさか…」
PRINTFORML 「ひっくっ…あ、あぁ…ぐすっ…」	PRINTFORML 「ひっくっ…あ、あぁ…ぐすっ…」
PRINTFORMW 「刺さりません、貫きますから」	PRINTFORMW 「刺さりません、貫きますから」
PRINTFORMW 「ここよ…ここをよく狙って…」	PRINTFORMW 「ここよ…ここをよく狙って…」
PRINTFORMW 「はい、あーんしてください。」	PRINTFORMW 「はい、あーんしてください。」
PRINTFORMW 「中はダメって言ったのに……」	PRINTFORMW 「中はダメって言ったのに……」
PRINTFORMW 「や、駄目！なんか変！ああ！」	PRINTFORMW 「や、駄目！なんか変！ああ！」
PRINTFORMW 「ああ♪なんて非道いことを♪」	PRINTFORMW 「ああ♪なんて非道いことを♪」
PRINTFORMW ;cflag:805 == 3	PRINTFORMW ;cflag:805 == 3
PRINTFORMW 「こんなこと……いけないのに」	PRINTFORMW 「こんなこと……いけないのに」
PRINTFORMW 「厳しいですね……霊撃が……」	PRINTFORMW 「厳しいですね……霊撃が……」
PRINTFORMW 「眠いなんて言ってられません」	PRINTFORMW 「眠いなんて言ってられません」
PRINTFORMW 「ああ…もう、お仕舞なのね…」	PRINTFORMW 「ああ…もう、お仕舞なのね…」
PRINTFORMW 「何とか…乗り切ったかしら？」	PRINTFORMW 「何とか…乗り切ったかしら？」
PRINTFORMW 咲夜は飛び切りの笑顔を見せた。	PRINTFORMW 咲夜は飛び切りの笑顔を見せた。
PRINTFORMW 「お、お嬢様！なんてお姿に！」	PRINTFORMW 「お、お嬢様！なんてお姿に！」
PRINTFORMW 「便利なものとかありました？」	PRINTFORMW 「便利なものとかありました？」
PRINTFORMW 「さあ、私があなたを守ります」	PRINTFORMW 「さあ、私があなたを守ります」
PRINTFORMW 「貴女がいてくれると心強いわ」	PRINTFORMW 「貴女がいてくれると心強いわ」
PRINTFORML 「あら……もしかしてまた……」	PRINTFORML 「あら……もしかしてまた……」
PRINTFORMW （この感覚……寄生された!?）	PRINTFORMW （この感覚……寄生された!?）
PRINTFORMW （体のなかに……何かいる！？）	PRINTFORMW （体のなかに……何かいる！？）
PRINTFORML 「あら、もしかすると私……♪」	PRINTFORML 「あら、もしかすると私……♪」
PRINTFORMW 「もう……二度と見たくないわ」	PRINTFORMW 「もう……二度と見たくないわ」
PRINTFORMW 「もう、これ以上は動けないわ」	PRINTFORMW 「もう、これ以上は動けないわ」
PRINTFORMW 「名残惜しいですがひとまずは」	PRINTFORMW 「名残惜しいですがひとまずは」
PRINTFORMW 「いいわね、使わせてもらうわ」	PRINTFORMW 「いいわね、使わせてもらうわ」
PRINTFORMW 「……私……まだ生きてる……」	PRINTFORMW 「……私……まだ生きてる……」
PRINTFORMW 「ちゃんとした泉でよかったわ」	PRINTFORMW 「ちゃんとした泉でよかったわ」
PRINTFORMW 「私に速さで勝てると思って？」	PRINTFORMW 「私に速さで勝てると思って？」
PRINTFORMW 「免許証とか入ってないかしら」	PRINTFORMW 「免許証とか入ってないかしら」
PRINTFORMW 「や、やめなさい、突かないで！	PRINTFORMW 「や、やめなさい、突かないで！
PRINTFORMW 「ちょっと！どこに！っぁあ！」	PRINTFORMW 「ちょっと！どこに！っぁあ！」
PRINTFORMW 咲夜は気丈にもナイフを構えた！	PRINTFORMW 咲夜は気丈にもナイフを構えた！
PRINTFORML 「いつもより派手にいきますよ」	PRINTFORML 「いつもより派手にいきますよ」
PRINTFORMW 咲夜の決意をこめたナイフ弾幕！	PRINTFORMW 咲夜の決意をこめたナイフ弾幕！
PRINTFORML 「足止めさせていただきます！」	PRINTFORML 「足止めさせていただきます！」
PRINTFORMW 「体の力が…上手く入らない…」	PRINTFORMW 「体の力が…上手く入らない…」
PRINTFORMW 「お嬢様だけでも…どうか……」	PRINTFORMW 「お嬢様だけでも…どうか……」
PRINTFORMW 「振り払わないと、不味い…！」	PRINTFORMW 「振り払わないと、不味い…！」
PRINTFORMW 「な、何か生みつけたわね！？」	PRINTFORMW 「な、何か生みつけたわね！？」
PRINTFORMW 「早く出口を見つけたいですわ」	PRINTFORMW 「早く出口を見つけたいですわ」
PRINTFORMW 「あら…あなたも居ましたの？」	PRINTFORMW 「あら…あなたも居ましたの？」
PRINTFORML 「パチュリー様、お気をつけて」	PRINTFORML 「パチュリー様、お気をつけて」
PRINTFORMW 「絶対幻想郷に帰りましょうね」	PRINTFORMW 「絶対幻想郷に帰りましょうね」
PRINTFORMW 「必ず、紅魔館へ帰りましょう」	PRINTFORMW 「必ず、紅魔館へ帰りましょう」
PRINTFORML 「無理しなくてよろしいですよ」	PRINTFORML 「無理しなくてよろしいですよ」
PRINTFORMW 「魔法での殲滅、期待しますよ」	PRINTFORMW 「魔法での殲滅、期待しますよ」
PRINTFORMW 「絶対幻想郷へ帰りましょう！」	PRINTFORMW 「絶対幻想郷へ帰りましょう！」
PRINTFORMW 「一緒に脱出を目指しましょう」	PRINTFORMW 「一緒に脱出を目指しましょう」
PRINTFORML 「うぅっ…もう我慢出来ない…」	PRINTFORML 「うぅっ…もう我慢出来ない…」
PRINTFORML 「いえ、なんでもありませんわ」	PRINTFORML 「いえ、なんでもありませんわ」
PRINTFORML 「こ、こんなの信じられない！」	PRINTFORML 「こ、こんなの信じられない！」
PRINTFORML 「お掃除ならお手の物ですよ？」	PRINTFORML 「お掃除ならお手の物ですよ？」
PRINTFORML 「今敵と遭遇するのはまずい…」	PRINTFORML 「今敵と遭遇するのはまずい…」
PRINTFORML 「罠なんかに気をつけないとね」	PRINTFORML 「罠なんかに気をつけないとね」
PRINTFORMW 「初めてがこんな奴ねぇ…はぁ」	PRINTFORMW 「初めてがこんな奴ねぇ…はぁ」
PRINTFORMW 「今は争ってる場合じゃあ…！」	PRINTFORMW 「今は争ってる場合じゃあ…！」
PRINTFORMW 「お嬢様だけでもご無事なら…」	PRINTFORMW 「お嬢様だけでもご無事なら…」
PRINTFORMW 「私が周りを警戒してるから…」	PRINTFORMW 「私が周りを警戒してるから…」
PRINTFORML 「お嬢様、お休みくださいませ」	PRINTFORML 「お嬢様、お休みくださいませ」
PRINTFORMW 「嘘…お嬢様、そのお腹って…」	PRINTFORMW 「嘘…お嬢様、そのお腹って…」
PRINTFORMW 「そ、そこは触らないでっ…！」	PRINTFORMW 「そ、そこは触らないでっ…！」
PRINTFORMW 「見てから回避余裕、でしたわ」	PRINTFORMW 「見てから回避余裕、でしたわ」
PRINTFORML （妖夢、仇は取るわ…絶対に！）	PRINTFORML （妖夢、仇は取るわ…絶対に！）
PRINTFORML 「…霊夢でさえしくじる相手？」	PRINTFORML 「…霊夢でさえしくじる相手？」
PRINTFORMW 「息絶えて下さらないかしら」	PRINTFORMW 「息絶えて下さらないかしら」
PRINTFORMW 「小手調べといきましょうか」	PRINTFORMW 「小手調べといきましょうか」
PRINTFORMW 「いいんですか？ヤりますよ」	PRINTFORMW 「いいんですか？ヤりますよ」
PRINTFORMW 「もう…早く済ませなさいよ」	PRINTFORMW 「もう…早く済ませなさいよ」
PRINTFORMW 「やぁ、やめてくださいぃ♪」	PRINTFORMW 「やぁ、やめてくださいぃ♪」
PRINTFORMW 「来るっ♪ああっあああ～♪」	PRINTFORMW 「来るっ♪ああっあああ～♪」
PRINTFORMW 「とにかくもうやめ…んっ！」	PRINTFORMW 「とにかくもうやめ…んっ！」
PRINTFORML 「ぁぁ！ぁあぅ！ぁあ…ぁ…」	PRINTFORML 「ぁぁ！ぁあぅ！ぁあ…ぁ…」
PRINTFORMW 「やん♪はなしてください♪」	PRINTFORMW 「やん♪はなしてください♪」
PRINTFORMW 「ぃぃんんゃあぁあああぁ♪」	PRINTFORMW 「ぃぃんんゃあぁあああぁ♪」
PRINTFORMW 「そんなことよりもねえ…♪」	PRINTFORMW 「そんなことよりもねえ…♪」
PRINTFORMW 「ああ！破けちゃいました♪」	PRINTFORMW 「ああ！破けちゃいました♪」
PRINTFORMW 「しまったわ！こんな時に！」	PRINTFORMW 「しまったわ！こんな時に！」
PRINTFORMW 「あら、背中がお留守ですよ」	PRINTFORMW 「あら、背中がお留守ですよ」
PRINTFORMW 「ぁっ、ぁっ、あぁ」;３３３	PRINTFORMW 「ぁっ、ぁっ、あぁ」;３３３
PRINTFORMW 「ねえ、ちょっといいかしら」	PRINTFORMW 「ねえ、ちょっといいかしら」
PRINTFORMW 「こちらこそよろしくです♪」	PRINTFORMW 「こちらこそよろしくです♪」
PRINTFORMW 「目を、醒ましてください…」	PRINTFORMW 「目を、醒ましてください…」
PRINTFORMW （この感覚……まさかまた…）	PRINTFORMW （この感覚……まさかまた…）
PRINTFORMW 「また……生んじゃった……」	PRINTFORMW 「また……生んじゃった……」
PRINTFORMW 「まだ終わらないっていうの」	PRINTFORMW 「まだ終わらないっていうの」
PRINTFORMW 「少ししたら交代しましょう」	PRINTFORMW 「少ししたら交代しましょう」
PRINTFORMW 「なにか役に立つものは……」	PRINTFORMW 「なにか役に立つものは……」
PRINTFORMW 「拾いものはどうしましょう」	PRINTFORMW 「拾いものはどうしましょう」
PRINTFORMW 「私……一人でやっていくわ」	PRINTFORMW 「私……一人でやっていくわ」
PRINTFORMW 「何かいやーな予感がするわ」	PRINTFORMW 「何かいやーな予感がするわ」
PRINTFORMW 「お手柔らかにね、紳士さん」	PRINTFORMW 「お手柔らかにね、紳士さん」
PRINTFORMW 「やっ、なんてことするのよ」	PRINTFORMW 「やっ、なんてことするのよ」
PRINTFORMW 「何よこれ……離れなさいよ」	PRINTFORMW 「何よこれ……離れなさいよ」
PRINTFORMW 「や、ためて！零れちゃう！」	PRINTFORMW 「や、ためて！零れちゃう！」
PRINTFORMW 「無駄使いしないように、ね」	PRINTFORMW 「無駄使いしないように、ね」
PRINTFORMW 「この程度の痛みぐらい…！」	PRINTFORMW 「この程度の痛みぐらい…！」
PRINTFORMW 「ほらほら、こっちですよ？」	PRINTFORMW 「ほらほら、こっちですよ？」
PRINTFORMW 「そういうのは勘弁してっ！」	PRINTFORMW 「そういうのは勘弁してっ！」
PRINTFORMW 「…貞操帯が欲しくなるわね」	PRINTFORMW 「…貞操帯が欲しくなるわね」
PRINTFORMW 「触ってみなさい、切るわよ」	PRINTFORMW 「触ってみなさい、切るわよ」
PRINTFORML 「どこかで体を休めないと…」	PRINTFORML 「どこかで体を休めないと…」
PRINTFORMW 「私は先を急いでいますので」	PRINTFORMW 「私は先を急いでいますので」
PRINTFORMW 「私に…もっと力があれば…」	PRINTFORMW 「私に…もっと力があれば…」
PRINTFORML 「無理言ってごめんなさいね」	PRINTFORML 「無理言ってごめんなさいね」
PRINTFORMW 「いつも通りお供いたします」	PRINTFORMW 「いつも通りお供いたします」
PRINTFORMW 「紅魔館へお連れしましょう」	PRINTFORMW 「紅魔館へお連れしましょう」
PRINTFORML 「ふああああぁぁぁぁぁっ！」	PRINTFORML 「ふああああぁぁぁぁぁっ！」
PRINTFORMW 「ぐぅ！　はぁっ、はぁっ…」	PRINTFORMW 「ぐぅ！　はぁっ、はぁっ…」
PRINTFORMW （何…急に猛烈な吐き気が…）	PRINTFORMW （何…急に猛烈な吐き気が…）
PRINTFORML 「美鈴！？　しっかりして！」	PRINTFORML 「美鈴！？　しっかりして！」
PRINTFORMW 「…無理はなさらないように」	PRINTFORMW 「…無理はなさらないように」
PRINTFORMW 「フラン…おじょう、さま…」	PRINTFORMW 「フラン…おじょう、さま…」
PRINTFORMW 「敵が来ても私が守るから…」	PRINTFORMW 「敵が来ても私が守るから…」
PRINTFORMW （あれ…？　大丈夫そうね？）	PRINTFORMW （あれ…？　大丈夫そうね？）
PRINTFORML （あれ…？　大丈夫そうね？）	PRINTFORML （あれ…？　大丈夫そうね？）
PRINTFORMW 「嘘…美鈴、そのお腹って…」	PRINTFORMW 「嘘…美鈴、そのお腹って…」
PRINTFORMW 「嘘…妖夢、そのお腹って…」	PRINTFORMW 「嘘…妖夢、そのお腹って…」
PRINTFORMW （私が力尽きたときには……）	PRINTFORMW （私が力尽きたときには……）
PRINTFORMW 「文句言わないでください」	PRINTFORMW 「文句言わないでください」
PRINTFORMW 「さっ、触らないで下さい」	PRINTFORMW 「さっ、触らないで下さい」
PRINTFORMW 「その……分かるでしょ！」	PRINTFORMW 「その……分かるでしょ！」
PRINTFORMW 「……カラダがうずく……」	PRINTFORMW 「……カラダがうずく……」
PRINTFORMW 「えっ!?何があったの？」	PRINTFORMW 「えっ!?何があったの？」
PRINTFORMW 「ああもう、何やってるの」	PRINTFORMW 「ああもう、何やってるの」
PRINTFORMW 「この高ぶりは一体…！？」	PRINTFORMW 「この高ぶりは一体…！？」
PRINTFORMW 「こぷっ…………じゅる♪」	PRINTFORMW 「こぷっ…………じゅる♪」
PRINTFORMW 「ごほっ、ごほっ、酷い味」	PRINTFORMW 「ごほっ、ごほっ、酷い味」
PRINTFORMW 「ほいええふう……ちゅぷ」	PRINTFORMW 「ほいええふう……ちゅぷ」
PRINTFORMW 「今……何かされたかしら」	PRINTFORMW 「今……何かされたかしら」
PRINTFORMW 「不意打ち！気を付けて！」	PRINTFORMW 「不意打ち！気を付けて！」
PRINTFORMW 「あの姿…！まさか私の…」	PRINTFORMW 「あの姿…！まさか私の…」
PRINTFORMW 「ふう、お掃除 お掃除♪」	PRINTFORMW 「ふう、お掃除 お掃除♪」
PRINTFORMW 「また後で遊びましょう♪」	PRINTFORMW 「また後で遊びましょう♪」
PRINTFORMW 「ぅぅ……こんな時に……」	PRINTFORMW 「ぅぅ……こんな時に……」
PRINTFORMW (ぅぅ……もやもやするわ)	PRINTFORMW (ぅぅ……もやもやするわ)
PRINTFORMW 「ゃ……め…ゃ…」;４３３	PRINTFORMW 「ゃ……め…ゃ…」;４３３
PRINTFORMW 「ああ！こんなの、だめ！」	PRINTFORMW 「ああ！こんなの、だめ！」
PRINTFORMW 「お嬢様！なんてお姿に…」	PRINTFORMW 「お嬢様！なんてお姿に…」
PRINTFORMW 「ちょっと、大丈夫なの？」	PRINTFORMW 「ちょっと、大丈夫なの？」
PRINTFORMW 「あら、あなたもいたのね」	PRINTFORMW 「あら、あなたもいたのね」
PRINTFORMW 「ごめんなさい、でも……」	PRINTFORMW 「ごめんなさい、でも……」
PRINTFORMW 「さあ、お嬢様、ご命令を」	PRINTFORMW 「さあ、お嬢様、ご命令を」
PRINTFORMW 「な、何をするんですか！」	PRINTFORMW 「な、何をするんですか！」
PRINTFORMW 「こちらこそよろしくね	」	PRINTFORMW 「こちらこそよろしくね	」
PRINTFORMW 「ちょっと考えちゃいます」	PRINTFORMW 「ちょっと考えちゃいます」
PRINTFORML (まさか、また……あ……)	PRINTFORML (まさか、また……あ……)
PRINTFORMW （気のせい……だったの？）	PRINTFORMW （気のせい……だったの？）
PRINTFORMW 「なんて……悪い冗談……」	PRINTFORMW 「なんて……悪い冗談……」
PRINTFORMW 「ふ……う…はぁ…あぁあ」	PRINTFORMW 「ふ……う…はぁ…あぁあ」
PRINTFORMW 「何も出てきませんように」	PRINTFORMW 「何も出てきませんように」
PRINTFORMW 「ふう、これで安心かしら」	PRINTFORMW 「ふう、これで安心かしら」
PRINTFORMW 「さあ、何があるのかしら」	PRINTFORMW 「さあ、何があるのかしら」
PRINTFORMW 「ちょっと待ってみましょ」	PRINTFORMW 「ちょっと待ってみましょ」
PRINTFORMW 「これでひとまずは安全ね」	PRINTFORMW 「これでひとまずは安全ね」
PRINTFORMW 「や、ためて！零れちゃう！	PRINTFORMW 「や、ためて！零れちゃう！
PRINTFORMW 「私を捉えられるかしら？」	PRINTFORMW 「私を捉えられるかしら？」
PRINTFORMW 「体制を立て直しましょう」	PRINTFORMW 「体制を立て直しましょう」
PRINTFORML 「体が…アツい…くぅっ！」	PRINTFORML 「体が…アツい…くぅっ！」
PRINTFORML 「こういうのはいかが！？」	PRINTFORML 「こういうのはいかが！？」
PRINTFORMW 「まとめて…潰してやる…」	PRINTFORMW 「まとめて…潰してやる…」
PRINTFORMW 「一掃して差し上げますわ」	PRINTFORMW 「一掃して差し上げますわ」
PRINTFORMW 「そこ、がら空きですね！」	PRINTFORMW 「そこ、がら空きですね！」
PRINTFORMW 「もしかしてソコが弱点？」	PRINTFORMW 「もしかしてソコが弱点？」
PRINTFORMW 「こんな…ところでっ……」	PRINTFORMW 「こんな…ところでっ……」
PRINTFORMW 「うぐっ！…あ…あぁ……」	PRINTFORMW 「うぐっ！…あ…あぁ……」
PRINTFORMW 「直すのも一苦労なのよ！」	PRINTFORMW 「直すのも一苦労なのよ！」
PRINTFORMW 「ぐうっ！　ま、まだ……」	PRINTFORMW 「ぐうっ！　ま、まだ……」
PRINTFORMW 「まだ倒れるわけには…！」	PRINTFORMW 「まだ倒れるわけには…！」
PRINTFORML 「だめっ、体が火照って…」	PRINTFORML 「だめっ、体が火照って…」
PRINTFORMW 「まだ…諦めるわけには…」	PRINTFORMW 「まだ…諦めるわけには…」
PRINTFORMW 「ナイフを回収しないと…」	PRINTFORMW 「ナイフを回収しないと…」
PRINTFORML 「お嬢様、お気をつけて…」	PRINTFORML 「お嬢様、お気をつけて…」
PRINTFORMW 「それでは、お気をつけて」	PRINTFORMW 「それでは、お気をつけて」
PRINTFORMW 「それじゃあ、気をつけて」	PRINTFORMW 「それじゃあ、気をつけて」
PRINTFORMW 「お気をつけくださいませ」	PRINTFORMW 「お気をつけくださいませ」
PRINTFORML 「ど、どうしてですか！？」	PRINTFORML 「ど、どうしてですか！？」
PRINTFORMW 「そうですか…では、また」	PRINTFORMW 「そうですか…では、また」
PRINTFORML 「お任せください、お嬢様」	PRINTFORML 「お任せください、お嬢様」
PRINTFORMW 「…完全に油断していたわ」	PRINTFORMW 「…完全に油断していたわ」
PRINTFORMW 「い、いや……ううぅっ！」	PRINTFORMW 「い、いや……ううぅっ！」
PRINTFORMW 「いえ、何かの間違いよ…」	PRINTFORMW 「いえ、何かの間違いよ…」
PRINTFORML 「今探し回るのは危険ね…」	PRINTFORML 「今探し回るのは危険ね…」
PRINTFORML 「来るなら、来てみなさい」	PRINTFORML 「来るなら、来てみなさい」
PRINTFORMW 「ほら、もうこれで大丈夫」	PRINTFORMW 「ほら、もうこれで大丈夫」
PRINTFORMW 「…無理はしないようにね」	PRINTFORMW 「…無理はしないようにね」
PRINTFORMW 「美鈴、気分が悪そうね…」	PRINTFORMW 「美鈴、気分が悪そうね…」
PRINTFORML 「少し休んでいてください」	PRINTFORML 「少し休んでいてください」
PRINTFORML 「お嬢様の！？　まさか…」	PRINTFORML 「お嬢様の！？　まさか…」
PRINTFORML 「…おじょう……さま……」	PRINTFORML 「…おじょう……さま……」
PRINTFORMW 「…仇は取ってあげるわよ」	PRINTFORMW 「…仇は取ってあげるわよ」
PRINTFORMW 「いい加減にして頂戴！」	PRINTFORMW 「いい加減にして頂戴！」
PRINTFORMW 「あぁ……早くシなきゃ」	PRINTFORMW 「あぁ……早くシなきゃ」
PRINTFORMW 「今からそうなるのよ♪」	PRINTFORMW 「今からそうなるのよ♪」
PRINTFORMW 「んぃぃぃぃぃぁぁ！！」	PRINTFORMW 「んぃぃぃぃぃぁぁ！！」
PRINTFORMW 「あら、ごめんなさい♪」	PRINTFORMW 「あら、ごめんなさい♪」
PRINTFORMW 「あら、背中がお留守よ」	PRINTFORMW 「あら、背中がお留守よ」
PRINTFORMW 「手ごたえありませんね」	PRINTFORMW 「手ごたえありませんね」
PRINTFORMW 「なにかあったかしら？」	PRINTFORMW 「なにかあったかしら？」
PRINTFORMW 「皆でお屋敷に帰るわよ」	PRINTFORMW 「皆でお屋敷に帰るわよ」
PRINTFORMW 「さあ、妹様、ご命令を」	PRINTFORMW 「さあ、妹様、ご命令を」
PRINTFORMW 「さあ、頑張りましょう」	PRINTFORMW 「さあ、頑張りましょう」
PRINTFORMW 「ああ……何でもないわ」	PRINTFORMW 「ああ……何でもないわ」
PRINTFORMW （もう……戻れない……）	PRINTFORMW （もう……戻れない……）
PRINTFORMW 「ふ……う…はぁ…あぁ」	PRINTFORMW 「ふ……う…はぁ…あぁ」
PRINTFORMW 「ありがとう、助かるわ」	PRINTFORMW 「ありがとう、助かるわ」
PRINTFORMW 「そして時は流れ始める」	PRINTFORMW 「そして時は流れ始める」
PRINTFORMW 「覚悟決めて、行くわよ」	PRINTFORMW 「覚悟決めて、行くわよ」
PRINTFORMW 「ちょっと疲れたかしら」	PRINTFORMW 「ちょっと疲れたかしら」
PRINTFORMW 「気持ち悪いところよね」	PRINTFORMW 「気持ち悪いところよね」
PRINTFORMW 「ゆっくり休みましょう」	PRINTFORMW 「ゆっくり休みましょう」
PRINTFORMW 「正直……気持ち悪いわ」	PRINTFORMW 「正直……気持ち悪いわ」
PRINTFORMW 「保険証とかないかしら」	PRINTFORMW 「保険証とかないかしら」
PRINTFORMW 「何よ……何なのよもう」	PRINTFORMW 「何よ……何なのよもう」
PRINTFORMW 「ガスは私でも危険だわ」	PRINTFORMW 「ガスは私でも危険だわ」
PRINTFORMW 「先を急がせて頂きます」	PRINTFORMW 「先を急がせて頂きます」
PRINTFORMW 「お、落ち着くのよ…！」	PRINTFORMW 「お、落ち着くのよ…！」
PRINTFORMW 「ここは駄目なのよっ！」	PRINTFORMW 「ここは駄目なのよっ！」
PRINTFORML 「こ、殺して…やるっ…」	PRINTFORML 「こ、殺して…やるっ…」
PRINTFORML 「…お…じょう…さ……」	PRINTFORML 「…お…じょう…さ……」
PRINTFORMW 「か、回避できた…！？」	PRINTFORMW 「か、回避できた…！？」
PRINTFORMW 「まだよ、まだ戦える…」	PRINTFORMW 「まだよ、まだ戦える…」
PRINTFORMW （おじょう……さま……）	PRINTFORMW （おじょう……さま……）
PRINTFORMW 「絶対に許さないわよ！」	PRINTFORMW 「絶対に許さないわよ！」
PRINTFORML 「恥ずかしくないわよ…」	PRINTFORML 「恥ずかしくないわよ…」
PRINTFORML 「ぱ、パチュリー様！？」	PRINTFORML 「ぱ、パチュリー様！？」
PRINTFORML 「ふ、フランお嬢様！？」	PRINTFORML 「ふ、フランお嬢様！？」
PRINTFORMW 「ありがとう。助かるわ」	PRINTFORMW 「ありがとう。助かるわ」
PRINTFORMW 「どうか、お気をつけて」	PRINTFORMW 「どうか、お気をつけて」
PRINTFORMW 「そちらもお気をつけて」	PRINTFORMW 「そちらもお気をつけて」
PRINTFORMW 「一旦ここでお別れです」	PRINTFORMW 「一旦ここでお別れです」
PRINTFORML 「もういっそ殺してよ…」	PRINTFORML 「もういっそ殺してよ…」
PRINTFORML 「だ、大丈夫かしら…？」	PRINTFORML 「だ、大丈夫かしら…？」
PRINTFORMW 「ま、待って…い、嫌…」	PRINTFORMW 「ま、待って…い、嫌…」
PRINTFORMW 「よろしくお願いします」	PRINTFORMW 「よろしくお願いします」
PRINTFORMW 「お嬢様によろしくね…」	PRINTFORMW 「お嬢様によろしくね…」
PRINTFORML 「……お嬢…さ…ま……」	PRINTFORML 「……お嬢…さ…ま……」
PRINTFORMW 「何この寒気。まさか…」	PRINTFORMW 「何この寒気。まさか…」
PRINTFORMW 「妙な寒気と吐き気が…」	PRINTFORMW 「妙な寒気と吐き気が…」
PRINTFORML 「美鈴の！？　まさか…」	PRINTFORML 「美鈴の！？　まさか…」
PRINTFORMW 「…仇は取ってあげるわ」	PRINTFORMW 「…仇は取ってあげるわ」
PRINTFORML 「…よ……よう、む……」	PRINTFORML 「…よ……よう、む……」
PRINTFORML 「霊夢の！？　まさか…」	PRINTFORML 「霊夢の！？　まさか…」
PRINTFORML 「魔理沙！？　まさか…」	PRINTFORML 「魔理沙！？　まさか…」
PRINTFORML 「鈴仙の！？　まさか…」	PRINTFORML 「鈴仙の！？　まさか…」
PRINTFORMW 「退かせてもらうわね」	PRINTFORMW 「退かせてもらうわね」
PRINTFORMW 「ここが弱いんですね」	PRINTFORMW 「ここが弱いんですね」
PRINTFORMW 「討たせてもらいます」	PRINTFORMW 「討たせてもらいます」
PRINTFORMW 「ぁぁ……ゃめ…て…」	PRINTFORMW 「ぁぁ……ゃめ…て…」
PRINTFORMW 「いぁ……いゃあ……」	PRINTFORMW 「いぁ……いゃあ……」
PRINTFORMW 「こんな……屈辱が…」	PRINTFORMW 「こんな……屈辱が…」
PRINTFORMW 「お願い…ここに……」	PRINTFORMW 「お願い…ここに……」
PRINTFORMW 「じゃ、番を頼むわね」	PRINTFORMW 「じゃ、番を頼むわね」
PRINTFORML ;１９１（タイミング？	PRINTFORML ;１９１（タイミング？
PRINTFORMW 「じゃ♪もう一回ね♪」	PRINTFORMW 「じゃ♪もう一回ね♪」
PRINTFORMW 「いまの……は……？」	PRINTFORMW 「いまの……は……？」
PRINTFORMW 「やっ！やめなさい！」	PRINTFORMW 「やっ！やめなさい！」
PRINTFORMW 「危ないことしますね」	PRINTFORMW 「危ないことしますね」
PRINTFORMW 「見ないでください！」	PRINTFORMW 「見ないでください！」
PRINTFORMW 「くっ…わざと服を…」	PRINTFORMW 「くっ…わざと服を…」
PRINTFORMW 「まさかあの敵は…？」	PRINTFORMW 「まさかあの敵は…？」
PRINTFORMW 「ひぃ！ぃぃぃぐぅ！」	PRINTFORMW 「ひぃ！ぃぃぃぐぅ！」
PRINTFORMW 「ぁっ、ん、ぁだめ！」	PRINTFORMW 「ぁっ、ん、ぁだめ！」
PRINTFORMW お嬢様！なんてお姿♪」	PRINTFORMW お嬢様！なんてお姿♪」
PRINTFORMW 「あら♪いいところに」	PRINTFORMW 「あら♪いいところに」
PRINTFORMW 「何か知りませんこと」	PRINTFORMW 「何か知りませんこと」
PRINTFORMW （体の調子が妙ね……）	PRINTFORMW （体の調子が妙ね……）
PRINTFORML (いよいよなのね……)	PRINTFORML (いよいよなのね……)
PRINTFORMW 「認めるしかないのね」	PRINTFORMW 「認めるしかないのね」
PRINTFORMW 「ふう……体が重いわ」	PRINTFORMW 「ふう……体が重いわ」
PRINTFORMW 「ここを乗り切れば…」	PRINTFORMW 「ここを乗り切れば…」
PRINTFORMW 「これで、ひとまずは」	PRINTFORMW 「これで、ひとまずは」
PRINTFORMW 「ゆっくり行きましょ」	PRINTFORMW 「ゆっくり行きましょ」
PRINTFORMW 「誰もいませんか―？」	PRINTFORMW 「誰もいませんか―？」
PRINTFORMW 「使えそうね、かなり」	PRINTFORMW 「使えそうね、かなり」
PRINTFORMW 「紅茶はないのかしら」	PRINTFORMW 「紅茶はないのかしら」
PRINTFORMW 「きっと仕掛け爆弾よ」	PRINTFORMW 「きっと仕掛け爆弾よ」
PRINTFORMW 「遊びはこれまでよ！」	PRINTFORMW 「遊びはこれまでよ！」
PRINTFORML 「手、手が震えて…！」	PRINTFORML 「手、手が震えて…！」
PRINTFORML 「こっちに来ないで！」	PRINTFORML 「こっちに来ないで！」
PRINTFORML 「本当に…面倒なっ！」	PRINTFORML 「本当に…面倒なっ！」
PRINTFORMW 「お、お尻は駄目っ！」	PRINTFORMW 「お、お尻は駄目っ！」
PRINTFORMW 「げぇっ！　うぅっ…」	PRINTFORMW 「げぇっ！　うぅっ…」
PRINTFORMW 「…今度は…何を……」	PRINTFORMW 「…今度は…何を……」
PRINTFORMW 「危ないわねぇ、もう」	PRINTFORMW 「危ないわねぇ、もう」
PRINTFORMW （体の震えが…くっ！）	PRINTFORMW （体の震えが…くっ！）
PRINTFORMW 「こんな…ところで…」	PRINTFORMW 「こんな…ところで…」
PRINTFORMW 「そんな程度でしたか」	PRINTFORMW 「そんな程度でしたか」
PRINTFORML 「…申し訳ありません」	PRINTFORML 「…申し訳ありません」
PRINTFORML 「ちょっと、美鈴！？」	PRINTFORML 「ちょっと、美鈴！？」
PRINTFORMW 「…大丈夫なのかしら」	PRINTFORMW 「…大丈夫なのかしら」
PRINTFORML 「美鈴、気をつけてね」	PRINTFORML 「美鈴、気をつけてね」
PRINTFORML 「ありがとうね、美鈴」	PRINTFORML 「ありがとうね、美鈴」
PRINTFORML 「無理しなくていいの」	PRINTFORML 「無理しなくていいの」
PRINTFORMW 「いつもと一緒ですね」	PRINTFORMW 「いつもと一緒ですね」
PRINTFORMW （火照りが冷めた…？）	PRINTFORMW （火照りが冷めた…？）
PRINTFORML 「ごほっ…ううっ……」	PRINTFORML 「ごほっ…ううっ……」
PRINTFORML 「はぁ、はぁ、はぁ…」	PRINTFORML 「はぁ、はぁ、はぁ…」
PRINTFORMW 「パチュリー…さま…」	PRINTFORMW 「パチュリー…さま…」
PRINTFORML 「い、嫌！　そこは…」	PRINTFORML 「い、嫌！　そこは…」
PRINTFORML 「妖夢！？　まさか…」	PRINTFORML 「妖夢！？　まさか…」
PRINTFORML 「早苗！？　まさか…」	PRINTFORML 「早苗！？　まさか…」
﻿PRINTFORMW 「今は……我慢……」	PRINTFORMW 「今は……我慢……」
PRINTFORMW 「これはどうかしら」	PRINTFORMW 「これはどうかしら」
PRINTFORMW 「容赦はしませんよ」	PRINTFORMW 「容赦はしませんよ」
PRINTFORMW 「さ、触らないで！」	PRINTFORMW 「さ、触らないで！」
PRINTFORML ;１３６　一度に頻出	PRINTFORML ;１３６　一度に頻出
PRINTFORMW 「嫌、嫌よ、ああ！」	PRINTFORMW 「嫌、嫌よ、ああ！」
PRINTFORMW 「ふう、やれやれね」	PRINTFORMW 「ふう、やれやれね」
PRINTFORMW 「やめてください！」	PRINTFORMW 「やめてください！」
PRINTFORMW 「お行儀が悪いわよ」	PRINTFORMW 「お行儀が悪いわよ」
PRINTFORMW 「躾けが悪いわよ！」	PRINTFORMW 「躾けが悪いわよ！」
PRINTFORMW 「もう……駄目……」	PRINTFORMW 「もう……駄目……」
PRINTFORMW 「だ♪駄目ですぅ♪」	PRINTFORMW 「だ♪駄目ですぅ♪」
PRINTFORMW 「私としたことが！」	PRINTFORMW 「私としたことが！」
PRINTFORMW 「ここまでくれば…」	PRINTFORMW 「ここまでくれば…」
PRINTFORMW 「ゃ……やめて……」	PRINTFORMW 「ゃ……やめて……」
PRINTFORMW 「は、はなしなさい」	PRINTFORMW 「は、はなしなさい」
PRINTFORML 「あら、あなたなの」	PRINTFORML 「あら、あなたなの」
PRINTFORMW 「楽しんでるのね♪」	PRINTFORMW 「楽しんでるのね♪」
PRINTFORMW 「あら素敵な恰好♪」	PRINTFORMW 「あら素敵な恰好♪」
PRINTFORML 「そんな、酷い……」	PRINTFORML 「そんな、酷い……」
PRINTFORML 「あっ、お嬢様……」	PRINTFORML 「あっ、お嬢様……」
PRINTFORMW 「さあ、頑張るわよ」	PRINTFORMW 「さあ、頑張るわよ」
PRINTFORMW ああ♪もうすぐ……♪	PRINTFORMW ああ♪もうすぐ……♪
PRINTFORMW 「結構疲れるものね」	PRINTFORMW 「結構疲れるものね」
PRINTFORMW 「悪いわね、お願い」	PRINTFORMW 「悪いわね、お願い」
PRINTFORMW 「今戦う訳には……」	PRINTFORMW 「今戦う訳には……」
PRINTFORMW 「罠はないかしら？」	PRINTFORMW 「罠はないかしら？」
PRINTFORMW 「今は動けないわね」	PRINTFORMW 「今は動けないわね」
PRINTFORMW 「なにかないかしら」	PRINTFORMW 「なにかないかしら」
PRINTFORMW 「茶葉でもいいわよ」	PRINTFORMW 「茶葉でもいいわよ」
PRINTFORMW 「ちょっと怖いわね」	PRINTFORMW 「ちょっと怖いわね」
PRINTFORMW 「何か……変な感じ」	PRINTFORMW 「何か……変な感じ」
PRINTFORMW 「Ｉ　Ｅ　Ｄ　！！」	PRINTFORMW 「Ｉ　Ｅ　Ｄ　！！」
PRINTFORML 十六夜咲夜の口上です	PRINTFORML 十六夜咲夜の口上です
PRINTFORMW 「まずは手堅く、ね」	PRINTFORMW 「まずは手堅く、ね」
PRINTFORMW 「これで終わりよ！」	PRINTFORMW 「これで終わりよ！」
PRINTFORMW 「あっ…ううっ……」	PRINTFORMW 「あっ…ううっ……」
PRINTFORMW 「お、お嬢…様……」	PRINTFORMW 「お、お嬢…様……」
PRINTFORMW 「余計な真似をっ！」	PRINTFORMW 「余計な真似をっ！」
PRINTFORMW 「ここまで…なの…」	PRINTFORMW 「ここまで…なの…」
PRINTFORMW 「た、助かった…？」	PRINTFORMW 「た、助かった…？」
PRINTFORML 「妖夢、気をつけて」	PRINTFORML 「妖夢、気をつけて」
PRINTFORML 「ありがとう、妖夢」	PRINTFORML 「ありがとう、妖夢」
PRINTFORML 「よろしくね、美鈴」	PRINTFORML 「よろしくね、美鈴」
PRINTFORML 「よろしくね、妖夢」	PRINTFORML 「よろしくね、妖夢」
PRINTFORMW 「背中は任せるわよ」	PRINTFORMW 「背中は任せるわよ」
PRINTFORMW 「まあ気をつけてね」	PRINTFORMW 「まあ気をつけてね」
PRINTFORMW 「背中は任せて頂戴」	PRINTFORMW 「背中は任せて頂戴」
PRINTFORML 「今日は体が軽いわ」	PRINTFORML 「今日は体が軽いわ」
PRINTFORML 「まさか、そんな！」	PRINTFORML 「まさか、そんな！」
PRINTFORML 「出口はまだなの…」	PRINTFORML 「出口はまだなの…」
PRINTFORML 「申し訳ありません」	PRINTFORML 「申し訳ありません」
PRINTFORMW 「美鈴…どうして…」	PRINTFORMW 「美鈴…どうして…」
PRINTFORMW 「…仇は取りますよ」	PRINTFORMW 「…仇は取りますよ」
PRINTFORMW 「時間が惜しい…」	PRINTFORMW 「時間が惜しい…」
PRINTFORMW 「待たせました！」	PRINTFORMW 「待たせました！」
PRINTFORMW 「止まりなさい！」	PRINTFORMW 「止まりなさい！」
PRINTFORMW 「逃がしませんよ」	PRINTFORMW 「逃がしませんよ」
PRINTFORMW 「ここを……ね？」	PRINTFORMW 「ここを……ね？」
PRINTFORMW 「もう……早く！」	PRINTFORMW 「もう……早く！」
PRINTFORMW 「うそ………私…」	PRINTFORMW 「うそ………私…」
PRINTFORMW 「ぁぅぅ……ぁぁ」	PRINTFORMW 「ぁぅぅ……ぁぁ」
PRINTFORMW 「当たりませんよ」	PRINTFORMW 「当たりませんよ」
PRINTFORMW 「こんなもの……」	PRINTFORMW 「こんなもの……」
PRINTFORMW 「痛いですよっ！」	PRINTFORMW 「痛いですよっ！」
PRINTFORMW 「まいたかしら？」	PRINTFORMW 「まいたかしら？」
PRINTFORMW 「ぁぁあああっ！」	PRINTFORMW 「ぁぁあああっ！」
PRINTFORMW 「や、やめなさい」	PRINTFORMW 「や、やめなさい」
PRINTFORMW 「パチュリー様！」	PRINTFORMW 「パチュリー様！」
PRINTFORML 「あっ、妹様……」	PRINTFORML 「あっ、妹様……」
PRINTFORMW 「ご機嫌いかが？」	PRINTFORMW 「ご機嫌いかが？」
PRINTFORMW 「大変だったわね」	PRINTFORMW 「大変だったわね」
PRINTFORMW 「大丈夫ですか？」	PRINTFORMW 「大丈夫ですか？」
PRINTFORMW 「大丈夫かしら？」	PRINTFORMW 「大丈夫かしら？」
PRINTFORMW 「共に戦いますわ」	PRINTFORMW 「共に戦いますわ」
PRINTFORMW 「心細いですわね」	PRINTFORMW 「心細いですわね」
PRINTFORMW 「おやすみなさい」	PRINTFORMW 「おやすみなさい」
PRINTFORMW 「今は動かないの」	PRINTFORMW 「今は動かないの」
PRINTFORMW 「誰か来るかしら」	PRINTFORMW 「誰か来るかしら」
PRINTFORMW 「勇者の気分だわ」	PRINTFORMW 「勇者の気分だわ」
PRINTFORMW 時は止まらなかった	PRINTFORMW 時は止まらなかった
PRINTFORMW 「泉はこりごりよ」	PRINTFORMW 「泉はこりごりよ」
PRINTFORMW 「いや！いやぁ！」	PRINTFORMW 「いや！いやぁ！」
PRINTFORMW 「やあ、もう嫌！」	PRINTFORMW 「やあ、もう嫌！」
PRINTFORMW 「これは……何？」	PRINTFORMW 「これは……何？」
PRINTFORMW 「当たらないわよ」	PRINTFORMW 「当たらないわよ」
PRINTFORMW 「お手柔らかにね」	PRINTFORMW 「お手柔らかにね」
PRINTFORML 「これは、どう！」	PRINTFORML 「これは、どう！」
PRINTFORML 「狙い撃ちよっ！」	PRINTFORML 「狙い撃ちよっ！」
PRINTFORMW 「狙い撃ちよっ！」	PRINTFORMW 「狙い撃ちよっ！」
PRINTFORMW 「狙い打ちよっ！」	PRINTFORMW 「狙い打ちよっ！」
PRINTFORMW 「一匹お掃除完了」	PRINTFORMW 「一匹お掃除完了」
PRINTFORMW 「まだ…私は……」	PRINTFORMW 「まだ…私は……」
PRINTFORMW 「体が…熱い……」	PRINTFORMW 「体が…熱い……」
PRINTFORML 「…ごめんなさい」	PRINTFORML 「…ごめんなさい」
PRINTFORML 「パチュリー様！」	PRINTFORML 「パチュリー様！」
PRINTFORML 「お、お嬢様！？」	PRINTFORML 「お、お嬢様！？」
PRINTFORML 「フランお嬢様！」	PRINTFORML 「フランお嬢様！」
PRINTFORML 「あら、魔理沙！」	PRINTFORML 「あら、魔理沙！」
PRINTFORML 「お供いたします」	PRINTFORML 「お供いたします」
PRINTFORMW 「大丈夫かしら…」	PRINTFORMW 「大丈夫かしら…」
PRINTFORMW 「あっ……うっ！」	PRINTFORMW 「あっ……うっ！」
PRINTFORML 「こ、これって…」	PRINTFORML 「こ、これって…」
PRINTFORML 「ごめんね、妖夢」	PRINTFORML 「ごめんね、妖夢」
PRINTFORML 「お、お尻に！？」	PRINTFORML 「お、お尻に！？」
PRINTFORMW 「あうぅっっっ！」	PRINTFORMW 「あうぅっっっ！」
PRINTFORML 「し、しまった！」	PRINTFORML 「し、しまった！」
PRINTFORML 「…この服は！？」	PRINTFORML 「…この服は！？」
PRINTFORMW 「待ちなさい！」	PRINTFORMW 「待ちなさい！」
PRINTFORMW 「しぶといわね」	PRINTFORMW 「しぶといわね」
PRINTFORMW 「逃がさない！」	PRINTFORMW 「逃がさない！」
PRINTFORMW 「いかがかしら」	PRINTFORMW 「いかがかしら」
PRINTFORMW 「気持ち悪い…」	PRINTFORMW 「気持ち悪い…」
PRINTFORMW 「がら空きね！」	PRINTFORMW 「がら空きね！」
PRINTFORMW 「離しなさい！」	PRINTFORMW 「離しなさい！」
PRINTFORMW 「や！やあっ！」	PRINTFORMW 「や！やあっ！」
PRINTFORMW 「そこだけは…」	PRINTFORMW 「そこだけは…」
PRINTFORMW 「や、やめて！」	PRINTFORMW 「や、やめて！」
PRINTFORMW 「ヨユーです♪」	PRINTFORMW 「ヨユーです♪」
PRINTFORMW 「危ないですね」	PRINTFORMW 「危ないですね」
PRINTFORMW 「やめ……て…」	PRINTFORMW 「やめ……て…」
PRINTFORMW 「えっ！敵襲？」	PRINTFORMW 「えっ！敵襲？」
PRINTFORMW 「まだイケるわ」	PRINTFORMW 「まだイケるわ」
PRINTFORMW 「まだいけるわ」	PRINTFORMW 「まだいけるわ」
PRINTFORMW 「えっ！敵!?」	PRINTFORMW 「えっ！敵!?」
PRINTFORMW 「つらいですね」	PRINTFORMW 「つらいですね」
PRINTFORMW パチュリー様！」	PRINTFORMW パチュリー様！」
PRINTFORMW なんて姿に…♪」	PRINTFORMW なんて姿に…♪」
PRINTFORMW 「あなたまで！」	PRINTFORMW 「あなたまで！」
PRINTFORMW 「なんてこと…」	PRINTFORMW 「なんてこと…」
PRINTFORMW 「お休みなさい」	PRINTFORMW 「お休みなさい」
PRINTFORMW 「ちょっと休憩」	PRINTFORMW 「ちょっと休憩」
PRINTFORMW 「どきなさい！」	PRINTFORMW 「どきなさい！」
PRINTFORMW 「覚悟決めてね」	PRINTFORMW 「覚悟決めてね」
PRINTFORMW 「やってやるわ」	PRINTFORMW 「やってやるわ」
PRINTFORMW 「こちらは……」	PRINTFORMW 「こちらは……」
PRINTFORML 「こ、これは！」	PRINTFORML 「こ、これは！」
PRINTFORMW 「やるわよ！！」	PRINTFORMW 「やるわよ！！」
PRINTFORMW 「あら～これは」	PRINTFORMW 「あら～これは」
PRINTFORMW 「あら助かるわ」	PRINTFORMW 「あら助かるわ」
PRINTFORMW 「危なかったわ」	PRINTFORMW 「危なかったわ」
PRINTFORMW 「な！横から！」	PRINTFORMW 「な！横から！」
PRINTFORMW 「子供だましね」	PRINTFORMW 「子供だましね」
PRINTFORMW 「なんか……変」	PRINTFORMW 「なんか……変」
PRINTFORMW 「ＩＥＤかしら」	PRINTFORMW 「ＩＥＤかしら」
PRINTFORMW 「危ないですわ」	PRINTFORMW 「危ないですわ」
PRINTFORML 「これでどう？」	PRINTFORML 「これでどう？」
PRINTFORMW 「変態の怪物め」	PRINTFORMW 「変態の怪物め」
PRINTFORMW 「んんんっ！？」	PRINTFORMW 「んんんっ！？」
PRINTFORMW 「この変態…！」	PRINTFORMW 「この変態…！」
PRINTFORMW 「しまっ…！？」	PRINTFORMW 「しまっ…！？」
PRINTFORMW 「んんんっ…！」	PRINTFORMW 「んんんっ…！」
PRINTFORML 「あら、霊夢！」	PRINTFORML 「あら、霊夢！」
PRINTFORML 「私は偽者です」	PRINTFORML 「私は偽者です」
PRINTFORMW 「…冗談ですよ」	PRINTFORMW 「…冗談ですよ」
PRINTFORMW 「お気をつけて」	PRINTFORMW 「お気をつけて」
PRINTFORML 「…そうですか」	PRINTFORML 「…そうですか」
PRINTFORMW 「気をつけてね」	PRINTFORMW 「気をつけてね」
PRINTFORML 「誰か居る！？」	PRINTFORML 「誰か居る！？」
PRINTFORML 「はぁ、はぁ…」	PRINTFORML 「はぁ、はぁ…」
PRINTFORMW 「…うぅ………」	PRINTFORMW 「…うぅ………」
PRINTFORMW 「…そうですか」	PRINTFORMW 「…そうですか」
PRINTFORMW （ひ、酷い……）	PRINTFORMW （ひ、酷い……）
PRINTFORML 「む、胸に！？」	PRINTFORML 「む、胸に！？」
PRINTFORMW 「これで十分」	PRINTFORMW 「これで十分」
PRINTFORMW 「がらあきね」	PRINTFORMW 「がらあきね」
PRINTFORMW 「とどめッ！」	PRINTFORMW 「とどめッ！」
PRINTFORMW 「刺します！」	PRINTFORMW 「刺します！」
PRINTFORML 「ええい……」	PRINTFORML 「ええい……」
PRINTFORMW スパーーン！！	PRINTFORMW スパーーン！！
PRINTFORMW 「ごくっ……」	PRINTFORMW 「ごくっ……」
PRINTFORMW 「さ、次、次」	PRINTFORMW 「さ、次、次」
PRINTFORMW 「んん………」	PRINTFORMW 「んん………」
PRINTFORMW 「んんぅ……」	PRINTFORMW 「んんぅ……」
PRINTFORMW 「ひゃぁん♪」	PRINTFORMW 「ひゃぁん♪」
PRINTFORMW 「しまった！」	PRINTFORMW 「しまった！」
PRINTFORMW 「ぁ……ぁ…」	PRINTFORMW 「ぁ……ぁ…」
PRINTFORMW 「仕留めるわ」	PRINTFORMW 「仕留めるわ」
PRINTFORMW 「さ、次です」	PRINTFORMW 「さ、次です」
PRINTFORMW 「や、やめて」	PRINTFORMW 「や、やめて」
PRINTFORMW あなたまで！」	PRINTFORMW あなたまで！」
PRINTFORMW 「メイリン！」	PRINTFORMW 「メイリン！」
PRINTFORMW 「浄化開始！」	PRINTFORMW 「浄化開始！」
PRINTFORMW 「行きましょ」	PRINTFORMW 「行きましょ」
PRINTFORMW 「ぁえ……？」	PRINTFORMW 「ぁえ……？」
PRINTFORMW 「あら、素敵」	PRINTFORMW 「あら、素敵」
PRINTFORMW 「怪しいわね」	PRINTFORMW 「怪しいわね」
PRINTFORMW 「お断りだわ」	PRINTFORMW 「お断りだわ」
PRINTFORML 文字色は薄い青	PRINTFORML 文字色は薄い青
PRINTFORMW 「い、痛っ！」	PRINTFORMW 「い、痛っ！」
PRINTFORMW 「きゃあっ！」	PRINTFORMW 「きゃあっ！」
PRINTFORMW 「破廉恥な！」	PRINTFORMW 「破廉恥な！」
PRINTFORMW 「よろしくね」	PRINTFORMW 「よろしくね」
PRINTFORMW 「んっ…！？」	PRINTFORMW 「んっ…！？」
PRINTFORML 「うぐっ！？」	PRINTFORML 「うぐっ！？」
PRINTFORML 「あ、あれ…」	PRINTFORML 「あ、あれ…」
PRINTFORML 「許せない…」	PRINTFORML 「許せない…」
PRINTFORMW 「時間が…」	PRINTFORMW 「時間が…」
PRINTFORMW 「射てっ！」	PRINTFORMW 「射てっ！」
PRINTFORMW 「いざっ！」	PRINTFORMW 「いざっ！」
PRINTFORMW 「それっ！」	PRINTFORMW 「それっ！」
PRINTFORMW 「お時間を」	PRINTFORMW 「お時間を」
PRINTFORMW 「えい！！」	PRINTFORMW 「えい！！」
PRINTFORMW 「とう！！」	PRINTFORMW 「とう！！」
PRINTFORMW 「ぃぁあ！」	PRINTFORMW 「ぃぁあ！」
PRINTFORMW 「ごくっ…」	PRINTFORMW 「ごくっ…」
PRINTFORMW 「あぐっ！」	PRINTFORMW 「あぐっ！」
PRINTFORMW 「しまっｔ」	PRINTFORMW 「しまっｔ」
PRINTFORMW 「平気よ！」	PRINTFORMW 「平気よ！」
PRINTFORMW 「つっ！♪」	PRINTFORMW 「つっ！♪」
PRINTFORMW 「やぁん♪」	PRINTFORMW 「やぁん♪」
PRINTFORMW 「危ない！」	PRINTFORMW 「危ない！」
PRINTFORMW 「ぃや……」	PRINTFORMW 「ぃや……」
PRINTFORMW メイリン！」	PRINTFORMW メイリン！」
PRINTFORMW 「頼むわね」	PRINTFORMW 「頼むわね」
PRINTFORMW 「一段落ね」	PRINTFORMW 「一段落ね」
PRINTFORMW 「進むわよ」	PRINTFORMW 「進むわよ」
PRINTFORMW 「いいわね」	PRINTFORMW 「いいわね」
PRINTFORMW 「貴重品ね」	PRINTFORMW 「貴重品ね」
PRINTFORMW 「あら素敵」	PRINTFORMW 「あら素敵」
PRINTFORML 「そう……」	PRINTFORML 「そう……」
PRINTFORMW 「ぁあ……」	PRINTFORMW 「ぁあ……」
PRINTFORMW 「痛いっ！」	PRINTFORMW 「痛いっ！」
PRINTFORML 作：だおもん	PRINTFORML 作：だおもん
PRINTFORMW 「…すけべ」	PRINTFORMW 「…すけべ」
PRINTFORMW 「きゃっ！」	PRINTFORMW 「きゃっ！」
PRINTFORML 「あぁ……」	PRINTFORML 「あぁ……」
PRINTFORML 「妖夢！？」	PRINTFORML 「妖夢！？」
PRINTFORML 「ごめんね」	PRINTFORML 「ごめんね」
PRINTFORML 「んん！？」	PRINTFORML 「んん！？」
PRINTFORMW 「…最悪ね」	PRINTFORMW 「…最悪ね」
PRINTFORML 「うぅ……」	PRINTFORML 「うぅ……」
PRINTFORMW 「今よ！」	PRINTFORMW 「今よ！」
PRINTFORMW 「ちっ！」	PRINTFORMW 「ちっ！」
PRINTFORMW 「くっ！」	PRINTFORMW 「くっ！」
PRINTFORMW 「やっ！」	PRINTFORMW 「やっ！」
PRINTFORMW 「はっ！」	PRINTFORMW 「はっ！」
PRINTFORMW 「布石ね」	PRINTFORMW 「布石ね」
PRINTFORMW 「えい！」	PRINTFORMW 「えい！」
PRINTFORMW 「とう！」	PRINTFORMW 「とう！」
PRINTFORMW 「や！！」	PRINTFORMW 「や！！」
PRINTFORMW 「あ……」	PRINTFORMW 「あ……」
PRINTFORML 「えい！」	PRINTFORML 「えい！」
PRINTFORML ;２１２１	PRINTFORML ;２１２１
PRINTFORMW 「痛っ！」	PRINTFORMW 「痛っ！」
PRINTFORMW 「妹様！」	PRINTFORMW 「妹様！」
PRINTFORMW 「探検ね」	PRINTFORMW 「探検ね」
PRINTFORMW 「ん…ぁ」	PRINTFORMW 「ん…ぁ」
PRINTFORMW 「遅い！」	PRINTFORMW 「遅い！」
PRINTFORML 「…ふぅ」	PRINTFORML 「…ふぅ」
PRINTFORML 「美鈴！」	PRINTFORML 「美鈴！」
PRINTFORML 「妖夢！」	PRINTFORML 「妖夢！」
PRINTFORML 「おっと」	PRINTFORML 「おっと」
PRINTFORML 「…そう」	PRINTFORML 「…そう」
PRINTFORMW 「えい」	PRINTFORMW 「えい」
PRINTFORMW 「とう」	PRINTFORMW 「とう」
PRINTFORMW 「や！」	PRINTFORMW 「や！」
PRINTFORML ;１０５	PRINTFORML ;１０５
PRINTFORML ;１０６	PRINTFORML ;１０６
PRINTFORML ;１０７	PRINTFORML ;１０７
PRINTFORML ;１０９	PRINTFORML ;１０９
PRINTFORML ;１１１	PRINTFORML ;１１１
PRINTFORML ;１１２	PRINTFORML ;１１２
PRINTFORML ;１１３	PRINTFORML ;１１３
PRINTFORML ;１１５	PRINTFORML ;１１５
PRINTFORML ;１１６	PRINTFORML ;１１６
PRINTFORML ;１１７	PRINTFORML ;１１７
PRINTFORML ;１１９	PRINTFORML ;１１９
PRINTFORML ;１２０	PRINTFORML ;１２０
PRINTFORML ;１２１	PRINTFORML ;１２１
PRINTFORML ;１２２	PRINTFORML ;１２２
PRINTFORML ;１２３	PRINTFORML ;１２３
PRINTFORML ;１２４	PRINTFORML ;１２４
PRINTFORML ;１２５	PRINTFORML ;１２５
PRINTFORML ;１２６	PRINTFORML ;１２６
PRINTFORML ;１２７	PRINTFORML ;１２７
PRINTFORML ;１２８	PRINTFORML ;１２８
PRINTFORML ;１２９	PRINTFORML ;１２９
PRINTFORML ;１３０	PRINTFORML ;１３０
PRINTFORML ;１３１	PRINTFORML ;１３１
PRINTFORML ;１３２	PRINTFORML ;１３２
PRINTFORML ;１３３	PRINTFORML ;１３３
PRINTFORML ;１３４	PRINTFORML ;１３４
PRINTFORML ;１３５	PRINTFORML ;１３５
PRINTFORML ;１３７	PRINTFORML ;１３７
PRINTFORML ;１３８	PRINTFORML ;１３８
PRINTFORML ;１３９	PRINTFORML ;１３９
PRINTFORML ;１４０	PRINTFORML ;１４０
PRINTFORML ;１４１	PRINTFORML ;１４１
PRINTFORML ;１４２	PRINTFORML ;１４２
PRINTFORML ;１４３	PRINTFORML ;１４３
PRINTFORML ;１４４	PRINTFORML ;１４４
PRINTFORML ;１４５	PRINTFORML ;１４５
PRINTFORML ;１４６	PRINTFORML ;１４６
PRINTFORML ;１４８	PRINTFORML ;１４８
PRINTFORML ;１４９	PRINTFORML ;１４９
PRINTFORML ;１５０	PRINTFORML ;１５０
PRINTFORML ;１５１	PRINTFORML ;１５１
PRINTFORML ;１５２	PRINTFORML ;１５２
PRINTFORML ;１５３	PRINTFORML ;１５３
PRINTFORML ;１５４	PRINTFORML ;１５４
PRINTFORML ;１５５	PRINTFORML ;１５５
PRINTFORML ;１５６	PRINTFORML ;１５６
PRINTFORML ;１５７	PRINTFORML ;１５７
PRINTFORML ;１５８	PRINTFORML ;１５８
PRINTFORML ;１５９	PRINTFORML ;１５９
PRINTFORML ;１６０	PRINTFORML ;１６０
PRINTFORML ;１６１	PRINTFORML ;１６１
PRINTFORML ;１６３	PRINTFORML ;１６３
PRINTFORML ;１６４	PRINTFORML ;１６４
PRINTFORML ;１６５	PRINTFORML ;１６５
PRINTFORML ;１６６	PRINTFORML ;１６６
PRINTFORML ;１６７	PRINTFORML ;１６７
PRINTFORML ;１６８	PRINTFORML ;１６８
PRINTFORML ;１６９	PRINTFORML ;１６９
PRINTFORML ;１７０	PRINTFORML ;１７０
PRINTFORML ;１７１	PRINTFORML ;１７１
PRINTFORML ;１７２	PRINTFORML ;１７２
PRINTFORML ;１７３	PRINTFORML ;１７３
PRINTFORML ;１７４	PRINTFORML ;１７４
PRINTFORML ;１７５	PRINTFORML ;１７５
PRINTFORML ;１７６	PRINTFORML ;１７６
PRINTFORML ;１７７	PRINTFORML ;１７７
PRINTFORML ;１７８	PRINTFORML ;１７８
PRINTFORML ;１７９	PRINTFORML ;１７９
PRINTFORML ;１８０	PRINTFORML ;１８０
PRINTFORML ;１８１	PRINTFORML ;１８１
PRINTFORML ;１８２	PRINTFORML ;１８２
PRINTFORML ;１８３	PRINTFORML ;１８３
PRINTFORML ;１８４	PRINTFORML ;１８４
PRINTFORML ;１８５	PRINTFORML ;１８５
PRINTFORML ;１８６	PRINTFORML ;１８６
PRINTFORML ;１８８	PRINTFORML ;１８８
PRINTFORML ;１８９	PRINTFORML ;１８９
PRINTFORML ;１９０	PRINTFORML ;１９０
PRINTFORML ;１９２	PRINTFORML ;１９２
PRINTFORML ;１９３	PRINTFORML ;１９３
PRINTFORML ;１９４	PRINTFORML ;１９４
PRINTFORML ;１９５	PRINTFORML ;１９５
PRINTFORML ;１９６	PRINTFORML ;１９６
PRINTFORML ;１９７	PRINTFORML ;１９７
PRINTFORML ;１９８	PRINTFORML ;１９８
PRINTFORML ;１９９	PRINTFORML ;１９９
PRINTFORML ;２００	PRINTFORML ;２００
PRINTFORML ;２０１	PRINTFORML ;２０１
PRINTFORML ;２０２	PRINTFORML ;２０２
PRINTFORML ;２０３	PRINTFORML ;２０３
PRINTFORML ;２０４	PRINTFORML ;２０４
PRINTFORML ;２０５	PRINTFORML ;２０５
PRINTFORML ;２０６	PRINTFORML ;２０６
PRINTFORML ;２０７	PRINTFORML ;２０７
PRINTFORML ;２０８	PRINTFORML ;２０８
PRINTFORML ;２０９	PRINTFORML ;２０９
PRINTFORML ;２１０	PRINTFORML ;２１０
PRINTFORML ;２１１	PRINTFORML ;２１１
PRINTFORML ;２１２	PRINTFORML ;２１２
PRINTFORML ;２１３	PRINTFORML ;２１３
PRINTFORML ;２１４	PRINTFORML ;２１４
PRINTFORML ;２１５	PRINTFORML ;２１５
PRINTFORML ;２１６	PRINTFORML ;２１６
PRINTFORML ;２１７	PRINTFORML ;２１７
PRINTFORML ;２１８	PRINTFORML ;２１８
PRINTFORML ;２１９	PRINTFORML ;２１９
PRINTFORML ;２２０	PRINTFORML ;２２０
PRINTFORML ;２２１	PRINTFORML ;２２１
PRINTFORML ;２２２	PRINTFORML ;２２２
PRINTFORML ;２２３	PRINTFORML ;２２３
PRINTFORML ;２２４	PRINTFORML ;２２４
PRINTFORML ;２２５	PRINTFORML ;２２５
PRINTFORML ;２２６	PRINTFORML ;２２６
PRINTFORML ;２２７	PRINTFORML ;２２７
PRINTFORML ;２２８	PRINTFORML ;２２８
PRINTFORML ;２２９	PRINTFORML ;２２９
PRINTFORML ;２３０	PRINTFORML ;２３０
PRINTFORML ;２３１	PRINTFORML ;２３１
PRINTFORML ;２３２	PRINTFORML ;２３２
PRINTFORML ;２３３	PRINTFORML ;２３３
PRINTFORML ;２３４	PRINTFORML ;２３４
PRINTFORML ;２３５	PRINTFORML ;２３５
PRINTFORML ;２３６	PRINTFORML ;２３６
PRINTFORML ;２３７	PRINTFORML ;２３７
PRINTFORML ;２３８	PRINTFORML ;２３８
PRINTFORML ;２３９	PRINTFORML ;２３９
PRINTFORML ;２４０	PRINTFORML ;２４０
PRINTFORML ;２４１	PRINTFORML ;２４１
PRINTFORML ;２４２	PRINTFORML ;２４２
PRINTFORML ;２４３	PRINTFORML ;２４３
PRINTFORML ;２４４	PRINTFORML ;２４４
PRINTFORML ;２４５	PRINTFORML ;２４５
PRINTFORML ;２４６	PRINTFORML ;２４６
PRINTFORML ;２４７	PRINTFORML ;２４７
PRINTFORML ;２４８	PRINTFORML ;２４８
PRINTFORML ;２４９	PRINTFORML ;２４９
PRINTFORML ;２５０	PRINTFORML ;２５０
PRINTFORML ;２５１	PRINTFORML ;２５１
PRINTFORML ;２５２	PRINTFORML ;２５２
PRINTFORML ;２５３	PRINTFORML ;２５３
PRINTFORML ;２５４	PRINTFORML ;２５４
PRINTFORML ;２５５	PRINTFORML ;２５５
PRINTFORML ;２５６	PRINTFORML ;２５６
PRINTFORML ;２５７	PRINTFORML ;２５７
PRINTFORML ;２５８	PRINTFORML ;２５８
PRINTFORML ;２５９	PRINTFORML ;２５９
PRINTFORML ;２６０	PRINTFORML ;２６０
PRINTFORML ;２６１	PRINTFORML ;２６１
PRINTFORML ;２６２	PRINTFORML ;２６２
PRINTFORML ;２６３	PRINTFORML ;２６３
PRINTFORML ;２６４	PRINTFORML ;２６４
PRINTFORML ;２６５	PRINTFORML ;２６５
PRINTFORML ;２６６	PRINTFORML ;２６６
PRINTFORML ;２６７	PRINTFORML ;２６７
PRINTFORML ;２６８	PRINTFORML ;２６８
PRINTFORML ;２６９	PRINTFORML ;２６９
PRINTFORML ;２７０	PRINTFORML ;２７０
PRINTFORML ;２７１	PRINTFORML ;２７１
PRINTFORML ;２７２	PRINTFORML ;２７２
PRINTFORML ;２７３	PRINTFORML ;２７３
PRINTFORML ;２７４	PRINTFORML ;２７４
PRINTFORML ;２７５	PRINTFORML ;２７５
PRINTFORML ;２７６	PRINTFORML ;２７６
PRINTFORML ;２７７	PRINTFORML ;２７７
PRINTFORML ;２７８	PRINTFORML ;２７８
PRINTFORML ;２７９	PRINTFORML ;２７９
PRINTFORML ;２８０	PRINTFORML ;２８０
PRINTFORML ;２８１	PRINTFORML ;２８１
PRINTFORML ;２８２	PRINTFORML ;２８２
PRINTFORML ;２８３	PRINTFORML ;２８３
PRINTFORML ;２８４	PRINTFORML ;２８４
PRINTFORML ;２８５	PRINTFORML ;２８５
PRINTFORML ;２８６	PRINTFORML ;２８６
PRINTFORML ;２８７	PRINTFORML ;２８７
PRINTFORML ;２８８	PRINTFORML ;２８８
PRINTFORML ;２８９	PRINTFORML ;２８９
PRINTFORML ;２９０	PRINTFORML ;２９０
PRINTFORML ;２９１	PRINTFORML ;２９１
PRINTFORML ;２９２	PRINTFORML ;２９２
PRINTFORML ;２９３	PRINTFORML ;２９３
PRINTFORML ;２９４	PRINTFORML ;２９４
PRINTFORML ;２９５	PRINTFORML ;２９５
PRINTFORML ;２９６	PRINTFORML ;２９６
PRINTFORML ;２９７	PRINTFORML ;２９７
PRINTFORML ;２９８	PRINTFORML ;２９８
PRINTFORML ;２９９	PRINTFORML ;２９９
PRINTFORML ;３００	PRINTFORML ;３００
PRINTFORML ;３０１	PRINTFORML ;３０１
PRINTFORML ;３０２	PRINTFORML ;３０２
PRINTFORML ;３０３	PRINTFORML ;３０３
PRINTFORML ;３０４	PRINTFORML ;３０４
PRINTFORML ;３０５	PRINTFORML ;３０５
PRINTFORML ;３０６	PRINTFORML ;３０６
PRINTFORML ;３０７	PRINTFORML ;３０７
PRINTFORML ;３０８	PRINTFORML ;３０８
PRINTFORML ;３０９	PRINTFORML ;３０９
PRINTFORML ;３１０	PRINTFORML ;３１０
PRINTFORML ;３１１	PRINTFORML ;３１１
PRINTFORML ;３１２	PRINTFORML ;３１２
PRINTFORML ;３１３	PRINTFORML ;３１３
PRINTFORML ;３１４	PRINTFORML ;３１４
PRINTFORML ;３１５	PRINTFORML ;３１５
PRINTFORML ;３１６	PRINTFORML ;３１６
PRINTFORML ;３１７	PRINTFORML ;３１７
PRINTFORML ;３１８	PRINTFORML ;３１８
PRINTFORML ;３１９	PRINTFORML ;３１９
PRINTFORML ;３２０	PRINTFORML ;３２０
PRINTFORML ;３２１	PRINTFORML ;３２１
PRINTFORML ;３２２	PRINTFORML ;３２２
PRINTFORML ;３２３	PRINTFORML ;３２３
PRINTFORML ;３２４	PRINTFORML ;３２４
PRINTFORML ;３２５	PRINTFORML ;３２５
PRINTFORML ;３２６	PRINTFORML ;３２６
PRINTFORML ;３２７	PRINTFORML ;３２７
PRINTFORML ;３２８	PRINTFORML ;３２８
PRINTFORML ;３２９	PRINTFORML ;３２９
PRINTFORML ;３３０	PRINTFORML ;３３０
PRINTFORML ;３３１	PRINTFORML ;３３１
PRINTFORML ;３３２	PRINTFORML ;３３２
PRINTFORML ;３３３	PRINTFORML ;３３３
PRINTFORML ;３３４	PRINTFORML ;３３４
PRINTFORML ;３３５	PRINTFORML ;３３５
PRINTFORML ;３３６	PRINTFORML ;３３６
PRINTFORML ;３３７	PRINTFORML ;３３７
PRINTFORML ;３３８	PRINTFORML ;３３８
PRINTFORML ;３３９	PRINTFORML ;３３９
PRINTFORML ;３４０	PRINTFORML ;３４０
PRINTFORML ;３４１	PRINTFORML ;３４１
PRINTFORML ;３４２	PRINTFORML ;３４２
PRINTFORML ;３４３	PRINTFORML ;３４３
PRINTFORML ;３４４	PRINTFORML ;３４４
PRINTFORML ;３４５	PRINTFORML ;３４５
PRINTFORML ;３４６	PRINTFORML ;３４６
PRINTFORML ;３４７	PRINTFORML ;３４７
PRINTFORML ;３４８	PRINTFORML ;３４８
PRINTFORML ;３４９	PRINTFORML ;３４９
PRINTFORML ;３５０	PRINTFORML ;３５０
PRINTFORML ;３５１	PRINTFORML ;３５１
PRINTFORML ;３５２	PRINTFORML ;３５２
PRINTFORML ;３５３	PRINTFORML ;３５３
PRINTFORML ;３５４	PRINTFORML ;３５４
PRINTFORML ;３５５	PRINTFORML ;３５５
PRINTFORML ;３５６	PRINTFORML ;３５６
PRINTFORML ;３５７	PRINTFORML ;３５７
PRINTFORML ;３５８	PRINTFORML ;３５８
PRINTFORML ;３５９	PRINTFORML ;３５９
PRINTFORML ;３６０	PRINTFORML ;３６０
PRINTFORML ;３６１	PRINTFORML ;３６１
PRINTFORML ;３６２	PRINTFORML ;３６２
PRINTFORML ;３６３	PRINTFORML ;３６３
PRINTFORML ;３６４	PRINTFORML ;３６４
PRINTFORML ;３６５	PRINTFORML ;３６５
PRINTFORML ;３６６	PRINTFORML ;３６６
PRINTFORML ;３６７	PRINTFORML ;３６７
PRINTFORML ;３６８	PRINTFORML ;３６８
PRINTFORML ;３６９	PRINTFORML ;３６９
PRINTFORML ;３７０	PRINTFORML ;３７０
PRINTFORML ;３７１	PRINTFORML ;３７１
PRINTFORML ;３７２	PRINTFORML ;３７２
PRINTFORML ;３７３	PRINTFORML ;３７３
PRINTFORML ;３７４	PRINTFORML ;３７４
PRINTFORML ;３７５	PRINTFORML ;３７５
PRINTFORML ;３７６	PRINTFORML ;３７６
PRINTFORML ;３７７	PRINTFORML ;３７７
PRINTFORML ;３７８	PRINTFORML ;３７８
PRINTFORML ;３７９	PRINTFORML ;３７９
PRINTFORML ;３８０	PRINTFORML ;３８０
PRINTFORML ;３８１	PRINTFORML ;３８１
PRINTFORML ;３８２	PRINTFORML ;３８２
PRINTFORML ;３８３	PRINTFORML ;３８３
PRINTFORML ;３８４	PRINTFORML ;３８４
PRINTFORML ;３８５	PRINTFORML ;３８５
PRINTFORML ;３８６	PRINTFORML ;３８６
PRINTFORML ;３８７	PRINTFORML ;３８７
PRINTFORML ;３８８	PRINTFORML ;３８８
PRINTFORML ;３８９	PRINTFORML ;３８９
PRINTFORML ;３９０	PRINTFORML ;３９０
PRINTFORML ;３９１	PRINTFORML ;３９１
PRINTFORML ;３９２	PRINTFORML ;３９２
PRINTFORML ;３９３	PRINTFORML ;３９３
PRINTFORML ;３９４	PRINTFORML ;３９４
PRINTFORML ;３９５	PRINTFORML ;３９５
PRINTFORML ;３９６	PRINTFORML ;３９６
PRINTFORML ;３９７	PRINTFORML ;３９７
PRINTFORML ;３９８	PRINTFORML ;３９８
PRINTFORML ;３９９	PRINTFORML ;３９９
PRINTFORML ;４００	PRINTFORML ;４００
PRINTFORML ;４０１	PRINTFORML ;４０１
PRINTFORML ;４０２	PRINTFORML ;４０２
PRINTFORML ;４０３	PRINTFORML ;４０３
PRINTFORML ;４０４	PRINTFORML ;４０４
PRINTFORML ;４０５	PRINTFORML ;４０５
PRINTFORML ;４０６	PRINTFORML ;４０６
PRINTFORML ;４０７	PRINTFORML ;４０７
PRINTFORML ;４０８	PRINTFORML ;４０８
PRINTFORML ;４０９	PRINTFORML ;４０９
PRINTFORML ;４１０	PRINTFORML ;４１０
PRINTFORML ;４１１	PRINTFORML ;４１１
PRINTFORML ;４１２	PRINTFORML ;４１２
PRINTFORML ;４１３	PRINTFORML ;４１３
PRINTFORML ;４１４	PRINTFORML ;４１４
PRINTFORML ;４１５	PRINTFORML ;４１５
PRINTFORML ;４１６	PRINTFORML ;４１６
PRINTFORML ;４１７	PRINTFORML ;４１７
PRINTFORML ;４１８	PRINTFORML ;４１８
PRINTFORML ;４１９	PRINTFORML ;４１９
PRINTFORML ;４２０	PRINTFORML ;４２０
PRINTFORML ;４２１	PRINTFORML ;４２１
PRINTFORML ;４２２	PRINTFORML ;４２２
PRINTFORML ;４２３	PRINTFORML ;４２３
PRINTFORML ;４２４	PRINTFORML ;４２４
PRINTFORML ;４２５	PRINTFORML ;４２５
PRINTFORML ;４２６	PRINTFORML ;４２６
PRINTFORML ;４２７	PRINTFORML ;４２７
PRINTFORML ;４２８	PRINTFORML ;４２８
PRINTFORML ;４２９	PRINTFORML ;４２９
PRINTFORML ;４３０	PRINTFORML ;４３０
PRINTFORML ;４３１	PRINTFORML ;４３１
PRINTFORML ;４３２	PRINTFORML ;４３２
PRINTFORML ;４３３	PRINTFORML ;４３３
PRINTFORML ;４３４	PRINTFORML ;４３４
PRINTFORML ;４３５	PRINTFORML ;４３５
PRINTFORML ;４３６	PRINTFORML ;４３６
PRINTFORML ;４３７	PRINTFORML ;４３７
PRINTFORML ;４３８	PRINTFORML ;４３８
PRINTFORML ;４３９	PRINTFORML ;４３９
PRINTFORML ;４４０	PRINTFORML ;４４０
PRINTFORML ;４４１	PRINTFORML ;４４１
PRINTFORML ;４４２	PRINTFORML ;４４２
PRINTFORML ;４４３	PRINTFORML ;４４３
PRINTFORML ;４４４	PRINTFORML ;４４４
PRINTFORML ;４４５	PRINTFORML ;４４５
PRINTFORML ;４４６	PRINTFORML ;４４６
PRINTFORML ;４４７	PRINTFORML ;４４７
PRINTFORML ;４４８	PRINTFORML ;４４８
PRINTFORML ;４４９	PRINTFORML ;４４９
PRINTFORML ;４５０	PRINTFORML ;４５０
PRINTFORML ;４５１	PRINTFORML ;４５１
PRINTFORML ;４５２	PRINTFORML ;４５２
PRINTFORML ;４５３	PRINTFORML ;４５３
PRINTFORML ;４５４	PRINTFORML ;４５４
PRINTFORML ;４５５	PRINTFORML ;４５５
PRINTFORML ;４５６	PRINTFORML ;４５６
PRINTFORML ;４５７	PRINTFORML ;４５７
PRINTFORML ;４５８	PRINTFORML ;４５８
PRINTFORML ;４５９	PRINTFORML ;４５９
PRINTFORML ;４６０	PRINTFORML ;４６０
PRINTFORML ;４６１	PRINTFORML ;４６１
PRINTFORML ;４６２	PRINTFORML ;４６２
PRINTFORML ;４６３	PRINTFORML ;４６３
PRINTFORML ;４６４	PRINTFORML ;４６４
PRINTFORML ;４６５	PRINTFORML ;４６５
PRINTFORML ;４６６	PRINTFORML ;４６６
PRINTFORML ;４６７	PRINTFORML ;４６７
PRINTFORML ;４６８	PRINTFORML ;４６８
PRINTFORML ;４６９	PRINTFORML ;４６９
PRINTFORML ;４７０	PRINTFORML ;４７０
PRINTFORML ;４７１	PRINTFORML ;４７１
PRINTFORML ;４７２	PRINTFORML ;４７２
PRINTFORML ;４７３	PRINTFORML ;４７３
PRINTFORML ;４７４	PRINTFORML ;４７４
PRINTFORML ;４７５	PRINTFORML ;４７５
PRINTFORML ;４７６	PRINTFORML ;４７６
PRINTFORML ;４７７	PRINTFORML ;４７７
PRINTFORML ;４７８	PRINTFORML ;４７８
PRINTFORML ;４７９	PRINTFORML ;４７９
PRINTFORML ;４８０	PRINTFORML ;４８０
PRINTFORML ;４８１	PRINTFORML ;４８１
PRINTFORML ;４８２	PRINTFORML ;４８２
PRINTFORML ;４８３	PRINTFORML ;４８３
PRINTFORML ;４８４	PRINTFORML ;４８４
PRINTFORML ;４８５	PRINTFORML ;４８５
PRINTFORML ;４８６	PRINTFORML ;４８６
PRINTFORML ;４８７	PRINTFORML ;４８７
PRINTFORML ;４８８	PRINTFORML ;４８８
PRINTFORML ;４８９	PRINTFORML ;４８９
PRINTFORML ;４９０	PRINTFORML ;４９０
PRINTFORML ;４９１	PRINTFORML ;４９１
PRINTFORML ;４９２	PRINTFORML ;４９２
PRINTFORML ;４９３	PRINTFORML ;４９３
PRINTFORML ;４９４	PRINTFORML ;４９４
PRINTFORML ;４９５	PRINTFORML ;４９５
PRINTFORML ;４９６	PRINTFORML ;４９６
PRINTFORML ;４９７	PRINTFORML ;４９７
PRINTFORML ;４９８	PRINTFORML ;４９８
PRINTFORML ;４９９	PRINTFORML ;４９９
PRINTFORML ;５００	PRINTFORML ;５００
PRINTFORML ;５０１	PRINTFORML ;５０１
PRINTFORML ;５０２	PRINTFORML ;５０２
PRINTFORML ;５０３	PRINTFORML ;５０３
PRINTFORML ;５０４	PRINTFORML ;５０４
PRINTFORML ;５０５	PRINTFORML ;５０５
PRINTFORML ;５０６	PRINTFORML ;５０６
PRINTFORML ;５０７	PRINTFORML ;５０７
PRINTFORML ;５０８	PRINTFORML ;５０８
PRINTFORML ;５０９	PRINTFORML ;５０９
PRINTFORML ;５１０	PRINTFORML ;５１０
PRINTFORML ;５１１	PRINTFORML ;５１１
PRINTFORML ;５１２	PRINTFORML ;５１２
PRINTFORML ;５１３	PRINTFORML ;５１３
PRINTFORML ;５１４	PRINTFORML ;５１４
PRINTFORML ;５１５	PRINTFORML ;５１５
PRINTFORML ;５１６	PRINTFORML ;５１６
PRINTFORML ;５１７	PRINTFORML ;５１７
PRINTFORML ;５１８	PRINTFORML ;５１８
PRINTFORML ;５１９	PRINTFORML ;５１９
PRINTFORML ;５２０	PRINTFORML ;５２０
PRINTFORML ;５２１	PRINTFORML ;５２１
PRINTFORML ;５２２	PRINTFORML ;５２２
PRINTFORML ;５２３	PRINTFORML ;５２３
PRINTFORML ;５２４	PRINTFORML ;５２４
PRINTFORML ;５２５	PRINTFORML ;５２５
PRINTFORML ;５２６	PRINTFORML ;５２６
PRINTFORML ;５２７	PRINTFORML ;５２７
PRINTFORML ;５２８	PRINTFORML ;５２８
PRINTFORML ;５２９	PRINTFORML ;５２９
PRINTFORML ;５３０	PRINTFORML ;５３０
PRINTFORML ;５３１	PRINTFORML ;５３１
PRINTFORML ;５３２	PRINTFORML ;５３２
PRINTFORML ;５３３	PRINTFORML ;５３３
PRINTFORML ;５３４	PRINTFORML ;５３４
PRINTFORML ;５３５	PRINTFORML ;５３５
PRINTFORML ;５３６	PRINTFORML ;５３６
PRINTFORML ;５３７	PRINTFORML ;５３７
PRINTFORML ;５３８	PRINTFORML ;５３８
PRINTFORML ;５３９	PRINTFORML ;５３９
PRINTFORML ;５４０	PRINTFORML ;５４０
PRINTFORML ;５４１	PRINTFORML ;５４１
PRINTFORML ;５４２	PRINTFORML ;５４２
PRINTFORML ;５４３	PRINTFORML ;５４３
PRINTFORML ;５４４	PRINTFORML ;５４４
PRINTFORML ;５４５	PRINTFORML ;５４５
PRINTFORML ;５４６	PRINTFORML ;５４６
PRINTFORML ;５４７	PRINTFORML ;５４７
PRINTFORML ;５４８	PRINTFORML ;５４８
PRINTFORML ;５４９	PRINTFORML ;５４９
PRINTFORML ;５５０	PRINTFORML ;５５０
PRINTFORML ;５５１	PRINTFORML ;５５１
PRINTFORML ;５５２	PRINTFORML ;５５２
PRINTFORML ;５５３	PRINTFORML ;５５３
PRINTFORML ;５５４	PRINTFORML ;５５４
PRINTFORMW ;４１２	PRINTFORMW ;４１２
PRINTFORMW 「ああ♪	PRINTFORMW 「ああ♪
PRINTFORMW 妹様！」	PRINTFORMW 妹様！」
PRINTFORMW （ん？）	PRINTFORMW （ん？）
PRINTFORML 「……」	PRINTFORML 「……」
PRINTFORML 「っ！」	PRINTFORML 「っ！」
PRINTFORML 「うっ」	PRINTFORML 「うっ」
PRINTFORMW 「や」	PRINTFORMW 「や」
PRINTFORMW １６２	PRINTFORMW １６２
PRINTFORML 「…」	PRINTFORML 「…」
PRINTFORMW 「	PRINTFORMW 「
PRINTFORMW 	PRINTFORMW 
PRINTFORML 	PRINTFORML 
