//口上:

PRINTFORMDW ちらりと目をやった、露わになった%ARGS:1%の乳房。ぱくぱくと開いては乱暴の後を思わせる%ARGS:1%のヴァギナ	PRINTFORMDW ちらりと目をやった、露わになった%ARGS:1%の乳房。ぱくぱくと開いては乱暴の後を思わせる%ARGS:1%のヴァギナ
PRINTFORMDW わずかなの屠自古%TACHI()%の休息の時をあざ笑うかのように、妖しい蠢きが屠自古%TACHI()%の全身を包む…	PRINTFORMDW わずかなの屠自古%TACHI()%の休息の時をあざ笑うかのように、妖しい蠢きが屠自古%TACHI()%の全身を包む…
PRINTFORMDW 屠自古が陰茎を引き抜くと、%CALLNAME:1%と屠自古の精液のカクテルが%ARGS:1%の女陰から逆流した…	PRINTFORMDW 屠自古が陰茎を引き抜くと、%CALLNAME:1%と屠自古の精液のカクテルが%ARGS:1%の女陰から逆流した…
PRINTFORMDW 屠自古の股間で脈打つ剛直は、まるで屠自古と別の意思を持つかのようにふりふりと敵の攻撃を誘い、揺れている…	PRINTFORMDW 屠自古の股間で脈打つ剛直は、まるで屠自古と別の意思を持つかのようにふりふりと敵の攻撃を誘い、揺れている…
PRINTFORMDL 女の悦びとはまた違った快楽に屠自古は耐えきれず、直ぐに自らの肉棒を%ARGS:1%の奥にまで突っ込み、	PRINTFORMDL 女の悦びとはまた違った快楽に屠自古は耐えきれず、直ぐに自らの肉棒を%ARGS:1%の奥にまで突っ込み、
PRINTFORMDW 出し入れの度に体を跳ねさせる玩具を思うさま楽しんだ%ARGS:1%は一気に腸内のものを引き抜いた…	PRINTFORMDW 出し入れの度に体を跳ねさせる玩具を思うさま楽しんだ%ARGS:1%は一気に腸内のものを引き抜いた…
PRINTFORMW 「フフフ……ハッハッハッ！！…………アーーハッハッハ！！！！　チリ一つ残さず消滅させてやるわ！！」	PRINTFORMW 「フフフ……ハッハッハッ！！…………アーーハッハッハ！！！！　チリ一つ残さず消滅させてやるわ！！」
PRINTFORMW 「！！！！　ふきゅうあっ！！！　うあっ！！　し、にゅうっ！！！　トんじゃ、ううううぅぅっっ！！！」	PRINTFORMW 「！！！！　ふきゅうあっ！！！　うあっ！！　し、にゅうっ！！！　トんじゃ、ううううぅぅっっ！！！」
PRINTFORMDL ごぽっ、ごぽっ、と濁った射精音と共に%ARGS:1%の膣内を満たした屠自古のペニスが抜かれると、	PRINTFORMDL ごぽっ、ごぽっ、と濁った射精音と共に%ARGS:1%の膣内を満たした屠自古のペニスが抜かれると、
PRINTFORMDW 直ぐに屠自古は駆け寄り、声をかけたが反応が無い。どうやら心身共に擦り切れてしまっているようだ…	PRINTFORMDW 直ぐに屠自古は駆け寄り、声をかけたが反応が無い。どうやら心身共に擦り切れてしまっているようだ…
PRINTFORMDL 屠自古は%CALLNAME:1%が使用済みにも関わらず、精液の逆流する%ARGS:1%のナカへ	PRINTFORMDL 屠自古は%CALLNAME:1%が使用済みにも関わらず、精液の逆流する%ARGS:1%のナカへ
PRINTFORMDW 屠自古は膣内に幼体が排出される感触を味わいながら、駄々をこねる子供のように泣きじゃくっている	PRINTFORMDW 屠自古は膣内に幼体が排出される感触を味わいながら、駄々をこねる子供のように泣きじゃくっている
PRINTFORMDW 屠自古は凄惨な陵辱を受けたのか、意識が戻っても依然として心ここにあらず、といった様子であった	PRINTFORMDW 屠自古は凄惨な陵辱を受けたのか、意識が戻っても依然として心ここにあらず、といった様子であった
PRINTFORML 屠自古の股間にあったそれがむくむくと大きくなるにつれて、屠自古の頭に桃色の靄がかかっていった…	PRINTFORML 屠自古の股間にあったそれがむくむくと大きくなるにつれて、屠自古の頭に桃色の靄がかかっていった…
PRINTFORMDW 屠自古はいつもの強気な態度をかなぐり捨て、涙と陵辱でぐしゃぐしゃになった顔でこちらを見た…	PRINTFORMDW 屠自古はいつもの強気な態度をかなぐり捨て、涙と陵辱でぐしゃぐしゃになった顔でこちらを見た…
PRINTFORMDW まるで屠自古の一部であるように僅かな外気の流れを快楽に変換して屠自古の脳に送りつけている…	PRINTFORMDW まるで屠自古の一部であるように僅かな外気の流れを快楽に変換して屠自古の脳に送りつけている…
PRINTFORMDW でろりと擬似陰茎から排出された酷い臭いの白濁液が%ARGS:1%の股間から溢れ出していた…	PRINTFORMDW でろりと擬似陰茎から排出された酷い臭いの白濁液が%ARGS:1%の股間から溢れ出していた…
PRINTFORMDW 屠自古は自らの体内を押し広げる異物に眼球をぐるりと回し、涎を垂らしながら意識を飛ばした…	PRINTFORMDW 屠自古は自らの体内を押し広げる異物に眼球をぐるりと回し、涎を垂らしながら意識を飛ばした…
PRINTFORML 「まあ胸なんて大きくても邪魔なだけよ……って言ったらいつも太子様が凄い笑顔をなさるのよね」	PRINTFORML 「まあ胸なんて大きくても邪魔なだけよ……って言ったらいつも太子様が凄い笑顔をなさるのよね」
PRINTFORML 「うごぉっ！！　が、…！！　ぶあっ！　も、おっ！！　いぃ！！　いいからああぁぁっっ！！！」	PRINTFORML 「うごぉっ！！　が、…！！　ぶあっ！　も、おっ！！　いぃ！！　いいからああぁぁっっ！！！」
PRINTFORMDL 迷宮を進むと、屠自古は陵辱の末にあられもない姿で打ち捨てられた%ARGS:1%と出会った	PRINTFORMDL 迷宮を進むと、屠自古は陵辱の末にあられもない姿で打ち捨てられた%ARGS:1%と出会った
PRINTFORMDW かなり巨大な触手を相手にしていたのだろう、三本の指が難なく入り、淫靡な水音を立て始めた…	PRINTFORMDW かなり巨大な触手を相手にしていたのだろう、三本の指が難なく入り、淫靡な水音を立て始めた…
PRINTFORMDW 屠自古は不明瞭な呟きを漏らすと、%ARGS:1%の腿を両腕でつかみ、自らの方へ引き寄せた	PRINTFORMDW 屠自古は不明瞭な呟きを漏らすと、%ARGS:1%の腿を両腕でつかみ、自らの方へ引き寄せた
PRINTFORMW 「目に物見せてあげるわ！　天に十六地に八方！　ウォーホー　ツーベイ　イー　チャンガッ！」	PRINTFORMW 「目に物見せてあげるわ！　天に十六地に八方！　ウォーホー　ツーベイ　イー　チャンガッ！」
PRINTFORMDL 屠自古は口では皮肉っぽく言いながらも、後ろ髪を引かれている様にのろのろと去っていった…	PRINTFORMDL 屠自古は口では皮肉っぽく言いながらも、後ろ髪を引かれている様にのろのろと去っていった…
PRINTFORMDW 屠自古は触手の淫靡なうねりに身を任せ、%ARGS:0%が自分を見捨てた事にも気付かずに	PRINTFORMDW 屠自古は触手の淫靡なうねりに身を任せ、%ARGS:0%が自分を見捨てた事にも気付かずに
PRINTFORML 「言うなればあなたは三輪逆(みわのさかう)、恨むならあなたをこうした敵を恨みなさい……」	PRINTFORML 「言うなればあなたは三輪逆(みわのさかう)、恨むならあなたをこうした敵を恨みなさい……」
PRINTFORML それまで優しく纏わりついていた淫蟲の何匹かがひくひくとカウパーを流しだした鈴口を見つけ、	PRINTFORML それまで優しく纏わりついていた淫蟲の何匹かがひくひくとカウパーを流しだした鈴口を見つけ、
PRINTFORML やがて限界という限界を超えた屠自古のペニスは中の淫蟲をも押し出す凄まじい勢いで射精した…	PRINTFORML やがて限界という限界を超えた屠自古のペニスは中の淫蟲をも押し出す凄まじい勢いで射精した…
PRINTFORMDL 屠自古は堕ちきった表情で、涎を垂らしながら擬似陰茎から送られる男の快楽に流されている…	PRINTFORMDL 屠自古は堕ちきった表情で、涎を垂らしながら擬似陰茎から送られる男の快楽に流されている…
PRINTFORMDW 屠自古は愛液の流れ出す秘裂を敵に曝け出し、触手による無慈悲な暴虐を心待ちにしている…	PRINTFORMDW 屠自古は愛液の流れ出す秘裂を敵に曝け出し、触手による無慈悲な暴虐を心待ちにしている…
PRINTFORMW 「太子様…早く脱出致しましょう。こんな所にいらっしゃっては気も滅入ってしまいます……」	PRINTFORMW 「太子様…早く脱出致しましょう。こんな所にいらっしゃっては気も滅入ってしまいます……」
PRINTFORMW 「大陸の製法で作られているようね、詳しい事はわからないけど、凄まじいパワーを感じるわ」	PRINTFORMW 「大陸の製法で作られているようね、詳しい事はわからないけど、凄まじいパワーを感じるわ」
PRINTFORML 「わ、わらひぃっ…！！　女なのにザーメン出してだらしなくイッちゃうのおおぉぉっ！！！」	PRINTFORML 「わ、わらひぃっ…！！　女なのにザーメン出してだらしなくイッちゃうのおおぉぉっ！！！」
PRINTFORMDW あまりにも深く突き刺さった%ARGS:1%のそれは屠自古の腹越しに形が分かる程だ…	PRINTFORMDW あまりにも深く突き刺さった%ARGS:1%のそれは屠自古の腹越しに形が分かる程だ…
PRINTFORMDW 少し触れただけで屠自古のモノは大きく震え、女のそれとは全く異質の快感を与えてきた…	PRINTFORMDW 少し触れただけで屠自古のモノは大きく震え、女のそれとは全く異質の快感を与えてきた…
PRINTFORMDW 無理矢理生やされた擬似陰茎がゆっくりと鎌首をもたげ、どくどくと元気良く脈打っている	PRINTFORMDW 無理矢理生やされた擬似陰茎がゆっくりと鎌首をもたげ、どくどくと元気良く脈打っている
PRINTFORMW 「なんか、こう、私たちが必死で行ってる事を簡単に薬でやられると、辛いものがあるわ」	PRINTFORMW 「なんか、こう、私たちが必死で行ってる事を簡単に薬でやられると、辛いものがあるわ」
PRINTFORML 「い…いま、おまめっ、いじられっ!?　ひゅあああぁぁっ！　っ！はあぁッッ！！！！」	PRINTFORML 「い…いま、おまめっ、いじられっ!?　ひゅあああぁぁっ！　っ！はあぁッッ！！！！」
PRINTFORMDW 屠自古は肩で息をさせ、股間から落ちる糸もそのままに普通ではあり得ない提案をした…	PRINTFORMDW 屠自古は肩で息をさせ、股間から落ちる糸もそのままに普通ではあり得ない提案をした…
PRINTFORMW 抵抗できない%ARGS:1%の肉オナホに突っ込んで猿みたいに腰振る変態なのぉ！！」	PRINTFORMW 抵抗できない%ARGS:1%の肉オナホに突っ込んで猿みたいに腰振る変態なのぉ！！」
PRINTFORMDL 屠自古はソレを片手で掬い取ると、指にカクテルを塗りたくり思うさましゃぶり始めた…	PRINTFORMDL 屠自古はソレを片手で掬い取ると、指にカクテルを塗りたくり思うさましゃぶり始めた…
PRINTFORMDW 抜け出す事に気を取られていた屠自古は突然の衝撃に目を白黒させて達している…。 	PRINTFORMDW 抜け出す事に気を取られていた屠自古は突然の衝撃に目を白黒させて達している…。 
PRINTFORMDW 構わず打ち込まれた凶悪なソレは%ARGS:0%の腸内を余す所無く愛撫している…	PRINTFORMDW 構わず打ち込まれた凶悪なソレは%ARGS:0%の腸内を余す所無く愛撫している…
PRINTFORML 「や、めて……っ！！　お願いぃ…！！　なん…でもするからぁ…………助けてぇ……」	PRINTFORML 「や、めて……っ！！　お願いぃ…！！　なん…でもするからぁ…………助けてぇ……」
PRINTFORMW 「まだあの部屋にたむろしてるアレ居るの……嘘だと言いなさいよ%ARGS:1%！」	PRINTFORMW 「まだあの部屋にたむろしてるアレ居るの……嘘だと言いなさいよ%ARGS:1%！」
PRINTFORMW 「この前巫女と戦ったときに気付いたんだけど、亡霊になるとお札って痛いのよね……」	PRINTFORMW 「この前巫女と戦ったときに気付いたんだけど、亡霊になるとお札って痛いのよね……」
PRINTFORML 「ところでこの素材は何なの？　軽くて丈夫で透けてるって、夢みたいなものじゃない」	PRINTFORML 「ところでこの素材は何なの？　軽くて丈夫で透けてるって、夢みたいなものじゃない」
PRINTFORMW 「きっと物凄い味なんでしょうけど、これを食べる人は意識が無いから味が分からない」	PRINTFORMW 「きっと物凄い味なんでしょうけど、これを食べる人は意識が無いから味が分からない」
PRINTFORML 「あ、ぎいぃっ！！　いたい！！　痛い痛い痛い！　ああああぁぁぁぁあぁっっ！！！」	PRINTFORML 「あ、ぎいぃっ！！　いたい！！　痛い痛い痛い！　ああああぁぁぁぁあぁっっ！！！」
PRINTFORMDL 屠自古は泉から這い上がると、秘所からごぽりごぽりと溢れだす白濁液も気に留めず、	PRINTFORMDL 屠自古は泉から這い上がると、秘所からごぽりごぽりと溢れだす白濁液も気に留めず、
PRINTFORMDW 淫蟲たちはみるみるうちに集まり、肥大化し、やがて一本の醜悪な肉棒へと変化した…	PRINTFORMDW 淫蟲たちはみるみるうちに集まり、肥大化し、やがて一本の醜悪な肉棒へと変化した…
PRINTFORML 「う、ひぃああああぁぁぁっ！！　知らない！！　こんなのしらないのおぉぉっ！！！」	PRINTFORML 「う、ひぃああああぁぁぁっ！！　知らない！！　こんなのしらないのおぉぉっ！！！」
PRINTFORMDL 虚ろに開いた眼に手をかざす。反応は無い。弾力のある頬を突付いてみる。反応は無い	PRINTFORMDL 虚ろに開いた眼に手をかざす。反応は無い。弾力のある頬を突付いてみる。反応は無い
PRINTFORMDW いつしか%ARGS:1%だけでなく、指を出し入れしていた屠自古の息も弾んでいた	PRINTFORMDW いつしか%ARGS:1%だけでなく、指を出し入れしていた屠自古の息も弾んでいた
PRINTFORML 「くううぅぅぅッ?!　うし、ろでぇっ！　……イッてるの！　イッてるからぁ！！」	PRINTFORML 「くううぅぅぅッ?!　うし、ろでぇっ！　……イッてるの！　イッてるからぁ！！」
PRINTFORMDW 体が弛緩しているのか、屠自古の股間からはちょろちょろと小水が漏れ出している…	PRINTFORMDW 体が弛緩しているのか、屠自古の股間からはちょろちょろと小水が漏れ出している…
PRINTFORML 「やったわ！　電磁波で敵の場所が察知できるように…ってもう見えるじゃないの！」	PRINTFORML 「やったわ！　電磁波で敵の場所が察知できるように…ってもう見えるじゃないの！」
PRINTFORMDL 捕らわれた神子の嬌声を振り払うように、屠自古は迷宮の暗闇に姿を消していった…	PRINTFORMDL 捕らわれた神子の嬌声を振り払うように、屠自古は迷宮の暗闇に姿を消していった…
PRINTFORML 「良い相手が見つかって良かったわ……じゃ、お邪魔虫は退散させてもらおうかしら」	PRINTFORML 「良い相手が見つかって良かったわ……じゃ、お邪魔虫は退散させてもらおうかしら」
PRINTFORMDW 屠自古は布都の気配を読みとり、なるべくその事を触れないように気を使っている…	PRINTFORMDW 屠自古は布都の気配を読みとり、なるべくその事を触れないように気を使っている…
PRINTFORMW 「う、がぁっ?!　あ、あはああああぁぁぁっっ！！　や、いやよおおぉっっ！！！」	PRINTFORMW 「う、がぁっ?!　あ、あはああああぁぁぁっっ！！　や、いやよおおぉっっ！！！」
PRINTFORMDW もはや屠自古の身体は抵抗なく快楽を受け入れ、腰をかくかく揺らして達している…	PRINTFORMDW もはや屠自古の身体は抵抗なく快楽を受け入れ、腰をかくかく揺らして達している…
PRINTFORMDW %ARGS:1%は裸で転がっている屠自古の近くに道具袋を見つけて漁り始めた…	PRINTFORMDW %ARGS:1%は裸で転がっている屠自古の近くに道具袋を見つけて漁り始めた…
PRINTFORMDW 突如として泉は意識を持つかのようにうねり、難無く屠自古の膣内に侵入してきた！	PRINTFORMDW 突如として泉は意識を持つかのようにうねり、難無く屠自古の膣内に侵入してきた！
PRINTFORMDW 屠自古%TACHI()%hは泉に入ると同時に自らの秘所に違和感を感じ取った…	PRINTFORMDW 屠自古%TACHI()%hは泉に入ると同時に自らの秘所に違和感を感じ取った…
PRINTFORMW 　ダメぇっ！！　これ、もう、わた、しっ！！！　堕ちてるぅ！　堕ちるのぉっ！！」	PRINTFORMW 　ダメぇっ！！　これ、もう、わた、しっ！！！　堕ちてるぅ！　堕ちるのぉっ！！」
PRINTFORMDW %ARGS:0%の懇願を尻目に触手は内壁を引きずり出す感触を楽しんでいる…	PRINTFORMDW %ARGS:0%の懇願を尻目に触手は内壁を引きずり出す感触を楽しんでいる…
PRINTFORMW 「くれぐれも無理はしないで欲しいわね。布都は名目としては私の主人なんだから」	PRINTFORMW 「くれぐれも無理はしないで欲しいわね。布都は名目としては私の主人なんだから」
PRINTFORMW 「舶来の飲み物……すごい色だけど、どんな味かしら。…………うっ、苦いわね…」	PRINTFORMW 「舶来の飲み物……すごい色だけど、どんな味かしら。…………うっ、苦いわね…」
PRINTFORMW 「だからといって味見も貴重すぎて出来ない……う～、一嘗めだけ、駄目かしら？」	PRINTFORMW 「だからといって味見も貴重すぎて出来ない……う～、一嘗めだけ、駄目かしら？」
PRINTFORMDW 屠自古の意思と反し、屠自古の手は動き続け、やがてスイッチへと伸びていった…	PRINTFORMDW 屠自古の意思と反し、屠自古の手は動き続け、やがてスイッチへと伸びていった…
PRINTFORML 「あああぁぁぁっ、駄目っ！！　こつん、て、あたって、にゃああぁぁっっ！！！」	PRINTFORML 「あああぁぁぁっ、駄目っ！！　こつん、て、あたって、にゃああぁぁっっ！！！」
PRINTFORML 「や、だっ！！　いやいやいやああぁっ！！　こん、なああああぁぁぁっっ！！！」	PRINTFORML 「や、だっ！！　いやいやいやああぁっ！！　こん、なああああぁぁぁっっ！！！」
PRINTFORMDW 口ではそう言いながらも、屠自古は大粒の涙をこぼし、怒りを覚えているようだ…	PRINTFORMDW 口ではそう言いながらも、屠自古は大粒の涙をこぼし、怒りを覚えているようだ…
PRINTFORMDW 喉から食道へ、食道から腹、そして秘所へじわぁとした熱と快楽がほとばしった…	PRINTFORMDW 喉から食道へ、食道から腹、そして秘所へじわぁとした熱と快楽がほとばしった…
PRINTFORML 「ダ、メッ…いまぁっ！　イッてぇ！　びんっ！　あふぅ、にゃああぁぁ……っ！」	PRINTFORML 「ダ、メッ…いまぁっ！　イッてぇ！　びんっ！　あふぅ、にゃああぁぁ……っ！」
PRINTFORMDW 触手の執拗な責めから逃げ出した屠自古は、ふらふらと地上へと上がっていった…	PRINTFORMDW 触手の執拗な責めから逃げ出した屠自古は、ふらふらと地上へと上がっていった…
PRINTFORML 「…………!!?　ダメダメダメっ！！　たまごぉ！！　産みつけ、ちゃあぁぁ！」	PRINTFORML 「…………!!?　ダメダメダメっ！！　たまごぉ！！　産みつけ、ちゃあぁぁ！」
PRINTFORMDW 屠自古の一物は割れ目に触れる度に、嬉しそうにぴこんっ、と跳ね上がっている…	PRINTFORMDW 屠自古の一物は割れ目に触れる度に、嬉しそうにぴこんっ、と跳ね上がっている…
PRINTFORMDL 屠自古はちらりとこちらを見たように思われたが、その目は何も映していない。	PRINTFORMDL 屠自古はちらりとこちらを見たように思われたが、その目は何も映していない。
PRINTFORMDW 　屠自古は呼吸を乱し、腿をこすり合わせながらもやや暴走気味に雷を放った。	PRINTFORMDW 　屠自古は呼吸を乱し、腿をこすり合わせながらもやや暴走気味に雷を放った。
PRINTFORMDW 屠自古は敵であるはずの触手を恥部に擦りつけ必死で快感を得ようとしている…	PRINTFORMDW 屠自古は敵であるはずの触手を恥部に擦りつけ必死で快感を得ようとしている…
PRINTFORMDW 衝撃の後に、脳を焼き切るようなチリチリした快感が屠自古の体を走り抜けた！	PRINTFORMDW 衝撃の後に、脳を焼き切るようなチリチリした快感が屠自古の体を走り抜けた！
PRINTFORML 「まだ私は大丈夫だけれど……いいわ、安全なうちに寝ておいて損はないものね」	PRINTFORML 「まだ私は大丈夫だけれど……いいわ、安全なうちに寝ておいて損はないものね」
PRINTFORMDW 屠自古は迷宮の地べたに尻を下ろし、丸見えの状態で自慰ショーを行っている…	PRINTFORMDW 屠自古は迷宮の地べたに尻を下ろし、丸見えの状態で自慰ショーを行っている…
PRINTFORMW 「あはああぁぁっっ！！　こど、もにぃっ！！　おっぱい吸われ、てえぇっ！！」	PRINTFORMW 「あはああぁぁっっ！！　こど、もにぃっ！！　おっぱい吸われ、てえぇっ！！」
PRINTFORMDW ひどい吐き気に襲われ、その場に崩れ落ちた屠自古の目から涙がこぼれ落ちた…	PRINTFORMDW ひどい吐き気に襲われ、その場に崩れ落ちた屠自古の目から涙がこぼれ落ちた…
PRINTFORMW 「そ、そん…な強く、吸わないでぇ……ち、ぎれちゃ、………は、ああぁ…っ！」	PRINTFORMW 「そ、そん…な強く、吸わないでぇ……ち、ぎれちゃ、………は、ああぁ…っ！」
PRINTFORML 「……って布都冗談だから、あぁ！　泣かないでよ！　ほら、飴！　飴居る?!」	PRINTFORML 「……って布都冗談だから、あぁ！　泣かないでよ！　ほら、飴！　飴居る?!」
PRINTFORMDL 冷静に分析していた屠自古は股間への妙な刺激が消えないことを不思議に思い、	PRINTFORMDL 冷静に分析していた屠自古は股間への妙な刺激が消えないことを不思議に思い、
PRINTFORML 「うああっ！！　どぴゅどぴゅしてるぅっ！！！　脈打ってるのおおぉぉ！！！」	PRINTFORML 「うああっ！！　どぴゅどぴゅしてるぅっ！！！　脈打ってるのおおぉぉ！！！」
PRINTFORMDL 屠自古はそう言いながらも自らのペニスを%ARGS:1%の秘裂へあてがった	PRINTFORMDL 屠自古はそう言いながらも自らのペニスを%ARGS:1%の秘裂へあてがった
PRINTFORMDW 屠自古は雷を凝縮して威力を高めているが、心なしか雷がピンクがかっている	PRINTFORMDW 屠自古は雷を凝縮して威力を高めているが、心なしか雷がピンクがかっている
PRINTFORML 　　　　　　　　　　　　　　　　　ゝ-ｰ,---r´　　　＼　　　　　／	PRINTFORML 　　　　　　　　　　　　　　　　　ゝ-ｰ,---r´　　　＼　　　　　／
PRINTFORMDW 屠自古は熱っぽいまなざしで得物を見つめていたが、何とか思いとどまった。	PRINTFORMDW 屠自古は熱っぽいまなざしで得物を見つめていたが、何とか思いとどまった。
PRINTFORM 屠自古は思うように快感を得る事が出来ずへこへことだらしなく腰を振っている…	PRINTFORM 屠自古は思うように快感を得る事が出来ずへこへことだらしなく腰を振っている…
PRINTFORMDW 屠自古は一瞬大きくなった神子の腹を視認すると、首を下に向けなくなった…	PRINTFORMDW 屠自古は一瞬大きくなった神子の腹を視認すると、首を下に向けなくなった…
PRINTFORMDL 屠自古は仲間がすぐ隣で寝息を立てていることに背徳的な快感を覚えながら、	PRINTFORMDL 屠自古は仲間がすぐ隣で寝息を立てていることに背徳的な快感を覚えながら、
PRINTFORMW 「やあぁぁ！　ロータ、ち、くびに埋ま……ひゃ、ああああぁぁぁぁっ！！！」	PRINTFORMW 「やあぁぁ！　ロータ、ち、くびに埋ま……ひゃ、ああああぁぁぁぁっ！！！」
PRINTFORML 「！！　ッ！！！　わ、たしぃ！！　おっぱいでえぇっ、イッてりゅぅ！！！」	PRINTFORML 「！！　ッ！！！　わ、たしぃ！！　おっぱいでえぇっ、イッてりゅぅ！！！」
PRINTFORMDW 屠自古はだらしなく舌を出し、流れる一筋の血も気にかけず己を慰めている…	PRINTFORMDW 屠自古はだらしなく舌を出し、流れる一筋の血も気にかけず己を慰めている…
PRINTFORML 「むかし、万という男がいたわ。……今なら彼の気持ちが分かる気がするわね」	PRINTFORML 「むかし、万という男がいたわ。……今なら彼の気持ちが分かる気がするわね」
PRINTFORMDW 屠自古は直腸を蠢く異物の感触に、目を見開き舌を突き出して硬直している…	PRINTFORMDW 屠自古は直腸を蠢く異物の感触に、目を見開き舌を突き出して硬直している…
PRINTFORML 「ひぎっ！！　ううぅっ！！　か、…は……し、めつけられ、て…………！！」	PRINTFORML 「ひぎっ！！　ううぅっ！！　か、…は……し、めつけられ、て…………！！」
PRINTFORML 「大人しく…じょ、ううああぁぁぁっ！！！　いやああぁぁぁっっ！！！！　」	PRINTFORML 「大人しく…じょ、ううああぁぁぁっ！！！　いやああぁぁぁっっ！！！！　」
PRINTFORMDW それだけでなく屠自古は下半身に血が集中し、熱を帯びているのを感じていた	PRINTFORMDW それだけでなく屠自古は下半身に血が集中し、熱を帯びているのを感じていた
PRINTFORMDW 光球で敵の動きを止めた屠自古は武器を天高く掲げ、雷の力を溜めている…	PRINTFORMDW 光球で敵の動きを止めた屠自古は武器を天高く掲げ、雷の力を溜めている…
PRINTFORMW 　　　　　　　　　　　　　　　　　　　　　　　　　　　`ヽ＿＿／　　.	PRINTFORMW 　　　　　　　　　　　　　　　　　　　　　　　　　　　`ヽ＿＿／　　.
PRINTFORML 「やあぁあぁぁぁ！！　くるくる来るぅッッ！！　キちゃうのおぉ！！！！」	PRINTFORML 「やあぁあぁぁぁ！！　くるくる来るぅッッ！！　キちゃうのおぉ！！！！」
PRINTFORML 「幻想郷には、怨霊から神になった大先輩がいるそうね。行方を知らない？」	PRINTFORML 「幻想郷には、怨霊から神になった大先輩がいるそうね。行方を知らない？」
PRINTFORML 「ほんならコレは利息としてもうときますわ、えろぅすいまへんなあ……！」	PRINTFORML 「ほんならコレは利息としてもうときますわ、えろぅすいまへんなあ……！」
PRINTFORMW 「うううあぁっ！！　と、とまらなぁっ！！　こわれる！　こあらるのぉ！」	PRINTFORMW 「うううあぁっ！！　と、とまらなぁっ！！　こわれる！　こあらるのぉ！」
PRINTFORMW 「や、めっ！！　す……吸わないでぇっ！！　はあっ、ああああぁっっ！！」	PRINTFORMW 「や、めっ！！　す……吸わないでぇっ！！　はあっ、ああああぁっっ！！」
PRINTFORML 「気をつけないとすぐに力が足りなくなるわよ、よく考えて浄化しましょう」	PRINTFORML 「気をつけないとすぐに力が足りなくなるわよ、よく考えて浄化しましょう」
PRINTFORMDW 屠自古はこちらを見ることもなく、ふらふらと迷宮の奥へ消えていった……	PRINTFORMDW 屠自古はこちらを見ることもなく、ふらふらと迷宮の奥へ消えていった……
PRINTFORML 「なんだかねえ……どうせ犯されるならありがた迷惑としか思えないわね」 	PRINTFORML 「なんだかねえ……どうせ犯されるならありがた迷惑としか思えないわね」 
PRINTFORML 「へえぁあ！！　なに、こりぇっ！！！　しらない！！　知らないのぉ！！」	PRINTFORML 「へえぁあ！！　なに、こりぇっ！！！　しらない！！　知らないのぉ！！」
PRINTFORML 「%CALLNAME:(LOCAL:4)%……せいぜい頑張りなさい…」	PRINTFORML 「%CALLNAME:(LOCAL:4)%……せいぜい頑張りなさい…」
PRINTFORML 「……どうしたの、サカってしょうがないんじゃないの？　早くしなさいよ」	PRINTFORML 「……どうしたの、サカってしょうがないんじゃないの？　早くしなさいよ」
PRINTFORMW 弾幕と妖怪、触手と妊娠とを、コンクリート・ミキサーにかけてぶちまけた、	PRINTFORMW 弾幕と妖怪、触手と妊娠とを、コンクリート・ミキサーにかけてぶちまけた、
PRINTFORML 　　　　　　　　　　　　　　　　　　　　ヽ　　　　._,.-‐´._	PRINTFORML 　　　　　　　　　　　　　　　　　　　　ヽ　　　　._,.-‐´._
PRINTFORML (ダブルバスタアアァァーーー！！！！　コレダアァァァーーーー！！！)	PRINTFORML (ダブルバスタアアァァーーー！！！！　コレダアァァァーーーー！！！)
PRINTFORMDW 体が軋むような衝撃にも、発情した屠自古の体は反応してしまっている…	PRINTFORMDW 体が軋むような衝撃にも、発情した屠自古の体は反応してしまっている…
PRINTFORML 「あ！　あぁぁ！　ち、くびぃ、にい……ひ、ひゃあああぁぁあっっ！！」	PRINTFORML 「あ！　あぁぁ！　ち、くびぃ、にい……ひ、ひゃあああぁぁあっっ！！」
PRINTFORMDL 怪しい花粉を吸い込んだ屠自古はその場で座り込んで寝息を立て始めた。	PRINTFORMDL 怪しい花粉を吸い込んだ屠自古はその場で座り込んで寝息を立て始めた。
PRINTFORML 「こう、上手いこと電気信号なんかで、この死骸を操れたりしないかしら」	PRINTFORML 「こう、上手いこと電気信号なんかで、この死骸を操れたりしないかしら」
PRINTFORMDW 屠自古は掠れた笑いを含んだまま、壊れた人形のように動かなくなった…	PRINTFORMDW 屠自古は掠れた笑いを含んだまま、壊れた人形のように動かなくなった…
PRINTFORMW 「多生部大って罪人が似たようなの持ってたような……違ったかしら……」	PRINTFORMW 「多生部大って罪人が似たようなの持ってたような……違ったかしら……」
PRINTFORMDW 屠自古は実に自然な動作でそれをポケットにしまい、先に進んでいった。	PRINTFORMDW 屠自古は実に自然な動作でそれをポケットにしまい、先に進んでいった。
PRINTFORML 「はああぁぁっっ！！　はいっ、て、るの、にぃ……せ、つないいのぉ…」	PRINTFORML 「はああぁぁっっ！！　はいっ、て、るの、にぃ……せ、つないいのぉ…」
PRINTFORMDW 屠自古は震える拳を握りしめ、膨らんだ己の腹を打つ為に腕を高く掲げた	PRINTFORMDW 屠自古は震える拳を握りしめ、膨らんだ己の腹を打つ為に腕を高く掲げた
PRINTFORMDW 産道を押し広げる自らの子供に処女膜を破られるという理不尽な痛みに、	PRINTFORMDW 産道を押し広げる自らの子供に処女膜を破られるという理不尽な痛みに、
PRINTFORML 「ところで……何か余っている物資は無いかしら？　こちらも厳しいのよ」	PRINTFORML 「ところで……何か余っている物資は無いかしら？　こちらも厳しいのよ」
PRINTFORMDW 屠自古は衣服の中をまさぐられる度に、甘い声を切れ切れに発している…	PRINTFORMDW 屠自古は衣服の中をまさぐられる度に、甘い声を切れ切れに発している…
PRINTFORMDW 屠自古は自らを心配そうに見つめる眼差しを認めると、力無く微笑んだ…	PRINTFORMDW 屠自古は自らを心配そうに見つめる眼差しを認めると、力無く微笑んだ…
PRINTFORML 「えっ……！！　ま、って！！　触手、はもう……い、むぐぐぐぅっ！！」	PRINTFORML 「えっ……！！　ま、って！！　触手、はもう……い、むぐぐぐぅっ！！」
PRINTFORMDW やがて淫蟲は屠自古の腸内を犯し尽くし満足したのか、一匹、また一匹と	PRINTFORMDW やがて淫蟲は屠自古の腸内を犯し尽くし満足したのか、一匹、また一匹と
PRINTFORML 「うはあぁぁっ！！　にゅるにゅるがぁ……から、みっ！　ついてっ！！」	PRINTFORML 「うはあぁぁっ！！　にゅるにゅるがぁ……から、みっ！　ついてっ！！」
PRINTFORML 淫蟲のぬめりのある体表が敏感な屠自古のペニスをなぞり、刺激していく…	PRINTFORML 淫蟲のぬめりのある体表が敏感な屠自古のペニスをなぞり、刺激していく…
PRINTFORM 「あ、あぁ、ああぁぁぁ…………くっついたぁ……もう、外せないわよぉ……	PRINTFORM 「あ、あぁ、ああぁぁぁ…………くっついたぁ……もう、外せないわよぉ……
PRINTFORMDL そして屠自古は向き直ると再び%ARGS:1%の元にしゃがみこんだ…	PRINTFORMDL そして屠自古は向き直ると再び%ARGS:1%の元にしゃがみこんだ…
PRINTFORMW 屠自古はピストンを止め、最奥部で%ARGS:1%の子宮に狙いを定めた	PRINTFORMW 屠自古はピストンを止め、最奥部で%ARGS:1%の子宮に狙いを定めた
PRINTFORMDW 屠自古は躊躇せず%ARGS:1%の膣内に己のザーメンを流し込んだ…	PRINTFORMDW 屠自古は躊躇せず%ARGS:1%の膣内に己のザーメンを流し込んだ…
PRINTFORML 　　　　　　　　　　　　　　　　　　　　　　　　　　_,‐-､.　	PRINTFORML 　　　　　　　　　　　　　　　　　　　　　　　　　　_,‐-､.　
PRINTFORML 　　　　　　　　　　　　　　　　　ヽー‐´　/　　＼　　｀ｰ-＿_	PRINTFORML 　　　　　　　　　　　　　　　　　ヽー‐´　/　　＼　　｀ｰ-＿_
PRINTFORML 「動かないのは訓練されてない触手、動くのはよく訓練された触手よ！」	PRINTFORML 「動かないのは訓練されてない触手、動くのはよく訓練された触手よ！」
PRINTFORML 「えっちなことしたいとかぁ…じぇんじぇんかんがえてないからぁ……」	PRINTFORML 「えっちなことしたいとかぁ…じぇんじぇんかんがえてないからぁ……」
PRINTFORMDW 屠自古は物のように無造作に投げ捨てられたが、ぴくりとも動かない…	PRINTFORMDW 屠自古は物のように無造作に投げ捨てられたが、ぴくりとも動かない…
PRINTFORMDW 部屋の隅に渋緑の円座があると思ったら、丸まって眠る屠自古だった。	PRINTFORMDW 部屋の隅に渋緑の円座があると思ったら、丸まって眠る屠自古だった。
PRINTFORMW 「こういうのは、私が生きてた時にもあったわ。人間の欲って凄いわね」	PRINTFORMW 「こういうのは、私が生きてた時にもあったわ。人間の欲って凄いわね」
PRINTFORMDW 屠自古は荒い息で自らの不浄の穴に極太のアナルバイブを差し入れた…	PRINTFORMDW 屠自古は荒い息で自らの不浄の穴に極太のアナルバイブを差し入れた…
PRINTFORML 「やあぁぁっ！！　うしろでなんてぇっ！！　ふきゅううぅぅっ！！！」	PRINTFORML 「やあぁぁっ！！　うしろでなんてぇっ！！　ふきゅううぅぅっ！！！」
PRINTFORML 「万全、とはいかない、けれど……。私で良ければ……力になるわ……」	PRINTFORML 「万全、とはいかない、けれど……。私で良ければ……力になるわ……」
PRINTFORML 「聖者になるつもりはないのよ。でも、渡さないわけにも行かないもの」	PRINTFORML 「聖者になるつもりはないのよ。でも、渡さないわけにも行かないもの」
PRINTFORMDW 屠自古は自らのクリトリスに不気味な圧力に晒されているのに気付いた	PRINTFORMDW 屠自古は自らのクリトリスに不気味な圧力に晒されているのに気付いた
PRINTFORMDW 素早く泉から抜け出し距離を置いたが、何かが出てくる気配は無かった	PRINTFORMDW 素早く泉から抜け出し距離を置いたが、何かが出てくる気配は無かった
PRINTFORML 「泉に入った者だけを襲うのかしら……とりあえず、………っ!?!?」	PRINTFORML 「泉に入った者だけを襲うのかしら……とりあえず、………っ!?!?」
PRINTFORMDW 室内に響きわたる程の恥音をたてながら、体内の淫蟲を排泄している…	PRINTFORMDW 室内に響きわたる程の恥音をたてながら、体内の淫蟲を排泄している…
PRINTFORMDW 屠自古は放心状態で、自らに起こった出来事を処理しきれないようだ…	PRINTFORMDW 屠自古は放心状態で、自らに起こった出来事を処理しきれないようだ…
PRINTFORML 「でてるっ！！　でてるからっ！！　うご、いちゃ……あ、が……！！」	PRINTFORML 「でてるっ！！　でてるからっ！！　うご、いちゃ……あ、が……！！」
PRINTFORMW 「やああぁぁぁッッ！！　でるッ！！　精液でちゃうのおぉぉっ！！！」	PRINTFORMW 「やああぁぁぁッッ！！　でるッ！！　精液でちゃうのおぉぉっ！！！」
PRINTFORML 「いやぁ！！　だめよぉっっ！！！　だ、めえええええぇぇっっ！！！」	PRINTFORML 「いやぁ！！　だめよぉっっ！！！　だ、めえええええぇぇっっ！！！」
PRINTFORMDL 口では絶望しているように話しているが、その口元は緩みきっていて、	PRINTFORMDL 口では絶望しているように話しているが、その口元は緩みきっていて、
PRINTFORM 「あはぁ……もう、でるぅ……亡霊のそーろーちんぽもうでちゃうのぉ！！	PRINTFORM 「あはぁ……もう、でるぅ……亡霊のそーろーちんぽもうでちゃうのぉ！！
PRINTFORML 「こんな所にいれないわよ！　私は隣の部屋へ逃げさせてもらうわ！」	PRINTFORML 「こんな所にいれないわよ！　私は隣の部屋へ逃げさせてもらうわ！」
PRINTFORML 「旧約聖書にあるソドムとゴモラの火よ。インドラの雷とも言うわね」	PRINTFORML 「旧約聖書にあるソドムとゴモラの火よ。インドラの雷とも言うわね」
PRINTFORML 「こんな事なら赤檮(いちい)にでも射術を習っておくべきだったわ」	PRINTFORML 「こんな事なら赤檮(いちい)にでも射術を習っておくべきだったわ」
PRINTFORMW 「いまは、ダメぇ……こっち、入れられると、堕ちちゃうからぁ…」 	PRINTFORMW 「いまは、ダメぇ……こっち、入れられると、堕ちちゃうからぁ…」 
PRINTFORML 「いま、だぁ、めえっ…！　とけちゃう、とろけちゃう…からぁ……」	PRINTFORML 「いま、だぁ、めえっ…！　とけちゃう、とろけちゃう…からぁ……」
PRINTFORML 「あんたの力は借りない……って意地張ってる場合でもないのよね…」	PRINTFORML 「あんたの力は借りない……って意地張ってる場合でもないのよね…」
PRINTFORMW 「私がガラが悪いってよく言われるけど、タチは布都の方が悪いのよ」	PRINTFORMW 「私がガラが悪いってよく言われるけど、タチは布都の方が悪いのよ」
PRINTFORMW 「あそこも触手、むこうも触手、そしてここも触手……嫌になるわね」	PRINTFORMW 「あそこも触手、むこうも触手、そしてここも触手……嫌になるわね」
PRINTFORML 「なるべく敵がこちらのテリトリーに入るのを待つのがいいのかしら」	PRINTFORML 「なるべく敵がこちらのテリトリーに入るのを待つのがいいのかしら」
PRINTFORMW 「隼人だとか土蜘蛛でも、もうちょっとマシな武器使ってたわよ……」	PRINTFORMW 「隼人だとか土蜘蛛でも、もうちょっとマシな武器使ってたわよ……」
PRINTFORML 「私がずっと見張っておこうかしら、うーん…でも少しは寝たいわね」	PRINTFORML 「私がずっと見張っておこうかしら、うーん…でも少しは寝たいわね」
PRINTFORML 「き…もちよくなんてぇっ！！　あ、ああ、ひぃやあぁぁぁっっ！！」	PRINTFORML 「き…もちよくなんてぇっ！！　あ、ああ、ひぃやあぁぁぁっっ！！」
PRINTFORMDW 屠自古がそう言いながら強がって組んだ腕は、かすかに震えていた…	PRINTFORMDW 屠自古がそう言いながら強がって組んだ腕は、かすかに震えていた…
PRINTFORMDW 屠自古の頭に先の戦闘でのおぞましい記憶がフラッシュバックする…	PRINTFORMDW 屠自古の頭に先の戦闘でのおぞましい記憶がフラッシュバックする…
PRINTFORMW 「う、っぐ…き、来た……のね……ぎ！　ぐうううぅぅぅ！！！！」;	PRINTFORMW 「う、っぐ…き、来た……のね……ぎ！　ぐうううぅぅぅ！！！！」;
PRINTFORMW 「ふぅーーーー……、ひ、ぃーーーーー…………、あ、ああぁ………」	PRINTFORMW 「ふぅーーーー……、ひ、ぃーーーーー…………、あ、ああぁ………」
PRINTFORML 「亡霊とは言え、私は大臣の一族よ。火事場泥棒の真似事なんて……」	PRINTFORML 「亡霊とは言え、私は大臣の一族よ。火事場泥棒の真似事なんて……」
PRINTFORMDW 屠自古の絶頂と同調して、残っていた淫蟲がいっせいに震えだした！	PRINTFORMDW 屠自古の絶頂と同調して、残っていた淫蟲がいっせいに震えだした！
PRINTFORMDL まだ淫蟲が残っているかのような腸内の異物感と、ごぽごぽと溢れる	PRINTFORMDL まだ淫蟲が残っているかのような腸内の異物感と、ごぽごぽと溢れる
PRINTFORMDW 淫蟲の出した濁った体液と自らの腸液に不快な表情を隠さなかった…	PRINTFORMDW 淫蟲の出した濁った体液と自らの腸液に不快な表情を隠さなかった…
PRINTFORML 「ふぐぅっ！！　うあぁっっ！！　ひっ！　ひはあぁぁあっっ！！！」	PRINTFORML 「ふぐぅっ！！　うあぁっっ！！　ひっ！　ひはあぁぁあっっ！！！」
PRINTFORMDW 機会があれば救出しようと思い、屠自古はその場を離れようとした…	PRINTFORMDW 機会があれば救出しようと思い、屠自古はその場を離れようとした…
PRINTFORM 「だいたぁい……、節操なくはんのぉする、このちんぽが悪いのよぉ……	PRINTFORM 「だいたぁい……、節操なくはんのぉする、このちんぽが悪いのよぉ……
PRINTFORMW い、いいのよね？　挿入れちゃうわよぉ……？　嫌ならいやとぉ……」	PRINTFORMW い、いいのよね？　挿入れちゃうわよぉ……？　嫌ならいやとぉ……」
PRINTFORMW 「もうっ……チンポ、無しじゃ……いられない、体、にぃ……っ！！」	PRINTFORMW 「もうっ……チンポ、無しじゃ……いられない、体、にぃ……っ！！」
PRINTFORM 「ひ、ひぃ！　ひきゅううううぅぅぅ！！！！　せいえき、で、てるのぉ	PRINTFORM 「ひ、ひぃ！　ひきゅううううぅぅぅ！！！！　せいえき、で、てるのぉ
PRINTFORMDW 屠自古は指でピンと突き出た乳頭を自分で弄って敵を誘っている…	PRINTFORMDW 屠自古は指でピンと突き出た乳頭を自分で弄って敵を誘っている…
PRINTFORML 　　　　　　　　　　　　　　　　　　　ヽ｀ー-＿　-´　　　７	PRINTFORML 　　　　　　　　　　　　　　　　　　　ヽ｀ー-＿　-´　　　７
PRINTFORML 　　　　　　　　　　　　　　　　　　　　＼　　　　　　,-'´	PRINTFORML 　　　　　　　　　　　　　　　　　　　　＼　　　　　　,-'´
PRINTFORML 　　　　　　　　　　　　　　　　　　　　　＿／　　ﾑ｀--￣/	PRINTFORML 　　　　　　　　　　　　　　　　　　　　　＿／　　ﾑ｀--￣/
PRINTFORML 「まだよ！　まだ沈めない！！　手持ちを打ちつくすまではっ！！」	PRINTFORML 「まだよ！　まだ沈めない！！　手持ちを打ちつくすまではっ！！」
PRINTFORMDL 屠自古はわざわざ尻穴を守るという行為に羞恥を感じているようだ	PRINTFORMDL 屠自古はわざわざ尻穴を守るという行為に羞恥を感じているようだ
PRINTFORML 「私を捉えたいなら踝羸(すがる)の一人でも連れてくることね！」	PRINTFORML 「私を捉えたいなら踝羸(すがる)の一人でも連れてくることね！」
PRINTFORM 「あ、はぁ……しゅ、集中できないからぁ…仕方なくっ、きゅうッ！！	PRINTFORM 「あ、はぁ……しゅ、集中できないからぁ…仕方なくっ、きゅうッ！！
PRINTFORML 「……あんたが居るって事は、あんたの能力でも脱出できないのね」	PRINTFORML 「……あんたが居るって事は、あんたの能力でも脱出できないのね」
PRINTFORML 「何でもないわ。それにしてもこの迷宮は広くてまいっちゃうわね」	PRINTFORML 「何でもないわ。それにしてもこの迷宮は広くてまいっちゃうわね」
PRINTFORMW 「量産型って性能は低いし、見かけたらこまめに潰した方が良いわ」	PRINTFORMW 「量産型って性能は低いし、見かけたらこまめに潰した方が良いわ」
PRINTFORMW 「……これ、身代わりになるの？　叩いたらすぐ壊れそうだけれど」	PRINTFORMW 「……これ、身代わりになるの？　叩いたらすぐ壊れそうだけれど」
PRINTFORML 「太子様に見張ってもらえるなら、安心して眠ることができます…」	PRINTFORML 「太子様に見張ってもらえるなら、安心して眠ることができます…」
PRINTFORML 「ひっ！！！　うそよぉっ！！　わた、っ！　ばけもの、のぉ！！」	PRINTFORML 「ひっ！！！　うそよぉっ！！　わた、っ！　ばけもの、のぉ！！」
PRINTFORML 「う、そっ！！！　ああぁっ！！　ふ、ぐうううぅぅぅっっ！！！」	PRINTFORML 「う、そっ！！！　ああぁっ！！　ふ、ぐうううぅぅぅっっ！！！」
PRINTFORML 「だめえ！！　そこっ、いじられっ……！！　へえああっっ！！！」	PRINTFORML 「だめえ！！　そこっ、いじられっ……！！　へえああっっ！！！」
PRINTFORML 「ううう、ふうぅぅっ！！　ぴゅっ、ぴゅってえええぇぇぇ！！！」	PRINTFORML 「ううう、ふうぅぅっ！！　ぴゅっ、ぴゅってえええぇぇぇ！！！」
PRINTFORMW 「いやぁっ！！　暴れないでぇっ！！　うそっ！　嘘だからぁ！！」	PRINTFORMW 「いやぁっ！！　暴れないでぇっ！！　うそっ！　嘘だからぁ！！」
PRINTFORMDW 屠自古は腕を振り下ろす事もできず、ぼろぼろと一人涙を流した…	PRINTFORMDW 屠自古は腕を振り下ろす事もできず、ぼろぼろと一人涙を流した…
PRINTFORML 「……触手の部屋に身篭りの憂鬱、……萎靡沈滞ってこういう事ね」	PRINTFORML 「……触手の部屋に身篭りの憂鬱、……萎靡沈滞ってこういう事ね」
PRINTFORMW 「ふぅーーーー……、ひ、ぃーー………い、かない……で、ぇ……」	PRINTFORMW 「ふぅーーーー……、ひ、ぃーー………い、かない……で、ぇ……」
PRINTFORML 「れもぉ……ずこずこしたらぁ……きもちぃから、いっかぁ………」	PRINTFORML 「れもぉ……ずこずこしたらぁ……きもちぃから、いっかぁ………」
PRINTFORMDW 屠自古の膣内に居た幼体が急激に成長し、屠自古の腹を圧迫した…	PRINTFORMDW 屠自古の膣内に居た幼体が急激に成長し、屠自古の腹を圧迫した…
PRINTFORMDW 屠自古はあまりの衝撃に白目を剥きながらも蹂躙され続けている…	PRINTFORMDW 屠自古はあまりの衝撃に白目を剥きながらも蹂躙され続けている…
PRINTFORMDW そこには――屠自古の股間には、固くそりたった男根が生えていた	PRINTFORMDW そこには――屠自古の股間には、固くそりたった男根が生えていた
PRINTFORMDW しかし、落とし穴から伸びた触手が屠自古を穴へ引きずり込んだ！	PRINTFORMDW しかし、落とし穴から伸びた触手が屠自古を穴へ引きずり込んだ！
PRINTFORML 「しゅごぉい……！　てがぁ、勝手に、くちゅ、くちゅ、ってえ！」	PRINTFORML 「しゅごぉい……！　てがぁ、勝手に、くちゅ、くちゅ、ってえ！」
PRINTFORML 「いやあぁ！　ふ、ぐぅ！！　は、あ、ああああぁぁぁっっ！！！」	PRINTFORML 「いやあぁ！　ふ、ぐぅ！！　は、あ、ああああぁぁぁっっ！！！」
PRINTFORMDW 淫蟲の出した濁った体液と自らの腸液を断続的に噴き出していた…	PRINTFORMDW 淫蟲の出した濁った体液と自らの腸液を断続的に噴き出していた…
PRINTFORMDL 嵐のように淫蟲が去り行き、ぐったりと横たわる屠自古の股間には	PRINTFORMDL 嵐のように淫蟲が去り行き、ぐったりと横たわる屠自古の股間には
PRINTFORML 「い、嫌！　な、なになになにぃっ!?!!　あ、つまって………」	PRINTFORML 「い、嫌！　な、なになになにぃっ!?!!　あ、つまって………」
PRINTFORML 「く……！　お、ぼえて…なさい……。……い…やああぁぁっ！！」	PRINTFORML 「く……！　お、ぼえて…なさい……。……い…やああぁぁっ！！」
PRINTFORMW 陵辱の後に住みついた発情と寄生。異空間が生み出したソドムの宮。	PRINTFORMW 陵辱の後に住みついた発情と寄生。異空間が生み出したソドムの宮。
PRINTFORMDW 見ると、擬似陰茎は屠自古の淫核と完全に一体化し、定着していた	PRINTFORMDW 見ると、擬似陰茎は屠自古の淫核と完全に一体化し、定着していた
PRINTFORMW 「私の栗羊羹食べたって…どうして布都は確認しないのかしら？」	PRINTFORMW 「私の栗羊羹食べたって…どうして布都は確認しないのかしら？」
PRINTFORML 　　　　　　　　　　　　　　　　　　　　　ヽ---ｧ　.,／	PRINTFORML 　　　　　　　　　　　　　　　　　　　　　ヽ---ｧ　.,／
PRINTFORML 　　　　　　　　　　　　　　　　　　　　　,´/　ヽ　　＼　	PRINTFORML 　　　　　　　　　　　　　　　　　　　　　,´/　ヽ　　＼　
PRINTFORMW 　　　　　　　　　　　　　　　　　　　　メイ！　　　オーウ！	PRINTFORMW 　　　　　　　　　　　　　　　　　　　　メイ！　　　オーウ！
PRINTFORML 「ボルテッカー三段返し……今言うと洒落にならないかしら……」	PRINTFORML 「ボルテッカー三段返し……今言うと洒落にならないかしら……」
PRINTFORML 「何が目的よ！　…まあロクでもないことなのは分かるけど……」	PRINTFORML 「何が目的よ！　…まあロクでもないことなのは分かるけど……」
PRINTFORMDW 屠自古は息を荒げ、自らの意思と関わらず自らを慰め始めた…。	PRINTFORMDW 屠自古は息を荒げ、自らの意思と関わらず自らを慰め始めた…。
PRINTFORML 「どうしたの？　スサノオの神産みの方が気合い入ってるわよ！」	PRINTFORML 「どうしたの？　スサノオの神産みの方が気合い入ってるわよ！」
PRINTFORML 「ﾌｩｰ…ﾌｩｰ…ｸﾜｯ！　……なんでもぉ…何でも、ないわ」	PRINTFORML 「ﾌｩｰ…ﾌｩｰ…ｸﾜｯ！　……なんでもぉ…何でも、ないわ」
PRINTFORMW 「こんな奴らから逃げ回る事になるなんて思ってもみなかったわ」	PRINTFORMW 「こんな奴らから逃げ回る事になるなんて思ってもみなかったわ」
PRINTFORMW 「ドリル！！　これこそ漢の、女の！　そして亡霊のロマンね！」	PRINTFORMW 「ドリル！！　これこそ漢の、女の！　そして亡霊のロマンね！」
PRINTFORML 「倉って言っても、ウチの物を納めてるのじゃあなかったけどね」	PRINTFORML 「倉って言っても、ウチの物を納めてるのじゃあなかったけどね」
PRINTFORMDW ﾅﾃﾞﾅﾃﾞｼﾃｰ、ﾌｧｰ…ﾌﾞﾙｽｺ…ﾌｧｰ…ﾌﾞﾙｽｺ	PRINTFORMDW ﾅﾃﾞﾅﾃﾞｼﾃｰ、ﾌｧｰ…ﾌﾞﾙｽｺ…ﾌｧｰ…ﾌﾞﾙｽｺ
PRINTFORMW 「不死鳥、そういえば幻想郷にも居るとか聞いたことがあるわね」	PRINTFORMW 「不死鳥、そういえば幻想郷にも居るとか聞いたことがあるわね」
PRINTFORMDW 屠自古は挿入れていた指を掻き回しながらゆっくり引き抜いた…	PRINTFORMDW 屠自古は挿入れていた指を掻き回しながらゆっくり引き抜いた…
PRINTFORMDL しかし屠自古はこれまでの化け物の胎動と恐怖を思い起こすと、	PRINTFORMDL しかし屠自古はこれまでの化け物の胎動と恐怖を思い起こすと、
PRINTFORML 屠自古は処女を失ったショックと貫通の快楽で我を見失っている…	PRINTFORML 屠自古は処女を失ったショックと貫通の快楽で我を見失っている…
PRINTFORML 「そう……難事があればいつでも力になるわ、遠慮なく言ってね」	PRINTFORML 「そう……難事があればいつでも力になるわ、遠慮なく言ってね」
PRINTFORMDW 屠自古は水を飲むと同時に、舌先に走る甘い痺れを感じ取った。	PRINTFORMDW 屠自古は水を飲むと同時に、舌先に走る甘い痺れを感じ取った。
PRINTFORMDW 屠自古は喉を通る白濁したゼリー状の汚物に眉をひそめている…	PRINTFORMDW 屠自古は喉を通る白濁したゼリー状の汚物に眉をひそめている…
PRINTFORML 「よ…かったわぁ……わたしぃ……かんぜんに墜ちたかとぉ……」	PRINTFORML 「よ…かったわぁ……わたしぃ……かんぜんに墜ちたかとぉ……」
PRINTFORML 「ひゃ、めてぇっ！！　これ、はっ…ひっ！　あひゃあぁぁっ！」	PRINTFORML 「ひゃ、めてぇっ！！　これ、はっ…ひっ！　あひゃあぁぁっ！」
PRINTFORML (あがああぁぁぁぁっ！！　死ぬ！！　しんじゃうううぅぅ！！)	PRINTFORML (あがああぁぁぁぁっ！！　死ぬ！！　しんじゃうううぅぅ！！)
PRINTFORM 「ふぅー……ふ、はっ……！　な、何…………？　は、にゃああぁぁ	PRINTFORM 「ふぅー……ふ、はっ……！　な、何…………？　は、にゃああぁぁ
PRINTFORML 「まだまだ……ここでやられちゃ一族に合わせる顔が無いもの」	PRINTFORML 「まだまだ……ここでやられちゃ一族に合わせる顔が無いもの」
PRINTFORML 「ええ、そうよ。祟りなんて八つ当たりの一種に過ぎないのよ」	PRINTFORML 「ええ、そうよ。祟りなんて八つ当たりの一種に過ぎないのよ」
PRINTFORML 　　　　　　　　　　　　　　　　　　　　　　　､ー'/　　	PRINTFORML 　　　　　　　　　　　　　　　　　　　　　　　､ー'/　　
PRINTFORML 「せ…説明するわ！　あえてぇ…力を、ためて、ちゅぎの……」	PRINTFORML 「せ…説明するわ！　あえてぇ…力を、ためて、ちゅぎの……」
PRINTFORML 「……私も人外だけど、異形に易々と股を開く亡霊じゃないわ」	PRINTFORML 「……私も人外だけど、異形に易々と股を開く亡霊じゃないわ」
PRINTFORML 「うあ…!?　わ…私は一本漬にしても美味しくない、ッ…！」	PRINTFORML 「うあ…!?　わ…私は一本漬にしても美味しくない、ッ…！」
PRINTFORMW 「何が目的なのかしら？この生物も、この空間を作ったモノも」	PRINTFORMW 「何が目的なのかしら？この生物も、この空間を作ったモノも」
PRINTFORMDW 屠自古の顔からすぅ、と血の気が引いていくのが見て取れた…	PRINTFORMDW 屠自古の顔からすぅ、と血の気が引いていくのが見て取れた…
PRINTFORMW 「博霊の神にして元怨霊……先達の話を是非ご拝聴願いたいわ」	PRINTFORMW 「博霊の神にして元怨霊……先達の話を是非ご拝聴願いたいわ」
PRINTFORMW 「パラリラパラリラトジトジリン！触手は絶滅しなさ～い！！」	PRINTFORMW 「パラリラパラリラトジトジリン！触手は絶滅しなさ～い！！」
PRINTFORMW 「言いたかっただけよ。ごめん発射口こっち向けないでお願い」	PRINTFORMW 「言いたかっただけよ。ごめん発射口こっち向けないでお願い」
PRINTFORMDW ぶつぶつ言いながら屠自古は着替えを畳み直して袋に入れた…	PRINTFORMDW ぶつぶつ言いながら屠自古は着替えを畳み直して袋に入れた…
PRINTFORM 「し、かたなくぅ……やって…うあぁぁぁ、とろけちゃうぅぅ……	PRINTFORM 「し、かたなくぅ……やって…うあぁぁぁ、とろけちゃうぅぅ……
PRINTFORM ちょおっと、弄っ、ただけでぇ……きゅん、きゅんってえぇ………	PRINTFORM ちょおっと、弄っ、ただけでぇ……きゅん、きゅんってえぇ………
PRINTFORML 屠自古は顔を真っ赤にして涙を浮かべ、己の淫行を恥じている…	PRINTFORML 屠自古は顔を真っ赤にして涙を浮かべ、己の淫行を恥じている…
PRINTFORML 「勝手に寄生して、出てきたら家賃でも徴収してやろうかしら」	PRINTFORML 「勝手に寄生して、出てきたら家賃でも徴収してやろうかしら」
PRINTFORML 「…………母性なんて、湧くはずも無いと思っていたけどね…」	PRINTFORML 「…………母性なんて、湧くはずも無いと思っていたけどね…」
PRINTFORMW 「ひっ、ぎ！！　が！　があああああぁぁぁぁぁっっ！！！！」	PRINTFORMW 「ひっ、ぎ！！　が！　があああああぁぁぁぁぁっっ！！！！」
PRINTFORMW 「いやぁ……こん、な異形ぉ…………わた、しの……なか……」	PRINTFORMW 「いやぁ……こん、な異形ぉ…………わた、しの……なか……」
PRINTFORMW 「ぐ…うぅ……も、元々こんなのあってないようなものよっ！」	PRINTFORMW 「ぐ…うぅ……も、元々こんなのあってないようなものよっ！」
PRINTFORMDW 屠自古は懐から気付け薬を取り出すと、高々と頭上に掲げた！	PRINTFORMDW 屠自古は懐から気付け薬を取り出すと、高々と頭上に掲げた！
PRINTFORMW 「私の仲間になるなら『BF団万歳！』と……軽いジョークよ」	PRINTFORMW 「私の仲間になるなら『BF団万歳！』と……軽いジョークよ」
PRINTFORML 「……！　水がこんなに美味しいものだと思わなかったわ……」	PRINTFORML 「……！　水がこんなに美味しいものだと思わなかったわ……」
PRINTFORML 「ねぇー…ちょっとのあいだ……じゆう行動にぃ、しない…？」	PRINTFORML 「ねぇー…ちょっとのあいだ……じゆう行動にぃ、しない…？」
PRINTFORMDW 屠自古のやわらかな裸体はぬめぬめした液体で覆われている…	PRINTFORMDW 屠自古のやわらかな裸体はぬめぬめした液体で覆われている…
PRINTFORMDW 屠自古は妙に重くなった自らの体に気付き、事態を把握した…	PRINTFORMDW 屠自古は妙に重くなった自らの体に気付き、事態を把握した…
PRINTFORML 「うぅ…………のッ！！　ふざけっ、え？　ああ、どうも……」	PRINTFORML 「うぅ…………のッ！！　ふざけっ、え？　ああ、どうも……」
PRINTFORMDW 口ではそう言いながらも、屠自古は目をしばたかさせている…	PRINTFORMDW 口ではそう言いながらも、屠自古は目をしばたかさせている…
PRINTFORMDL 屠自古は自らの尻から産み落とされる淫蟲を全て出し切ると、	PRINTFORMDL 屠自古は自らの尻から産み落とされる淫蟲を全て出し切ると、
PRINTFORMDW 先刻までの愛撫にカウパーを垂らす男根がそそり立っていた…	PRINTFORMDW 先刻までの愛撫にカウパーを垂らす男根がそそり立っていた…
PRINTFORML 「げほっ！　……ごほっ！！　……う、げ、ええぇぇ…………」	PRINTFORML 「げほっ！　……ごほっ！！　……う、げ、ええぇぇ…………」
PRINTFORM 「ひきゃあああぁ！！！　はっ！！　う、へあああぁぁぁ！！！！	PRINTFORM 「ひきゃあああぁ！！！　はっ！！　う、へあああぁぁぁ！！！！
PRINTFORMW セイガの手を逃れたトジコを待っていたのは、また地獄だった。	PRINTFORMW セイガの手を逃れたトジコを待っていたのは、また地獄だった。
PRINTFORML 「は、やくぅ……、もぅ……せつなくて堪らないのぉ……♪」	PRINTFORML 「は、やくぅ……、もぅ……せつなくて堪らないのぉ……♪」
PRINTFORML そう言って屠自古は既に充血しきったクリトリスを強調した…	PRINTFORML そう言って屠自古は既に充血しきったクリトリスを強調した…
PRINTFORML 「はぁ……。さぁ、化け物共……犯すなら私にしなさい……」	PRINTFORML 「はぁ……。さぁ、化け物共……犯すなら私にしなさい……」
PRINTFORML 　　　　　　　　　　　　　　　　　　　　　ゝｰ-,　＼　	PRINTFORML 　　　　　　　　　　　　　　　　　　　　　ゝｰ-,　＼　
PRINTFORML 「コードD.A.N.S.O.U.G.A　ダンソーガ!!」	PRINTFORML 「コードD.A.N.S.O.U.G.A　ダンソーガ!!」
PRINTFORML 「時間よ！　ただ、閃光に視界を失うのはあんただけどね！」	PRINTFORML 「時間よ！　ただ、閃光に視界を失うのはあんただけどね！」
PRINTFORMDW 屠自古は自らの大事を掻き回そうとする右手を抑えている…	PRINTFORMDW 屠自古は自らの大事を掻き回そうとする右手を抑えている…
PRINTFORML 「大きいからって…好きにしていいわけじゃ……ふぁっ?!」	PRINTFORML 「大きいからって…好きにしていいわけじゃ……ふぁっ?!」
PRINTFORMDL 屠自古は涎を垂らしながら自らの秘所をまさぐり始めた…。	PRINTFORMDL 屠自古は涎を垂らしながら自らの秘所をまさぐり始めた…。
PRINTFORML 「参ったわね……。今度アイツと戦うときは注意しないと…」	PRINTFORML 「参ったわね……。今度アイツと戦うときは注意しないと…」
PRINTFORML 「…………布都と一緒なのがせめてもの救いでしょうか……」	PRINTFORML 「…………布都と一緒なのがせめてもの救いでしょうか……」
PRINTFORMW 「何か変事はあったかしら……まあ、この迷宮自体変事よね」	PRINTFORMW 「何か変事はあったかしら……まあ、この迷宮自体変事よね」
PRINTFORMW 「ああ、さっき起きたところなのよ。……うわ、ひどい寝癖」	PRINTFORMW 「ああ、さっき起きたところなのよ。……うわ、ひどい寝癖」
PRINTFORMW 「果物なの……？　え？　なんで武器として使うのかしら？」	PRINTFORMW 「果物なの……？　え？　なんで武器として使うのかしら？」
PRINTFORML 「うはぁっ！！……ひっ！　ッきゅううううぅぅぅ！！！！」	PRINTFORML 「うはぁっ！！……ひっ！　ッきゅううううぅぅぅ！！！！」
PRINTFORML 「…昔を思い出すわね。……大分よかったわ、今と比べれば」	PRINTFORML 「…昔を思い出すわね。……大分よかったわ、今と比べれば」
PRINTFORML 「一歩も……動けそうに、ない、わ……足、無い……けどぉ」	PRINTFORML 「一歩も……動けそうに、ない、わ……足、無い……けどぉ」
PRINTFORMDW 屠自古はふよふよと浮かび、一切物音を立てずに動いている	PRINTFORMDW 屠自古はふよふよと浮かび、一切物音を立てずに動いている
PRINTFORML 「……くぅ、う。…………なにを、やってるのかしらね……」	PRINTFORML 「……くぅ、う。…………なにを、やってるのかしらね……」
PRINTFORML 「…………んっ……く、ぅ……わたし…生きて、た……の？」	PRINTFORML 「…………んっ……く、ぅ……わたし…生きて、た……の？」
PRINTFORML 「ううぅぅう……何とかして、はず、っ、ひゃいいぃっ！！」	PRINTFORML 「ううぅぅう……何とかして、はず、っ、ひゃいいぃっ！！」
PRINTFORML 「まぁ……おかしくなる気持ちも分からないでも無い、わよ」	PRINTFORML 「まぁ……おかしくなる気持ちも分からないでも無い、わよ」
PRINTFORMDW これからの未知なる男性の快楽を期待しているようだった…	PRINTFORMDW これからの未知なる男性の快楽を期待しているようだった…
PRINTFORMDW 脳裏に浮かぶ%ARGS:1%の痴態が屠自古の歩を止めた	PRINTFORMDW 脳裏に浮かぶ%ARGS:1%の痴態が屠自古の歩を止めた
PRINTFORMDW 胸を触る。かすかに声を上げているが、抵抗する様子は無い	PRINTFORMDW 胸を触る。かすかに声を上げているが、抵抗する様子は無い
PRINTFORMW 言うが早いか屠自古は先端を%ARGS:1%へ差し込んだ…	PRINTFORMW 言うが早いか屠自古は先端を%ARGS:1%へ差し込んだ…
PRINTFORM 　やばあぁっ…きもちいいぃ……わたしちんぽで感じてるのおぉ	PRINTFORM 　やばあぁっ…きもちいいぃ……わたしちんぽで感じてるのおぉ
PRINTFORML 見かけたら、仲間にしてやると探索が賑やかになる、かも。	PRINTFORML 見かけたら、仲間にしてやると探索が賑やかになる、かも。
PRINTFORML 「末代と言わず世の終わりまで……祟ってやりましょう？」	PRINTFORML 「末代と言わず世の終わりまで……祟ってやりましょう？」
PRINTFORML 　　　　　　　　　　　　　　　　　　　　　　/　、　＼	PRINTFORML 　　　　　　　　　　　　　　　　　　　　　　/　、　＼
PRINTFORMDW 体を張った冗談を遮られて屠自古は恥ずかしがっている…	PRINTFORMDW 体を張った冗談を遮られて屠自古は恥ずかしがっている…
PRINTFORMDW 屠自古は大きく深呼吸して、気持ちを落ち着かせている…	PRINTFORMDW 屠自古は大きく深呼吸して、気持ちを落ち着かせている…
PRINTFORMDW 自らの手と室内に響く淫らな水音を止められないようだ…	PRINTFORMDW 自らの手と室内に響く淫らな水音を止められないようだ…
PRINTFORMDW しかし、自らの淫欲に負け、屠自古の秘部に手が触れた…	PRINTFORMDW しかし、自らの淫欲に負け、屠自古の秘部に手が触れた…
PRINTFORM 「あっ！　やっ！　とまら、やあぁっ！　とまらないのぉ！　	PRINTFORM 「あっ！　やっ！　とまら、やあぁっ！　とまらないのぉ！　
PRINTFORMDW 屠自古は頬を赤く上気させ、内腿を擦り合わせている…。	PRINTFORMDW 屠自古は頬を赤く上気させ、内腿を擦り合わせている…。
PRINTFORM 「お願いぃ……そんな眼で見ないでぇ…………ふあッ！　あッ	PRINTFORM 「お願いぃ……そんな眼で見ないでぇ…………ふあッ！　あッ
PRINTFORML 「くっ…、ごめんね。……今の私じゃ……無理、だわ……」	PRINTFORML 「くっ…、ごめんね。……今の私じゃ……無理、だわ……」
PRINTFORMW 「亡霊になった時はもう怖いものなんて無いと思ったのに」	PRINTFORMW 「亡霊になった時はもう怖いものなんて無いと思ったのに」
PRINTFORMW 「百式…いや、なんでもないわ。このリーチは有難いわね」	PRINTFORMW 「百式…いや、なんでもないわ。このリーチは有難いわね」
PRINTFORML 「太陰太極図を模した武具、この前の巫女も使ってたわね」	PRINTFORML 「太陰太極図を模した武具、この前の巫女も使ってたわね」
PRINTFORMW 「まあ、道教的にも重要なものだし、とっておきましょう」	PRINTFORMW 「まあ、道教的にも重要なものだし、とっておきましょう」
PRINTFORMW 「私の死んでる間に僧侶ってドMの集団になっていたのね」	PRINTFORMW 「私の死んでる間に僧侶ってドMの集団になっていたのね」
PRINTFORML 「こんなぁ…見つかり、そうなぁ……ところぉ……でぇ…」	PRINTFORML 「こんなぁ…見つかり、そうなぁ……ところぉ……でぇ…」
PRINTFORML 「あぁ～……ううあぁ～……せつな、ぁい、わ、よおぉ…」	PRINTFORML 「あぁ～……ううあぁ～……せつな、ぁい、わ、よおぉ…」
PRINTFORMDW 屠自古はやっとの事で%ARGS:1%を振り払ったが、	PRINTFORMDW 屠自古はやっとの事で%ARGS:1%を振り払ったが、
PRINTFORML 「気分は治った……けど、今度は体が付いてこないわ……」	PRINTFORML 「気分は治った……けど、今度は体が付いてこないわ……」
PRINTFORML 「跡、形も……残してやらないんだからぁ………っ！！」 	PRINTFORML 「跡、形も……残してやらないんだからぁ………っ！！」 
PRINTFORML 「二度まで死んだ身よ…、惜しい筈も無く捧げてあげるわ」	PRINTFORML 「二度まで死んだ身よ…、惜しい筈も無く捧げてあげるわ」
PRINTFORML 「歩かなくていい、って点ではやっぱり亡霊でよかったわ」	PRINTFORML 「歩かなくていい、って点ではやっぱり亡霊でよかったわ」
PRINTFORML 「そう身構えないで……余ってただけ、よ。他意は無いわ」	PRINTFORML 「そう身構えないで……余ってただけ、よ。他意は無いわ」
PRINTFORML 「うぇっ！……ゴホっ、ゲホっ！　な…んなのよ………！」	PRINTFORML 「うぇっ！……ゴホっ、ゲホっ！　な…んなのよ………！」
PRINTFORMDW 屠自古はまさに極楽と言った表情で沐浴を満喫している…	PRINTFORMDW 屠自古はまさに極楽と言った表情で沐浴を満喫している…
PRINTFORML 「……味のほうはともかくとして、眠気は吹き飛んだわね」	PRINTFORML 「……味のほうはともかくとして、眠気は吹き飛んだわね」
PRINTFORML 「あひゃ、あっ！!　ふわぁ………！！　いぎいぃっ！！」	PRINTFORML 「あひゃ、あっ！!　ふわぁ………！！　いぎいぃっ！！」
PRINTFORML 淫蟲は屠自古の撒き散らしたゼリー状の子種を吸っている…	PRINTFORML 淫蟲は屠自古の撒き散らしたゼリー状の子種を吸っている…
PRINTFORML 「んごーーーっ！！　ぁ！！　っっんーーーーー！！！！」	PRINTFORML 「んごーーーっ！！　ぁ！！　っっんーーーーー！！！！」
PRINTFORML 「………………ぅー。……………ひゅー……ひゅーー……」	PRINTFORML 「………………ぅー。……………ひゅー……ひゅーー……」
PRINTFORMW 「ひっ?!　あ……？　……い、いやああああぁぁっ！！！	PRINTFORMW 「ひっ?!　あ……？　……い、いやああああぁぁっ！！！
PRINTFORMW 「敵は最悪の触手達！　だけど私が命を懸けて挑めば…」	PRINTFORMW 「敵は最悪の触手達！　だけど私が命を懸けて挑めば…」
PRINTFORMD そう言いつつ、後ろ手にワンピースの裾を捲り上げながら	PRINTFORMD そう言いつつ、後ろ手にワンピースの裾を捲り上げながら
PRINTFORMW 「次元連結システムの応用で、雷と天の力を一つに！！」	PRINTFORMW 「次元連結システムの応用で、雷と天の力を一つに！！」
PRINTFORMDL 　屠自古は顔を真っ赤にして目に涙を浮かべているが、	PRINTFORMDL 　屠自古は顔を真っ赤にして目に涙を浮かべているが、
PRINTFORML 「ふにゃあああぁぁ！　だめぇ！　こえらめなのぉ！！」	PRINTFORML 「ふにゃあああぁぁ！　だめぇ！　こえらめなのぉ！！」
PRINTFORMDW 屠自古は恥辱と快楽で顔をぐしゃぐしゃにしている…。	PRINTFORMDW 屠自古は恥辱と快楽で顔をぐしゃぐしゃにしている…。
PRINTFORML 「あかちゃん、ま、でぇ……穢さ…ない、でぇ……！！」	PRINTFORML 「あかちゃん、ま、でぇ……穢さ…ない、でぇ……！！」
PRINTFORML 「もぉ……げんかい…。ちょっと、だけ……だからぁ…」	PRINTFORML 「もぉ……げんかい…。ちょっと、だけ……だからぁ…」
PRINTFORML (でも……元はといえば私がこんな姿になったのも……)	PRINTFORML (でも……元はといえば私がこんな姿になったのも……)
PRINTFORMDW 屠自古は弱りきった声で何度も、低く呟いていた……。	PRINTFORMDW 屠自古は弱りきった声で何度も、低く呟いていた……。
PRINTFORML 「…………気を遣わないで。情けなくなっちゃうわ……」	PRINTFORML 「…………気を遣わないで。情けなくなっちゃうわ……」
PRINTFORMDW 屠自古は極力薄暗い周りの光景を見ないで話している…	PRINTFORMDW 屠自古は極力薄暗い周りの光景を見ないで話している…
PRINTFORML 「暗いし不快ね。…………そうね。やってみようかしら」	PRINTFORML 「暗いし不快ね。…………そうね。やってみようかしら」
PRINTFORMDW 屠自古はため息を付きながらも情報を書き留めている…	PRINTFORMDW 屠自古はため息を付きながらも情報を書き留めている…
PRINTFORMW 「生きてここから出ましょう。……私は死んでるけどね」	PRINTFORMW 「生きてここから出ましょう。……私は死んでるけどね」
PRINTFORMDW こんな狭い場所で核ミサイルを打つ気だったのだろうか	PRINTFORMDW こんな狭い場所で核ミサイルを打つ気だったのだろうか
PRINTFORMW 「神道の生者のための護符って、私から一番遠い物よね」	PRINTFORMW 「神道の生者のための護符って、私から一番遠い物よね」
PRINTFORMW 「洋菓子よ。濃厚な甘さで香り高い茶との相性は抜群ね」	PRINTFORMW 「洋菓子よ。濃厚な甘さで香り高い茶との相性は抜群ね」
PRINTFORML 「今じゃ簡単に手にはいるのよね。時の流れを感じるわ」	PRINTFORML 「今じゃ簡単に手にはいるのよね。時の流れを感じるわ」
PRINTFORML 「ぬるめの湯で、四度くらいに分けて楽しむのが風流よ」	PRINTFORML 「ぬるめの湯で、四度くらいに分けて楽しむのが風流よ」
PRINTFORMW 「やだ、折り方がめちゃくちゃじゃない。誰よ畳んだの」	PRINTFORMW 「やだ、折り方がめちゃくちゃじゃない。誰よ畳んだの」
PRINTFORML 「最初は私がやるわ……あなた達よりは耐えられるから」	PRINTFORML 「最初は私がやるわ……あなた達よりは耐えられるから」
PRINTFORMDW 屠自古の手は快楽を求めて敏感な部分に伸びていった…	PRINTFORMDW 屠自古の手は快楽を求めて敏感な部分に伸びていった…
PRINTFORML 「うはぁ……先っちょ、がぁ…ジン、ジンするのぉ……」	PRINTFORML 「うはぁ……先っちょ、がぁ…ジン、ジンするのぉ……」
PRINTFORMDW 張った胸の先端からは依然として母乳が流れ出ている…	PRINTFORMDW 張った胸の先端からは依然として母乳が流れ出ている…
PRINTFORML 「この感じ…生きてた時にも……いつだったかしら……」	PRINTFORML 「この感じ…生きてた時にも……いつだったかしら……」
PRINTFORML 「弱い相手はもう飽きた～♪強い相手はどこにいる～♪」	PRINTFORML 「弱い相手はもう飽きた～♪強い相手はどこにいる～♪」
PRINTFORML 「……はぁ。化け物に散らされるより万倍マシ、かしら」	PRINTFORML 「……はぁ。化け物に散らされるより万倍マシ、かしら」
PRINTFORML 「知って損する事はないものね。いいわ、確か…・・・」	PRINTFORML 「知って損する事はないものね。いいわ、確か…・・・」
PRINTFORMW 「私に楯突く触手が者共、所業を背負えば現世に還る！」	PRINTFORMW 「私に楯突く触手が者共、所業を背負えば現世に還る！」
PRINTFORMW 「聞きなさい！　盛者必衰！！　命の鐘の響きあり！！」	PRINTFORMW 「聞きなさい！　盛者必衰！！　命の鐘の響きあり！！」
PRINTFORML 「ディバイデイィィング、ドライバァァァーーー！！！」	PRINTFORML 「ディバイデイィィング、ドライバァァァーーー！！！」
PRINTFORML 「やってらんないわよ！　私は私でやらせてもらうわ！」	PRINTFORML 「やってらんないわよ！　私は私でやらせてもらうわ！」
PRINTFORML (い……一度イッておかないと…せつな、いぃ……っ！)	PRINTFORML (い……一度イッておかないと…せつな、いぃ……っ！)
PRINTFORMDW むしろより強い力で逆流し、屠自古の膣内を満たした…	PRINTFORMDW むしろより強い力で逆流し、屠自古の膣内を満たした…
PRINTFORMDW そう言いながら屠自古はテキパキと荷物を漁っている…	PRINTFORMDW そう言いながら屠自古はテキパキと荷物を漁っている…
PRINTFORMDW いつもの射精感と違う感覚に屠自古は驚きの声を上げた	PRINTFORMDW いつもの射精感と違う感覚に屠自古は驚きの声を上げた
PRINTFORML 「神霊(ゴッド・ゴオォォスト)、チェェェンジ！！」	PRINTFORML 「神霊(ゴッド・ゴオォォスト)、チェェェンジ！！」
PRINTFORML 「止めれるものなら止めてみなさい！超電磁スピン！」	PRINTFORML 「止めれるものなら止めてみなさい！超電磁スピン！」
PRINTFORML 「そこ！　串に刺さった雀とか言うんじゃないわよ！」	PRINTFORML 「そこ！　串に刺さった雀とか言うんじゃないわよ！」
PRINTFORMW 「や、ふぁぁ……。し、たくっ、ない…のにぃ……」 	PRINTFORMW 「や、ふぁぁ……。し、たくっ、ない…のにぃ……」 
PRINTFORML 「!?　ダメダメダメぇ！！　お豆……剥いちゃ…！」	PRINTFORML 「!?　ダメダメダメぇ！！　お豆……剥いちゃ…！」
PRINTFORMDW あまりの快楽に屠自古は口をパクパクさせている…。	PRINTFORMDW あまりの快楽に屠自古は口をパクパクさせている…。
PRINTFORML 「何これっ……あっ、あひゅあぁぁ……しゅごぉ…！」	PRINTFORML 「何これっ……あっ、あひゅあぁぁ……しゅごぉ…！」
PRINTFORML 「足があったら捕まってたわね。亡霊でよかったわ…」	PRINTFORML 「足があったら捕まってたわね。亡霊でよかったわ…」
PRINTFORML 「認めたくないものね、亡霊ゆえの楽観というものを」	PRINTFORML 「認めたくないものね、亡霊ゆえの楽観というものを」
PRINTFORML 「……私を、置いて行く意味……分かってるのよね？」	PRINTFORML 「……私を、置いて行く意味……分かってるのよね？」
PRINTFORML 「あら、青娥。俗世は捨てきったんじゃなかったの？」	PRINTFORML 「あら、青娥。俗世は捨てきったんじゃなかったの？」
PRINTFORML 「まじまじ見つめないで……しょうがないじゃない…」	PRINTFORML 「まじまじ見つめないで……しょうがないじゃない…」
PRINTFORMW 「下は……すぐ落ちちゃって。穿いとけばよかったわ」	PRINTFORMW 「下は……すぐ落ちちゃって。穿いとけばよかったわ」
PRINTFORML 「どうも沸きやすいのとそうでないのが居るみたいね」	PRINTFORML 「どうも沸きやすいのとそうでないのが居るみたいね」
PRINTFORM 「えぇ、冗談よ。私はそんな事しないわ……本当よぉ！」	PRINTFORM 「えぇ、冗談よ。私はそんな事しないわ……本当よぉ！」
PRINTFORML 「悪いけど、これ以上連れて行くのは難しそうね……」	PRINTFORML 「悪いけど、これ以上連れて行くのは難しそうね……」
PRINTFORMW 「まあ、私のスペカって全部一緒みたいなもんだけど」	PRINTFORMW 「まあ、私のスペカって全部一緒みたいなもんだけど」
PRINTFORMW 「いっぺん死んでから、みえるものだってあるのに…」	PRINTFORMW 「いっぺん死んでから、みえるものだってあるのに…」
PRINTFORMW 「昔の異変で使われたもの？　どうしてここに……？」	PRINTFORMW 「昔の異変で使われたもの？　どうしてここに……？」
PRINTFORMW 「僧が精神を安らかにするために叩いてもらう……？」	PRINTFORMW 「僧が精神を安らかにするために叩いてもらう……？」
PRINTFORML 「あ…あはっ！　………にゃ、あああぁっ！！　……」	PRINTFORML 「あ…あはっ！　………にゃ、あああぁっ！！　……」
PRINTFORMDW 屠自古の乳からはだらしなく母乳が垂れ流れている…	PRINTFORMDW 屠自古の乳からはだらしなく母乳が垂れ流れている…
PRINTFORMW 「いよいよかしら……もう、覚悟は…う、できてるわ」	PRINTFORMW 「いよいよかしら……もう、覚悟は…う、できてるわ」
PRINTFORML 「さ…すがにここまで大きくなると隠せないわね……」	PRINTFORML 「さ…すがにここまで大きくなると隠せないわね……」
PRINTFORML 「…………いくら亡霊でも、元は人間よね……そりゃ」	PRINTFORML 「…………いくら亡霊でも、元は人間よね……そりゃ」
PRINTFORML 「どうしても無理っていうなら見捨てても構わないわ」	PRINTFORML 「どうしても無理っていうなら見捨てても構わないわ」
PRINTFORML 「………………、え？　ぜんぜん寝てなんて無い……」	PRINTFORML 「………………、え？　ぜんぜん寝てなんて無い……」
PRINTFORMDW 屠自古は死角に身を隠し、神経を張り詰めている……	PRINTFORMDW 屠自古は死角に身を隠し、神経を張り詰めている……
PRINTFORML 「ううぅ！　ここだけはぁ……だめぇ……かしらぁ？」	PRINTFORML 「ううぅ！　ここだけはぁ……だめぇ……かしらぁ？」
PRINTFORML 「もぉー、がまん、むりぃ……いれちゃう…のぉ……」	PRINTFORML 「もぉー、がまん、むりぃ……いれちゃう…のぉ……」
PRINTFORMDW 屠自古は歯を食いしばり苦痛の叫びを上げている… 	PRINTFORMDW 屠自古は歯を食いしばり苦痛の叫びを上げている… 
PRINTFORML 「……って太子様冗談ですから、あ、すみません……」	PRINTFORML 「……って太子様冗談ですから、あ、すみません……」
PRINTFORML 「ごめんなさいね、もう少し調べたい事があって……」	PRINTFORML 「ごめんなさいね、もう少し調べたい事があって……」
PRINTFORML 「これで少しゆっくり出来るわね……何しようかしら」	PRINTFORML 「これで少しゆっくり出来るわね……何しようかしら」
PRINTFORMDW 屠自古は暫く辺りを見回して、状況を理解したようだ	PRINTFORMDW 屠自古は暫く辺りを見回して、状況を理解したようだ
PRINTFORMDW 屠自古は顔を真っ赤にしながら、周りの仲間のを見た	PRINTFORMDW 屠自古は顔を真っ赤にしながら、周りの仲間のを見た
PRINTFORMDL 屠自古は慌てて膣内からそれを掻き出そうとするが、	PRINTFORMDL 屠自古は慌てて膣内からそれを掻き出そうとするが、
PRINTFORMDL ビクンビクンと脈を打って雄雄しく反り立つそれは、	PRINTFORMDL ビクンビクンと脈を打って雄雄しく反り立つそれは、
PRINTFORML 「ヒャッハァーー！！　やあってやんよぉーー！！！」	PRINTFORML 「ヒャッハァーー！！　やあってやんよぉーー！！！」
PRINTFORML 「そ、こ、ちがっ……は、入って、こない、でっ！！」	PRINTFORML 「そ、こ、ちがっ……は、入って、こない、でっ！！」
PRINTFORMDL 淫蟲が去った後も、ぽっかり空いた屠自古の肛門は、	PRINTFORMDL 淫蟲が去った後も、ぽっかり空いた屠自古の肛門は、
PRINTFORML 「やぁっ！　へんっ！　ぜんぶっ、あっついのぉ！！」	PRINTFORML 「やぁっ！　へんっ！　ぜんぶっ、あっついのぉ！！」
PRINTFORML 「へ…へはあぁ…………とまりゃない…にょおぉ……」	PRINTFORML 「へ…へはあぁ…………とまりゃない…にょおぉ……」
PRINTFORML 「んごぉっ！！　ふぁ!?　うぼおぉぉっっ！！？！」	PRINTFORML 「んごぉっ！！　ふぁ!?　うぼおぉぉっっ！！？！」
PRINTFORM (わたし……なに、してんのよぉ…………さい、てぇ……	PRINTFORM (わたし……なに、してんのよぉ…………さい、てぇ……
PRINTFORM 「あぁ……もう、むりぃ……や、犯って……やんよぉ……	PRINTFORM 「あぁ……もう、むりぃ……や、犯って……やんよぉ……
PRINTFORMDL 屠自古の淀んだ瞳は中空に投げかけられている…。	PRINTFORMDL 屠自古の淀んだ瞳は中空に投げかけられている…。
PRINTFORMDW 屠自古の尻穴はヒクつき、期待に打ち震えている…	PRINTFORMDW 屠自古の尻穴はヒクつき、期待に打ち震えている…
PRINTFORML 「……私はここよ。　逃げも隠れも……しない、わ」	PRINTFORML 「……私はここよ。　逃げも隠れも……しない、わ」
PRINTFORML 「ガゴッ…はぁ、くッ……ガゴウジサイクロンッ！」	PRINTFORML 「ガゴッ…はぁ、くッ……ガゴウジサイクロンッ！」
PRINTFORML 「ち、畜しょおおぉぉ……にゃああぁぁぁぁ！！！」	PRINTFORML 「ち、畜しょおおぉぉ……にゃああぁぁぁぁ！！！」
PRINTFORML 「蝦夷兄様……世界は私達を悪者にしたいそうよ？」	PRINTFORML 「蝦夷兄様……世界は私達を悪者にしたいそうよ？」
PRINTFORMDW 屠自古は狙いが定まらずしきりに首を振っている。	PRINTFORMDW 屠自古は狙いが定まらずしきりに首を振っている。
PRINTFORML 「電気なら、竹を媒体にすれば効率がいいかしらね」	PRINTFORML 「電気なら、竹を媒体にすれば効率がいいかしらね」
PRINTFORML 「うあぁ……っ！　きもちぃ…気持ちいいのぉ……」	PRINTFORML 「うあぁ……っ！　きもちぃ…気持ちいいのぉ……」
PRINTFORMDL 敵はワンピースの胸部ばかりを執拗に狙っている。	PRINTFORMDL 敵はワンピースの胸部ばかりを執拗に狙っている。
PRINTFORML 「っ！！　……っ！　はっ！！　あ！！　ああ！！」	PRINTFORML 「っ！！　……っ！　はっ！！　あ！！　ああ！！」
PRINTFORML 「きひいぃ！！こ、の……化け物の、母性なんてっ」	PRINTFORML 「きひいぃ！！こ、の……化け物の、母性なんてっ」
PRINTFORML 「あっ！　や、あ、う、ひゃああぁぁぁっっ！！！」	PRINTFORML 「あっ！　や、あ、う、ひゃああぁぁぁっっ！！！」
PRINTFORMW 「あぁ……ふ、きゅううぅぅぅぅっっ?!?!?!」	PRINTFORMW 「あぁ……ふ、きゅううぅぅぅぅっっ?!?!?!」
PRINTFORML 「うぅぅうう………た、たいした事ないわ、ね……」	PRINTFORML 「うぅぅうう………た、たいした事ないわ、ね……」
PRINTFORML 「当たらなければ…！　どうという事は無いのよ！」	PRINTFORML 「当たらなければ…！　どうという事は無いのよ！」
PRINTFORML 「もう！　何なのよ！　亡霊を苛めて楽しいの!?」	PRINTFORML 「もう！　何なのよ！　亡霊を苛めて楽しいの!?」
PRINTFORML 「きもちぃ、の………がまん、できないわよぉ……」	PRINTFORML 「きもちぃ、の………がまん、できないわよぉ……」
PRINTFORM 　こん、なぁ…きもちぃのにぃ……にげるなんてぇ……	PRINTFORM 　こん、なぁ…きもちぃのにぃ……にげるなんてぇ……
PRINTFORMW 「太子様、お怪我は…。いえ、私は大丈夫ですから」	PRINTFORMW 「太子様、お怪我は…。いえ、私は大丈夫ですから」
PRINTFORMW 「しかしこんな事、私の生きてた時には無かったわ」	PRINTFORMW 「しかしこんな事、私の生きてた時には無かったわ」
PRINTFORMDW 屠自古の雷で、薄暗い迷宮に少し明かりが灯った…	PRINTFORMDW 屠自古の雷で、薄暗い迷宮に少し明かりが灯った…
PRINTFORMW 「これは……もしかしてミサイルってやつかしら？」	PRINTFORMW 「これは……もしかしてミサイルってやつかしら？」
PRINTFORMW 「私の生きてた時代の妖怪ってもっと粗暴だったわ」	PRINTFORMW 「私の生きてた時代の妖怪ってもっと粗暴だったわ」
PRINTFORMW 「…………だから何なの？　嫌がらせなのかしら？」	PRINTFORMW 「…………だから何なの？　嫌がらせなのかしら？」
PRINTFORMW 「宴で見たけど、これ、鬼の宝の瓢箪じゃないの？」	PRINTFORMW 「宴で見たけど、これ、鬼の宝の瓢箪じゃないの？」
PRINTFORML 「私が生きていた頃には、まだお茶は無かったのよ」	PRINTFORML 「私が生きていた頃には、まだお茶は無かったのよ」
PRINTFORML 「私、これ飲んでも大丈夫かしら……まあ飲むけど」	PRINTFORML 「私、これ飲んでも大丈夫かしら……まあ飲むけど」
PRINTFORMW 「まあ何にせよ、あとはゴブレットがあれば完璧ね」	PRINTFORMW 「まあ何にせよ、あとはゴブレットがあれば完璧ね」
PRINTFORMD 挿入されたままの触手をきゅうきゅう締め付けながら	PRINTFORMD 挿入されたままの触手をきゅうきゅう締め付けながら
PRINTFORML 「はあ……はぁ…ちぎれちゃ……ふはあぁっっ！！」	PRINTFORML 「はあ……はぁ…ちぎれちゃ……ふはあぁっっ！！」
PRINTFORMDW 屠自古は未練がましく乳首を転がし、弄っている…	PRINTFORMDW 屠自古は未練がましく乳首を転がし、弄っている…
PRINTFORMDW 屠自古は淫核を潰していた指をのろのろとどけた…	PRINTFORMDW 屠自古は淫核を潰していた指をのろのろとどけた…
PRINTFORML 「うぅ……つわりが生きてた時よりひどい……わね」	PRINTFORML 「うぅ……つわりが生きてた時よりひどい……わね」
PRINTFORML 「うー、張って来たわね……服が駄目になっちゃう」	PRINTFORML 「うー、張って来たわね……服が駄目になっちゃう」
PRINTFORM 「こ…こんな化け物にぃ……あ、あぁ、あはあぁぁ……	PRINTFORM 「こ…こんな化け物にぃ……あ、あぁ、あはあぁぁ……
PRINTFORML 「あぁー、……わたしぃ…へんたい、だあぁ………」	PRINTFORML 「あぁー、……わたしぃ…へんたい、だあぁ………」
PRINTFORML 「ぼ…亡霊なんて食べたらお腹冷やすわ……よ……」	PRINTFORML 「ぼ…亡霊なんて食べたらお腹冷やすわ……よ……」
PRINTFORMD 屠自古は自分にそう言い聞かせながらも、不安そうに	PRINTFORMD 屠自古は自分にそう言い聞かせながらも、不安そうに
PRINTFORMDW 屠自古は疑似的な排泄にすら快感を感じている……	PRINTFORMDW 屠自古は疑似的な排泄にすら快感を感じている……
PRINTFORMDL 屠自古は膝を付き、尻を高く突き上げるようにして	PRINTFORMDL 屠自古は膝を付き、尻を高く突き上げるようにして
PRINTFORML 「やめてっ！　膣内でっ、あば、れないでぇっ！！」	PRINTFORML 「やめてっ！　膣内でっ、あば、れないでぇっ！！」
PRINTFORML 「う……はぁっ！！　ど、こをこい、つらぁっ！！」	PRINTFORML 「う……はぁっ！！　ど、こをこい、つらぁっ！！」
PRINTFORML 「わ、たし……おとこの…生えて……あ、は……は」	PRINTFORML 「わ、たし……おとこの…生えて……あ、は……は」
PRINTFORML 「ひうぅぅ…………うぞ、うぞ……して、るぅ……」	PRINTFORML 「ひうぅぅ…………うぞ、うぞ……して、るぅ……」
PRINTFORML 「ひぃっ！　……んー！！　んーっ、んぶぅ！？！」	PRINTFORML 「ひぃっ！　……んー！！　んーっ、んぶぅ！？！」
PRINTFORML 「ひあぁぁっ！　だめっ！　気、を…しっかり……」	PRINTFORML 「ひあぁぁっ！　だめっ！　気、を…しっかり……」
PRINTFORMW 「…………とか言ってる場合じゃないわよね。これ」	PRINTFORMW 「…………とか言ってる場合じゃないわよね。これ」
PRINTFORMW 「…………はぁっ……！　はあ…はあぁ…………！」	PRINTFORMW 「…………はぁっ……！　はあ…はあぁ…………！」
PRINTFORM ……こんなの見せられちゃ我慢なんて、出来るはずが…	PRINTFORM ……こんなの見せられちゃ我慢なんて、出来るはずが…
PRINTFORMW 屠自古は我に返り、逃げ去るようにその場を離れた…	PRINTFORMW 屠自古は我に返り、逃げ去るようにその場を離れた…
PRINTFORML 「まだまだ…やられても祟ってやるんだから……」	PRINTFORML 「まだまだ…やられても祟ってやるんだから……」
PRINTFORML 「ハッハァー！　ほんと豪族は地獄だわーっ！！」	PRINTFORML 「ハッハァー！　ほんと豪族は地獄だわーっ！！」
PRINTFORML 「一点を…しゅうちゅうしてぇ……あぁ～もう！」	PRINTFORML 「一点を…しゅうちゅうしてぇ……あぁ～もう！」
PRINTFORMDW 屠自古は股間をまさぐり、切なそうにしている。	PRINTFORMDW 屠自古は股間をまさぐり、切なそうにしている。
PRINTFORML 「力が強すぎると、透過って出来ないのよね……」	PRINTFORML 「力が強すぎると、透過って出来ないのよね……」
PRINTFORML 「やっ！　いま、イッて、ダメぇ！　なのにっ！」	PRINTFORML 「やっ！　いま、イッて、ダメぇ！　なのにっ！」
PRINTFORML 「無駄と分かっていても、守りたくなるものね…」	PRINTFORML 「無駄と分かっていても、守りたくなるものね…」
PRINTFORML 「もう破く服なんて……！　あ、う、はぁ……！」	PRINTFORML 「もう破く服なんて……！　あ、う、はぁ……！」
PRINTFORML 「ああぁぁ……あかちゃんのみるく…でてぅ……」	PRINTFORML 「ああぁぁ……あかちゃんのみるく…でてぅ……」
PRINTFORML 「し、絞るのもぉ！　そえもらめえぇぇっ！！！」	PRINTFORML 「し、絞るのもぉ！　そえもらめえぇぇっ！！！」
PRINTFORML 「嫌ッ……そんな、一気にぃ…来ちゃあぁぁ！！」	PRINTFORML 「嫌ッ……そんな、一気にぃ…来ちゃあぁぁ！！」
PRINTFORML 「ゆ…許してぇ……ふ、あ…あッ！　ああぁッ！」	PRINTFORML 「ゆ…許してぇ……ふ、あ…あッ！　ああぁッ！」
PRINTFORML 「な…っ？　なにっ？！　やっ！　にゃあぁ?!」	PRINTFORML 「な…っ？　なにっ？！　やっ！　にゃあぁ?!」
PRINTFORMDW 屠自古は糸の切れた人形のように膝を突いた…。	PRINTFORMDW 屠自古は糸の切れた人形のように膝を突いた…。
PRINTFORML 「みえるわ……ふるさとの……石舞台が…………」	PRINTFORML 「みえるわ……ふるさとの……石舞台が…………」
PRINTFORML 「そこでぇ……いっぱぁい…………えへへぇ……」	PRINTFORML 「そこでぇ……いっぱぁい…………えへへぇ……」
PRINTFORMDW 屠自古は目を潤ませて蕩けた表情をしている…。	PRINTFORMDW 屠自古は目を潤ませて蕩けた表情をしている…。
PRINTFORML 「お、ねがい……わ、たし…………も……う……」	PRINTFORML 「お、ねがい……わ、たし…………も……う……」
PRINTFORML 「……余裕がある内は、保護しておいてあげるわ」	PRINTFORML 「……余裕がある内は、保護しておいてあげるわ」
PRINTFORMW 「蘇我の祟りの力、とくと思い知らせてやるわよ」	PRINTFORMW 「蘇我の祟りの力、とくと思い知らせてやるわよ」
PRINTFORML 「これは……あ、なるほど。目を防護する道具ね」	PRINTFORML 「これは……あ、なるほど。目を防護する道具ね」
PRINTFORMW 「敏捷と美しさの種はハッサンにあげるものよね」	PRINTFORMW 「敏捷と美しさの種はハッサンにあげるものよね」
PRINTFORMD 剥き出しになった淫核への刺激に身体を痙攣させ、	PRINTFORMD 剥き出しになった淫核への刺激に身体を痙攣させ、
PRINTFORML 「んはぁ……おしりにぃ……なか…震え…っ！！」	PRINTFORML 「んはぁ……おしりにぃ……なか…震え…っ！！」
PRINTFORML 「なっ?!　吸わ、れっ！やめなさ、いぃぃ……」	PRINTFORML 「なっ?!　吸わ、れっ！やめなさ、いぃぃ……」
PRINTFORMW 「ぼ…亡霊のどこから養分を得ようってのよ……」	PRINTFORMW 「ぼ…亡霊のどこから養分を得ようってのよ……」
PRINTFORMW 「ここまで来たら早く出ていって欲しい、わ……」	PRINTFORMW 「ここまで来たら早く出ていって欲しい、わ……」
PRINTFORML 「あんまり好きでもないのに、なんでかしらね？」	PRINTFORML 「あんまり好きでもないのに、なんでかしらね？」
PRINTFORML 「遅れてる…のね。そう……そうに決まってるわ」	PRINTFORML 「遅れてる…のね。そう……そうに決まってるわ」
PRINTFORML 「な…胎内で、あば、れ……元気…すぎ……るわ」	PRINTFORML 「な…胎内で、あば、れ……元気…すぎ……るわ」
PRINTFORML 「手伝ってあげるわ、ただし何でもビリビリよ？」	PRINTFORML 「手伝ってあげるわ、ただし何でもビリビリよ？」
PRINTFORMW 「神霊廟が英雄本色！　玩具で遊ぶは笑止千万！」	PRINTFORMW 「神霊廟が英雄本色！　玩具で遊ぶは笑止千万！」
PRINTFORMDW 屠自古は申し訳なさそうに力無く微笑んでいる…	PRINTFORMDW 屠自古は申し訳なさそうに力無く微笑んでいる…
PRINTFORML 「や…中には……ああああああぁぁぁっっ!!?」	PRINTFORML 「や…中には……ああああああぁぁぁっっ!!?」
PRINTFORML 「もぉ……いやぁ……なんで、わたしがぁ………」	PRINTFORML 「もぉ……いやぁ……なんで、わたしがぁ………」
PRINTFORML 「ひっ……？　何なのよ、なんなのよコレぇ！！」	PRINTFORML 「ひっ……？　何なのよ、なんなのよコレぇ！！」
PRINTFORMW 「ゆううぅぅぅ！！　わた、イ、ってるぅ?!!」	PRINTFORMW 「ゆううぅぅぅ！！　わた、イ、ってるぅ?!!」
PRINTFORML 「ひゃぁっ！　そん、なっ、お豆ぇっ！　ばっ！」	PRINTFORML 「ひゃぁっ！　そん、なっ、お豆ぇっ！　ばっ！」
PRINTFORMDL 淫蟲は屠自古の淫核へ群がり、吸い付いている…	PRINTFORMDL 淫蟲は屠自古の淫核へ群がり、吸い付いている…
PRINTFORML 激痛にも似た電流が屠自古の心を灼き切って行く…	PRINTFORML 激痛にも似た電流が屠自古の心を灼き切って行く…
PRINTFORM 「こ、これ以上……大きく……しな、いでぇ…………	PRINTFORM 「こ、これ以上……大きく……しな、いでぇ…………
PRINTFORML 「離し、な……さっ！　……ふぅ、ありがとうね」	PRINTFORML 「離し、な……さっ！　……ふぅ、ありがとうね」
PRINTFORM 「はあっ…！　はあぁっ！！　あ、ああぁぁっ！！！	PRINTFORM 「はあっ…！　はあぁっ！！　あ、ああぁぁっ！！！
PRINTFORMDW そして、%ARGS:1%の秘部へ指を挿入れる	PRINTFORMDW そして、%ARGS:1%の秘部へ指を挿入れる
PRINTFORMW どうやら完全にスイッチが入ってしまったようだ…	PRINTFORMW どうやら完全にスイッチが入ってしまったようだ…
PRINTFORML 「ほら……す、好きにすればいいじゃない……」	PRINTFORML 「ほら……す、好きにすればいいじゃない……」
PRINTFORMDL どうやら小さな祟りを起こしているようだ…。	PRINTFORMDL どうやら小さな祟りを起こしているようだ…。
PRINTFORMDL 屠自古の暗い微笑みは眩い雷光で隠された…。	PRINTFORMDL 屠自古の暗い微笑みは眩い雷光で隠された…。
PRINTFORML 「夢殿和心拳、奥義！　招！　らあぁぁい！　」	PRINTFORML 「夢殿和心拳、奥義！　招！　らあぁぁい！　」
PRINTFORM 「溜めてためてためて……いっき、にぃ…ふぁ……	PRINTFORM 「溜めてためてためて……いっき、にぃ…ふぁ……
PRINTFORML 「決して全然力が入らないわけじゃないわ……」	PRINTFORML 「決して全然力が入らないわけじゃないわ……」
PRINTFORML 「しょ…しょうよぉ…これはぁ…せつやく……」	PRINTFORML 「しょ…しょうよぉ…これはぁ…せつやく……」
PRINTFORML 「は…反応がセピアになる前に逃げないと……」	PRINTFORML 「は…反応がセピアになる前に逃げないと……」
PRINTFORMDW 自慰に耽る屠自古の全身を肉の壁が包み込む…	PRINTFORMDW 自慰に耽る屠自古の全身を肉の壁が包み込む…
PRINTFORML 「やぁ……手ぇ、はなしてよぉ……おねがい…」	PRINTFORML 「やぁ……手ぇ、はなしてよぉ……おねがい…」
PRINTFORML 「うぅ……こ、こっち見たら後でビリビリよ！」	PRINTFORML 「うぅ……こ、こっち見たら後でビリビリよ！」
PRINTFORML 「…………に、やあぁぁ。がまんよ……私ぃ…」	PRINTFORML 「…………に、やあぁぁ。がまんよ……私ぃ…」
PRINTFORML 「ふ、うぅ、随分まいっちんぐな攻撃ね……！」	PRINTFORML 「ふ、うぅ、随分まいっちんぐな攻撃ね……！」
PRINTFORML 「知らな……っ?!　ひ、きゃあぁぁっっ！！」	PRINTFORML 「知らな……っ?!　ひ、きゃあぁぁっっ！！」
PRINTFORML 「なんでっ……わたしがこんな化け物のっ…！」	PRINTFORML 「なんでっ……わたしがこんな化け物のっ…！」
PRINTFORML 「質量を持った残像とでも言わせてもらうわ！」	PRINTFORML 「質量を持った残像とでも言わせてもらうわ！」
PRINTFORML 「早く……あんぜんなとこに…行きましょ……」	PRINTFORML 「早く……あんぜんなとこに…行きましょ……」
PRINTFORMW 「休む？　進む？　私はどっちでも構わないわ」	PRINTFORMW 「休む？　進む？　私はどっちでも構わないわ」
PRINTFORML 「この私が、戦いの中で戦いを見失うなんて！」	PRINTFORML 「この私が、戦いの中で戦いを見失うなんて！」
PRINTFORML (畜生っ！！　……私は何やってんのよ…!?)	PRINTFORML (畜生っ！！　……私は何やってんのよ…!?)
PRINTFORMW 「ここは薄暗いし、汚いし物件としては最悪ね」	PRINTFORMW 「ここは薄暗いし、汚いし物件としては最悪ね」
PRINTFORMW 「協力してあげるわ。あくまで仕方なく、よ…」	PRINTFORMW 「協力してあげるわ。あくまで仕方なく、よ…」
PRINTFORML 「なんとか、助けられたら良いのだけれど……」	PRINTFORML 「なんとか、助けられたら良いのだけれど……」
PRINTFORML 「あ、これウチの倉にあった奴と同じだわ……」	PRINTFORML 「あ、これウチの倉にあった奴と同じだわ……」
PRINTFORMW 「まあ持っておきましょう、これはいいモノよ」	PRINTFORMW 「まあ持っておきましょう、これはいいモノよ」
PRINTFORMW 「デメリットなしでトランザムなんて反則よね」	PRINTFORMW 「デメリットなしでトランザムなんて反則よね」
PRINTFORMW 「亡霊の絶対領域なんて誰に需要あるのよ……」	PRINTFORMW 「亡霊の絶対領域なんて誰に需要あるのよ……」
PRINTFORMW 「鰯の頭も信心から。困ったら縋る事にするわ」	PRINTFORMW 「鰯の頭も信心から。困ったら縋る事にするわ」
PRINTFORMW 「海沿いの断崖にいる人に飲ませればいいのね」	PRINTFORMW 「海沿いの断崖にいる人に飲ませればいいのね」
PRINTFORML 「それじゃあ、少ししたら起こすわ、おやすみ」	PRINTFORML 「それじゃあ、少ししたら起こすわ、おやすみ」
PRINTFORML 「せめて浄化してからが良かったんだけれど…」	PRINTFORML 「せめて浄化してからが良かったんだけれど…」
PRINTFORML 「こ…こんな太いの………うううぅぅっっ！！」	PRINTFORML 「こ…こんな太いの………うううぅぅっっ！！」
PRINTFORML 「うはぁっ！　ああっ！　い、い！　のぉっ！」	PRINTFORML 「うはぁっ！　ああっ！　い、い！　のぉっ！」
PRINTFORML 「どぉして……ここが…疼くのお…よぉ、っ！」	PRINTFORML 「どぉして……ここが…疼くのお…よぉ、っ！」
PRINTFORMW 「ぐ…う、ぅぅ……。う、えぇぇぇん…………」	PRINTFORMW 「ぐ…う、ぅぅ……。う、えぇぇぇん…………」
PRINTFORML 「気のせい…ね。そうよね。まさか亡霊が……」	PRINTFORML 「気のせい…ね。そうよね。まさか亡霊が……」
PRINTFORML 	「う……そ……。お、腹…ふくら、んで……」	PRINTFORML 	「う……そ……。お、腹…ふくら、んで……」
PRINTFORMW 「あ…ぐぅ……こ、ども………う…まれ………」	PRINTFORMW 「あ…ぐぅ……こ、ども………う…まれ………」
PRINTFORML 「さて、探索一つでも用心しないといけないわ」	PRINTFORML 「さて、探索一つでも用心しないといけないわ」
PRINTFORML 「身包み置いて行かはんのが……身のためやで」	PRINTFORML 「身包み置いて行かはんのが……身のためやで」
PRINTFORML 「ここであなたと敵対すべきではないわね……」	PRINTFORML 「ここであなたと敵対すべきではないわね……」
PRINTFORML 「え、ほ…本当に悪いわよ……いいのかしら？」	PRINTFORML 「え、ほ…本当に悪いわよ……いいのかしら？」
PRINTFORML 「どうしても、と言うなら留める理由が無いわ」	PRINTFORML 「どうしても、と言うなら留める理由が無いわ」
PRINTFORML 「危なくなったらここに戻ってくるのもありね」	PRINTFORML 「危なくなったらここに戻ってくるのもありね」
PRINTFORML 「屠蘇かしら？　仙薬に近い味の物があるわね」	PRINTFORML 「屠蘇かしら？　仙薬に近い味の物があるわね」
PRINTFORMDW 陰鬱な迷宮に屠自古の悲痛な訴えが木霊した…	PRINTFORMDW 陰鬱な迷宮に屠自古の悲痛な訴えが木霊した…
PRINTFORML 淫蟲は屠自古の肉棒へ群がり、吸い付いている…	PRINTFORML 淫蟲は屠自古の肉棒へ群がり、吸い付いている…
PRINTFORMW わたしのせきにんじゃあぁ……ないわぁ……♪」	PRINTFORMW わたしのせきにんじゃあぁ……ないわぁ……♪」
PRINTFORML 「…………わ、私っ?!　な、なにを…………」	PRINTFORML 「…………わ、私っ?!　な、なにを…………」
PRINTFORM 「あ、はっ♪　%CALLNAME:1%のがぁ…	PRINTFORM 「あ、はっ♪　%CALLNAME:1%のがぁ…
PRINTFORMDW 唇を噛みしめ、屠自古は心を奮い立たせた。	PRINTFORMDW 唇を噛みしめ、屠自古は心を奮い立たせた。
PRINTFORML 「わたひが、おとりに…なってやんよぉ……」	PRINTFORML 「わたひが、おとりに…なってやんよぉ……」
PRINTFORML 「身重で戦えってほうがどうかしてるわ……」	PRINTFORML 「身重で戦えってほうがどうかしてるわ……」
PRINTFORML 「今のはミナデインじゃないわ、デインよ！」	PRINTFORML 「今のはミナデインじゃないわ、デインよ！」
PRINTFORMDW 屠自古は息を荒げながらも弾幕を放った…。	PRINTFORMDW 屠自古は息を荒げながらも弾幕を放った…。
PRINTFORML 「……TZK1138、ロックを解除するわ」	PRINTFORML 「……TZK1138、ロックを解除するわ」
PRINTFORML 「硬貨が無くてもレールガンは打てるのよ！」	PRINTFORML 「硬貨が無くてもレールガンは打てるのよ！」
PRINTFORML 「ターゲットをセンターにロックオン、発射」	PRINTFORML 「ターゲットをセンターにロックオン、発射」
PRINTFORML 「こういう化け物に急所ってあるのかしら？」	PRINTFORML 「こういう化け物に急所ってあるのかしら？」
PRINTFORM 「いっせー……のぴょっ?!　あ、うあぁぁ……	PRINTFORM 「いっせー……のぴょっ?!　あ、うあぁぁ……
PRINTFORML (絶対言う事なんて無いと思ってたけど……)	PRINTFORML (絶対言う事なんて無いと思ってたけど……)
PRINTFORML 「ふぅーーー、はああぁぁぁーーー…………」	PRINTFORML 「ふぅーーー、はああぁぁぁーーー…………」
PRINTFORML 「こんな奴らの好きになんかさせないわよ！」	PRINTFORML 「こんな奴らの好きになんかさせないわよ！」
PRINTFORML (あれ？　体が薄くなってきたかしら……？)	PRINTFORML (あれ？　体が薄くなってきたかしら……？)
PRINTFORML 「いやああぁぁぁ！！　ごしごし、てぇ！！」	PRINTFORML 「いやああぁぁぁ！！　ごしごし、てぇ！！」
PRINTFORML 「これ以上大きくなったらどうするのよ……」	PRINTFORML 「これ以上大きくなったらどうするのよ……」
PRINTFORML 「しまっ………………。……すかー、すかー」	PRINTFORML 「しまっ………………。……すかー、すかー」
PRINTFORML 「やっ、何吸ってんのよ！　離れなさいっ！」	PRINTFORML 「やっ、何吸ってんのよ！　離れなさいっ！」
PRINTFORML 「当たらなければどうという事は無いわね！」	PRINTFORML 「当たらなければどうという事は無いわね！」
PRINTFORML 「やぁ……。た、祟り殺してやるんだから！」	PRINTFORML 「やぁ……。た、祟り殺してやるんだから！」
PRINTFORMDL そう言いながらも屠自古はもじもじしている	PRINTFORMDL そう言いながらも屠自古はもじもじしている
PRINTFORML 「こ…の…っ！　逃がさないってことね……」	PRINTFORML 「こ…の…っ！　逃がさないってことね……」
PRINTFORML 「い……っ、今ダメ！　ちょっと待って！！」	PRINTFORML 「い……っ、今ダメ！　ちょっと待って！！」
PRINTFORMDW 屠自古は己の力不足に痛切な悔恨を覚えた…	PRINTFORMDW 屠自古は己の力不足に痛切な悔恨を覚えた…
PRINTFORML 「そう言えば、厨房のお味噌が切れてました」	PRINTFORML 「そう言えば、厨房のお味噌が切れてました」
PRINTFORML 「ふふ、これが私の豊御食炊屋姫ってことね」	PRINTFORML 「ふふ、これが私の豊御食炊屋姫ってことね」
PRINTFORMW 「三刀流か、それとも持ち主は犬……かもね」	PRINTFORMW 「三刀流か、それとも持ち主は犬……かもね」
PRINTFORMDW 屠自古はなぜかテンションが上がっている。	PRINTFORMDW 屠自古はなぜかテンションが上がっている。
PRINTFORMW 「あれ…核ミサイルじゃない？　残念ね……」	PRINTFORMW 「あれ…核ミサイルじゃない？　残念ね……」
PRINTFORMW 「道教で言うならさしずめ酒みたいなもんね」	PRINTFORMW 「道教で言うならさしずめ酒みたいなもんね」
PRINTFORMW 「鬼がやられるならどうしようもないわよね」	PRINTFORMW 「鬼がやられるならどうしようもないわよね」
PRINTFORMW 「誰が食べるかはよく考えたほうがいいわね」	PRINTFORMW 「誰が食べるかはよく考えたほうがいいわね」
PRINTFORML 「せめて良い夢が見られるといいのだけれど」	PRINTFORML 「せめて良い夢が見られるといいのだけれど」
PRINTFORML 「……はぁ、はぁ、はぁ…ん…は、ぁぁ……」	PRINTFORML 「……はぁ、はぁ、はぁ…ん…は、ぁぁ……」
PRINTFORM 「でもぉ……ごしごしぃ…やめらんなぁ、い……	PRINTFORM 「でもぉ……ごしごしぃ…やめらんなぁ、い……
PRINTFORMDW 屠自古はまだ菊座に指を出し入れしている…	PRINTFORMDW 屠自古はまだ菊座に指を出し入れしている…
PRINTFORMW 「もう……重くて…浮かんでられないわ……」	PRINTFORMW 「もう……重くて…浮かんでられないわ……」
PRINTFORMW 「気を遣ってるんじゃなくて、食欲がないの」	PRINTFORMW 「気を遣ってるんじゃなくて、食欲がないの」
PRINTFORML 「できちゃったものはしょうがない、わ……」	PRINTFORML 「できちゃったものはしょうがない、わ……」
PRINTFORML 「懐胎の進行が早い、ってびっくりするわ…」	PRINTFORML 「懐胎の進行が早い、ってびっくりするわ…」
PRINTFORML 「置いていったらあんたを祟ってやるからね」	PRINTFORML 「置いていったらあんたを祟ってやるからね」
PRINTFORML 「確か布都がこんなやり方で…あ、できたわ」	PRINTFORML 「確か布都がこんなやり方で…あ、できたわ」
PRINTFORML 「あ…今、ブチって……。…痛ぃ、いわ……」	PRINTFORML 「あ…今、ブチって……。…痛ぃ、いわ……」
PRINTFORML 「わたし…何、う、うぅ……ええぇぇぇ……」	PRINTFORML 「わたし…何、う、うぅ……ええぇぇぇ……」
PRINTFORMDW 何の気無しに視線を自らの下半身にやった…	PRINTFORMDW 何の気無しに視線を自らの下半身にやった…
PRINTFORML 「こ…っ、こんなの反そく、にゃあぁぁぁ！」	PRINTFORML 「こ…っ、こんなの反そく、にゃあぁぁぁ！」
PRINTFORML 「落ち着いてぇ……自りつ…じりちゅぅ……」	PRINTFORML 「落ち着いてぇ……自りつ…じりちゅぅ……」
PRINTFORML 「これ、体の良い援交だったんじゃないの？」	PRINTFORML 「これ、体の良い援交だったんじゃないの？」
PRINTFORML 「経路が増えるのは生存の可能性も増やすわ」	PRINTFORML 「経路が増えるのは生存の可能性も増やすわ」
PRINTFORML 「今はいいわね。場所を覚えておきましょう」	PRINTFORML 「今はいいわね。場所を覚えておきましょう」
PRINTFORMDW 屠自古の抵抗も虚しく、窄まりに殺到した…	PRINTFORMDW 屠自古の抵抗も虚しく、窄まりに殺到した…
PRINTFORML 「……やぁ…おちんぽ…………はえ、て……」	PRINTFORML 「……やぁ…おちんぽ…………はえ、て……」
PRINTFORML 「ひっ……そ、そんなのやってられっ……！」	PRINTFORML 「ひっ……そ、そんなのやってられっ……！」
PRINTFORM 「はかっ?!　つ、つよぉ…！！　はきゅ！　っ	PRINTFORM 「はかっ?!　つ、つよぉ…！！　はきゅ！　っ
PRINTFORML 「ひ、……ど、どうしろって言うのよぉ……」	PRINTFORML 「ひ、……ど、どうしろって言うのよぉ……」
PRINTFORML 「や、……こ、これは……ち、がう…のぉ…」	PRINTFORML 「や、……こ、これは……ち、がう…のぉ…」
PRINTFORML 「戦えないのなら壁になれと……厳しいわ」	PRINTFORML 「戦えないのなら壁になれと……厳しいわ」
PRINTFORML 「耐えてみせるわよ…このくらい……っ！」	PRINTFORML 「耐えてみせるわよ…このくらい……っ！」
PRINTFORML 「超電磁ヨーヨー！……ヨーヨーって何？」	PRINTFORML 「超電磁ヨーヨー！……ヨーヨーって何？」
PRINTFORML 「私の仲間に指一本触れさせやしないわ！」	PRINTFORML 「私の仲間に指一本触れさせやしないわ！」
PRINTFORMDL 部屋に居た誰もが一瞬視界を失った……。	PRINTFORMDL 部屋に居た誰もが一瞬視界を失った……。
PRINTFORMDL やがて決心したように括約筋に力を込めた	PRINTFORMDL やがて決心したように括約筋に力を込めた
PRINTFORML 「ショーツでも穿いとけばよかったわ……」	PRINTFORML 「ショーツでも穿いとけばよかったわ……」
PRINTFORMDW 迷宮につんざくような悲鳴が響き渡った…	PRINTFORMDW 迷宮につんざくような悲鳴が響き渡った…
PRINTFORML 「コス、っちゃぁ！　ひ、きゃあっ！！！」	PRINTFORML 「コス、っちゃぁ！　ひ、きゃあっ！！！」
PRINTFORM 「うあぁっ!?　胸だけでぇ…………っ?!」	PRINTFORM 「うあぁっ!?　胸だけでぇ…………っ?!」
PRINTFORML 「人外風情が……嘗め腐りやがってぇ……」	PRINTFORML 「人外風情が……嘗め腐りやがってぇ……」
PRINTFORML 「くっ…！　この服気に入ってたのに……」	PRINTFORML 「くっ…！　この服気に入ってたのに……」
PRINTFORML 「いやぁ……イヤよぉ……うえぇぇぇん…」	PRINTFORML 「いやぁ……イヤよぉ……うえぇぇぇん…」
PRINTFORML 「……ぁーー…♪　ぅー♪　もっとぉ……」	PRINTFORML 「……ぁーー…♪　ぅー♪　もっとぉ……」
PRINTFORML 「た…太子様、その格好は危ないです……」	PRINTFORML 「た…太子様、その格好は危ないです……」
PRINTFORML 「何…そんなに足の所が気になるかしら？」	PRINTFORML 「何…そんなに足の所が気になるかしら？」
PRINTFORMW 「って、ごめんなさい。敵かと思ったのよ」	PRINTFORMW 「って、ごめんなさい。敵かと思ったのよ」
PRINTFORMW 「時間が分からないから両方言っておくわ」	PRINTFORMW 「時間が分からないから両方言っておくわ」
PRINTFORML 「きょ、今日はこのへんで堪忍したるわ！」	PRINTFORML 「きょ、今日はこのへんで堪忍したるわ！」
PRINTFORMDW 少し照れながら、屠自古は探索を続けた。	PRINTFORMDW 少し照れながら、屠自古は探索を続けた。
PRINTFORMW 「弓……私はそんなに得意じゃないのよね」	PRINTFORMW 「弓……私はそんなに得意じゃないのよね」
PRINTFORMW 「そういえば幻想郷にそんな妖怪いたわね」	PRINTFORMW 「そういえば幻想郷にそんな妖怪いたわね」
PRINTFORMW 「自制が効かない奴に飲ませればいいのね」	PRINTFORMW 「自制が効かない奴に飲ませればいいのね」
PRINTFORMW 「危なくなったらすたこら逃げろ～♪…ね」	PRINTFORMW 「危なくなったらすたこら逃げろ～♪…ね」
PRINTFORML 「胸を…しぼませる？　変わった薬ね……」	PRINTFORML 「胸を…しぼませる？　変わった薬ね……」
PRINTFORML 「ふぁ……あ、ううっ…なんで……溢れ…」	PRINTFORML 「ふぁ……あ、ううっ…なんで……溢れ…」
PRINTFORML 「あ…あうぅ、ふああぁぁぁっっ！！！」」	PRINTFORML 「あ…あうぅ、ふああぁぁぁっっ！！！」」
PRINTFORML 「あはあぁっっ！！…みるくぅ、でて……」	PRINTFORML 「あはあぁっっ！！…みるくぅ、でて……」
PRINTFORMW 「ふうぅぅうぅ……大丈夫、大丈夫よ……」	PRINTFORMW 「ふうぅぅうぅ……大丈夫、大丈夫よ……」
PRINTFORMDW 屠自古は迷宮の物陰に駆け込んでいった…	PRINTFORMDW 屠自古は迷宮の物陰に駆け込んでいった…
PRINTFORML 「お酒……？　あ、私は遠慮して…………」	PRINTFORML 「お酒……？　あ、私は遠慮して…………」
PRINTFORMW 「……これ、一度言ってみたかったのよね」	PRINTFORMW 「……これ、一度言ってみたかったのよね」
PRINTFORML 「次元連結システムのちょっとした応用よ」	PRINTFORML 「次元連結システムのちょっとした応用よ」
PRINTFORML 「……ありがと、あなたの為にも頑張るわ」	PRINTFORML 「……ありがと、あなたの為にも頑張るわ」
PRINTFORML (いや、罠ね……。そうに決まってる……)	PRINTFORML (いや、罠ね……。そうに決まってる……)
PRINTFORML 「やっとこれともおさらばできるのね……」	PRINTFORML 「やっとこれともおさらばできるのね……」
PRINTFORML 「癒されるわ……成仏してしまいそうね…」	PRINTFORML 「癒されるわ……成仏してしまいそうね…」
PRINTFORML 「きゃっ?!　やあッ！　ふあぁぁっ！！」	PRINTFORML 「きゃっ?!　やあッ！　ふあぁぁっ！！」
PRINTFORML 「あはぁ……やっぱ、むりぃ…きもちぃ…」	PRINTFORML 「あはぁ……やっぱ、むりぃ…きもちぃ…」
PRINTFORMDW 屠自古は縦横無尽に周りを飛び回っている	PRINTFORMDW 屠自古は縦横無尽に周りを飛び回っている
PRINTFORML 「よかったわ……これで……………………」	PRINTFORML 「よかったわ……これで……………………」
PRINTFORML 「うあ、ぁ！！　びゅーびゅー出てっ！！」	PRINTFORML 「うあ、ぁ！！　びゅーびゅー出てっ！！」
PRINTFORML 「嘘……こんなので……私…うそよぉ……」	PRINTFORML 「嘘……こんなので……私…うそよぉ……」
PRINTFORM 「ひやあぁぁぁっ！！　ねじこ、まれてっ！！	PRINTFORM 「ひやあぁぁぁっ！！　ねじこ、まれてっ！！
PRINTFORM 「こ……こんな、のっ、てええぇぇっ！！！！	PRINTFORM 「こ……こんな、のっ、てええぇぇっ！！！！
PRINTFORML 「う、はぁっ！　ひ、ひきゃ、ああっ！！」	PRINTFORML 「う、はぁっ！　ひ、ひきゃ、ああっ！！」
PRINTFORML 見られてる、のにぃ……止まらないのぉ……	PRINTFORML 見られてる、のにぃ……止まらないのぉ……
PRINTFORMW 今回もトジコと地獄に付き合ってもらうわ。	PRINTFORMW 今回もトジコと地獄に付き合ってもらうわ。
PRINTFORML 「はぁ……はぁ……終わった…のぉ……？」	PRINTFORML 「はぁ……はぁ……終わった…のぉ……？」
PRINTFORML 「意識が無いなら……しかたないわね……」	PRINTFORML 「意識が無いなら……しかたないわね……」
PRINTFORMW 「き…期待なんてしてないわよぉ……♪」	PRINTFORMW 「き…期待なんてしてないわよぉ……♪」
PRINTFORMDL 屠自古は恥辱でその白い肌を上気させ、	PRINTFORMDL 屠自古は恥辱でその白い肌を上気させ、
PRINTFORML 「あの邪仙……元はと言えばあいつが…」	PRINTFORML 「あの邪仙……元はと言えばあいつが…」
PRINTFORML 「天空剣！　Ｖの字斬りいぃーー！！！」	PRINTFORML 「天空剣！　Ｖの字斬りいぃーー！！！」
PRINTFORML 「サンダァーーー…クロオォーーー！！」	PRINTFORML 「サンダァーーー…クロオォーーー！！」
PRINTFORML 「……………いやいや、何でもないわ…」	PRINTFORML 「……………いやいや、何でもないわ…」
PRINTFORML 「下がお留守よ！　私には効かないけど」	PRINTFORML 「下がお留守よ！　私には効かないけど」
PRINTFORMDW 中から聞こえていた物音が途絶えた…。	PRINTFORMDW 中から聞こえていた物音が途絶えた…。
PRINTFORML 「ひぃっ、あ、ふにゃああぁぁぁ……♪」	PRINTFORML 「ひぃっ、あ、ふにゃああぁぁぁ……♪」
PRINTFORMDL 屠自古は必死で声を押し殺しているが、	PRINTFORMDL 屠自古は必死で声を押し殺しているが、
PRINTFORMDL 屠自古は精一杯強がっているようだ。 	PRINTFORMDL 屠自古は精一杯強がっているようだ。 
PRINTFORML 「やっ！……そこは…そこだけはぁっ！」	PRINTFORML 「やっ！……そこは…そこだけはぁっ！」
PRINTFORML 「随分な、あっ!?　、趣味ね、ぇっ!」	PRINTFORML 「随分な、あっ!?　、趣味ね、ぇっ!」
PRINTFORML 「離しなさっ！　ッ!?　ぐうぅっ！！」	PRINTFORML 「離しなさっ！　ッ!?　ぐうぅっ！！」
PRINTFORML 「にゃ?!　あ、あぁぁぁぁ…………っ」	PRINTFORML 「にゃ?!　あ、あぁぁぁぁ…………っ」
PRINTFORML 「んっ…はあ、はぁ。キリが無いわ……」	PRINTFORML 「んっ…はあ、はぁ。キリが無いわ……」
PRINTFORML 「どうしたの？　左の弾幕が薄いのよ？」	PRINTFORML 「どうしたの？　左の弾幕が薄いのよ？」
PRINTFORML 「……後で助けに来るわ……ええ、必ず」	PRINTFORML 「……後で助けに来るわ……ええ、必ず」
PRINTFORML 「………………は……は、あは…………」	PRINTFORML 「………………は……は、あは…………」
PRINTFORMDW 屠自古の笑顔はどこかひきつっている…	PRINTFORMDW 屠自古の笑顔はどこかひきつっている…
PRINTFORML 「………あんまり見るとビリビリよ…？」	PRINTFORML 「………あんまり見るとビリビリよ…？」
PRINTFORML 「くれぐれもお気を付けなさいますよう」	PRINTFORML 「くれぐれもお気を付けなさいますよう」
PRINTFORMW 「え……下着…？　胸当ては付けてるわ」	PRINTFORMW 「え……下着…？　胸当ては付けてるわ」
PRINTFORML 「ありがとう、大切に使わせてもらうわ」	PRINTFORML 「ありがとう、大切に使わせてもらうわ」
PRINTFORMW 「気休めだけども、持っておきましょう」	PRINTFORMW 「気休めだけども、持っておきましょう」
PRINTFORML 「これ、柄に歯形が付いてないかしら？」	PRINTFORML 「これ、柄に歯形が付いてないかしら？」
PRINTFORMW 「人の考える事って、どこでも同じよね」	PRINTFORMW 「人の考える事って、どこでも同じよね」
PRINTFORMW 「万能って名前からして胡散臭いわよね」	PRINTFORMW 「万能って名前からして胡散臭いわよね」
PRINTFORML 「はあぁ…んっ、あっ！　あはぁ！……」	PRINTFORML 「はあぁ…んっ、あっ！　あはぁ！……」
PRINTFORML 「ちょっとだけぇ……だからぁ…………」	PRINTFORML 「ちょっとだけぇ……だからぁ…………」
PRINTFORM ひっ！　きゅうぅっ！！　はああっ、はあっ	PRINTFORM ひっ！　きゅうぅっ！！　はああっ、はあっ
PRINTFORML 「こんな姿……誰にも見せたくないわ…」	PRINTFORML 「こんな姿……誰にも見せたくないわ…」
PRINTFORML 「気休めでも、過ごしやすくなったわね」	PRINTFORML 「気休めでも、過ごしやすくなったわね」
PRINTFORML 「あんたみたいな異形となんてっ……！」	PRINTFORML 「あんたみたいな異形となんてっ……！」
PRINTFORML 屠自古はノリノリで強請りを行っている…	PRINTFORML 屠自古はノリノリで強請りを行っている…
PRINTFORML 「ふぼぁ……おぶ！　むぐ、ぅぅっ！！」	PRINTFORML 「ふぼぁ……おぶ！　むぐ、ぅぅっ！！」
PRINTFORML 「不思議ね！　体中が漲る！　漲るわ！」	PRINTFORML 「不思議ね！　体中が漲る！　漲るわ！」
PRINTFORMDW その場でしばらく蹲って動かなかった…	PRINTFORMDW その場でしばらく蹲って動かなかった…
PRINTFORML (迂闊だったわ……！　早く出ないと！)	PRINTFORML (迂闊だったわ……！　早く出ないと！)
PRINTFORMD 屠自古は茹蛸のように顔を真っ赤にして、	PRINTFORMD 屠自古は茹蛸のように顔を真っ赤にして、
PRINTFORMDW 屠自古は複雑な表情で苦笑いしている…	PRINTFORMDW 屠自古は複雑な表情で苦笑いしている…
PRINTFORML 「擬態よっ！　壁から離れッ！！　っ！」	PRINTFORML 「擬態よっ！　壁から離れッ！！　っ！」
PRINTFORMW 「亡霊に落とし穴なんて、愚か者めが！」	PRINTFORMW 「亡霊に落とし穴なんて、愚か者めが！」
PRINTFORML 「亡霊に落とし穴なんて、愚か者めが！」	PRINTFORML 「亡霊に落とし穴なんて、愚か者めが！」
PRINTFORML 「しばらく…………そっとしといて……」	PRINTFORML 「しばらく…………そっとしといて……」
PRINTFORMDW ずる、ずるりと菊座を這いだして来た…	PRINTFORMDW ずる、ずるりと菊座を這いだして来た…
PRINTFORML 「なっ……どこから沸いてきたのッ?!」	PRINTFORML 「なっ……どこから沸いてきたのッ?!」
PRINTFORML 「何ッ!?　とりあえずさせないわっ！」	PRINTFORML 「何ッ!?　とりあえずさせないわっ！」
PRINTFORM 「何かしら……禍々しくはあるけれど……」	PRINTFORM 「何かしら……禍々しくはあるけれど……」
PRINTFORML 「…………もぉ………………いやぁ……」	PRINTFORML 「…………もぉ………………いやぁ……」
PRINTFORML 「全く……性欲の捌け口を間違ってるわ」	PRINTFORML 「全く……性欲の捌け口を間違ってるわ」
PRINTFORMDL 屠自古はうわ言のように独白を続けた…	PRINTFORMDL 屠自古はうわ言のように独白を続けた…
PRINTFORMDW 発情期の動物のように腰を降り始めた…	PRINTFORMDW 発情期の動物のように腰を降り始めた…
PRINTFORML 緊張感がねえので嫌な人はOFF推奨。	PRINTFORML 緊張感がねえので嫌な人はOFF推奨。
PRINTFORML 「しょうがない、私が行ってやんよ！」	PRINTFORML 「しょうがない、私が行ってやんよ！」
PRINTFORML 敵に向けて媚びる様に尻を振っている…	PRINTFORML 敵に向けて媚びる様に尻を振っている…
PRINTFORML 「ぐうぅ……が、我慢よ……はぁっ！」	PRINTFORML 「ぐうぅ……が、我慢よ……はぁっ！」
PRINTFORML 「豪族の意地ってもんがあるのよ！！」	PRINTFORML 「豪族の意地ってもんがあるのよ！！」
PRINTFORML 「うくっ…………こ……ないでっ！　」	PRINTFORML 「うくっ…………こ……ないでっ！　」
PRINTFORML 「ふぅー……。ぁあ……ん、だめだめ」	PRINTFORML 「ふぅー……。ぁあ……ん、だめだめ」
PRINTFORML 「大長谷の二の舞は勘弁っ！　よっ！」	PRINTFORML 「大長谷の二の舞は勘弁っ！　よっ！」
PRINTFORMDL 何やら違う事を考えていたようだ…。	PRINTFORMDL 何やら違う事を考えていたようだ…。
PRINTFORML 「ポジトロンレーザーは一発で十分ね」	PRINTFORML 「ポジトロンレーザーは一発で十分ね」
PRINTFORML 「ま…まだ…？　も、はな、してぇ…」	PRINTFORML 「ま…まだ…？　も、はな、してぇ…」
PRINTFORML (うわああああぁぁぁぁっっ！！！！)	PRINTFORML (うわああああぁぁぁぁっっ！！！！)
PRINTFORML 「説明するわ！　あえて力を溜めて…」	PRINTFORML 「説明するわ！　あえて力を溜めて…」
PRINTFORML (これっ！　……ヤバいっ……！！！)	PRINTFORML (これっ！　……ヤバいっ……！！！)
PRINTFORML 「と…止まってぇ、お願いだから……」	PRINTFORML 「と…止まってぇ、お願いだから……」
PRINTFORML 「…………あ、ぐッ！　ふわ、……！」	PRINTFORML 「…………あ、ぐッ！　ふわ、……！」
PRINTFORML 「足があったら致命傷だったかしらね」	PRINTFORML 「足があったら致命傷だったかしらね」
PRINTFORML 「やめてっ！　も、もう勘弁して……」	PRINTFORML 「やめてっ！　も、もう勘弁して……」
PRINTFORML 「あうっ！　にゃっ!?　やあっ?!」	PRINTFORML 「あうっ！　にゃっ!?　やあっ?!」
PRINTFORML 「先っ、先っぽは、ひゃあぁぁ……！」	PRINTFORML 「先っ、先っぽは、ひゃあぁぁ……！」
PRINTFORML 「う、そぉ……おく、ふかぁ……！！」	PRINTFORML 「う、そぉ……おく、ふかぁ……！！」
PRINTFORMDL 触手は屠自古の一瞬の隙をついた！ 	PRINTFORMDL 触手は屠自古の一瞬の隙をついた！ 
PRINTFORML 「うそ、わらひッ、こんなのでっ…！」	PRINTFORML 「うそ、わらひッ、こんなのでっ…！」
PRINTFORML 「ビームでも何でも持ってきなさい！」	PRINTFORML 「ビームでも何でも持ってきなさい！」
PRINTFORML 「これ以上……私を汚さないで………」	PRINTFORML 「これ以上……私を汚さないで………」
PRINTFORML 「い…今更恥ずかしくなん…てぇ……」	PRINTFORML 「い…今更恥ずかしくなん…てぇ……」
PRINTFORML 「うあぁ……っ、ず、りゅって………」	PRINTFORML 「うあぁ……っ、ず、りゅって………」
PRINTFORML 「まだ立て直せるわ……行きましょう」	PRINTFORML 「まだ立て直せるわ……行きましょう」
PRINTFORML 「あれ……？　倒しちゃったぁ……？」	PRINTFORML 「あれ……？　倒しちゃったぁ……？」
PRINTFORML 「亡霊になったりはしない、わよね…」	PRINTFORML 「亡霊になったりはしない、わよね…」
PRINTFORMW 「悲しいけどこれ、正当防衛なのよね」	PRINTFORMW 「悲しいけどこれ、正当防衛なのよね」
PRINTFORM 「ずるぃ……よぉ……。わたひ…もぉ……	PRINTFORM 「ずるぃ……よぉ……。わたひ…もぉ……
PRINTFORMDL 終わる事の無い快楽に没頭している…	PRINTFORMDL 終わる事の無い快楽に没頭している…
PRINTFORMW 「困ったら私の所に来てもいいのよ？」	PRINTFORMW 「困ったら私の所に来てもいいのよ？」
PRINTFORML 「幻想郷の事を教えてもらえるかしら」	PRINTFORML 「幻想郷の事を教えてもらえるかしら」
PRINTFORML 「……ﾁｯ、無駄な時間を食ったわね」	PRINTFORML 「……ﾁｯ、無駄な時間を食ったわね」
PRINTFORMW 「山のバーストンごっこができるわね」	PRINTFORMW 「山のバーストンごっこができるわね」
PRINTFORMDW 屠自古には歪曲して伝わったようだ…	PRINTFORMDW 屠自古には歪曲して伝わったようだ…
PRINTFORML 「ほ……本当に寝られるの？　ここで」	PRINTFORML 「ほ……本当に寝られるの？　ここで」
PRINTFORML 「…………いっそ笑って欲しいわ…」 	PRINTFORML 「…………いっそ笑って欲しいわ…」 
PRINTFORMW 「ちょっと、朝食の量を減らすわ……」	PRINTFORMW 「ちょっと、朝食の量を減らすわ……」
PRINTFORML 「ここは本当に気が滅入るわね………」	PRINTFORML 「ここは本当に気が滅入るわね………」
PRINTFORML 「ちょっと調子が良くなかったみたい」	PRINTFORML 「ちょっと調子が良くなかったみたい」
PRINTFORML 「ここじゃ何が起きても驚かないけど」	PRINTFORML 「ここじゃ何が起きても驚かないけど」
PRINTFORML 「ちょっと…………辛くなってきたわ」	PRINTFORML 「ちょっと…………辛くなってきたわ」
PRINTFORML 「胎児の一人や二人、問題じゃないわ」	PRINTFORML 「胎児の一人や二人、問題じゃないわ」
PRINTFORMW その時！屠自古隊員が見たものは！！？	PRINTFORMW その時！屠自古隊員が見たものは！！？
PRINTFORML 「私が先に行くわ……生身よりマシよ」	PRINTFORML 「私が先に行くわ……生身よりマシよ」
PRINTFORML (ダメぇ……私、自分で、なんて……)	PRINTFORML (ダメぇ……私、自分で、なんて……)
PRINTFORML 「そんな余裕があれば露店でも開くわ」	PRINTFORML 「そんな余裕があれば露店でも開くわ」
PRINTFORML 「今は戦う気分じゃないの、悪いわね」	PRINTFORML 「今は戦う気分じゃないの、悪いわね」
PRINTFORMW 「あなたはあなたの道を行きなさい！」	PRINTFORMW 「あなたはあなたの道を行きなさい！」
PRINTFORML 「こんなピンチ……切り抜けられるわ」	PRINTFORML 「こんなピンチ……切り抜けられるわ」
PRINTFORML 「全て周到に、用心して行きましょう」	PRINTFORML 「全て周到に、用心して行きましょう」
PRINTFORML 「くっ……ど…どこに……っ…嫌あ！」	PRINTFORML 「くっ……ど…どこに……っ…嫌あ！」
PRINTFORMW 「ひ…ひぃぃ……。な、によこれ……」	PRINTFORMW 「ひ…ひぃぃ……。な、によこれ……」
PRINTFORMDW 剛直を携えながらも探索を再開した…	PRINTFORMDW 剛直を携えながらも探索を再開した…
PRINTFORML 「ちょっと理解が追いつかないわ……」	PRINTFORML 「ちょっと理解が追いつかないわ……」
PRINTFORML 「………………ぷはっ、危ないわね！」	PRINTFORML 「………………ぷはっ、危ないわね！」
PRINTFORML 「そんな……吸う、なぁ…………っ！」	PRINTFORML 「そんな……吸う、なぁ…………っ！」
PRINTFORML 「さ…さぁ、おねがい……するわ……」	PRINTFORML 「さ…さぁ、おねがい……するわ……」
PRINTFORM 　か、らみついてっ！！　すごいのぉ！！	PRINTFORM 　か、らみついてっ！！　すごいのぉ！！
PRINTFORMDW パン、パンと乾いた音が迷宮に響く…	PRINTFORMDW パン、パンと乾いた音が迷宮に響く…
PRINTFORML 「やれやれ……役に立ったかしら？」	PRINTFORML 「やれやれ……役に立ったかしら？」
PRINTFORML 「と……時には退いてみるべきね…」	PRINTFORML 「と……時には退いてみるべきね…」
PRINTFORML 「敵に背を向けるなんて、屈辱ね…」	PRINTFORML 「敵に背を向けるなんて、屈辱ね…」
PRINTFORML 「がまんして……我慢よわたしぃ…」	PRINTFORML 「がまんして……我慢よわたしぃ…」
PRINTFORML 「祟りも消耗品よ。電気を大切に！」	PRINTFORML 「祟りも消耗品よ。電気を大切に！」
PRINTFORML 「こういうのは布都の仕事だわ……」	PRINTFORML 「こういうのは布都の仕事だわ……」
PRINTFORML 「豪族ってもインドア派も居るのよ」	PRINTFORML 「豪族ってもインドア派も居るのよ」
PRINTFORML 「拘束が緩んだ…い……今ね…！！」	PRINTFORML 「拘束が緩んだ…い……今ね…！！」
PRINTFORML 「くッ……!?うご、け……ないっ」	PRINTFORML 「くッ……!?うご、け……ないっ」
PRINTFORMW 「はぁ…はぁ、ん、……～～～ッ！」	PRINTFORMW 「はぁ…はぁ、ん、……～～～ッ！」
PRINTFORML 「こ…こねくりまわさないでぇ……」	PRINTFORML 「こ…こねくりまわさないでぇ……」
PRINTFORML 「いまあっ、ムリっ！　なのぉっ！」	PRINTFORML 「いまあっ、ムリっ！　なのぉっ！」
PRINTFORML 「あ……あたっ、て、るのぉ…！！」	PRINTFORML 「あ……あたっ、て、るのぉ…！！」
PRINTFORML 「き、気持ちわるいだけ、よッ！！」	PRINTFORML 「き、気持ちわるいだけ、よッ！！」
PRINTFORML 「やっ、あ…?!　離れなさッ!?」	PRINTFORML 「やっ、あ…?!　離れなさッ!?」
PRINTFORML 「そうそう当たるものじゃないわ！」	PRINTFORML 「そうそう当たるものじゃないわ！」
PRINTFORML 「犬とでも乳繰り合ってなさいよ！」	PRINTFORML 「犬とでも乳繰り合ってなさいよ！」
PRINTFORML 「もう一回……死ぬのかしらね……」	PRINTFORML 「もう一回……死ぬのかしらね……」
PRINTFORML 「太子様、ありがとうございます！」	PRINTFORML 「太子様、ありがとうございます！」
PRINTFORML 「……。隠してもしょうがないわね」	PRINTFORML 「……。隠してもしょうがないわね」
PRINTFORML 「あんまり、その、見ないで………」	PRINTFORML 「あんまり、その、見ないで………」
PRINTFORML 「え…？　大根じゃないです………」	PRINTFORML 「え…？　大根じゃないです………」
PRINTFORML 「やって…………やるぜぇ……！！」	PRINTFORML 「やって…………やるぜぇ……！！」
PRINTFORML 「誰、か……たす…け………………」	PRINTFORML 「誰、か……たす…け………………」
PRINTFORML 「ふぅ、とにかく休みましょう……」	PRINTFORML 「ふぅ、とにかく休みましょう……」
PRINTFORML 「私はそんな器用な事出来ないけど」	PRINTFORML 「私はそんな器用な事出来ないけど」
PRINTFORML 「悪い気がするけど……助かったわ」	PRINTFORML 「悪い気がするけど……助かったわ」
PRINTFORMW 「ﾀﾁｻﾚ…ｺｺｶﾗﾀﾁｻﾚ……」	PRINTFORMW 「ﾀﾁｻﾚ…ｺｺｶﾗﾀﾁｻﾚ……」
PRINTFORMW 「確かにここの事も重要だけれども」	PRINTFORMW 「確かにここの事も重要だけれども」
PRINTFORMDW 「無邪気に外法って、怖いわよね」	PRINTFORMDW 「無邪気に外法って、怖いわよね」
PRINTFORML 「それじゃあ一旦別行動という事ね」	PRINTFORML 「それじゃあ一旦別行動という事ね」
PRINTFORMW 「蓬で出来てるって訳じゃないのね」	PRINTFORMW 「蓬で出来てるって訳じゃないのね」
PRINTFORMW 「ん？　ここでもこれは使えるの？」	PRINTFORMW 「ん？　ここでもこれは使えるの？」
PRINTFORMW 「ああ、布都の結界みたいなものね」	PRINTFORMW 「ああ、布都の結界みたいなものね」
PRINTFORMW 「今夜は宴ね……肴は触手だけれど」	PRINTFORMW 「今夜は宴ね……肴は触手だけれど」
PRINTFORMW 「何か特別な効能がある種、かしら」	PRINTFORMW 「何か特別な効能がある種、かしら」
PRINTFORML (聞こえて……無いわよね…………)	PRINTFORML (聞こえて……無いわよね…………)
PRINTFORMDW ぴちゃぴちゃと水音を立て続けた…	PRINTFORMDW ぴちゃぴちゃと水音を立て続けた…
PRINTFORML 「むねぇ…はちきれそうなのぉ……」	PRINTFORML 「むねぇ…はちきれそうなのぉ……」
PRINTFORML 「いやぁ……おっぱい…もれてる…」	PRINTFORML 「いやぁ……おっぱい…もれてる…」
PRINTFORM 「ひやぁ…ん……ふ、わああぁぁぁ……	PRINTFORM 「ひやぁ…ん……ふ、わああぁぁぁ……
PRINTFORML 「……！　…！！　…ぅ…ぁ………」	PRINTFORML 「……！　…！！　…ぅ…ぁ………」
PRINTFORMW 「こうなったら……雷で、私ごと…」	PRINTFORMW 「こうなったら……雷で、私ごと…」
PRINTFORMDW 屠自古は口数が少なくなっている…	PRINTFORMDW 屠自古は口数が少なくなっている…
PRINTFORML 「身重でも、動ける事はあるわ……」	PRINTFORML 「身重でも、動ける事はあるわ……」
PRINTFORML 「時には猪の様に愚直に進むのよ！」	PRINTFORML 「時には猪の様に愚直に進むのよ！」
PRINTFORML 「そして時には鹿の様に臆病に……」	PRINTFORML 「そして時には鹿の様に臆病に……」
PRINTFORML 「ふああぁぁ……やさしくぅ…ね？」	PRINTFORML 「ふああぁぁ……やさしくぅ…ね？」
PRINTFORMW 「ふう、大声出してすっきりしたわ」	PRINTFORMW 「ふう、大声出してすっきりしたわ」
PRINTFORML 「亡霊なのにぃ……火照るのぉ……」	PRINTFORML 「亡霊なのにぃ……火照るのぉ……」
PRINTFORML 「はあ、触手ばっかりで嫌になるわ」	PRINTFORML 「はあ、触手ばっかりで嫌になるわ」
PRINTFORMW (しまっ、飲んじゃ……く、う……)	PRINTFORMW (しまっ、飲んじゃ……く、う……)
PRINTFORML 「あれぇ……つづきはぁ…………？」	PRINTFORML 「あれぇ……つづきはぁ…………？」
PRINTFORMDW 屠自古は夢中で自身を慰めている…	PRINTFORMDW 屠自古は夢中で自身を慰めている…
PRINTFORML 「さ…いっ、てえぇ……よぉ………」	PRINTFORML 「さ…いっ、てえぇ……よぉ………」
PRINTFORML 「っせーのっ！　って気持ち悪い！」	PRINTFORML 「っせーのっ！　って気持ち悪い！」
PRINTFORML 「あ、はああぁぁぁぁっ！」					PRINTFORML 「あ、はああぁぁぁぁっ！」				
PRINTFORML 「……なっ、まさか……服って……」	PRINTFORML 「……なっ、まさか……服って……」
PRINTFORML 「うぅ……まぁ予想してたけど……」	PRINTFORML 「うぅ……まぁ予想してたけど……」
PRINTFORML とめっ！　とめてええええぇ！！っ」	PRINTFORML とめっ！　とめてええええぇ！！っ」
PRINTFORML 「自己責任よ。自分で処理しなさい」	PRINTFORML 「自己責任よ。自分で処理しなさい」
PRINTFORM きもちぃぃ！！　すごおぉいわぁ！！！	PRINTFORM きもちぃぃ！！　すごおぉいわぁ！！！
PRINTFORM (このままじゃまともに戦えない……	PRINTFORM (このままじゃまともに戦えない……
PRINTFORML 「一度退いて体勢を整えましょう」	PRINTFORML 「一度退いて体勢を整えましょう」
PRINTFORM ここに挿入れたいんでしょぉ…………	PRINTFORM ここに挿入れたいんでしょぉ…………
PRINTFORML 「超電磁ぃ…タツマキーーー！！」	PRINTFORML 「超電磁ぃ…タツマキーーー！！」
PRINTFORML 「集中、余計なことは考えないわ」	PRINTFORML 「集中、余計なことは考えないわ」
PRINTFORMW 「やああぁぁぁって！　やんよ！」	PRINTFORMW 「やああぁぁぁって！　やんよ！」
PRINTFORML (今、接近されるとマズいわ……)	PRINTFORML (今、接近されるとマズいわ……)
PRINTFORML 「乾坤一擲、敵の殲滅を狙うわ！」	PRINTFORML 「乾坤一擲、敵の殲滅を狙うわ！」
PRINTFORML 「あんたの拍動を止めてやるわ！」	PRINTFORML 「あんたの拍動を止めてやるわ！」
PRINTFORML 「んーっ！　ぬ…抜けてやんよ！」	PRINTFORML 「んーっ！　ぬ…抜けてやんよ！」
PRINTFORML 屠自古は静かに機会を窺っている。	PRINTFORML 屠自古は静かに機会を窺っている。
PRINTFORML 「いくら狙いやすいからって…！」	PRINTFORML 「いくら狙いやすいからって…！」
PRINTFORML 「ひいいあああぁぁっっっぅ！！」	PRINTFORML 「ひいいあああぁぁっっっぅ！！」
PRINTFORML 「～～っっっ！！　だめぇぇっ！」	PRINTFORML 「～～っっっ！！　だめぇぇっ！」
PRINTFORML 「に、にゃあああぁぁっッッ！！」	PRINTFORML 「に、にゃあああぁぁっッッ！！」
PRINTFORML 「き…ついっ、離しなさいっ！！」	PRINTFORML 「き…ついっ、離しなさいっ！！」
PRINTFORML 「あ、や……いやあぁぁぁっ！！」	PRINTFORML 「あ、や……いやあぁぁぁっ！！」
PRINTFORML 「くっ…大丈夫、すぐ持ち直すわ」	PRINTFORML 「くっ…大丈夫、すぐ持ち直すわ」
PRINTFORMW 「………………う…あ……っ……」	PRINTFORMW 「………………う…あ……っ……」
PRINTFORML 「やって…………やるですぅ……」	PRINTFORML 「やって…………やるですぅ……」
PRINTFORML 「やって…………やるってぇ……」	PRINTFORML 「やって…………やるってぇ……」
PRINTFORML 「た…食べられちゃ……助け……」	PRINTFORML 「た…食べられちゃ……助け……」
PRINTFORML (このまま……どうなるのぉ……)	PRINTFORML (このまま……どうなるのぉ……)
PRINTFORMDW 屠自古静かな寝息を立てている…	PRINTFORMDW 屠自古静かな寝息を立てている…
PRINTFORML 「私にそ…そんな趣味ないわよ！」	PRINTFORML 「私にそ…そんな趣味ないわよ！」
PRINTFORML 「…………太子様……すみません」	PRINTFORML 「…………太子様……すみません」
PRINTFORML 「あ、太子さ…ま。……どうも！」	PRINTFORML 「あ、太子さ…ま。……どうも！」
PRINTFORMW 「また買い足しておきますね……」	PRINTFORMW 「また買い足しておきますね……」
PRINTFORMW 「黄泉だってもうちょっとマシよ」	PRINTFORMW 「黄泉だってもうちょっとマシよ」
PRINTFORML 「あ…敵に気付かれるかしら……」	PRINTFORML 「あ…敵に気付かれるかしら……」
PRINTFORMW 「仲間がいてくれるのは嬉しいわ」	PRINTFORMW 「仲間がいてくれるのは嬉しいわ」
PRINTFORML 「縁があれば、また会いましょう」	PRINTFORML 「縁があれば、また会いましょう」
PRINTFORMW 「時計？　あぁ、漏刻のすごい奴」	PRINTFORMW 「時計？　あぁ、漏刻のすごい奴」
PRINTFORMW 「………………何も見なかったわ」	PRINTFORMW 「………………何も見なかったわ」
PRINTFORML 「……そんな暇無いでしょうけど」	PRINTFORML 「……そんな暇無いでしょうけど」
PRINTFORML 「何かあったらすぐに起こしてね」	PRINTFORML 「何かあったらすぐに起こしてね」
PRINTFORMDW 屠自古の声は期待に満ちている…	PRINTFORMDW 屠自古の声は期待に満ちている…
PRINTFORMD ピンと立った乳首を弾かれた拍子に	PRINTFORMD ピンと立った乳首を弾かれた拍子に
PRINTFORML 「うぅぅ……お、さまらないぃ…」	PRINTFORML 「うぅぅ……お、さまらないぃ…」
PRINTFORMW 「……ぐうぅ、や、られた…のね」	PRINTFORMW 「……ぐうぅ、や、られた…のね」
PRINTFORML 「う～ん……膾が食べたいわ……」	PRINTFORML 「う～ん……膾が食べたいわ……」
PRINTFORML 「うっ……、おぅえぇ…………う」	PRINTFORML 「うっ……、おぅえぇ…………う」
PRINTFORMDW 屠自古は額に脂汗を浮かべている	PRINTFORMDW 屠自古は額に脂汗を浮かべている
PRINTFORML 「も……時間…か、しら…………」	PRINTFORML 「も……時間…か、しら…………」
PRINTFORML 「この部屋なら有利に戦えるわね」	PRINTFORML 「この部屋なら有利に戦えるわね」
PRINTFORML 「弱い相手はどこにいるー♪……」	PRINTFORML 「弱い相手はどこにいるー♪……」
PRINTFORML 「しょうがないわ…とっておきよ」	PRINTFORML 「しょうがないわ…とっておきよ」
PRINTFORML 「悪いけど、こちらもカツカツよ」	PRINTFORML 「悪いけど、こちらもカツカツよ」
PRINTFORML 「でも、くれぐれも気をつけてね」	PRINTFORML 「でも、くれぐれも気をつけてね」
PRINTFORML 「疼きが治まっていく…不思議ね」	PRINTFORML 「疼きが治まっていく…不思議ね」
PRINTFORMDW もじもじ股を擦りあわせている…	PRINTFORMDW もじもじ股を擦りあわせている…
PRINTFORMD 衣服の下からも激しく自己主張する	PRINTFORMD 衣服の下からも激しく自己主張する
PRINTFORML 「うう……スライムまみれね……」	PRINTFORML 「うう……スライムまみれね……」
PRINTFORML 「………………？　…………！！」	PRINTFORML 「………………？　…………！！」
PRINTFORML 「……ず…随分とかわいい罠ね…」	PRINTFORML 「……ず…随分とかわいい罠ね…」
PRINTFORML 「触らぬ神に祟り無し、よね……」	PRINTFORML 「触らぬ神に祟り無し、よね……」
PRINTFORMW ここは迷宮テンタクルスのゴモラ。	PRINTFORMW ここは迷宮テンタクルスのゴモラ。
﻿PRINTFORML 触手宮　蘇我屠自古の口上です。	PRINTFORML 触手宮　蘇我屠自古の口上です。
PRINTFORML 「うぅ、ちょっと休ませて……」	PRINTFORML 「うぅ、ちょっと休ませて……」
PRINTFORML 「や……やってらんないわよ！」	PRINTFORML 「や……やってらんないわよ！」
PRINTFORML 「なんで私がこんなことを……」	PRINTFORML 「なんで私がこんなことを……」
PRINTFORML 「超電磁スパアアアァァク！！」	PRINTFORML 「超電磁スパアアアァァク！！」
PRINTFORML 「私に楯突く奴はビリビリよ！」	PRINTFORML 「私に楯突く奴はビリビリよ！」
PRINTFORMDW 轟音と共に桃色の雷が煌いた…	PRINTFORMDW 轟音と共に桃色の雷が煌いた…
PRINTFORML 「空中爆雷っ、まあ唯の弾幕ね」	PRINTFORML 「空中爆雷っ、まあ唯の弾幕ね」
PRINTFORML 「やっ…！　なんで、こんな…」	PRINTFORML 「やっ…！　なんで、こんな…」
PRINTFORML 「いい加減に…！　にゃあっ！」	PRINTFORML 「いい加減に…！　にゃあっ！」
PRINTFORML 「……大丈夫、体はまだ動くわ」	PRINTFORML 「……大丈夫、体はまだ動くわ」
PRINTFORML 「！！！！！！！！！！！！！」	PRINTFORML 「！！！！！！！！！！！！！」
PRINTFORML 「そんな、狙わないでよ…っ！」	PRINTFORML 「そんな、狙わないでよ…っ！」
PRINTFORML 「しつこいっ！　って、しまっ」	PRINTFORML 「しつこいっ！　って、しまっ」
PRINTFORML 「軌道が、不規則…きゃっ?!」	PRINTFORML 「軌道が、不規則…きゃっ?!」
PRINTFORML 「この触手、無駄に器用ね……」	PRINTFORML 「この触手、無駄に器用ね……」
PRINTFORML 「やああぁっ！　嘘嘘嘘ッ！！」	PRINTFORML 「やああぁっ！　嘘嘘嘘ッ！！」
PRINTFORML 「イッ、きゅううぅぅぅっ！！」	PRINTFORML 「イッ、きゅううぅぅぅっ！！」
PRINTFORML 「今は…当たってやれないわね」	PRINTFORML 「今は…当たってやれないわね」
PRINTFORML 「そう簡単には捕まらないわ！」	PRINTFORML 「そう簡単には捕まらないわ！」
PRINTFORML 「……何……亡霊も寝るわよ…」	PRINTFORML 「……何……亡霊も寝るわよ…」
PRINTFORML 「け…結構手こずったわね……」	PRINTFORML 「け…結構手こずったわね……」
PRINTFORMW 「見える！　私にも見えるわ！」	PRINTFORMW 「見える！　私にも見えるわ！」
PRINTFORML 「赤い……リビングバイン…？」	PRINTFORML 「赤い……リビングバイン…？」
PRINTFORMW 「今も無い？　そりゃそうよね」	PRINTFORMW 「今も無い？　そりゃそうよね」
PRINTFORMW 「………なんでここにあるのよ」	PRINTFORMW 「………なんでここにあるのよ」
PRINTFORMW 「これ、装備するの？　私が？」	PRINTFORMW 「これ、装備するの？　私が？」
PRINTFORML 「これは何に使う棒かしら……」	PRINTFORML 「これは何に使う棒かしら……」
PRINTFORMW 「また漠然としたお守りね……」	PRINTFORMW 「また漠然としたお守りね……」
PRINTFORMW 「原料は何か気になるところね」	PRINTFORMW 「原料は何か気になるところね」
PRINTFORML 「ああぁぁぁ……ふ…あぁ……」	PRINTFORML 「ああぁぁぁ……ふ…あぁ……」
PRINTFORML 「くうぅ……さいあく、ね……」	PRINTFORML 「くうぅ……さいあく、ね……」
PRINTFORMW (何かしら……？　怖気が……)	PRINTFORMW (何かしら……？　怖気が……)
PRINTFORMW 「くうぅ…あばれ、ないで……」	PRINTFORMW 「くうぅ…あばれ、ないで……」
PRINTFORML 「もう全快よ、心配かけたわね」	PRINTFORML 「もう全快よ、心配かけたわね」
PRINTFORML 「無事よ……すこし苦しいだけ」	PRINTFORML 「無事よ……すこし苦しいだけ」
PRINTFORML (無意識に、腹を庇ってる……)	PRINTFORML (無意識に、腹を庇ってる……)
PRINTFORML 「乳母……なんていないものね」	PRINTFORML 「乳母……なんていないものね」
PRINTFORML 「う…っ……、こ…の野郎……」	PRINTFORML 「う…っ……、こ…の野郎……」
PRINTFORML 「……っ、どうしたのよっ？！」	PRINTFORML 「……っ、どうしたのよっ？！」
PRINTFORML 「本当に?!　恩に着るわ……」	PRINTFORML 「本当に?!　恩に着るわ……」
PRINTFORML (私……味…覚えて……ッ?!)	PRINTFORML (私……味…覚えて……ッ?!)
PRINTFORML 「擬態よっ！　壁から離れて！」	PRINTFORML 「擬態よっ！　壁から離れて！」
PRINTFORML 「あひゃああああぁぁぁぁ?!」	PRINTFORML 「あひゃああああぁぁぁぁ?!」
PRINTFORML 「くッ！　……み…見ないで…」	PRINTFORML 「くッ！　……み…見ないで…」
PRINTFORML 「い、いぎゃあぁぁっっ！！！」	PRINTFORML 「い、いぎゃあぁぁっっ！！！」
PRINTFORM 　ないじゃないの、よおぉぉ………	PRINTFORM 　ないじゃないの、よおぉぉ………
PRINTFORM あはぁ…んっ、ぱぁ、はぁ、ん……	PRINTFORM あはぁ…んっ、ぱぁ、はぁ、ん……
PRINTFORML 情にもろい亡霊は好きですか？	PRINTFORML 情にもろい亡霊は好きですか？
PRINTFORMW 「こんなこともあろうかと！」	PRINTFORMW 「こんなこともあろうかと！」
PRINTFORM 「ほら……好きにして…よ……ぉ	PRINTFORM 「ほら……好きにして…よ……ぉ
PRINTFORML 「轟雷に塵と消えなさい！！」	PRINTFORML 「轟雷に塵と消えなさい！！」
PRINTFORML 「稲妻殺法おおおぉぉぉ！！」	PRINTFORML 「稲妻殺法おおおぉぉぉ！！」
PRINTFORML 「三分間だけ待ってやんよ！」	PRINTFORML 「三分間だけ待ってやんよ！」
PRINTFORML 「こっちに寄るな……下衆が」	PRINTFORML 「こっちに寄るな……下衆が」
PRINTFORML 「かんつぅ……えへへへぇ…」	PRINTFORML 「かんつぅ……えへへへぇ…」
PRINTFORML 「必殺必中！　雷神アロー！」	PRINTFORML 「必殺必中！　雷神アロー！」
PRINTFORM 「わ…わたしのぉ……下もぉ……	PRINTFORM 「わ…わたしのぉ……下もぉ……
PRINTFORML 「も、駄目、っ！　こんな、」	PRINTFORML 「も、駄目、っ！　こんな、」
PRINTFORML 「いまはっ、ちょ、このっ！」	PRINTFORML 「いまはっ、ちょ、このっ！」
PRINTFORML (嫌あ！　出して出してぇ！)	PRINTFORML (嫌あ！　出して出してぇ！)
PRINTFORMW (私……どうなるのかしら…)	PRINTFORMW (私……どうなるのかしら…)
PRINTFORM 「もぉ……わたし、……あはぁ…	PRINTFORM 「もぉ……わたし、……あはぁ…
PRINTFORMDW 屠自古は自慰に耽っている…	PRINTFORMDW 屠自古は自慰に耽っている…
PRINTFORML 「やられる訳にはいかないわ」	PRINTFORML 「やられる訳にはいかないわ」
PRINTFORML 「流石亡霊ね、何とも無いわ」	PRINTFORML 「流石亡霊ね、何とも無いわ」
PRINTFORML 「ひゃっ、そこ、はぁっ……」	PRINTFORML 「ひゃっ、そこ、はぁっ……」
PRINTFORML 「の、る、にゃあぁっっ！！」	PRINTFORML 「の、る、にゃあぁっっ！！」
PRINTFORML 「…………なか、…あつ……」	PRINTFORML 「…………なか、…あつ……」
PRINTFORML 「目眩ましのつもりかしら？」	PRINTFORML 「目眩ましのつもりかしら？」
PRINTFORML 「当たれ！　当たってよぉ！」	PRINTFORML 「当たれ！　当たってよぉ！」
PRINTFORML 「吊るし大根なんて御免よ！」	PRINTFORML 「吊るし大根なんて御免よ！」
PRINTFORM 「ふあぁ…溢れてしまいます……	PRINTFORM 「ふあぁ…溢れてしまいます……
PRINTFORML 「死して屍拾うもの無し、ね」	PRINTFORML 「死して屍拾うもの無し、ね」
PRINTFORML 「欲張りは身を滅ぼすわよ？」	PRINTFORML 「欲張りは身を滅ぼすわよ？」
PRINTFORML 「はなし……なさいって……」	PRINTFORML 「はなし……なさいって……」
PRINTFORMW 「拙速こそが兵法の常道よ！」	PRINTFORMW 「拙速こそが兵法の常道よ！」
PRINTFORML 「あら、布都………、…ッ！」	PRINTFORML 「あら、布都………、…ッ！」
PRINTFORML 「そう、無理なら構わないわ」	PRINTFORML 「そう、無理なら構わないわ」
PRINTFORMW 「いかにも有難そうなお札ね」	PRINTFORMW 「いかにも有難そうなお札ね」
PRINTFORMW 「…魔方陣？　何かしら……」	PRINTFORMW 「…魔方陣？　何かしら……」
PRINTFORML 「これがあるとまず一安心ね」	PRINTFORML 「これがあるとまず一安心ね」
PRINTFORMW 「むぅ……これはなかなか…」	PRINTFORMW 「むぅ……これはなかなか…」
PRINTFORML 「も……げんか…………くー」	PRINTFORML 「も……げんか…………くー」
PRINTFORML 「あなたは寝なくて大丈夫？」	PRINTFORML 「あなたは寝なくて大丈夫？」
PRINTFORMW 「………………いや、ぁ……」	PRINTFORMW 「………………いや、ぁ……」
PRINTFORML 「…………ん、何でもないわ」	PRINTFORML 「…………ん、何でもないわ」
PRINTFORML 「………調子が上がらないわ」	PRINTFORML 「………調子が上がらないわ」
PRINTFORML 「う、…………いや、大丈夫」	PRINTFORML 「う、…………いや、大丈夫」
PRINTFORML (何かしら……この感じ…？)	PRINTFORML (何かしら……この感じ…？)
PRINTFORML 「もう……膨らんできた……」	PRINTFORML 「もう……膨らんできた……」
PRINTFORML 「母乳、滲んで…………嫌ね」	PRINTFORML 「母乳、滲んで…………嫌ね」
PRINTFORML 「私を試しているのかしら？」	PRINTFORML 「私を試しているのかしら？」
PRINTFORML 「私で良ければ、力を貸すわ」	PRINTFORML 「私で良ければ、力を貸すわ」
PRINTFORMW 「しっかり、今薬をあげるわ」	PRINTFORMW 「しっかり、今薬をあげるわ」
PRINTFORML 「これで持ち直せるかしら？」	PRINTFORML 「これで持ち直せるかしら？」
PRINTFORMD 屠自古は少し安心しながらも、	PRINTFORMD 屠自古は少し安心しながらも、
PRINTFORMW 「落ち着いて……自律、自律」	PRINTFORMW 「落ち着いて……自律、自律」
PRINTFORML (脳髄が……灼けるっ…！！)	PRINTFORML (脳髄が……灼けるっ…！！)
PRINTFORML 「…………………………はっ」	PRINTFORML 「…………………………はっ」
PRINTFORML 「～～～～～～～～ッ！！！」	PRINTFORML 「～～～～～～～～ッ！！！」
PRINTFORMW 「……うがなぃ…ね…………」	PRINTFORMW 「……うがなぃ…ね…………」
PRINTFORMD 「しょうがない…わよねぇ……	PRINTFORMD 「しょうがない…わよねぇ……
PRINTFORM 「もぉ……ダメぇ、限かぁい……	PRINTFORM 「もぉ……ダメぇ、限かぁい……
PRINTFORM 「わらひぃ……メス、チン、ポォ	PRINTFORM 「わらひぃ……メス、チン、ポォ
PRINTFORML 　た…耐えてやんよ……！」	PRINTFORML 　た…耐えてやんよ……！」
PRINTFORM 「ここはぁ……敏感なのぉ……	PRINTFORM 「ここはぁ……敏感なのぉ……
PRINTFORML 「下がって！ここは私に！」	PRINTFORML 「下がって！ここは私に！」
PRINTFORML 「超電磁ボォーーール！！」	PRINTFORML 「超電磁ボォーーール！！」
PRINTFORML 「そうよ、これは節約攻撃」	PRINTFORML 「そうよ、これは節約攻撃」
PRINTFORML 「そこだけ動きが鈍いわ！」	PRINTFORML 「そこだけ動きが鈍いわ！」
PRINTFORML (もしかして私、ヤバい？)	PRINTFORML (もしかして私、ヤバい？)
PRINTFORML 「……ふぅーー。…………」	PRINTFORML 「……ふぅーー。…………」
PRINTFORMW 　・　・　・　・　・　・　	PRINTFORMW 　・　・　・　・　・　・　
PRINTFORML 「まだ私を辱めたいの……」	PRINTFORML 「まだ私を辱めたいの……」
PRINTFORML 「もぅ、どこを狙って…！」	PRINTFORML 「もぅ、どこを狙って…！」
PRINTFORML 「なんで、わかるのよ…！」	PRINTFORML 「なんで、わかるのよ…！」
PRINTFORML 「…おのれポルナレフ！！」	PRINTFORML 「…おのれポルナレフ！！」
PRINTFORML 「ひっ！　……悪趣味ね…」	PRINTFORML 「ひっ！　……悪趣味ね…」
PRINTFORML 「そ、れだけっ、はっ！！」	PRINTFORML 「そ、れだけっ、はっ！！」
PRINTFORML 「ううん……神子さまぁ…」	PRINTFORML 「ううん……神子さまぁ…」
PRINTFORM 「痛ぁ…私にそんな趣味は……	PRINTFORM 「痛ぁ…私にそんな趣味は……
PRINTFORM 「自分で…脱ぎますからぁ……	PRINTFORM 「自分で…脱ぎますからぁ……
PRINTFORML ……あれ、夢だったの…？」	PRINTFORML ……あれ、夢だったの…？」
PRINTFORML 「あぁ……んっ……すぅ…」	PRINTFORML 「あぁ……んっ……すぅ…」
PRINTFORML 「この触手……動くわ!?」	PRINTFORML 「この触手……動くわ!?」
PRINTFORML 「何、娼婦でも始めたの？」	PRINTFORML 「何、娼婦でも始めたの？」
PRINTFORML 「こんにちは、こんばんは」	PRINTFORML 「こんにちは、こんばんは」
PRINTFORML 「お互い気をつけましょう」	PRINTFORML 「お互い気をつけましょう」
PRINTFORML 「無事に出れるといいわね」	PRINTFORML 「無事に出れるといいわね」
PRINTFORML 「……効いてたらいいわね」	PRINTFORML 「……効いてたらいいわね」
PRINTFORMW 「ぶわぁくねえぇぇつ！！」	PRINTFORMW 「ぶわぁくねえぇぇつ！！」
PRINTFORMW 「何のあてつけかしら……」	PRINTFORMW 「何のあてつけかしら……」
PRINTFORMW 「あとで一杯やりましょう」	PRINTFORMW 「あとで一杯やりましょう」
PRINTFORML 「たの……んだわ…………」	PRINTFORML 「たの……んだわ…………」
PRINTFORML 「ふぅー……、ふーー……」	PRINTFORML 「ふぅー……、ふーー……」
PRINTFORML 「わ…忘れて。お願い……」	PRINTFORML 「わ…忘れて。お願い……」
PRINTFORML (月の障りが来ない……？)	PRINTFORML (月の障りが来ない……？)
PRINTFORML 「う……あ、…い、たい…」	PRINTFORML 「う……あ、…い、たい…」
PRINTFORMDL 屠自古は目を擦っている…	PRINTFORMDL 屠自古は目を擦っている…
PRINTFORML 「狐の様な狡猾さも必要ね」	PRINTFORML 「狐の様な狡猾さも必要ね」
PRINTFORML 「一人じゃ心細いわね……」	PRINTFORML 「一人じゃ心細いわね……」
PRINTFORML 「ちょっと、きついわね…」	PRINTFORML 「ちょっと、きついわね…」
PRINTFORML 「うう……あつぅい………」	PRINTFORML 「うう……あつぅい………」
PRINTFORML 「太子様、こちらをどうぞ」	PRINTFORML 「太子様、こちらをどうぞ」
PRINTFORML 「なに？　……その笑みは」	PRINTFORML 「なに？　……その笑みは」
PRINTFORML 「………凄い霊泉ね、これ」	PRINTFORML 「………凄い霊泉ね、これ」
PRINTFORML 「横ッ！　……危ないわね」	PRINTFORML 「横ッ！　……危ないわね」
PRINTFORML 「く……う、はぁっ！！！」	PRINTFORML 「く……う、はぁっ！！！」
PRINTFORML (透ける暇も、ないっ?!)	PRINTFORML (透ける暇も、ないっ?!)
PRINTFORML 尿道まで入り込んでいった…	PRINTFORML 尿道まで入り込んでいった…
PRINTFORML 「うあっ！　ちょ、な……」	PRINTFORML 「うあっ！　ちょ、な……」
PRINTFORMW 「う、はああぁぁっ！！！」	PRINTFORMW 「う、はああぁぁっ！！！」
PRINTFORM 「う?!　はああぁぁぁっ！！	PRINTFORM 「う?!　はああぁぁぁっ！！
PRINTFORM 　でも締め付けてくるぅ……！	PRINTFORM 　でも締め付けてくるぅ……！
PRINTFORMDW 屠自古は上の空のようだ	PRINTFORMDW 屠自古は上の空のようだ
PRINTFORML 「にゃ、あああぁぁぁ♪」	PRINTFORML 「にゃ、あああぁぁぁ♪」
PRINTFORML 「ふ、ああぁぁぁぁ……」	PRINTFORML 「ふ、ああぁぁぁぁ……」
PRINTFORML 「ふあぁっ……きもち…」	PRINTFORML 「ふあぁっ……きもち…」
PRINTFORML 「ひゃ！　気持ち悪っ！」	PRINTFORML 「ひゃ！　気持ち悪っ！」
PRINTFORMW (もう…………いっか)		PRINTFORMW (もう…………いっか)	
PRINTFORM 「他ならどこでもぉ……ねぇ	PRINTFORM 「他ならどこでもぉ……ねぇ
PRINTFORML 「………～～～っ…！！」	PRINTFORML 「………～～～っ…！！」
PRINTFORML 「そこ、弱い、のお……！	PRINTFORML 「そこ、弱い、のお……！
PRINTFORML 「ゴルゴムの仕業ね……」	PRINTFORML 「ゴルゴムの仕業ね……」
PRINTFORML 「アパム！　アパーム！」	PRINTFORML 「アパム！　アパーム！」
PRINTFORML 「当たってやんねえよ！」	PRINTFORML 「当たってやんねえよ！」
PRINTFORM 「え…そんなご趣味が……？	PRINTFORM 「え…そんなご趣味が……？
PRINTFORML 「おぞましい…うぅ……」	PRINTFORML 「おぞましい…うぅ……」
PRINTFORML 「撒いた…？　ふぅ……」	PRINTFORML 「撒いた…？　ふぅ……」
PRINTFORML 「早く……いや…ぁ……」	PRINTFORML 「早く……いや…ぁ……」
PRINTFORML 「うぅ……すみません…」	PRINTFORML 「うぅ……すみません…」
PRINTFORMW 「なかなか強力なモノね」	PRINTFORMW 「なかなか強力なモノね」
PRINTFORMW 「実は水銀含有とか……」	PRINTFORMW 「実は水銀含有とか……」
PRINTFORMW 「へぇ……蓬莱の薬師の」	PRINTFORMW 「へぇ……蓬莱の薬師の」
PRINTFORML 「しょうがないわね……」	PRINTFORML 「しょうがないわね……」
PRINTFORML 「軽蔑……しないで……」	PRINTFORML 「軽蔑……しないで……」
PRINTFORML 「私、なんでこんな……」	PRINTFORML 「私、なんでこんな……」
PRINTFORML 「ちょ、っと……ごめん」	PRINTFORML 「ちょ、っと……ごめん」
PRINTFORML 「ねないこ　だれかしら」	PRINTFORML 「ねないこ　だれかしら」
PRINTFORML 「ぃっτゃωょ…………」	PRINTFORML 「ぃっτゃωょ…………」
PRINTFORML 「こう薄暗いと命がけね」	PRINTFORML 「こう薄暗いと命がけね」
PRINTFORML 「あー……、ふえぇ……」	PRINTFORML 「あー……、ふえぇ……」
PRINTFORML 「願い下げっ！　よッ！」	PRINTFORML 「願い下げっ！　よッ！」
PRINTFORML 「……うん、潤うわ……」	PRINTFORML 「……うん、潤うわ……」
PRINTFORML 「景気づけよ、まぁ一杯」	PRINTFORML 「景気づけよ、まぁ一杯」
PRINTFORML 「ふう……心が落ち着く」	PRINTFORML 「ふう……心が落ち着く」
PRINTFORML 「………………うまい！」	PRINTFORML 「………………うまい！」
PRINTFORML 「う、はああぁっ！！！」	PRINTFORML 「う、はああぁっ！！！」
PRINTFORML 「………………うぅ……」	PRINTFORML 「………………うぅ……」
PRINTFORML 「随分古典的な罠ね……」	PRINTFORML 「随分古典的な罠ね……」
PRINTFORML 「もう何でも有り……ね」	PRINTFORML 「もう何でも有り……ね」
PRINTFORML 楽しみ、ましょお……？」	PRINTFORML 楽しみ、ましょお……？」
PRINTFORMDW 自らの剛直を突き入れた	PRINTFORMDW 自らの剛直を突き入れた
PRINTFORMDL 屠自古の反応は無い。	PRINTFORMDL 屠自古の反応は無い。
PRINTFORML 「これが入鹿の雷よ！」	PRINTFORML 「これが入鹿の雷よ！」
PRINTFORML 「やああぁぁぁっ!!」	PRINTFORML 「やああぁぁぁっ!!」
PRINTFORML 「むー！　んむーっ！」	PRINTFORML 「むー！　んむーっ！」
PRINTFORML で…たい、のにぃ……」	PRINTFORML で…たい、のにぃ……」
PRINTFORML 「絶対ダメ…よぉ……」	PRINTFORML 「絶対ダメ…よぉ……」
PRINTFORML 「～っ！　効いたわ…」	PRINTFORML 「～っ！　効いたわ…」
PRINTFORML 「──────っ！！」	PRINTFORML 「──────っ！！」
PRINTFORML 「こっちは…勘弁して」	PRINTFORML 「こっちは…勘弁して」
PRINTFORML 「やめ、な、さいっ！」	PRINTFORML 「やめ、な、さいっ！」
PRINTFORML 「うぐっ?!……む…」	PRINTFORML 「うぐっ?!……む…」
PRINTFORML 「う…まずいわね……」	PRINTFORML 「う…まずいわね……」
PRINTFORML 「踏み込みが甘いわ！」	PRINTFORML 「踏み込みが甘いわ！」
PRINTFORML 「やってやったわよ！」	PRINTFORML 「やってやったわよ！」
PRINTFORML 「な…何とかしなきゃ」	PRINTFORML 「な…何とかしなきゃ」
PRINTFORML 「……！　油断したわ」	PRINTFORML 「……！　油断したわ」
PRINTFORML 「嘘…ですよね……？」	PRINTFORML 「嘘…ですよね……？」
PRINTFORMW 「え、何？　……苺？」	PRINTFORMW 「え、何？　……苺？」
PRINTFORMW 「え？　違ったかしら」	PRINTFORMW 「え？　違ったかしら」
PRINTFORML 「そんなに眠くないわ」	PRINTFORML 「そんなに眠くないわ」
PRINTFORMDL オーガスムに達した…	PRINTFORMDL オーガスムに達した…
PRINTFORML 「亡霊も……孕むのね」	PRINTFORML 「亡霊も……孕むのね」
PRINTFORML 「はー……はぁー……」	PRINTFORML 「はー……はぁー……」
PRINTFORMW 「………………わよ？」	PRINTFORMW 「………………わよ？」
PRINTFORML 「……やってやんよ！」	PRINTFORML 「……やってやんよ！」
PRINTFORML 「あれ……わたし……」	PRINTFORML 「あれ……わたし……」
PRINTFORML 「触手、いらないわよ」	PRINTFORML 「触手、いらないわよ」
PRINTFORML 「……か、はッ………」	PRINTFORML 「……か、はッ………」
PRINTFORML 「みなぎってやんよ！」	PRINTFORML 「みなぎってやんよ！」
PRINTFORML 「今は必要ないかしら」	PRINTFORML 「今は必要ないかしら」
PRINTFORML 「どう考えても罠ね…」	PRINTFORML 「どう考えても罠ね…」
PRINTFORM 　だから言ったじゃない！	PRINTFORM 　だから言ったじゃない！
PRINTFORML 「出し……やあぁぁ！」	PRINTFORML 「出し……やあぁぁ！」
PRINTFORML 「……あはは、は……」	PRINTFORML 「……あはは、は……」
PRINTFORM 　やってやん、よぉ…！！	PRINTFORM 　やってやん、よぉ…！！
PRINTFORMW 「死中に活ありね！」	PRINTFORMW 「死中に活ありね！」
PRINTFORML 「前進あるのみよ！」	PRINTFORML 「前進あるのみよ！」
PRINTFORM 「こ…こっち、よぉ……	PRINTFORM 「こ…こっち、よぉ……
PRINTFORML ……ん、ぁはあ……」	PRINTFORML ……ん、ぁはあ……」
PRINTFORM 「ふふ、ここよ、ここ…	PRINTFORM 「ふふ、ここよ、ここ…
PRINTFORML 「祟って…やるわ…」	PRINTFORML 「祟って…やるわ…」
PRINTFORML 「私におまかせを！」	PRINTFORML 「私におまかせを！」
PRINTFORML 「おろかものめが！」	PRINTFORML 「おろかものめが！」
PRINTFORML 「やぁってやんよ！」	PRINTFORML 「やぁってやんよ！」
PRINTFORML 　　　　　　仏　　手	PRINTFORML 　　　　　　仏　　手
PRINTFORML 　　　　　　の　　共	PRINTFORML 　　　　　　の　　共
PRINTFORML 　無　　　　慈　　に	PRINTFORML 　無　　　　慈　　に
PRINTFORML 　用　　　　悲　　　	PRINTFORML 　用　　　　悲　　　
PRINTFORML 「……痺れなさい！」	PRINTFORML 「……痺れなさい！」
PRINTFORML 「む、まだまだぁ！」	PRINTFORML 「む、まだまだぁ！」
PRINTFORML 「く、は…………っ」	PRINTFORML 「く、は…………っ」
PRINTFORML 「か…はっ……！！」	PRINTFORML 「か…はっ……！！」
PRINTFORML 「う、あ、あぁっ！」	PRINTFORML 「う、あ、あぁっ！」
PRINTFORML 「ちょ…調子にぃ……	PRINTFORML 「ちょ…調子にぃ……
PRINTFORML 「――――ッ!!?」	PRINTFORML 「――――ッ!!?」
PRINTFORML 「う、後ろぉ……？」	PRINTFORML 「う、後ろぉ……？」
PRINTFORML 「うそっ!?　私？」	PRINTFORML 「うそっ!?　私？」
PRINTFORML 「…ありがと、布都」	PRINTFORML 「…ありがと、布都」
PRINTFORM 「あ…………えへへぇぇ	PRINTFORM 「あ…………えへへぇぇ
PRINTFORML 「ふぅー……ぅー…」	PRINTFORML 「ふぅー……ぅー…」
PRINTFORM 「愚かもの、ね…………	PRINTFORM 「愚かもの、ね…………
PRINTFORML 「それじゃあ、また」	PRINTFORML 「それじゃあ、また」
PRINTFORML 「反省してます……」	PRINTFORML 「反省してます……」
PRINTFORM 「だからごめんって！」	PRINTFORM 「だからごめんって！」
PRINTFORML 「よろしくお願いね」	PRINTFORML 「よろしくお願いね」
PRINTFORMW 「あら、そう。残念」	PRINTFORMW 「あら、そう。残念」
PRINTFORM し、しかたないわね……	PRINTFORM し、しかたないわね……
PRINTFORMD を翻弄され、屠自古は	PRINTFORMD を翻弄され、屠自古は
PRINTFORML 「ふ…う、うううぅ」	PRINTFORML 「ふ…う、うううぅ」
PRINTFORML 「……貧血かしら…」	PRINTFORML 「……貧血かしら…」
PRINTFORML 「よ……かったぁ…」	PRINTFORML 「よ……かったぁ…」
PRINTFORML 「……やっぱり、ね」	PRINTFORML 「……やっぱり、ね」
PRINTFORML 「まあ、祟るけれど」	PRINTFORML 「まあ、祟るけれど」
PRINTFORML 「待ってやんよ……」	PRINTFORML 「待ってやんよ……」
PRINTFORML 「…………あぁ……」	PRINTFORML 「…………あぁ……」
PRINTFORM 「いいの？　ありがとう	PRINTFORM 「いいの？　ありがとう
PRINTFORML 「……………………」	PRINTFORML 「……………………」
PRINTFORML 「ひぃー…ひぃー…」	PRINTFORML 「ひぃー…ひぃー…」
PRINTFORML は敏感なのにぃ！！」	PRINTFORML は敏感なのにぃ！！」
PRINTFORML 「は……、あ……っ」	PRINTFORML 「は……、あ……っ」
PRINTFORM 　ひどい味ねぇ…………	PRINTFORM 　ひどい味ねぇ…………
PRINTFORML 「…………う……」	PRINTFORML 「…………う……」
PRINTFORML 「あー……………」	PRINTFORML 「あー……………」
PRINTFORML 「く……ふぅ……。	PRINTFORML 「く……ふぅ……。
PRINTFORML 「守ってやんよ！」	PRINTFORML 「守ってやんよ！」
PRINTFORML 「耐えてやんよ！」	PRINTFORML 「耐えてやんよ！」
PRINTFORM 「こっち、よおぉ……	PRINTFORM 「こっち、よおぉ……
PRINTFORML 「やってやんよ！」	PRINTFORML 「やってやんよ！」
PRINTFORML 　　　　　御　　触	PRINTFORML 　　　　　御　　触
PRINTFORM 　　　　　　は　　　	PRINTFORM 　　　　　　は　　　
PRINTFORML 「ばっかもーん！」	PRINTFORML 「ばっかもーん！」
PRINTFORML 「おろかものが！」	PRINTFORML 「おろかものが！」
PRINTFORML 「殺ってやんよ！」	PRINTFORML 「殺ってやんよ！」
PRINTFORML 「こんな所っ……」	PRINTFORML 「こんな所っ……」
PRINTFORML 「掠っただけよ！」	PRINTFORML 「掠っただけよ！」
PRINTFORML 「次は当てるわ…」	PRINTFORML 「次は当てるわ…」
PRINTFORML 「……ふわぁぁぁ」	PRINTFORML 「……ふわぁぁぁ」
PRINTFORML (気色悪い…っ！)	PRINTFORML (気色悪い…っ！)
PRINTFORMDL ｷｭﾋﾟｰﾝ!!	PRINTFORMDL ｷｭﾋﾟｰﾝ!!
PRINTFORML 「……いい気味ね」	PRINTFORML 「……いい気味ね」
PRINTFORML 「……酷い、わね」	PRINTFORML 「……酷い、わね」
PRINTFORMW 「んー、おはよう」	PRINTFORMW 「んー、おはよう」
PRINTFORMW 「やってやんよ！」	PRINTFORMW 「やってやんよ！」
PRINTFORMW 「あら、いいお酒」	PRINTFORMW 「あら、いいお酒」
PRINTFORMW 「さ……最悪…よ」	PRINTFORMW 「さ……最悪…よ」
PRINTFORMW ぼごん！　ぼごん！	PRINTFORMW ぼごん！　ぼごん！
PRINTFORML 「うん…いけるわ」	PRINTFORML 「うん…いけるわ」
PRINTFORML 「鎮まりなさい！」	PRINTFORML 「鎮まりなさい！」
PRINTFORML 「行ってやんよ！」	PRINTFORML 「行ってやんよ！」
PRINTFORMDW ﾃｰﾚｯﾃﾚｰ!	PRINTFORMDW ﾃｰﾚｯﾃﾚｰ!
PRINTFORML 「ぐぅ…うっ！！」	PRINTFORML 「ぐぅ…うっ！！」
PRINTFORML 「丁度よかったわ」	PRINTFORML 「丁度よかったわ」
PRINTFORML 「…………ぉ……」	PRINTFORML 「…………ぉ……」
PRINTFORML 「あひゃあっ！！」	PRINTFORML 「あひゃあっ！！」
PRINTFORML 「い、やああぁぁぁ	PRINTFORML 「い、やああぁぁぁ
PRINTFORM うねってるのぉ！！！	PRINTFORM うねってるのぉ！！！
PRINTFORML 「………………」	PRINTFORML 「………………」
PRINTFORML 「……………？」	PRINTFORML 「……………？」
PRINTFORM 「はぁ……はぁ……	PRINTFORM 「はぁ……はぁ……
PRINTFORMW 「愚か者が！！」	PRINTFORMW 「愚か者が！！」
PRINTFORML 「喧嘩殺法よ！」	PRINTFORML 「喧嘩殺法よ！」
PRINTFORM あ……は、あぁ……	PRINTFORM あ……は、あぁ……
PRINTFORML 「ここはっ……」	PRINTFORML 「ここはっ……」
PRINTFORML 「ざ、残像よ！」	PRINTFORML 「ざ、残像よ！」
PRINTFORML 「！……………」	PRINTFORML 「！……………」
PRINTFORML 「ううぅッ!?」	PRINTFORML 「ううぅッ!?」
PRINTFORML 「やれやれ……」	PRINTFORML 「やれやれ……」
PRINTFORML 「あ、悪いわね」	PRINTFORML 「あ、悪いわね」
PRINTFORM 「あ…はげし……♪	PRINTFORM 「あ…はげし……♪
PRINTFORMW 「刻が見える！」	PRINTFORMW 「刻が見える！」
PRINTFORML 「すや…………」	PRINTFORML 「すや…………」
PRINTFORMW 「魔法の杖…ね」	PRINTFORMW 「魔法の杖…ね」
PRINTFORMW 「………………」	PRINTFORMW 「………………」
PRINTFORML 「ふわあぁ……っ	PRINTFORML 「ふわあぁ……っ
PRINTFORML 「…………はあ」	PRINTFORML 「…………はあ」
PRINTFORMW 「い…たぁ……」	PRINTFORMW 「い…たぁ……」
PRINTFORML 「い、やぁ……」	PRINTFORML 「い、やぁ……」
PRINTFORM 「これっ!!!?!	PRINTFORM 「これっ!!!?!
PRINTFORM バッキバキにしてぇ	PRINTFORM バッキバキにしてぇ
PRINTFORML 「……あ……」	PRINTFORML 「……あ……」
PRINTFORM だからぁ……ね？	PRINTFORM だからぁ……ね？
PRINTFORML 「またなの？」	PRINTFORML 「またなの？」
PRINTFORML 「……んっ！」	PRINTFORML 「……んっ！」
PRINTFORML 「えっ……？」	PRINTFORML 「えっ……？」
PRINTFORML 「行くわよ！」	PRINTFORML 「行くわよ！」
PRINTFORMW 「うぅん……」	PRINTFORMW 「うぅん……」
PRINTFORMW 「………すや」	PRINTFORMW 「………すや」
PRINTFORML 「そうね……」	PRINTFORML 「そうね……」
PRINTFORMW 「綺麗な剣ね」	PRINTFORMW 「綺麗な剣ね」
PRINTFORML 「ふあー…ぁ」	PRINTFORML 「ふあー…ぁ」
PRINTFORMW 「…………！」	PRINTFORMW 「…………！」
PRINTFORMW 「これは……」	PRINTFORMW 「これは……」
PRINTFORML 「はきょ?!」	PRINTFORML 「はきょ?!」
PRINTFORML 「うん……？」	PRINTFORML 「うん……？」
PRINTFORM 「ふ、うふふ……	PRINTFORM 「ふ、うふふ……
PRINTFORMW 次回、「フト」	PRINTFORMW 次回、「フト」
PRINTFORM 「……はあぁぁ…	PRINTFORM 「……はあぁぁ…
PRINTFORM 「ここよぉ……	PRINTFORM 「ここよぉ……
PRINTFORMW 「ばかー！」	PRINTFORMW 「ばかー！」
PRINTFORML 「そこッ！」	PRINTFORML 「そこッ！」
PRINTFORM 「うふ…ふ……	PRINTFORM 「うふ…ふ……
PRINTFORML 「くッ……」	PRINTFORML 「くッ……」
PRINTFORML 「ひぃ…！」	PRINTFORML 「ひぃ…！」
PRINTFORML 「成、敗！」	PRINTFORML 「成、敗！」
PRINTFORMDW ﾓﾙｽｧ!	PRINTFORMDW ﾓﾙｽｧ!
PRINTFORMD 触手の悪戯に	PRINTFORMD 触手の悪戯に
PRINTFORM 「あきゅぁ！！	PRINTFORM 「あきゅぁ！！
PRINTFORML 「…………」	PRINTFORML 「…………」
PRINTFORML 「やれやれ」	PRINTFORML 「やれやれ」
PRINTFORML 「上よッ！」	PRINTFORML 「上よッ！」
PRINTFORM 「触手…っ!?	PRINTFORM 「触手…っ!?
PRINTFORM 「だからぁ！　	PRINTFORM 「だからぁ！　
PRINTFORM 「……あはぁ…	PRINTFORM 「……あはぁ…
PRINTFORM 「はああぁぁ！	PRINTFORM 「はああぁぁ！
PRINTFORM いっぱぁい……	PRINTFORM いっぱぁい……
PRINTFORML 　よ！！」	PRINTFORML 　よ！！」
PRINTFORM 「やぁー……	PRINTFORM 「やぁー……
PRINTFORML 「ふぁ…」	PRINTFORML 「ふぁ…」
PRINTFORML 「くー…」	PRINTFORML 「くー…」
PRINTFORM 「うはぁっ！	PRINTFORM 「うはぁっ！
PRINTFORMDW ごくり…	PRINTFORMDW ごくり…
PRINTFORM 「これぇ……	PRINTFORM 「これぇ……
PRINTFORML 「ッ！」	PRINTFORML 「ッ！」
PRINTFORMW 「……」	PRINTFORMW 「……」
PRINTFORM クリトリス	PRINTFORM クリトリス
PRINTFORML 「……」	PRINTFORML 「……」
PRINTFORMDW ﾌﾞﾁ	PRINTFORMDW ﾌﾞﾁ
PRINTFORMW ごくん。	PRINTFORMW ごくん。
PRINTFORM 「…………	PRINTFORM 「…………
PRINTFORML …く」	PRINTFORML …く」
PRINTFORMW ……」	PRINTFORMW ……」
PRINTFORMDW どん	PRINTFORMDW どん
PRINTFORML ……」	PRINTFORML ……」
PRINTFORML 」		PRINTFORML 」	
PRINTFORML )	PRINTFORML )
PRINTFORML 」	PRINTFORML 」
PRINTFORMW 」	PRINTFORMW 」
PRINTFORMDW 	PRINTFORMDW 
PRINTFORM 尻穴	PRINTFORM 尻穴
PRINTFORM 性器	PRINTFORM 性器
PRINTFORM ……	PRINTFORM ……
PRINTFORM お尻	PRINTFORM お尻
PRINTFORM お豆	PRINTFORM お豆
PRINTFORM ソコ	PRINTFORM ソコ
PRINTFORM 「	PRINTFORM 「
PRINTFORML 	PRINTFORML 
PRINTFORM 胸	PRINTFORM 胸
PRINTFORML	PRINTFORML
PRINTFORMW	PRINTFORMW
