//口上:

PRINTFORMDW 布都は死に物狂いで暴れたが、抵抗虚しく触手の汚らわしい白濁液が布都の胎内に満たされた…	PRINTFORMDW 布都は死に物狂いで暴れたが、抵抗虚しく触手の汚らわしい白濁液が布都の胎内に満たされた…
PRINTFORML 「ひいぃ……、もう…われが、わるかった……。あやまる……あやま、う、ああぁぁ……」	PRINTFORML 「ひいぃ……、もう…われが、わるかった……。あやまる……あやま、う、ああぁぁ……」
PRINTFORMDW 布都は股間に両手を重ね、濡れぼそったヴァギナを弄りながら蕩けた表情をしている…。	PRINTFORMDW 布都は股間に両手を重ね、濡れぼそったヴァギナを弄りながら蕩けた表情をしている…。
PRINTFORMW 「お主も我の"どやがお"とやらが見たいのであろう？　そうだろうそうに決まっておる」	PRINTFORMW 「お主も我の"どやがお"とやらが見たいのであろう？　そうだろうそうに決まっておる」
PRINTFORMDW もはや布都の身体は抵抗なく快楽を受け入れ、腰をかくかく揺らして達している…	PRINTFORMDW もはや布都の身体は抵抗なく快楽を受け入れ、腰をかくかく揺らして達している…
PRINTFORML 「わ、我の本体は皿であってこのような形はあくまで写し身であってだな……」	PRINTFORML 「わ、我の本体は皿であってこのような形はあくまで写し身であってだな……」
PRINTFORML 「き、貴様に猶予をやろう！！　わ、我を解放するなら今の、ひきゅうっ！！	PRINTFORML 「き、貴様に猶予をやろう！！　わ、我を解放するなら今の、ひきゅうっ！！
PRINTFORMDW 布都はだらしなく舌を突き出して自らが生んだ快感に酔い痴れている…	PRINTFORMDW 布都はだらしなく舌を突き出して自らが生んだ快感に酔い痴れている…
PRINTFORMDL 怪しい花粉を吸い込んだ布都はその場で座り込んで寝息を立て始めた。	PRINTFORMDL 怪しい花粉を吸い込んだ布都はその場で座り込んで寝息を立て始めた。
PRINTFORML 「この程度で、心が乱されるとは仙人失格……だぁ…あんな、こと……」	PRINTFORML 「この程度で、心が乱されるとは仙人失格……だぁ…あんな、こと……」
PRINTFORML 「ひぃっ！　はあぁっ！！　来てるっ！！　きておる、かあっ！！！」	PRINTFORML 「ひぃっ！　はあぁっ！！　来てるっ！！　きておる、かあっ！！！」
PRINTFORML 「や、めぇ、よおおおおおおおぉぉぉっっ！！　う、はあぁぁっ！！」	PRINTFORML 「や、めぇ、よおおおおおおおぉぉぉっっ！！　う、はあぁぁっ！！」
PRINTFORML 「あがはああああぁぁぁっ！！！　おご、があああぁぁぁっ！！！！」	PRINTFORML 「あがはああああぁぁぁっ！！！　おご、があああぁぁぁっ！！！！」
PRINTFORML 「ひっ！！　やめろ、やめてくれえええええええぇぇぇぇっっ!?!」	PRINTFORML 「ひっ！！　やめろ、やめてくれえええええええぇぇぇぇっっ!?!」
PRINTFORML 「ぐうッ！　き、貴様ぁ…原型を留めていら、あッ！　ひゃうっ！！」	PRINTFORML 「ぐうッ！　き、貴様ぁ…原型を留めていら、あッ！　ひゃうっ！！」
PRINTFORML 「我の、を吸って何が面白いというのだ…！　は、なれんかぁ……！」	PRINTFORML 「我の、を吸って何が面白いというのだ…！　は、なれんかぁ……！」
PRINTFORML 「うぅ……あまり近寄るな……何をするか自分でも分からんのだ……」	PRINTFORML 「うぅ……あまり近寄るな……何をするか自分でも分からんのだ……」
PRINTFORM 「あやつは怒らせぬ方が良いぞ、雷が落ちる、いや、比喩でなくてな…」	PRINTFORM 「あやつは怒らせぬ方が良いぞ、雷が落ちる、いや、比喩でなくてな…」
PRINTFORML 布都は自らの精神の弱さを恥じて、淫行を思い出しては赤面している…	PRINTFORML 布都は自らの精神の弱さを恥じて、淫行を思い出しては赤面している…
PRINTFORML 「………………ハッ！　ね、寝ておらぬ！　よもや寝ておらぬぞ！！　	PRINTFORML 「………………ハッ！　ね、寝ておらぬ！　よもや寝ておらぬぞ！！　
PRINTFORMW (そう、だ……どうせ逃れえぬ、なら……この…快楽、を…………)	PRINTFORMW (そう、だ……どうせ逃れえぬ、なら……この…快楽、を…………)
PRINTFORM 「や、やめろっ！　こんな所を責めるなどっ！　どうか…し、ておるっ	PRINTFORM 「や、やめろっ！　こんな所を責めるなどっ！　どうか…し、ておるっ
PRINTFORMDL ADS(オールウェイズ・ドヤア・システム)をONにしますか？	PRINTFORMDL ADS(オールウェイズ・ドヤア・システム)をONにしますか？
PRINTFORMDW 敵の攻撃を受けた部分がジンジンと甘い熱を持って疼き始めた…	PRINTFORMDW 敵の攻撃を受けた部分がジンジンと甘い熱を持って疼き始めた…
PRINTFORML 「ううぅ……か、体の自由が効かぬ！　やぁ……と、まれぇ……」	PRINTFORML 「ううぅ……か、体の自由が効かぬ！　やぁ……と、まれぇ……」
PRINTFORM 「ふふん、我の能力を持ってすればあらゆる障害を避ける事が可能だ	PRINTFORM 「ふふん、我の能力を持ってすればあらゆる障害を避ける事が可能だ
PRINTFORM 「これも、尸解仙の修行の一つであるやもしれぬ。手抜きはできぬな	PRINTFORM 「これも、尸解仙の修行の一つであるやもしれぬ。手抜きはできぬな
PRINTFORML 「いやぁ！　嫌なのだっ！　ひうっ！！　へ、はああぁっ！！」	PRINTFORML 「いやぁ！　嫌なのだっ！　ひうっ！！　へ、はああぁっ！！」
PRINTFORM 「……貴様の様な人外がっ…！！　触れて良い場所と思うなッ！！	PRINTFORM 「……貴様の様な人外がっ…！！　触れて良い場所と思うなッ！！
PRINTFORML 「い、いぎいいいいいいぃぃぃっっ！！！！！？？！？！？！」	PRINTFORML 「い、いぎいいいいいいぃぃぃっっ！！！！！？？！？！？！」
PRINTFORML 「ひいぃぃ……う、嘘?!　わ、我がこ、んなあぁぁぁっ！」」	PRINTFORML 「ひいぃぃ……う、嘘?!　わ、我がこ、んなあぁぁぁっ！」」
PRINTFORML 「う、あああぁぁぁっ?!　な、何かキておるううぅぅ！！！」	PRINTFORML 「う、あああぁぁぁっ?!　な、何かキておるううぅぅ！！！」
PRINTFORMDW 布都が放った弾は、へろへろと力ない軌道を描いて飛んだ…	PRINTFORMDW 布都が放った弾は、へろへろと力ない軌道を描いて飛んだ…
PRINTFORM 「へこへこぉ……へこへこが止まらぬぅ……あひゃああぁぁ……	PRINTFORM 「へこへこぉ……へこへこが止まらぬぅ……あひゃああぁぁ……
PRINTFORML 「こ……この程度の辱めぇ…………我に、ふぁあぁっっ！！」	PRINTFORML 「こ……この程度の辱めぇ…………我に、ふぁあぁっっ！！」
PRINTFORML 「いぐぅ！！　ひっ?!　だ、駄目だ駄目だだめだぁっ！！」	PRINTFORML 「いぐぅ！！　ひっ?!　だ、駄目だ駄目だだめだぁっ！！」
PRINTFORML 「た、太子様……そのようにみだりに肌を露出させては……」	PRINTFORML 「た、太子様……そのようにみだりに肌を露出させては……」
PRINTFORML 「そうですな…まずはここを固めてしまうのが上策かと……」	PRINTFORML 「そうですな…まずはここを固めてしまうのが上策かと……」
PRINTFORMDL (ONにすると布都ちゃんの語尾に(ﾄﾞﾔｧが付きます)	PRINTFORMDL (ONにすると布都ちゃんの語尾に(ﾄﾞﾔｧが付きます)
PRINTFORML 「く、そ！　くそおぉぉ！！　うあああぁぁぁぁっっ！！」	PRINTFORML 「く、そ！　くそおぉぉ！！　うあああぁぁぁぁっっ！！」
PRINTFORM 「くっ！　我の意思ではない！　わりぇの、い、しではぁ……	PRINTFORM 「くっ！　我の意思ではない！　わりぇの、い、しではぁ……
PRINTFORMDW 布都を舳先に乗せたまま巨大な船体が相手に突貫した…	PRINTFORMDW 布都を舳先に乗せたまま巨大な船体が相手に突貫した…
PRINTFORML 「くっ…や、めろぉ……！　それ、だ、けはぁっ！！！」	PRINTFORML 「くっ…や、めろぉ……！　それ、だ、けはぁっ！！！」
PRINTFORMDW 布都は頬を赤く上気させ、内腿を擦り合わせている…。	PRINTFORMDW 布都は頬を赤く上気させ、内腿を擦り合わせている…。
PRINTFORM 「ひゃあぁ……ふ、触れるなぁ…っ！　我にふれるなあぁっ	PRINTFORM 「ひゃあぁ……ふ、触れるなぁ…っ！　我にふれるなあぁっ
PRINTFORML 「…………。……全て燃やしてしまえばよいのですか？」	PRINTFORML 「…………。……全て燃やしてしまえばよいのですか？」
PRINTFORM 「何が起こるや分からぬ。常に心を一間先に置いて進め……	PRINTFORM 「何が起こるや分からぬ。常に心を一間先に置いて進め……
PRINTFORM 「わ…われの胸など弄ってもつまらないであろう……っ！	PRINTFORM 「わ…われの胸など弄ってもつまらないであろう……っ！
PRINTFORML 「ふああ、あ、あぁぁぁ……あ、ああぁぁっ！！！！」	PRINTFORML 「ふああ、あ、あぁぁぁ……あ、ああぁぁっ！！！！」
PRINTFORML 「待てぇ！　今は…今はま…ず、んあああぁぁぁ！！」	PRINTFORML 「待てぇ！　今は…今はま…ず、んあああぁぁぁ！！」
PRINTFORML 「うぁ…う、うひゃあああああぁぁぁっっ！！！！」	PRINTFORML 「うぁ…う、うひゃあああああぁぁぁっっ！！！！」
PRINTFORML 「わ、我を、食べる、のか……？　い、やあ……」　	PRINTFORML 「わ、我を、食べる、のか……？　い、やあ……」　
PRINTFORM 「貴様等の不運は……相手が我だった。ただそれだけよ	PRINTFORM 「貴様等の不運は……相手が我だった。ただそれだけよ
PRINTFORML 「うぅ……なぜおぬしはそう堂々とできるのだ……」	PRINTFORML 「うぅ……なぜおぬしはそう堂々とできるのだ……」
PRINTFORMW 「ええ、こちらからは我が、囮は幸い幾らでも……」	PRINTFORMW 「ええ、こちらからは我が、囮は幸い幾らでも……」
PRINTFORM 「敵を知り、己を知れば百戦危うからずということだな	PRINTFORM 「敵を知り、己を知れば百戦危うからずということだな
PRINTFORML 「じゃ、邪魔するなぁっ！！　ひ、ひぎぃっ！！」	PRINTFORML 「じゃ、邪魔するなぁっ！！　ひ、ひぎぃっ！！」
PRINTFORMW 「あ…ありがたくぅ……ふ、ふうううぅっっ！！」	PRINTFORMW 「あ…ありがたくぅ……ふ、ふうううぅっっ！！」
PRINTFORMW 「ひゅぐううぅ！！　ひゃ、ひゃよおおぉっ！！」	PRINTFORMW 「ひゅぐううぅ！！　ひゃ、ひゃよおおぉっ！！」
PRINTFORM 「将を射んとするにはまず馬を……というわけだな？	PRINTFORM 「将を射んとするにはまず馬を……というわけだな？
PRINTFORML 「だ…から、そ、こは、ふぁ、う、ああぁぁ……」	PRINTFORML 「だ…から、そ、こは、ふぁ、う、ああぁぁ……」
PRINTFORML 「まだまだぁ！　……っ！！　ふっ、不覚っ！！」	PRINTFORML 「まだまだぁ！　……っ！！　ふっ、不覚っ！！」
PRINTFORML 「ころ、すうぅぅ……我がぁ…いああぁぁっ！！」	PRINTFORML 「ころ、すうぅぅ……我がぁ…いああぁぁっ！！」
PRINTFORM 「ひきゅうっ！！　ひっ　ひゃああああぁぁぁ！！！	PRINTFORM 「ひきゅうっ！！　ひっ　ひゃああああぁぁぁ！！！
PRINTFORM 「おお青娥殿。ご機嫌は…良いはずがございませんな	PRINTFORM 「おお青娥殿。ご機嫌は…良いはずがございませんな
PRINTFORM 「…我と共に行かなかった事、後悔しても知らぬぞ？	PRINTFORM 「…我と共に行かなかった事、後悔しても知らぬぞ？
PRINTFORM 「なるべく固まらず、離れすぎず探索をすべきだな…	PRINTFORM 「なるべく固まらず、離れすぎず探索をすべきだな…
PRINTFORM 「やはり…な。お主も我の復活を祝ってくれるのだな	PRINTFORM 「やはり…な。お主も我の復活を祝ってくれるのだな
PRINTFORM 「ふ……この程度障りに、も……ならぬ、わぁ！！	PRINTFORM 「ふ……この程度障りに、も……ならぬ、わぁ！！
PRINTFORML ――――立ち行かむ　せなに秋津を　掻き負ひて	PRINTFORML ――――立ち行かむ　せなに秋津を　掻き負ひて
PRINTFORM 「武事有る者はまた文事有り……逆もまた然り、ぞ	PRINTFORM 「武事有る者はまた文事有り……逆もまた然り、ぞ
PRINTFORM 「ぐうぅ……そ、そろそろ離せ！　は、なせぇ！！	PRINTFORM 「ぐうぅ……そ、そろそろ離せ！　は、なせぇ！！
PRINTFORMW (……何も……見えぬ…………。味方も、我も)	PRINTFORMW (……何も……見えぬ…………。味方も、我も)
PRINTFORML 「くっ……我の胸など相手にせんでよいわ……」	PRINTFORML 「くっ……我の胸など相手にせんでよいわ……」
PRINTFORM 「こ、このようなまやかし……我には通じぬわぁ…	PRINTFORM 「こ、このようなまやかし……我には通じぬわぁ…
PRINTFORML 「しかし、この広い迷宮でよく出会えたものだ」	PRINTFORML 「しかし、この広い迷宮でよく出会えたものだ」
PRINTFORML 「……すまん。必ず戻るゆえ、暫し耐えてくれ」	PRINTFORML 「……すまん。必ず戻るゆえ、暫し耐えてくれ」
PRINTFORM 「集中……しゅうちゅう……しゅう、ちゅう……	PRINTFORM 「集中……しゅうちゅう……しゅう、ちゅう……
PRINTFORM 「くっ！　我が貴様の思い通りになると思うな！	PRINTFORM 「くっ！　我が貴様の思い通りになると思うな！
PRINTFORMW 「く、そぉっ！　見るな！　見るなぁっ！！」	PRINTFORMW 「く、そぉっ！　見るな！　見るなぁっ！！」
PRINTFORML 「えぇい、しつこ、っ！　くううぅぅ……！」	PRINTFORML 「えぇい、しつこ、っ！　くううぅぅ……！」
PRINTFORML 「ふ、あ、はあぁ！　い、ひやあぁぁ！！！」	PRINTFORML 「ふ、あ、はあぁ！　い、ひやあぁぁ！！！」
PRINTFORML 「ふふん、ぅ……よ、かった……これでぇ…」	PRINTFORML 「ふふん、ぅ……よ、かった……これでぇ…」
PRINTFORM 「と、ともかく、生きる…！　それが全てだ……	PRINTFORM 「と、ともかく、生きる…！　それが全てだ……
PRINTFORM 「君子、危うきに、ちかぁ…寄らず、だぁ…… 	PRINTFORM 「君子、危うきに、ちかぁ…寄らず、だぁ…… 
PRINTFORML 「この下衆がぁ！　さっさとくたばれぇ……」	PRINTFORML 「この下衆がぁ！　さっさとくたばれぇ……」
PRINTFORM 「わ、我の裸体がそんなにめずらしい……のか？	PRINTFORM 「わ、我の裸体がそんなにめずらしい……のか？
PRINTFORML 「しかしこの世界は奇妙な事が起こるのだな」	PRINTFORML 「しかしこの世界は奇妙な事が起こるのだな」
PRINTFORML 「我が来た経路はこうだから……ここに……」	PRINTFORML 「我が来た経路はこうだから……ここに……」
PRINTFORM 「よし、戦力を分散させ、効率化を図るとしよう	PRINTFORM 「よし、戦力を分散させ、効率化を図るとしよう
PRINTFORM 「ふ、この秘術、一朝一夕で出来るものではない	PRINTFORM 「ふ、この秘術、一朝一夕で出来るものではない
PRINTFORM 「どうしたどうしたぁ！　我はここにおるぞ！！	PRINTFORM 「どうしたどうしたぁ！　我はここにおるぞ！！
PRINTFORM 「ふむ、……我はあの方角をあたってみようか…	PRINTFORM 「ふむ、……我はあの方角をあたってみようか…
PRINTFORM 「我の力が必要か？　いいだろういいだろう！！	PRINTFORM 「我の力が必要か？　いいだろういいだろう！！
PRINTFORM 「我の言う通りに動いておればよかったものを…	PRINTFORM 「我の言う通りに動いておればよかったものを…
PRINTFORMDL 布都は腰をガクガク揺らして達している…	PRINTFORMDL 布都は腰をガクガク揺らして達している…
PRINTFORML 「……ぐっ。されるがままとは情けない……	PRINTFORML 「……ぐっ。されるがままとは情けない……
PRINTFORM 「ひゅうーー……。ひうー……。かっ…たぁ」	PRINTFORM 「ひゅうーー……。ひうー……。かっ…たぁ」
PRINTFORM 「くっ！　満身創痍の身に奇襲！　上等だ！！	PRINTFORM 「くっ！　満身創痍の身に奇襲！　上等だ！！
PRINTFORML 「おーい……駄目だ。完全にトんでおる…」	PRINTFORML 「おーい……駄目だ。完全にトんでおる…」
PRINTFORM 「彼方は進まぬ方が無難だ。気が塞がっておる	PRINTFORM 「彼方は進まぬ方が無難だ。気が塞がっておる
PRINTFORM 「刻舟と言えども、知っておいた方がよい…な	PRINTFORM 「刻舟と言えども、知っておいた方がよい…な
PRINTFORM 「伏兵に必要なものは、運とタイミング…だな	PRINTFORM 「伏兵に必要なものは、運とタイミング…だな
PRINTFORM 「……食らえい！！　『大物忌正餐』！！！	PRINTFORM 「……食らえい！！　『大物忌正餐』！！！
PRINTFORML ――――人の子の　勉むは国の　為なれど	PRINTFORML ――――人の子の　勉むは国の　為なれど
PRINTFORM 「ええぃ、やはり遠距離戦は性に合わん！！	PRINTFORM 「ええぃ、やはり遠距離戦は性に合わん！！
PRINTFORML 「こ、これ以上何かすると承知せんぞ！！	PRINTFORML 「こ、これ以上何かすると承知せんぞ！！
PRINTFORML 「ひやぁぁ！！　止めろ！　や、あっ！」	PRINTFORML 「ひやぁぁ！！　止めろ！　や、あっ！」
PRINTFORML 「や…めよ……これ以上、はあぁぁ……」	PRINTFORML 「や…めよ……これ以上、はあぁぁ……」
PRINTFORML 「ふ、ふん……！　全く効きなどせんわ」	PRINTFORML 「ふ、ふん……！　全く効きなどせんわ」
PRINTFORML 「や、め……うもーっ！　むぐーっ！！」	PRINTFORML 「や、め……うもーっ！　むぐーっ！！」
PRINTFORML 「く…、かわし、きれっ?!　くうっ！」	PRINTFORML 「く…、かわし、きれっ?!　くうっ！」
PRINTFORMDW 布都は息を荒げ、自らを慰め始めた…。	PRINTFORMDW 布都は息を荒げ、自らを慰め始めた…。
PRINTFORM 「何をしておるかっ！！　気味の悪いっ！！	PRINTFORM 「何をしておるかっ！！　気味の悪いっ！！
PRINTFORM 「我の一撃を……さてはおぬしも尸解仙…？	PRINTFORM 「我の一撃を……さてはおぬしも尸解仙…？
PRINTFORM 「貴様の攻撃を食らうなど末代までの恥よ！	PRINTFORM 「貴様の攻撃を食らうなど末代までの恥よ！
PRINTFORML 「ひいぃ！　止めろ、止めてくれぇ！！」	PRINTFORML 「ひいぃ！　止めろ、止めてくれぇ！！」
PRINTFORM 「始めは処女の如く！　後には脱兎の如く！	PRINTFORM 「始めは処女の如く！　後には脱兎の如く！
PRINTFORM 「ひゃ……あ、相手になってやる…わぁ……	PRINTFORM 「ひゃ……あ、相手になってやる…わぁ……
PRINTFORMDW 布都は無防備に腹を出して眠っている…	PRINTFORMDW 布都は無防備に腹を出して眠っている…
PRINTFORML 「此処が案外と根の国であったりしてな」	PRINTFORML 「此処が案外と根の国であったりしてな」
PRINTFORML 「ご…後生だ……この事は誰にもぉ……」	PRINTFORML 「ご…後生だ……この事は誰にもぉ……」
PRINTFORMDW 布都は独特の歩法で気配を殺している…	PRINTFORMDW 布都は独特の歩法で気配を殺している…
PRINTFORM 「さあ行くぞ！　我の力を思い知るが良い！	PRINTFORM 「さあ行くぞ！　我の力を思い知るが良い！
PRINTFORM 「乱心か!?　ええい！　気を確かに持て！	PRINTFORM 「乱心か!?　ええい！　気を確かに持て！
PRINTFORM 「そ、そうか。ならば我の勘違いだ。すまん	PRINTFORM 「そ、そうか。ならば我の勘違いだ。すまん
PRINTFORML 緊張感がねえので嫌な人はOFF推奨。	PRINTFORML 緊張感がねえので嫌な人はOFF推奨。
PRINTFORM 「虎穴に入らずんば……というわけだな？	PRINTFORM 「虎穴に入らずんば……というわけだな？
PRINTFORML 「こ…この逃走は未来への進軍である！	PRINTFORML 「こ…この逃走は未来への進軍である！
PRINTFORM 「三十六計逃げるに如かず、と言うのでな	PRINTFORM 「三十六計逃げるに如かず、と言うのでな
PRINTFORM 「暫し準備にかかる！　前線は頼んだぞ！	PRINTFORM 「暫し準備にかかる！　前線は頼んだぞ！
PRINTFORML ――――天てらす　神の御末の　弥栄を	PRINTFORML ――――天てらす　神の御末の　弥栄を
PRINTFORM 「待たせな！　矢の雨よ！　降り注げぃ！	PRINTFORM 「待たせな！　矢の雨よ！　降り注げぃ！
PRINTFORM 「いやぁっ！！　こ、怖くなどないわ！！	PRINTFORM 「いやぁっ！！　こ、怖くなどないわ！！
PRINTFORML 「物理的な結界でないと機能せぬか……	PRINTFORML 「物理的な結界でないと機能せぬか……
PRINTFORM 「礼を言おう！　往時の感覚が戻ってきた	PRINTFORM 「礼を言おう！　往時の感覚が戻ってきた
PRINTFORMDL 何やら違う事を考えていたようだ…。	PRINTFORMDL 何やら違う事を考えていたようだ…。
PRINTFORM 「その動き、始めから計算のうちよっ！！	PRINTFORM 「その動き、始めから計算のうちよっ！！
PRINTFORML 「うーー！！！　ふむーーーっ！！！」	PRINTFORML 「うーー！！！　ふむーーーっ！！！」
PRINTFORML 「な……なぜ我が…こ、んな…っ！！」	PRINTFORML 「な……なぜ我が…こ、んな…っ！！」
PRINTFORML 「や、やめろぉ……もう許してくれ！」	PRINTFORML 「や、やめろぉ……もう許してくれ！」
PRINTFORML 「ぐぐ……、これではもう着れぬ……」	PRINTFORML 「ぐぐ……、これではもう着れぬ……」
PRINTFORML 「ぐ、う…ひゃ、あ、ああぁぁっ！！」	PRINTFORML 「ぐ、う…ひゃ、あ、ああぁぁっ！！」
PRINTFORM 「二兎を追う者は一兎をも得ず……だな？	PRINTFORM 「二兎を追う者は一兎をも得ず……だな？
PRINTFORM 「太子様、ご無事で何よりでございます！	PRINTFORM 「太子様、ご無事で何よりでございます！
PRINTFORML 「み、見るな……顔が灼けそうだ……」	PRINTFORML 「み、見るな……顔が灼けそうだ……」
PRINTFORM 「はかどっているか？　それは何よりだな	PRINTFORM 「はかどっているか？　それは何よりだな
PRINTFORML 「しかし、おぬしは亡霊で良かったな」	PRINTFORML 「しかし、おぬしは亡霊で良かったな」
PRINTFORM 「我に助力するとは……さてはおぬしも…	PRINTFORM 「我に助力するとは……さてはおぬしも…
PRINTFORMW 「ふむ…この突起を押せばよいのか？」	PRINTFORMW 「ふむ…この突起を押せばよいのか？」
PRINTFORMW 「おお！　炎だ！　炎が出おった！！」	PRINTFORMW 「おお！　炎だ！　炎が出おった！！」
PRINTFORMDL 布都は笑顔で火炎放射器をしまった…	PRINTFORMDL 布都は笑顔で火炎放射器をしまった…
PRINTFORML 「あくまで…素早く、されど静かに…」	PRINTFORML 「あくまで…素早く、されど静かに…」
PRINTFORM 「天、人、地の内の地を蔑ろには出来ぬな	PRINTFORM 「天、人、地の内の地を蔑ろには出来ぬな
PRINTFORML ちょろい！　ちょろいよ布都ちゃん！	PRINTFORML ちょろい！　ちょろいよ布都ちゃん！
PRINTFORML ドヤ顔の素敵な尸解仙は好きですか？	PRINTFORML ドヤ顔の素敵な尸解仙は好きですか？
PRINTFORM 「ぐむむ、い…今は耐えるべきであるな	PRINTFORM 「ぐむむ、い…今は耐えるべきであるな
PRINTFORM 「我らを邪魔する者は、芥も残さぬ！！	PRINTFORM 「我らを邪魔する者は、芥も残さぬ！！
PRINTFORM 「物部の砲煙弾雨！　其の身に受けよ！	PRINTFORM 「物部の砲煙弾雨！　其の身に受けよ！
PRINTFORM 「お主を倒せば我も晴れて仙人…だな？	PRINTFORM 「お主を倒せば我も晴れて仙人…だな？
PRINTFORM 「この方角…此方が貴様の天中殺よ！！	PRINTFORM 「この方角…此方が貴様の天中殺よ！！
PRINTFORM 「乾坤一擲……この一撃にて決する……	PRINTFORM 「乾坤一擲……この一撃にて決する……
PRINTFORML ――――夕空の　輝く星も　曇りなし	PRINTFORML ――――夕空の　輝く星も　曇りなし
PRINTFORM 「こ、この熱を……弾、にぃ……ゃあ…	PRINTFORM 「こ、この熱を……弾、にぃ……ゃあ…
PRINTFORM (ぬ…けねば…ならぬ……の、にぃ……	PRINTFORM (ぬ…けねば…ならぬ……の、にぃ……
PRINTFORML 「ひ、きゃあっ！！　ううぁっ！！」	PRINTFORML 「ひ、きゃあっ！！　ううぁっ！！」
PRINTFORM 「この拘束を解いた時が貴様の最期だ！	PRINTFORM 「この拘束を解いた時が貴様の最期だ！
PRINTFORM 「だ、からっ…！　は、な、せっ！！」	PRINTFORM 「だ、からっ…！　は、な、せっ！！」
PRINTFORML 「く、……よ、せっ！……う、あ…」	PRINTFORML 「く、……よ、せっ！……う、あ…」
PRINTFORML 「イっておる、ぅ！！　からぁ！！」	PRINTFORML 「イっておる、ぅ！！　からぁ！！」
PRINTFORML 「お、おいっ!?　そこは違うぞ！」	PRINTFORML 「お、おいっ!?　そこは違うぞ！」
PRINTFORMDL 触手は布都の一瞬の隙をついた！ 	PRINTFORMDL 触手は布都の一瞬の隙をついた！ 
PRINTFORM 「ふん！　なんだこの……粉…………は	PRINTFORM 「ふん！　なんだこの……粉…………は
PRINTFORM 「えぇい、避けるでない！　当たれぇ！	PRINTFORM 「えぇい、避けるでない！　当たれぇ！
PRINTFORM 「我を生け捕りとは…嘗められたものよ	PRINTFORM 「我を生け捕りとは…嘗められたものよ
PRINTFORML 「ぐぅ……このような、辱めぇ……」	PRINTFORML 「ぐぅ……このような、辱めぇ……」
PRINTFORM 「勝算が立つまで、一度離れるべきだな	PRINTFORM 「勝算が立つまで、一度離れるべきだな
PRINTFORM 「我も独自に色々と調べていたところだ	PRINTFORM 「我も独自に色々と調べていたところだ
PRINTFORM 「屠自古も巻き込まれたかもしれぬな」	PRINTFORM 「屠自古も巻き込まれたかもしれぬな」
PRINTFORM 「よし、少しは落ち着くことが出来るな	PRINTFORM 「よし、少しは落ち着くことが出来るな
PRINTFORM 「物部に伝わる十種の神宝のひとつ！	PRINTFORM 「物部に伝わる十種の神宝のひとつ！
PRINTFORM 「ううぅ……この状態で…出ろ、と？	PRINTFORM 「ううぅ……この状態で…出ろ、と？
PRINTFORM 「ゆくぞ！　これが物部の戦術だ！！	PRINTFORM 「ゆくぞ！　これが物部の戦術だ！！
PRINTFORM 「このような所で……終わらぬわぁ！	PRINTFORM 「このような所で……終わらぬわぁ！
PRINTFORM 「天へ！！　昇れええぇぇぇ！！！！	PRINTFORM 「天へ！！　昇れええぇぇぇ！！！！
PRINTFORML ――――古の　戦を偲び　我をもと	PRINTFORML ――――古の　戦を偲び　我をもと
PRINTFORMDW 布都は内股気味で攻撃を行った…	PRINTFORMDW 布都は内股気味で攻撃を行った…
PRINTFORM 「ま…まだ我の動くときではない……	PRINTFORM 「ま…まだ我の動くときではない……
PRINTFORML 「ぐはぅっ……や、やめ…………」	PRINTFORML 「ぐはぅっ……や、やめ…………」
PRINTFORML 「待て……！　この方角はっ……」	PRINTFORML 「待て……！　この方角はっ……」
PRINTFORML 「く、そぉ……これ以上何を……」	PRINTFORML 「く、そぉ……これ以上何を……」
PRINTFORML 「に…にげられた……のか……？」	PRINTFORML 「に…にげられた……のか……？」
PRINTFORML 「青娥、ど、の……。いえ、何も」	PRINTFORML 「青娥、ど、の……。いえ、何も」
PRINTFORM 「ふむ、我の為にしっかり働くのだ！	PRINTFORM 「ふむ、我の為にしっかり働くのだ！
PRINTFORM 「その方角、あまり進まぬ方が良いぞ	PRINTFORM 「その方角、あまり進まぬ方が良いぞ
PRINTFORM 「では、我は露払いに勤しみますぞ！	PRINTFORM 「では、我は露払いに勤しみますぞ！
PRINTFORM 「敵が動く？　それは我の管轄外だな	PRINTFORM 「敵が動く？　それは我の管轄外だな
PRINTFORM 「我らは隠された、という事……だな	PRINTFORM 「我らは隠された、という事……だな
PRINTFORM 「この地を知るのも悪手ではあるまい	PRINTFORM 「この地を知るのも悪手ではあるまい
PRINTFORM 「ええい！　効かぬ！　効かぬぞ！	PRINTFORM 「ええい！　効かぬ！　効かぬぞ！
PRINTFORMD 布都は何やらドギマギしている…	PRINTFORMD 布都は何やらドギマギしている…
PRINTFORM 「く、ぅ……せ、ぇ一杯！　撃つ！	PRINTFORM 「く、ぅ……せ、ぇ一杯！　撃つ！
PRINTFORM 「強者は一にて二も五をも得るのだ	PRINTFORM 「強者は一にて二も五をも得るのだ
PRINTFORM 「うぅ…踏み込みもままならぬ……	PRINTFORM 「うぅ…踏み込みもままならぬ……
PRINTFORM (もう…この……快感しか、ぁ……	PRINTFORM (もう…この……快感しか、ぁ……
PRINTFORM 「こ…こんなもの！　嬲るでないわ	PRINTFORM 「こ…こんなもの！　嬲るでないわ
PRINTFORM 「す……少しはやるようだな……っ	PRINTFORM 「す……少しはやるようだな……っ
PRINTFORML 「それはっ！　は、離れろっ！」	PRINTFORML 「それはっ！　は、離れろっ！」
PRINTFORM 「太子様、我に気遣いは無用です！	PRINTFORM 「太子様、我に気遣いは無用です！
PRINTFORM 「よし、……追っては来ぬようだな	PRINTFORM 「よし、……追っては来ぬようだな
PRINTFORML 「やぁ……。……う……………」	PRINTFORML 「やぁ……。……う……………」
PRINTFORMW 「くぉーー……くーー…………」	PRINTFORMW 「くぉーー……くーー…………」
PRINTFORM 「無謀の輩に我の相手は勤まらぬわ	PRINTFORM 「無謀の輩に我の相手は勤まらぬわ
PRINTFORML 「……！！！　…ひ…ぃ………」	PRINTFORML 「……！！！　…ひ…ぃ………」
PRINTFORM 「貴重な物資を易々と渡すとでも？	PRINTFORM 「貴重な物資を易々と渡すとでも？
PRINTFORM 「油断したな！　食らうがよいわ！	PRINTFORM 「油断したな！　食らうがよいわ！
PRINTFORM 「ふ、まともには食らわんぞぉ！	PRINTFORM 「ふ、まともには食らわんぞぉ！
PRINTFORM 「はっはっは！　我が相手だ！！	PRINTFORM 「はっはっは！　我が相手だ！！
PRINTFORM 「い……一旦下がらせてもらう…	PRINTFORM 「い……一旦下がらせてもらう…
PRINTFORM 「我が退くことになろうとは……	PRINTFORM 「我が退くことになろうとは……
PRINTFORM 「ぞ、造作もない、こ、とよッ！	PRINTFORM 「ぞ、造作もない、こ、とよッ！
PRINTFORM 「豪族の力を思い知るがよいわ！	PRINTFORM 「豪族の力を思い知るがよいわ！
PRINTFORML 「我にも一族の矜持がある！！	PRINTFORML 「我にも一族の矜持がある！！
PRINTFORM 「我のやり方でやらせてもらうぞ	PRINTFORM 「我のやり方でやらせてもらうぞ
PRINTFORM 「耐えられぬ……ほどでもっ…！	PRINTFORM 「耐えられぬ……ほどでもっ…！
PRINTFORM 「出でよ！！　天の磐船ぇ！！！	PRINTFORM 「出でよ！！　天の磐船ぇ！！！
PRINTFORM 「寄るな！　我に寄るなあっ！！	PRINTFORM 「寄るな！　我に寄るなあっ！！
PRINTFORM 「麁鹿火殿の御霊よ、我に力を！	PRINTFORM 「麁鹿火殿の御霊よ、我に力を！
PRINTFORM 「あえて言おう！　これが戦だ！	PRINTFORM 「あえて言おう！　これが戦だ！
PRINTFORML (出せっ！　出さぬかぁ！！)	PRINTFORML (出せっ！　出さぬかぁ！！)
PRINTFORM は……はやくぅ……抜けねば…」	PRINTFORM は……はやくぅ……抜けねば…」
PRINTFORML 「ひ、やあああぁぁっっ！！」	PRINTFORML 「ひ、やあああぁぁっっ！！」
PRINTFORM 「どうした！　掠っただけだぞ！	PRINTFORM 「どうした！　掠っただけだぞ！
PRINTFORML 「キリがないわ……くっ?!」	PRINTFORML 「キリがないわ……くっ?!」
PRINTFORM 「くぅ……窮地にあって負けぬ！	PRINTFORM 「くぅ……窮地にあって負けぬ！
PRINTFORML 「や、今は……無理、だ……」	PRINTFORML 「や、今は……無理、だ……」
PRINTFORML 「くぅ…我の、服が……っ！」	PRINTFORML 「くぅ…我の、服が……っ！」
PRINTFORM 「一度、建て直そうではないか…	PRINTFORM 「一度、建て直そうではないか…
PRINTFORML 「や、だっ！　……離せぃ！」	PRINTFORML 「や、だっ！　……離せぃ！」
PRINTFORM 「貴様等に戦の作法など無用だな	PRINTFORM 「貴様等に戦の作法など無用だな
PRINTFORM 「ふむ、そちらの首尾はどうだ？	PRINTFORM 「ふむ、そちらの首尾はどうだ？
PRINTFORM 「今は屠自古が羨ましく思えるぞ	PRINTFORM 「今は屠自古が羨ましく思えるぞ
PRINTFORM 「今回が初めて？　そうなのか…	PRINTFORM 「今回が初めて？　そうなのか…
PRINTFORM 「ふふん、いつでも来るがよいわ	PRINTFORM 「ふふん、いつでも来るがよいわ
PRINTFORM 「油断したな！　食らうのじゃ！	PRINTFORM 「油断したな！　食らうのじゃ！
PRINTFORMDW ADSをOFFにしました！	PRINTFORMDW ADSをOFFにしました！
PRINTFORM 「これぞ物部の八門遁甲陣……	PRINTFORM 「これぞ物部の八門遁甲陣……
PRINTFORM 「これぞ物部の根源一気陣……	PRINTFORM 「これぞ物部の根源一気陣……
PRINTFORM 「い…今は危険である、な……	PRINTFORM 「い…今は危険である、な……
PRINTFORM 「お前など止まって見えるわ！	PRINTFORM 「お前など止まって見えるわ！
PRINTFORM 「攻める！　我に続くのだ！！	PRINTFORM 「攻める！　我に続くのだ！！
PRINTFORM 「ぐ……卑、怯なあぁぁっ！！	PRINTFORM 「ぐ……卑、怯なあぁぁっ！！
PRINTFORM 「く、ふうぅぅ……でき、た…	PRINTFORM 「く、ふうぅぅ……でき、た…
PRINTFORM 「これが！　弾の扱い方だっ！	PRINTFORM 「これが！　弾の扱い方だっ！
PRINTFORM 「ここで大敗するわけには……	PRINTFORM 「ここで大敗するわけには……
PRINTFORM 「武芸は我の得意とする所……	PRINTFORM 「武芸は我の得意とする所……
PRINTFORML 「ふ、あ………ああ………」	PRINTFORML 「ふ、あ………ああ………」
PRINTFORML 「く、うぅ……ち、力が…」	PRINTFORML 「く、うぅ……ち、力が…」
PRINTFORMW 　・　・　・　・　・　・　	PRINTFORMW 　・　・　・　・　・　・　
PRINTFORM 腰がぁ……かって、にぃ……！	PRINTFORM 腰がぁ……かって、にぃ……！
PRINTFORM 「き、効かぬ！　効かぬわぁ！	PRINTFORM 「き、効かぬ！　効かぬわぁ！
PRINTFORML 「くっ……まさか服を…？」	PRINTFORML 「くっ……まさか服を…？」
PRINTFORML 「ひ…い、いや、無駄だ！」	PRINTFORML 「ひ…い、いや、無駄だ！」
PRINTFORM 「小手先だけで我が倒せるか！	PRINTFORM 「小手先だけで我が倒せるか！
PRINTFORM 「狙いは良い。が、当たらぬわ	PRINTFORM 「狙いは良い。が、当たらぬわ
PRINTFORML 「何をする気だ……っ?!」	PRINTFORML 「何をする気だ……っ?!」
PRINTFORM 「勝って甲の緒を締めよ……だ	PRINTFORM 「勝って甲の緒を締めよ……だ
PRINTFORM 「強靱、無敵、最強……だな？	PRINTFORM 「強靱、無敵、最強……だな？
PRINTFORML 「眠いと、士気が下がるぞ」	PRINTFORML 「眠いと、士気が下がるぞ」
PRINTFORM 「我の施しであるぞ。感謝せよ	PRINTFORM 「我の施しであるぞ。感謝せよ
PRINTFORMDW ADSをONにしました！	PRINTFORMDW ADSをONにしました！
﻿PRINTFORML 触手宮　物部の口上です。	PRINTFORML 触手宮　物部の口上です。
PRINTFORM 「この後退は後への布石よ！	PRINTFORM 「この後退は後への布石よ！
PRINTFORM 「八十平瓮の閃きを見よ！！	PRINTFORM 「八十平瓮の閃きを見よ！！
PRINTFORM 「貴様に負ける道理がないわ	PRINTFORM 「貴様に負ける道理がないわ
PRINTFORM 「敵を一気に殲滅するぞ！！	PRINTFORM 「敵を一気に殲滅するぞ！！
PRINTFORML 「あ…あ、あぁ…………」	PRINTFORML 「あ…あ、あぁ…………」
PRINTFORM 「お…抑え、られ、ぬっ……	PRINTFORM 「お…抑え、られ、ぬっ……
PRINTFORML (……い、今だなっ！！)	PRINTFORML (……い、今だなっ！！)
PRINTFORM 「さ……されるがままぁ……	PRINTFORM 「さ……されるがままぁ……
PRINTFORM 「こ、の…痴れ者がぁ……っ	PRINTFORM 「こ、の…痴れ者がぁ……っ
PRINTFORMDW (ひゃあああぁぁ！！　	PRINTFORMDW (ひゃあああぁぁ！！　
PRINTFORM 「わ…我のぉ、自慰がぁ……	PRINTFORM 「わ…我のぉ、自慰がぁ……
PRINTFORML 「ひ、や……う、そ……」	PRINTFORML 「ひ、や……う、そ……」
PRINTFORM 「ふん、止まって見えおる！	PRINTFORM 「ふん、止まって見えおる！
PRINTFORML 布都は不敵に笑っている…	PRINTFORML 布都は不敵に笑っている…
PRINTFORM 「……か、勝てば官軍…だな	PRINTFORM 「……か、勝てば官軍…だな
PRINTFORM 「勝てば良かろうなのだぁ！	PRINTFORM 「勝てば良かろうなのだぁ！
PRINTFORM 「無事でまた会えれば良いな	PRINTFORM 「無事でまた会えれば良いな
PRINTFORM 「貴公の話を聞かせてくれい	PRINTFORM 「貴公の話を聞かせてくれい
PRINTFORMDL 布都は目を擦っている…	PRINTFORMDL 布都は目を擦っている…
PRINTFORML 「…………む、こっちだ」	PRINTFORML 「…………む、こっちだ」
PRINTFORM 「させぬと言うておる……	PRINTFORM 「させぬと言うておる……
PRINTFORM 「我への攻撃も計算の内よ	PRINTFORM 「我への攻撃も計算の内よ
PRINTFORM 「この距離なら外すまい！	PRINTFORM 「この距離なら外すまい！
PRINTFORM 「この方角はまずいのでな	PRINTFORM 「この方角はまずいのでな
PRINTFORM 「我の弾幕は必殺よぉ！！	PRINTFORM 「我の弾幕は必殺よぉ！！
PRINTFORM 「この窮地に外さぬ…！！	PRINTFORM 「この窮地に外さぬ…！！
PRINTFORM 「これならかわせまいっ！	PRINTFORM 「これならかわせまいっ！
PRINTFORML 「…………むーっ！！」	PRINTFORML 「…………むーっ！！」
PRINTFORM 「…だ、め…………も……	PRINTFORM 「…だ、め…………も……
PRINTFORM 「後生だ……ここはぁ…っ	PRINTFORM 「後生だ……ここはぁ…っ
PRINTFORM 「す、好きにはさせぬっ！	PRINTFORM 「す、好きにはさせぬっ！
PRINTFORM 「我に当たっておらぬわ！	PRINTFORM 「我に当たっておらぬわ！
PRINTFORML 「当てねば……ならぬ」	PRINTFORML 「当てねば……ならぬ」
PRINTFORM 「一撃たりとも食らえぬな	PRINTFORM 「一撃たりとも食らえぬな
PRINTFORM 「ふむ、有難く頂戴しよう	PRINTFORM 「ふむ、有難く頂戴しよう
PRINTFORM 「全ては我が掌の上よ……	PRINTFORM 「全ては我が掌の上よ……
PRINTFORM 「我々で、必ず脱出するぞ	PRINTFORM 「我々で、必ず脱出するぞ
PRINTFORM 「我の力がご入用ですか？	PRINTFORM 「我の力がご入用ですか？
PRINTFORML 「ううぅぅぅ…………」	PRINTFORML 「ううぅぅぅ…………」
PRINTFORM 「中央突破こそ我が信条！	PRINTFORM 「中央突破こそ我が信条！
PRINTFORM 「伏せては死者の如く……	PRINTFORM 「伏せては死者の如く……
PRINTFORM 「そのような余裕はないな	PRINTFORM 「そのような余裕はないな
PRINTFORM 「我が出るまでもなかろう	PRINTFORM 「我が出るまでもなかろう
PRINTFORM 「去る者は追わず……だな	PRINTFORM 「去る者は追わず……だな
PRINTFORM 「とくと馳走してやろう	PRINTFORM 「とくと馳走してやろう
PRINTFORM 「そこ、だぁ……っ！！	PRINTFORM 「そこ、だぁ……っ！！
PRINTFORM 「悪く思うでないぞぉ！	PRINTFORM 「悪く思うでないぞぉ！
PRINTFORM 「こ、のままではぁ……	PRINTFORM 「こ、のままではぁ……
PRINTFORM 「…………う、はぁ……	PRINTFORM 「…………う、はぁ……
PRINTFORM 見られる、の、だぁ……	PRINTFORM 見られる、の、だぁ……
PRINTFORM 「ふんっ！　大事ないわ	PRINTFORM 「ふんっ！　大事ないわ
PRINTFORML ……くー…くー……」	PRINTFORML ……くー…くー……」
PRINTFORM 「ほう……よく避けたな	PRINTFORM 「ほう……よく避けたな
PRINTFORM 「ふふ……。どうした？	PRINTFORM 「ふふ……。どうした？
PRINTFORM 「ふ、撤退も策の内よ！	PRINTFORM 「ふ、撤退も策の内よ！
PRINTFORM 「貴様等では役不足よ！	PRINTFORM 「貴様等では役不足よ！
PRINTFORM 「先手はくれてやるわ！	PRINTFORM 「先手はくれてやるわ！
PRINTFORM 「我らは後の先を取る！	PRINTFORM 「我らは後の先を取る！
PRINTFORM 「手数で勝敗は決せぬわ	PRINTFORM 「手数で勝敗は決せぬわ
PRINTFORM 「僥倖、と言うべきだな	PRINTFORM 「僥倖、と言うべきだな
PRINTFORMW 「……………ぐぅ…」	PRINTFORMW 「……………ぐぅ…」
PRINTFORM 「よし、少し斥候を行う	PRINTFORM 「よし、少し斥候を行う
PRINTFORM 「用心して進まねばな…	PRINTFORM 「用心して進まねばな…
PRINTFORM 「ふむ、これで良いか？	PRINTFORM 「ふむ、これで良いか？
PRINTFORM 「話にもならぬわぁ！	PRINTFORM 「話にもならぬわぁ！
PRINTFORM 「汚物は消毒……だな	PRINTFORM 「汚物は消毒……だな
PRINTFORM 「ふうぅ、あぁっ!!	PRINTFORM 「ふうぅ、あぁっ!!
PRINTFORM 「か……貫通…か……	PRINTFORM 「か……貫通…か……
PRINTFORM 「下がれ三下共ぉ！！	PRINTFORM 「下がれ三下共ぉ！！
PRINTFORM 「暴虐、かつ繊細に！	PRINTFORM 「暴虐、かつ繊細に！
PRINTFORML 「ふああぁっ?!」	PRINTFORML 「ふああぁっ?!」
PRINTFORM 「当たってやれぬな！	PRINTFORM 「当たってやれぬな！
PRINTFORM 「くっ……間一髪だな	PRINTFORM 「くっ……間一髪だな
PRINTFORM 「まだ我一人で十分だ	PRINTFORM 「まだ我一人で十分だ
PRINTFORM 「我におまかせを！	PRINTFORM 「我におまかせを！
PRINTFORML 「ここから、だな	PRINTFORML 「ここから、だな
PRINTFORM 「我の妙技を見よ！	PRINTFORM 「我の妙技を見よ！
PRINTFORM く、いかんいかん…	PRINTFORM く、いかんいかん…
PRINTFORML ……あはぁ……」	PRINTFORML ……あはぁ……」
PRINTFORM 「え、へへへぇ……	PRINTFORM 「え、へへへぇ……
PRINTFORML 「……ひいっ！」	PRINTFORML 「……ひいっ！」
PRINTFORM 「この色情魔が……	PRINTFORM 「この色情魔が……
PRINTFORML 「な、何だ?!」	PRINTFORML 「な、何だ?!」
PRINTFORM 「すまぬな、屠自古	PRINTFORM 「すまぬな、屠自古
PRINTFORML 「ぐー…………」	PRINTFORML 「ぐー…………」
PRINTFORM 「では、武運を祈る	PRINTFORM 「では、武運を祈る
PRINTFORM 「これは……捗るな	PRINTFORM 「これは……捗るな
PRINTFORMDL [1] いいえ	PRINTFORMDL [1] いいえ
PRINTFORM 「猪口才わぁ！！	PRINTFORM 「猪口才わぁ！！
PRINTFORM 「食らえぇい！！	PRINTFORM 「食らえぇい！！
PRINTFORM 「間断なく射る！	PRINTFORM 「間断なく射る！
PRINTFORM 「な、ぜだぁ……	PRINTFORM 「な、ぜだぁ……
PRINTFORM 「そ…その程度か	PRINTFORM 「そ…その程度か
PRINTFORML 「そ……んな」	PRINTFORML 「そ……んな」
PRINTFORM 「これ、でぇ……	PRINTFORM 「これ、でぇ……
PRINTFORM 「……捨て置けぬ	PRINTFORM 「……捨て置けぬ
PRINTFORM 「うむ、頼んだぞ	PRINTFORM 「うむ、頼んだぞ
PRINTFORM 　我に続けぇ！！	PRINTFORM 　我に続けぇ！！
PRINTFORMDL [0] はい	PRINTFORMDL [0] はい
PRINTFORM 「まだまだぁ！	PRINTFORM 「まだまだぁ！
PRINTFORM 「瞬きも許さぬ	PRINTFORM 「瞬きも許さぬ
PRINTFORM 「我自ら撃つ！	PRINTFORM 「我自ら撃つ！
PRINTFORM 「それだけか？	PRINTFORM 「それだけか？
PRINTFORM 「煩いだけよ！	PRINTFORM 「煩いだけよ！
PRINTFORM 「無駄だぁ！！	PRINTFORM 「無駄だぁ！！
PRINTFORM 「一気に叩く！	PRINTFORM 「一気に叩く！
PRINTFORMW 「かくーー」	PRINTFORMW 「かくーー」
PRINTFORM 「宜しく頼むぞ	PRINTFORM 「宜しく頼むぞ
PRINTFORML 「むー……」	PRINTFORML 「むー……」
PRINTFORMW (ﾄﾞﾔｧ」	PRINTFORMW (ﾄﾞﾔｧ」
PRINTFORML (ﾄﾞﾔｧ」	PRINTFORML (ﾄﾞﾔｧ」
PRINTFORM 「我が出る！	PRINTFORM 「我が出る！
PRINTFORML 「う……」	PRINTFORML 「う……」
PRINTFORM 「弱いわぁ！	PRINTFORM 「弱いわぁ！
PRINTFORM 「鎮まれぇ！	PRINTFORM 「鎮まれぇ！
PRINTFORM 「甘いっ！	PRINTFORM 「甘いっ！
PRINTFORM 「無駄だ！	PRINTFORM 「無駄だ！
PRINTFORM 「穿つ…！	PRINTFORM 「穿つ…！
PRINTFORM 「鈍いわ！	PRINTFORM 「鈍いわ！
PRINTFORM 「用心せよ	PRINTFORM 「用心せよ
PRINTFORM 「行くぞ！	PRINTFORM 「行くぞ！
PRINTFORM 「次ぃ！	PRINTFORM 「次ぃ！
PRINTFORML 」 	PRINTFORML 」 
PRINTFORML )	PRINTFORML )
PRINTFORMW )	PRINTFORMW )
PRINTFORMW 」	PRINTFORMW 」
PRINTFORML 」	PRINTFORML 」
PRINTFORMDL 	PRINTFORMDL 
PRINTFORML 	PRINTFORML 
