//口上:

PRINTFORMW 「うぅ、水中に綺麗な石を見つけて取ろうとしたのまでは覚えてるんですが…」	PRINTFORMW 「うぅ、水中に綺麗な石を見つけて取ろうとしたのまでは覚えてるんですが…」	
PRINTFORML といってもまだ台詞はほとんど無いけどね	PRINTFORML といってもまだ台詞はほとんど無いけどね	
PRINTFORMW 「と、とりあえず出口を探しましょう…」	PRINTFORMW 「と、とりあえず出口を探しましょう…」
DATAFORM 「周りを綺麗にすれば戦い易いですよね？」	DATAFORM 「周りを綺麗にすれば戦い易いですよね？」	
DATAFORM 「そ、そんなところ触らないでください！」	DATAFORM 「そ、そんなところ触らないでください！」	
DATAFORM 「これで倒れてくれればいいんですが…」	DATAFORM 「これで倒れてくれればいいんですが…」	
PRINTFORML 「うぅ、通してくれなさそうです…」	PRINTFORML 「うぅ、通してくれなさそうです…」	
PRINTFORML 「あ、あなたがここの主ですね！」	PRINTFORML 「あ、あなたがここの主ですね！」	
DATAFORM 「出来れば来てほしくないんですが…」	DATAFORM 「出来れば来てほしくないんですが…」	
DATAFORM 「控えめでも当たると痛いですよ！」	DATAFORM 「控えめでも当たると痛いですよ！」	
DATAFORM 「わわ！？どこ触ってるんですか！」	DATAFORM 「わわ！？どこ触ってるんですか！」	
DATAFORM 「ひゃう！？やめて！入れないで！」	DATAFORM 「ひゃう！？やめて！入れないで！」	
DATAFORM 「こ、ここは激流に身をまかせて！」	DATAFORM 「こ、ここは激流に身をまかせて！」	
DATAFORM 「こうすればきっと避けれなく…」	DATAFORM 「こうすればきっと避けれなく…」	
PRINTFORMW 「ここはどこなんでしょう…」	PRINTFORMW 「ここはどこなんでしょう…」	
DATAFORM （節約した方がいいですよね…）	DATAFORM （節約した方がいいですよね…）	
DATAFORM 「…ということがありまして…」	DATAFORM 「…ということがありまして…」	
DATAFORM 「出来れば来ないで下さい…」	DATAFORM 「出来れば来ないで下さい…」	
DATAFORM 「む、胸はやめてください！」	DATAFORM 「む、胸はやめてください！」	
DATAFORM 「いやっ、摘まま…ないで…」	DATAFORM 「いやっ、摘まま…ないで…」	
DATAFORM 「うぅ…触らないで下さい…」	DATAFORM 「うぅ…触らないで下さい…」	
DATAFORM 「あわわ、向かって来ます…」	DATAFORM 「あわわ、向かって来ます…」	
DATAFORM 「なんとか振り切りました…」	DATAFORM 「なんとか振り切りました…」	
PRINTFORML 触手の天ぷら大好きです	PRINTFORML 触手の天ぷら大好きです	
DATAFORM 「と、とりあえずこれで…」	DATAFORM 「と、とりあえずこれで…」	
DATAFORM 「痛ッ、やめてください！」	DATAFORM 「痛ッ、やめてください！」	
DATAFORM 「み、見逃してください」	DATAFORM 「み、見逃してください」	
DATAFORM (早く抜け出さないと…)	DATAFORM (早く抜け出さないと…)	
DATAFORM 「どうにか出れました…」	DATAFORM 「どうにか出れました…」	
DATAFORM 「体中がべとべとです…」	DATAFORM 「体中がべとべとです…」	
DATAFORM 「痛い！…や、やめて！」	DATAFORM 「痛い！…や、やめて！」	
DATAFORM 「痛い！痛いですから！」	DATAFORM 「痛い！痛いですから！」	
DATAFORM 「痛ッ、もう、やめて！」	DATAFORM 「痛ッ、もう、やめて！」	
DATAFORM 「…な、何するんですか」	DATAFORM 「…な、何するんですか」	
DATAFORM 「いや…撫でないでぇ…」	DATAFORM 「いや…撫でないでぇ…」	
DATAFORM 「慎重に行きましょう…」	DATAFORM 「慎重に行きましょう…」	
﻿PRINTFORML わかさぎ姫口上です	PRINTFORML わかさぎ姫口上です	
DATAFORM 「まとめて倒します！」	DATAFORM 「まとめて倒します！」	
DATAFORM 「や、やけくそです！」	DATAFORM 「や、やけくそです！」	
DATAFORM 「やっと解けました…」	DATAFORM 「やっと解けました…」	
DATAFORM （力を溜めて一気に…）	DATAFORM （力を溜めて一気に…）	
DATAFORM （もう…むりですぅ…）	DATAFORM （もう…むりですぅ…）	
DATAFORM （か、体がかってに…）	DATAFORM （か、体がかってに…）	
DATAFORM 「き、汚いですから！」	DATAFORM 「き、汚いですから！」	
DATAFORM 「は、放して下さい！」	DATAFORM 「は、放して下さい！」	
DATAFORM 「何とか免れました…」	DATAFORM 「何とか免れました…」	
PRINTFORML 「ひっ！やめて！」	PRINTFORML 「ひっ！やめて！」	
DATAFORM 「今は耐えなきゃ…」	DATAFORM 「今は耐えなきゃ…」	
DATAFORM 「よ、避けないで！」	DATAFORM 「よ、避けないで！」	
DATAFORM 「あ、足を狙えば…」	DATAFORM 「あ、足を狙えば…」	
DATAFORM (こ、こうすれば…)	DATAFORM (こ、こうすれば…)	
DATAFORM 「苦しかったです…」	DATAFORM 「苦しかったです…」	
DATAFORM （わ、私…何して…）	DATAFORM （わ、私…何して…）	
DATAFORM 「酷いことしないで」	DATAFORM 「酷いことしないで」	
DATAFORM 「も、揉まないで！」	DATAFORM 「も、揉まないで！」	
DATAFORM 「そこッ…ダメッ…」	DATAFORM 「そこッ…ダメッ…」	
DATAFORM 「や、やめ…ひぅ！」	DATAFORM 「や、やめ…ひぅ！」	
DATAFORM 「触…らないで…！」	DATAFORM 「触…らないで…！」	
PRINTFORML 「うぅ、痛い…」	PRINTFORML 「うぅ、痛い…」	
DATAFORM 「ここは守りで…」	DATAFORM 「ここは守りで…」	
DATAFORM 「こ、来ないで！」	DATAFORM 「こ、来ないで！」	
DATAFORM 「ま、また後で…」	DATAFORM 「ま、また後で…」	
DATAFORM 「逃げましょう」	DATAFORM 「逃げましょう」	
DATAFORM 「うぅ、やめ…」	DATAFORM 「うぅ、やめ…」	
DATAFORM 「新手ですね…」	DATAFORM 「新手ですね…」	
DATAFORM 「当たって！」	DATAFORM 「当たって！」	
DATAFORM 「そこです！」	DATAFORM 「そこです！」	
DATAFORM 「貫いて！」	DATAFORM 「貫いて！」	
DATAFORM （くぅっ…）	DATAFORM （くぅっ…）	
DATAFORM 「痛い！…」	DATAFORM 「痛い！…」	
DATAFORM 「うぐッ…」	DATAFORM 「うぐッ…」	
DATAFORM 「放して！」	DATAFORM 「放して！」	
DATAFORM 「わわっ！」	DATAFORM 「わわっ！」	
DATAFORM 「えい！」	DATAFORM 「えい！」	
DATAFORM 「いや！」	DATAFORM 「いや！」	
DATAFORM （うぅ…）	DATAFORM （うぅ…）	
DATAFORM 「うぅ…」	DATAFORM 「うぅ…」	
DATAFORM 「くっ…」	DATAFORM 「くっ…」	
DATAFORM 「痛ッ！」	DATAFORM 「痛ッ！」	
PRINTFORML 	PRINTFORML 	
PRINTDATAL	PRINTDATAL	
PRINTDATAW	PRINTDATAW	
DATAFORM 	DATAFORM 	
