//口上:

PRINTFORMW 「そんな事する暇があるなら自分の体毛でも引き抜いたらどうだ～？少しは恥ずかしく無くなるんじゃないか？」	PRINTFORMW 「そんな事する暇があるなら自分の体毛でも引き抜いたらどうだ～？少しは恥ずかしく無くなるんじゃないか？」
PRINTFORMW 「な、…はは～ん、さては出来ないんでしょ？出来ないのよね？"何でも"っていうのは嘘なんでしょ？」	PRINTFORMW 「な、…はは～ん、さては出来ないんでしょ？出来ないのよね？"何でも"っていうのは嘘なんでしょ？」
PRINTFORMW 「どうだ！お前をひっくり返して、元の獣らしく四つん這いに戻してやったぞ？嬉しいか？嬉しいよな？」	PRINTFORMW 「どうだ！お前をひっくり返して、元の獣らしく四つん這いに戻してやったぞ？嬉しいか？嬉しいよな？」
PRINTFORMW 「それはこっちの台詞よ！この洞窟はアナタの仕業ね！元の私を返しなさい！ｱｵｰﾝ!(襲)」	PRINTFORMW 「それはこっちの台詞よ！この洞窟はアナタの仕業ね！元の私を返しなさい！ｱｵｰﾝ!(襲)」
PRINTFORMW 「ちょっと天邪鬼！アナタのその"何でもひっくり返す能力"で私を元の姿に戻しなさいよ！」	PRINTFORMW 「ちょっと天邪鬼！アナタのその"何でもひっくり返す能力"で私を元の姿に戻しなさいよ！」
PRINTFORMW 「えっと…それは…、あ、あなたが先の異変の黒幕だったから…きっと、これもあなたが…」	PRINTFORMW 「えっと…それは…、あ、あなたが先の異変の黒幕だったから…きっと、これもあなたが…」
PRINTFORMW 「な！？言ったわね！その舌引き抜いて二度と生意気な事を言えないようにしてあげるわ！」	PRINTFORMW 「な！？言ったわね！その舌引き抜いて二度と生意気な事を言えないようにしてあげるわ！」
PRINTFORMW 「わ、私はこんなことしないよ！私はてっきりあんたがしたんだと思ってたよ？」	PRINTFORMW 「わ、私はこんなことしないよ！私はてっきりあんたがしたんだと思ってたよ？」
PRINTFORMW 「て、ことは本当は犬の匂いが好きなのねー♪嬉しいわー♪ｱｵｰﾝ!(喜)」	PRINTFORMW 「て、ことは本当は犬の匂いが好きなのねー♪嬉しいわー♪ｱｵｰﾝ!(喜)」
PRINTFORMW 「何でそうなる！てか、どうやって渡すんだよ！待て！落ち着け！ﾊﾅｾｰ」	PRINTFORMW 「何でそうなる！てか、どうやって渡すんだよ！待て！落ち着け！ﾊﾅｾｰ」
PRINTFORMW 「わ、私をこんな所に連れてきたのはあなたですね！早く湖に帰して！」	PRINTFORMW 「わ、私をこんな所に連れてきたのはあなたですね！早く湖に帰して！」
PRINTFORMW 「この野獣が…ハイハイ、カゲロウスキスキー(棒)、これでどうだ！」	PRINTFORMW 「この野獣が…ハイハイ、カゲロウスキスキー(棒)、これでどうだ！」
PRINTFORMW 「ふんっ、毛皮があるのに服を着てるお前の方がよっぽど天邪鬼だよ」	PRINTFORMW 「ふんっ、毛皮があるのに服を着てるお前の方がよっぽど天邪鬼だよ」
PRINTFORMW 「あ、ありがとうございます！私、あなたのこと誤解してました！」	PRINTFORMW 「あ、ありがとうございます！私、あなたのこと誤解してました！」
PRINTFORMW 「な！？お、乙女に向かって…酷い！酷いわー！ｱｵｰﾝ!(泣)」	PRINTFORMW 「な！？お、乙女に向かって…酷い！酷いわー！ｱｵｰﾝ!(泣)」
PRINTFORMW 「おいおい、そっちが見せてるんだろ？八つ当たりは良くないぞ？」	PRINTFORMW 「おいおい、そっちが見せてるんだろ？八つ当たりは良くないぞ？」
PRINTFORMW 「だったら…この洞窟の主に会って返り討ちしてやる！下剋上だ！」	PRINTFORMW 「だったら…この洞窟の主に会って返り討ちしてやる！下剋上だ！」
PRINTFORMW 「う～ん、こんな事が出来れば簡単に支配者になれたんだがな…」	PRINTFORMW 「う～ん、こんな事が出来れば簡単に支配者になれたんだがな…」
PRINTFORML 「何か頂けると嬉しいのだけど…って、アナタが言いなさいよ！」	PRINTFORML 「何か頂けると嬉しいのだけど…って、アナタが言いなさいよ！」
PRINTFORMW 「あわわ、影狼さんも臭く無いですよ！石鹸の良い香りですよ！」	PRINTFORMW 「あわわ、影狼さんも臭く無いですよ！石鹸の良い香りですよ！」
PRINTFORMW 「ふふふ、生意気なアナタの寝顔でも見させてもらおうかしら？」	PRINTFORMW 「ふふふ、生意気なアナタの寝顔でも見させてもらおうかしら？」
PRINTFORMW 「って、わかさぎ姫じゃない！何でコイツと一緒にいるの！？」	PRINTFORMW 「って、わかさぎ姫じゃない！何でコイツと一緒にいるの！？」
PRINTFORMW 「何？体毛が欲しいの？！あげる！貰って！ｱｵｰﾝ!(熱)」	PRINTFORMW 「何？体毛が欲しいの？！あげる！貰って！ｱｵｰﾝ!(熱)」
PRINTFORMW 「はぁ？何で私がそんなことしなきゃならないんだ？やだね！」	PRINTFORMW 「はぁ？何で私がそんなことしなきゃならないんだ？やだね！」
PRINTFORMW 「減らず口を……！？そういえばアナタって天邪鬼なのよね…」	PRINTFORMW 「減らず口を……！？そういえばアナタって天邪鬼なのよね…」
PRINTFORMW 「やっと素直になったのねー♪嬉しいわー♪ｱｵｰﾝ!(喜)」	PRINTFORMW 「やっと素直になったのねー♪嬉しいわー♪ｱｵｰﾝ!(喜)」
DATAFORM 「その状態じゃ道具を使えないだろう？私が代わりに使ってやるよ」	DATAFORM 「その状態じゃ道具を使えないだろう？私が代わりに使ってやるよ」
DATAFORM 「当レジスタンスは誰でもウェルカム、仲間になるなら歓迎するよ」	DATAFORM 「当レジスタンスは誰でもウェルカム、仲間になるなら歓迎するよ」
PRINTFORMW 「ふん、お前の下品な寝顔を見るくらいなら先に寝てやるよ…」	PRINTFORMW 「ふん、お前の下品な寝顔を見るくらいなら先に寝てやるよ…」
PRINTFORMW 「ふふっ、正邪さんは口は悪いですけど寝顔はｶﾜｲｲですね」	PRINTFORMW 「ふふっ、正邪さんは口は悪いですけど寝顔はｶﾜｲｲですね」
PRINTFORMW 	しつこいなぁ、知らないよ、まぁ知ってても教えないけど」	PRINTFORMW 	しつこいなぁ、知らないよ、まぁ知ってても教えないけど」
PRINTFORMW 「影狼さん、い、今はここを出るために協力し合わないと！」	PRINTFORMW 「影狼さん、い、今はここを出るために協力し合わないと！」
PRINTFORML 「後で吠え面かくなよ？ってお前はいつも吠え面だったな…」	PRINTFORML 「後で吠え面かくなよ？ってお前はいつも吠え面だったな…」
PRINTFORMW 「私がこの姿になったのは正邪のせいじゃ！なんちゃって♪」	PRINTFORMW 「私がこの姿になったのは正邪のせいじゃ！なんちゃって♪」
PRINTFORMW 「姫！ってことはやっぱりこの洞窟は姫が私を捕える為に…」	PRINTFORMW 「姫！ってことはやっぱりこの洞窟は姫が私を捕える為に…」
PRINTFORMW 「人魚です！マグロじゃないです！ちゃんと動きますから！」	PRINTFORMW 「人魚です！マグロじゃないです！ちゃんと動きますから！」
PRINTFORMW 「わわ！知らん知らん！近寄るな！獣の匂いが移るだろ！」	PRINTFORMW 「わわ！知らん知らん！近寄るな！獣の匂いが移るだろ！」
PRINTFORMW 「こいつ…ゆ"る"さ"ん"！覚悟ー！ｱｵｰﾝ!(怒)」	PRINTFORMW 「こいつ…ゆ"る"さ"ん"！覚悟ー！ｱｵｰﾝ!(怒)」
PRINTFORMW 「あら、起きてると糞生意気だけど、寝顔はかわいいのね」	PRINTFORMW 「あら、起きてると糞生意気だけど、寝顔はかわいいのね」
PRINTFORMW 「ね、寝てる間に食べようとか、考えないでくださいよ？」	PRINTFORMW 「ね、寝てる間に食べようとか、考えないでくださいよ？」
PRINTFORMW 「前科があるだけで私を疑うの？酷イワー人魚酷イワー」	PRINTFORMW 「前科があるだけで私を疑うの？酷イワー人魚酷イワー」
PRINTFORMW 「いいのいいの、私も酷いこと言ったからおあいこだよ」	PRINTFORMW 「いいのいいの、私も酷いこと言ったからおあいこだよ」
PRINTFORMW 「服を着る事にすら反逆するなんて流石は天邪鬼ね～♪」	PRINTFORMW 「服を着る事にすら反逆するなんて流石は天邪鬼ね～♪」
PRINTFORMW 「しないよ、火を通さずに食べたら食中毒になるからな」	PRINTFORMW 「しないよ、火を通さずに食べたら食中毒になるからな」
PRINTFORMW 「…あ、穴の中に変な虫がいっぱい居るんですけど…」	PRINTFORMW 「…あ、穴の中に変な虫がいっぱい居るんですけど…」
PRINTFORMW 「あ、天邪鬼！アナタこんなところに隠れてたのね！」	PRINTFORMW 「あ、天邪鬼！アナタこんなところに隠れてたのね！」
PRINTFORMW 「誰でもいいさ、虐げられたらやり返す…下克上だ！」	PRINTFORMW 「誰でもいいさ、虐げられたらやり返す…下克上だ！」
PRINTFORMW 「正邪、お疲れだね…私が針治療で癒してあげるよ！」	PRINTFORMW 「正邪、お疲れだね…私が針治療で癒してあげるよ！」
PRINTFORMW 「追っ手から逃げて洞窟に逃げ込んだのはよかったが」	PRINTFORMW 「追っ手から逃げて洞窟に逃げ込んだのはよかったが」
PRINTFORMW 「ほら、あの地面にある穴は外と繋がってるんだよ」	PRINTFORMW 「ほら、あの地面にある穴は外と繋がってるんだよ」
PRINTFORMW 「あーそれな、大丈夫大丈夫、何もしてこないから」	PRINTFORMW 「あーそれな、大丈夫大丈夫、何もしてこないから」
PRINTFORMW 「か、影狼さん！？どうしたんですかその格好！？」	PRINTFORMW 「か、影狼さん！？どうしたんですかその格好！？」
PRINTFORMW 「あー…生臭いし、獣臭いから離れてくれないか？」	PRINTFORMW 「あー…生臭いし、獣臭いから離れてくれないか？」
PRINTFORMW 「正邪、見張りは私に任せてゆっくり休むといいよ」	PRINTFORMW 「正邪、見張りは私に任せてゆっくり休むといいよ」
PRINTFORMW 「…もしかして追っ手の仕業か？これは罠なのか？」	PRINTFORMW 「…もしかして追っ手の仕業か？これは罠なのか？」
PRINTFORMW 「違いますよ！半漁人は上半身が魚なんですよ！」	PRINTFORMW 「違いますよ！半漁人は上半身が魚なんですよ！」
PRINTFORMW 「そんなに帰りたいなら帰り道を教えてあげるよ」	PRINTFORMW 「そんなに帰りたいなら帰り道を教えてあげるよ」
PRINTFORML 「早く帰らないと、化け物の食い物にされるぞ？」	PRINTFORML 「早く帰らないと、化け物の食い物にされるぞ？」
PRINTFORML 「人魚の肉を食べると不老不死になるらしいな…」	PRINTFORML 「人魚の肉を食べると不老不死になるらしいな…」
PRINTFORMW 「げっ！？アンタ、もうこんなに成長したの！？」	PRINTFORMW 「げっ！？アンタ、もうこんなに成長したの！？」
PRINTFORMW 「お前は毛皮があるから裸でも平気そうだなって」	PRINTFORMW 「お前は毛皮があるから裸でも平気そうだなって」
PRINTFORMW 「ち、違う違う！取られたの！服取られたのー！」	PRINTFORMW 「ち、違う違う！取られたの！服取られたのー！」
PRINTFORMW 「もっと成長したら色んな所が似るんだろうな」	PRINTFORMW 「もっと成長したら色んな所が似るんだろうな」
PRINTFORMW 「正邪はそういう事だけ素直に言うんだよね…」	PRINTFORMW 「正邪はそういう事だけ素直に言うんだよね…」
PRINTFORMW 「なんだ狼女か、この洞窟はお前の巣なのか？」	PRINTFORMW 「なんだ狼女か、この洞窟はお前の巣なのか？」
PRINTFORMW 「抜いても直ぐに生えちゃうわよ！……ハッ!」	PRINTFORMW 「抜いても直ぐに生えちゃうわよ！……ハッ!」
PRINTFORML 「前言撤回！今すぐぎゃふんと言わせてやる！」	PRINTFORML 「前言撤回！今すぐぎゃふんと言わせてやる！」
PRINTFORMW 「えーい放せ放せ、犬くさいのは嫌いなんだ！」	PRINTFORMW 「えーい放せ放せ、犬くさいのは嫌いなんだ！」
PRINTFORMW 「天邪鬼、アナタの名前って正邪って言うのね」	PRINTFORMW 「天邪鬼、アナタの名前って正邪って言うのね」
PRINTFORMW 「う～ん、正邪じゃないなら真犯人はだーれ？」	PRINTFORMW 「う～ん、正邪じゃないなら真犯人はだーれ？」
PRINTFORMW 「ん？なんだ姫か、危うく踏み潰す所だったぞ」	PRINTFORMW 「ん？なんだ姫か、危うく踏み潰す所だったぞ」
DATAFORM 「私が素直に渡すと思ってるのか？おめでたいねえ」	DATAFORM 「私が素直に渡すと思ってるのか？おめでたいねえ」
DATAFORM 「付いてくるなって？じゃあ付き纏ってやろうかな」	DATAFORM 「付いてくるなって？じゃあ付き纏ってやろうかな」
PRINTFORMW 「う～、寝てる間に変な事しないで下さいね？」	PRINTFORMW 「う～、寝てる間に変な事しないで下さいね？」
DATAFORM 「ど、どんな手を使っても生き残ればいいのさ！」	DATAFORM 「ど、どんな手を使っても生き残ればいいのさ！」
PRINTFORMW 「ご、ごめんなさい…って自業自得ですよ！」	PRINTFORMW 「ご、ごめんなさい…って自業自得ですよ！」
PRINTFORMW 「ほ、ホントに帰り道を知らないんですか？」	PRINTFORMW 「ほ、ホントに帰り道を知らないんですか？」
PRINTFORMW 「わぁ♪影狼さんそっくりでかわいいです♪」	PRINTFORMW 「わぁ♪影狼さんそっくりでかわいいです♪」
PRINTFORMW 「狼女か、露出狂だったとはたまげたなぁ…」	PRINTFORMW 「狼女か、露出狂だったとはたまげたなぁ…」
PRINTFORMW 「違う違う！私は本当に嫌いなのであって…」	PRINTFORMW 「違う違う！私は本当に嫌いなのであって…」
PRINTFORMW 「べ、別にこんな時まで嘘をつかなくても…」	PRINTFORMW 「べ、別にこんな時まで嘘をつかなくても…」
DATAFORM 「のんきに寝てると大事な物を奪われちまうぞ？」	DATAFORM 「のんきに寝てると大事な物を奪われちまうぞ？」
PRINTFORMW 「敵が来たら、この針で起こしてあげるよ！」	PRINTFORMW 「敵が来たら、この針で起こしてあげるよ！」
PRINTFORMW 「わわ！懐に入ってくんな！押しつぶすぞ！」	PRINTFORMW 「わわ！懐に入ってくんな！押しつぶすぞ！」
DATAFORM （マズイ！このままじゃ呑みこまれちまう…！）	DATAFORM （マズイ！このままじゃ呑みこまれちまう…！）
PRINTFORMW 「は、半漁人じゃありません！人魚です！」	PRINTFORMW 「は、半漁人じゃありません！人魚です！」
PRINTFORMW 「…怒ったり、泣いたり、忙しい奴だな…」	PRINTFORMW 「…怒ったり、泣いたり、忙しい奴だな…」
PRINTFORML 「どうだ？すべすべだぞ？羨ましかろう？」	PRINTFORML 「どうだ？すべすべだぞ？羨ましかろう？」
PRINTFORML 「コロォォォス！！！！ｱｵｰﾝ!(怒)」	PRINTFORML 「コロォォォス！！！！ｱｵｰﾝ!(怒)」
PRINTFORML 「ならこっちはキャウンと言わせてやるよ」	PRINTFORML 「ならこっちはキャウンと言わせてやるよ」
PRINTFORMW 「姫にそういう趣味があったとは意外だぞ」	PRINTFORMW 「姫にそういう趣味があったとは意外だぞ」
PRINTFORMW 「嘘吐きな正邪の為に針を千本用意したよ」	PRINTFORMW 「嘘吐きな正邪の為に針を千本用意したよ」
PRINTFORMW 「目覚める頃には病みつきになってるわ♪」	PRINTFORMW 「目覚める頃には病みつきになってるわ♪」
PRINTFORML といってもまだ台詞はほとんど無いけどね	PRINTFORML といってもまだ台詞はほとんど無いけどね
DATAFORM 「こ、このままじゃ…コイツの好き勝手に…」	DATAFORM 「こ、このままじゃ…コイツの好き勝手に…」
PRINTFORML 「こいつが、この迷宮の主ってわけか…」	PRINTFORML 「こいつが、この迷宮の主ってわけか…」
PRINTFORML 「下剋上の邪魔だよ、消えてもらおうか」	PRINTFORML 「下剋上の邪魔だよ、消えてもらおうか」
PRINTFORMW 「あ、あなたはお尋ね者の天邪鬼さん！」	PRINTFORMW 「あ、あなたはお尋ね者の天邪鬼さん！」
PRINTFORMW 「あわわ、影狼さん泣かないで下さぃ…」	PRINTFORMW 「あわわ、影狼さん泣かないで下さぃ…」
PRINTFORMW 「うっ、獣の分際で偉そうに……えい！」	PRINTFORMW 「うっ、獣の分際で偉そうに……えい！」
PRINTFORMW 「いやー正邪が楽しそうで何よりだよー」	PRINTFORMW 「いやー正邪が楽しそうで何よりだよー」
PRINTFORMW 「恥ずかしいなら、最初から言うなよ…」	PRINTFORMW 「恥ずかしいなら、最初から言うなよ…」
PRINTFORMW 「ほーら、正邪の好きな獣の香りよ～♪」	PRINTFORMW 「ほーら、正邪の好きな獣の香りよ～♪」
PRINTFORMW 「えーい！臭い！毛深い！抱きつくな！」	PRINTFORMW 「えーい！臭い！毛深い！抱きつくな！」
PRINTFORMW 「正邪、もっと私に頼っていいんだよ？」	PRINTFORMW 「正邪、もっと私に頼っていいんだよ？」
PRINTFORMW 「な！？私の寝顔のどこが下品なのよ！」	PRINTFORMW 「な！？私の寝顔のどこが下品なのよ！」
PRINTFORMW 「正邪の胸は程よい高さで枕に良いのぅ」	PRINTFORMW 「正邪の胸は程よい高さで枕に良いのぅ」
DATAFORM （ひッ！？中で、膨らんで…あッ、嫌！…）	DATAFORM （ひッ！？中で、膨らんで…あッ、嫌！…）
DATAFORM 「新手か…私に反逆すると痛い目見るぞ？」	DATAFORM 「新手か…私に反逆すると痛い目見るぞ？」
PRINTFORMW 「わ、私、食べ物じゃないですよぉ…」	PRINTFORMW 「わ、私、食べ物じゃないですよぉ…」
PRINTFORMW 「んー、体毛はあいつの方が濃いかな」	PRINTFORMW 「んー、体毛はあいつの方が濃いかな」
PRINTFORMW 「影狼さんが聞いたら怒りますよ…？」	PRINTFORMW 「影狼さんが聞いたら怒りますよ…？」
PRINTFORML 「服が無くても平気とかｳﾗﾔﾏｼｰ」	PRINTFORML 「服が無くても平気とかｳﾗﾔﾏｼｰ」
PRINTFORMW 「捕まえたわよ天邪鬼！観念なさい！」	PRINTFORMW 「捕まえたわよ天邪鬼！観念なさい！」
PRINTFORMW 「いいんですよ？別に隠さなくても…」	PRINTFORMW 「いいんですよ？別に隠さなくても…」
PRINTFORMW 「正邪の肌って白くてすべすべだねー」	PRINTFORMW 「正邪の肌って白くてすべすべだねー」
PRINTFORML 「何か譲って頂ｹﾅｲﾃﾞｼｮｳｶ…」	PRINTFORML 「何か譲って頂ｹﾅｲﾃﾞｼｮｳｶ…」
PRINTFORMW 「…な、何の夢を見てるんでしょう…」	PRINTFORMW 「…な、何の夢を見てるんでしょう…」
PRINTFORMW 「あー…普通に起こしてくれないか？」	PRINTFORMW 「あー…普通に起こしてくれないか？」
DATAFORM 「ちょいと大きいのでもくれてやるか…」	DATAFORM 「ちょいと大きいのでもくれてやるか…」
PRINTFORMW 「そ、そんなのただの作り話です！」	PRINTFORMW 「そ、そんなのただの作り話です！」
PRINTFORMW 「うるさい！こっち見んな！死ね！」	PRINTFORMW 「うるさい！こっち見んな！死ね！」
PRINTFORMW 「うるさーーい！ｱｵｰﾝ!(襲)」	PRINTFORMW 「うるさーーい！ｱｵｰﾝ!(襲)」
PRINTFORML 「そんな格好だと風邪引くわよ～？」	PRINTFORML 「そんな格好だと風邪引くわよ～？」
PRINTFORML 「いつかぎゃふんと言わせてやるわ」	PRINTFORML 「いつかぎゃふんと言わせてやるわ」
PRINTFORMW 「だ、大丈夫ですか！？影狼さん！」	PRINTFORMW 「だ、大丈夫ですか！？影狼さん！」
PRINTFORMW 「自分でそう言ってるだろ……あ…」	PRINTFORMW 「自分でそう言ってるだろ……あ…」
PRINTFORMW 「も～、素直じゃないんだからー♪」	PRINTFORMW 「も～、素直じゃないんだからー♪」
PRINTFORMW 「あー？なんだ今更？それが何だよ」	PRINTFORMW 「あー？なんだ今更？それが何だよ」
PRINTFORMW 「おぉ！正邪、まだ生きておったか」	PRINTFORMW 「おぉ！正邪、まだ生きておったか」
DATAFORM （コイツはどうやってからかおうかな…）	DATAFORM （コイツはどうやってからかおうかな…）
PRINTFORML 「ほら！正邪、もっと大きな声で！」	PRINTFORML 「ほら！正邪、もっと大きな声で！」
DATAFORM 「反逆的だな、ますます欲しくなったよ」	DATAFORM 「反逆的だな、ますます欲しくなったよ」
DATAFORM 「お前の仲間になんか、なりたか無いね」	DATAFORM 「お前の仲間になんか、なりたか無いね」
PRINTFORMW 「ちょっとやめてよ、恥ずかしい…」	PRINTFORMW 「ちょっとやめてよ、恥ずかしい…」
PRINTFORMW 「ふん、犬と魚で、臭い仲ってか？」	PRINTFORMW 「ふん、犬と魚で、臭い仲ってか？」
PRINTFORMW 「えーい吠えるな、寝れないだろ！」	PRINTFORMW 「えーい吠えるな、寝れないだろ！」
PRINTFORMW 「くっ、起きたら覚えてなさいよ…」	PRINTFORMW 「くっ、起きたら覚えてなさいよ…」
PRINTFORMW 「zzz…ｲﾇ…ｸｻｲ…zzz…」	PRINTFORMW 「zzz…ｲﾇ…ｸｻｲ…zzz…」
PRINTFORMW 「火があっても食べないで下さい！」	PRINTFORMW 「火があっても食べないで下さい！」
PRINTFORMW 「まさかこんな所に出ちまうとは…」	PRINTFORMW 「まさかこんな所に出ちまうとは…」
PRINTFORML 台詞に文字色を付けろ？～ヤだね！	PRINTFORML 台詞に文字色を付けろ？～ヤだね！
DATAFORM 「！？しまった！食われッ…んんッ！」	DATAFORM 「！？しまった！食われッ…んんッ！」
DATAFORM 「そんなことで私に反逆できるのか？」	DATAFORM 「そんなことで私に反逆できるのか？」
DATAFORM 「向きをかえてやればﾁｮﾛｲもんよ」	DATAFORM 「向きをかえてやればﾁｮﾛｲもんよ」
PRINTFORMW 「おぉー、母親によく似てるねー」	PRINTFORMW 「おぉー、母親によく似てるねー」
PRINTFORMW 「もー素直じゃないんだからー♪」	PRINTFORMW 「もー素直じゃないんだからー♪」
PRINTFORMW 「…色々と危ないので遠慮します」	PRINTFORMW 「…色々と危ないので遠慮します」
DATAFORM 「こいつは私に使われる方がいいのさ」	DATAFORM 「こいつは私に使われる方がいいのさ」
DATAFORM （ヤバくなったらさっさと捨てるか…）	DATAFORM （ヤバくなったらさっさと捨てるか…）
PRINTFORMW 「このまま永眠させようかしら？」	PRINTFORMW 「このまま永眠させようかしら？」
PRINTFORMW 「zzz…ﾀﾞｲｽｷ…ﾃﾞｽ…」	PRINTFORMW 「zzz…ﾀﾞｲｽｷ…ﾃﾞｽ…」
PRINTFORMW 「！…そ、それは…言えません！」	PRINTFORMW 「！…そ、それは…言えません！」
DATAFORM (こんな状況ひっくり返してやる！)	DATAFORM (こんな状況ひっくり返してやる！)
DATAFORM 「動きを封じるなんて卑怯なんだよ」	DATAFORM 「動きを封じるなんて卑怯なんだよ」
DATAFORM 「動くな！抜け！さっさと抜けえ！」	DATAFORM 「動くな！抜け！さっさと抜けえ！」
DATAFORM （入って…来てる…ヤダ！…ヤダ！）	DATAFORM （入って…来てる…ヤダ！…ヤダ！）
DATAFORM 「体の向きを変えて…あらよっと！」	DATAFORM 「体の向きを変えて…あらよっと！」
PRINTFORMW 「ヘーソウナンダ、スゴイネー」	PRINTFORMW 「ヘーソウナンダ、スゴイネー」
PRINTFORMW 「どこにそんな持ってたんだ…」	PRINTFORMW 「どこにそんな持ってたんだ…」
PRINTFORML 「秘密道具とか持ってないか？」	PRINTFORML 「秘密道具とか持ってないか？」
DATAFORM （ここで使い切りたくはないな…）	DATAFORM （ここで使い切りたくはないな…）
DATAFORM （もう……むり……なのかなぁ…）	DATAFORM （もう……むり……なのかなぁ…）
DATAFORM 「しまっ！？…っく！動けない…」	DATAFORM 「しまっ！？…っく！動けない…」
DATAFORM （う、動けない…ヤダ！…ヤダ！）	DATAFORM （う、動けない…ヤダ！…ヤダ！）
DATAFORM （ﾋッ…ｲｲｯ、ｷﾓﾁｲｲ…♪）	DATAFORM （ﾋッ…ｲｲｯ、ｷﾓﾁｲｲ…♪）
DATAFORM 「私に反逆しようって？面白いね」	DATAFORM 「私に反逆しようって？面白いね」
PRINTFORMW 「…何が言いたいのかしら？」	PRINTFORMW 「…何が言いたいのかしら？」
PRINTFORMW 「え、えっと…成り行きで…」	PRINTFORMW 「え、えっと…成り行きで…」
PRINTFORMW 「か、影狼さんの体…綺麗…」	PRINTFORMW 「か、影狼さんの体…綺麗…」
PRINTFORMW 「ほーら、犬さんこちらー♪」	PRINTFORMW 「ほーら、犬さんこちらー♪」
PRINTFORMW 「抱きつくな！むさ苦しい！」	PRINTFORMW 「抱きつくな！むさ苦しい！」
PRINTFORMW 「…ふ、服はどうしたのー？」	PRINTFORMW 「…ふ、服はどうしたのー？」
PRINTFORML 「あー、私は人見知りだから」	PRINTFORML 「あー、私は人見知りだから」
DATAFORM 「お？仲間になってくれるのか？」	DATAFORM 「お？仲間になってくれるのか？」
PRINTFORMW 「わ、私は臭くないですよ！」	PRINTFORMW 「わ、私は臭くないですよ！」
PRINTFORMW 「私は目覚めないと思うぞ？」	PRINTFORMW 「私は目覚めないと思うぞ？」
DATAFORM 「わ！？どこ触ってんだ変態！」	DATAFORM 「わ！？どこ触ってんだ変態！」
DATAFORM （頭…真ｯｼﾛ…ｷﾓﾁｲｲ♪）	DATAFORM （頭…真ｯｼﾛ…ｷﾓﾁｲｲ♪）
PRINTFORML 「お前を倒して下克上だ！」	PRINTFORML 「お前を倒して下克上だ！」
PRINTFORMW 「ん？、なんだ半漁人か…」	PRINTFORMW 「ん？、なんだ半漁人か…」
PRINTFORMW 「真面目に聞いて下さい！」	PRINTFORMW 「真面目に聞いて下さい！」
PRINTFORMW 「何を根拠にそんな事を…」	PRINTFORMW 「何を根拠にそんな事を…」
PRINTFORMW 「お？あの狼女の子供か？」	PRINTFORMW 「お？あの狼女の子供か？」
PRINTFORMW 「また会ったわね、天邪鬼」	PRINTFORMW 「また会ったわね、天邪鬼」
PRINTFORMW 「…ワ、ワオーン！(襲)」	PRINTFORMW 「…ワ、ワオーン！(襲)」
PRINTFORMW 「あんたはブレないねー…」	PRINTFORMW 「あんたはブレないねー…」
DATAFORM 「聞きたいか？聞きたいよな？」	DATAFORM 「聞きたいか？聞きたいよな？」
DATAFORM （どんなウソを教えようかな…）	DATAFORM （どんなウソを教えようかな…）
PRINTFORML 「す、ストレートですね…」	PRINTFORML 「す、ストレートですね…」
DATAFORM 「ん？お礼？言うわけないだろ」	DATAFORM 「ん？お礼？言うわけないだろ」
DATAFORM 「な！？反逆か？反逆だな？！」	DATAFORM 「な！？反逆か？反逆だな？！」
DATAFORM 「手を出すなって？イヤだね！」	DATAFORM 「手を出すなって？イヤだね！」
PRINTFORMW 「私はそろそろ寝るよー…」	PRINTFORMW 「私はそろそろ寝るよー…」
DATAFORM 「ほれほれ避けろ避けろー！」	DATAFORM 「ほれほれ避けろ避けろー！」
DATAFORM 「体中がべとべとまみれだな」	DATAFORM 「体中がべとべとまみれだな」
DATAFORM 「痛ッ、いいかげんにしろ！」	DATAFORM 「痛ッ、いいかげんにしろ！」
DATAFORM 「お、お尻なんか触んなよ！」	DATAFORM 「お、お尻なんか触んなよ！」
DATAFORM 「つ、摘まむな！…やめッ…」	DATAFORM 「つ、摘まむな！…やめッ…」
DATAFORM 「やめろ！入れるな！死ね！」	DATAFORM 「やめろ！入れるな！死ね！」
DATAFORM 「ッッ！…後でひどいぞ…？」	DATAFORM 「ッッ！…後でひどいぞ…？」
DATAFORM 「ッが！？体が…動かない…」	DATAFORM 「ッが！？体が…動かない…」
DATAFORM 「ぐッ…ッ…く、くるじい…」	DATAFORM 「ぐッ…ッ…く、くるじい…」
PRINTFORMW 「ほ、ホントですか！？」	PRINTFORMW 「ほ、ホントですか！？」
PRINTFORMW 「で、では失礼します！」	PRINTFORMW 「で、では失礼します！」
PRINTFORMW 「わぁ♪かわいいです♪」	PRINTFORMW 「わぁ♪かわいいです♪」
PRINTFORMW 「あー、遠慮しとくよ…」	PRINTFORMW 「あー、遠慮しとくよ…」
DATAFORM 「あ、こら！勝手に取んな！」	DATAFORM 「あ、こら！勝手に取んな！」
DATAFORM 「そんな頼みは聞けないね！」	DATAFORM 「そんな頼みは聞けないね！」
PRINTFORMW 「影狼さんと添い寝です♪	PRINTFORMW 「影狼さんと添い寝です♪
PRINTFORMW 「いい加減ｺﾛｽわよ？」	PRINTFORMW 「いい加減ｺﾛｽわよ？」
PRINTFORMW 「ふふ♪かわいー寝顔♪」	PRINTFORMW 「ふふ♪かわいー寝顔♪」
PRINTFORMW 「ｸﾞｶﾞｰ…zzz…」	PRINTFORMW 「ｸﾞｶﾞｰ…zzz…」
PRINTFORMW 「…よだれ垂れてるぞ…」	PRINTFORMW 「…よだれ垂れてるぞ…」
PRINTFORMW 「ﾃﾝﾌﾟﾗ…zzz…」	PRINTFORMW 「ﾃﾝﾌﾟﾗ…zzz…」
PRINTFORMW 「マグロに興味は無いぞ」	PRINTFORMW 「マグロに興味は無いぞ」
PRINTFORMW 「へぇー、どんな風に？」	PRINTFORMW 「へぇー、どんな風に？」
DATAFORM 「ここは耐えるべきかな？」	DATAFORM 「ここは耐えるべきかな？」
DATAFORM 「お前にはこれで十分だ！」	DATAFORM 「お前にはこれで十分だ！」
DATAFORM 「さぁて逆襲の始まりだ！」	DATAFORM 「さぁて逆襲の始まりだ！」
DATAFORM （あ、頭を使え、冷静に…）	DATAFORM （あ、頭を使え、冷静に…）
DATAFORM （こ、好機があるはずだ…）	DATAFORM （こ、好機があるはずだ…）
DATAFORM 「痛ッ、よくもやったな…」	DATAFORM 「痛ッ、よくもやったな…」
DATAFORM 「や！？やめろ！食うな！」	DATAFORM 「や！？やめろ！食うな！」
DATAFORM （か、体が…沈んでいく…）	DATAFORM （か、体が…沈んでいく…）
DATAFORM 「下克上の邪魔だ、去りな」	DATAFORM 「下克上の邪魔だ、去りな」
PRINTFORMW 「どっちも一緒だろ？」	PRINTFORMW 「どっちも一緒だろ？」
PRINTFORMW 「…目が笑ってますよ」	PRINTFORMW 「…目が笑ってますよ」
PRINTFORML 「寒い？寒いでしょ？」	PRINTFORML 「寒い？寒いでしょ？」
PRINTFORML 「体毛ならいらんぞ？」	PRINTFORML 「体毛ならいらんぞ？」
PRINTFORMW 「おぉ、ｺﾜｲｺﾜｲ」	PRINTFORMW 「おぉ、ｺﾜｲｺﾜｲ」
PRINTFORML 「ほーら、また吠えた」	PRINTFORML 「ほーら、また吠えた」
PRINTFORMW 「(お？やったか？)」	PRINTFORMW 「(お？やったか？)」
PRINTFORMW 「正邪ーすりすりー♪」	PRINTFORMW 「正邪ーすりすりー♪」
PRINTFORMW 「毛を擦りつけんな！」	PRINTFORMW 「毛を擦りつけんな！」
PRINTFORMW 「あー…す、捨てた？」	PRINTFORMW 「あー…す、捨てた？」
DATAFORM 「ケッ、使えねー道具だな」	DATAFORM 「ケッ、使えねー道具だな」
DATAFORM (早く抜け出さないと…)	DATAFORM (早く抜け出さないと…)
DATAFORM 「ッ…今のは効いたぞ…」	DATAFORM 「ッ…今のは効いたぞ…」
DATAFORM 「痛い！…や、やめろ！」	DATAFORM 「痛い！…や、やめろ！」
DATAFORM 「む、胸は！…やめッ…」	DATAFORM 「む、胸は！…やめッ…」
PRINTFORMW 「うぅ、そんなぁ…」	PRINTFORMW 「うぅ、そんなぁ…」
PRINTFORML 「獣らしい恰好だな」	PRINTFORML 「獣らしい恰好だな」
PRINTFORMW 「ｱｵｰﾝ!(泣)」	PRINTFORMW 「ｱｵｰﾝ!(泣)」
PRINTFORMW 「きゃ！…ｲﾀﾀ…」	PRINTFORMW 「きゃ！…ｲﾀﾀ…」
PRINTFORMW 「ﾔﾒﾛｰﾊﾅｾｰ」	PRINTFORMW 「ﾔﾒﾛｰﾊﾅｾｰ」
PRINTFORML 「何かくれないか？」	PRINTFORML 「何かくれないか？」
DATAFORM 「やだね！渡すもんか！」	DATAFORM 「やだね！渡すもんか！」
DATAFORM 「ぬぅ、私は諦めんよ…」	DATAFORM 「ぬぅ、私は諦めんよ…」
PRINTFORMW 「ふぁ～…寝るか…」	PRINTFORMW 「ふぁ～…寝るか…」
DATAFORM 「ちょこまかすんな！」	DATAFORM 「ちょこまかすんな！」
DATAFORM 「まとめて喰らいな！」	DATAFORM 「まとめて喰らいな！」
DATAFORM 「今度はこっちの番だ」	DATAFORM 「今度はこっちの番だ」
DATAFORM （か、体がかってに…）	DATAFORM （か、体がかってに…）
DATAFORM 「うぐッ、や、やめ…」	DATAFORM 「うぐッ、や、やめ…」
DATAFORM 「も、もういいだろ！」	DATAFORM 「も、もういいだろ！」
PRINTFORMW 「あ！？天邪鬼！」	PRINTFORMW 「あ！？天邪鬼！」
PRINTFORML 「ほっといてよ！」	PRINTFORML 「ほっといてよ！」
PRINTFORML 「いつかｺﾛｽ…」	PRINTFORML 「いつかｺﾛｽ…」
PRINTFORMW 「げっ！？狼女！」	PRINTFORMW 「げっ！？狼女！」
PRINTFORML 「余計なお世話だ」	PRINTFORML 「余計なお世話だ」
DATAFORM 「こいつは貰っとくよ」	DATAFORM 「こいつは貰っとくよ」
PRINTFORMW 「おぉ、臭い臭い」	PRINTFORMW 「おぉ、臭い臭い」
PRINTFORMW 「大丈夫ですよ♪」	PRINTFORMW 「大丈夫ですよ♪」
PRINTFORMW 「んーよろしく…」	PRINTFORMW 「んーよろしく…」
PRINTFORML 「ひっ！やめろ！」	PRINTFORML 「ひっ！やめろ！」
﻿PRINTFORML 鬼人正邪口上です	PRINTFORML 鬼人正邪口上です
DATAFORM 「構ってらんねーな」	DATAFORM 「構ってらんねーな」
DATAFORM 「外野が邪魔だな…」	DATAFORM 「外野が邪魔だな…」
DATAFORM 「外堀を埋めるか…」	DATAFORM 「外堀を埋めるか…」
DATAFORM 「これならどうだ！」	DATAFORM 「これならどうだ！」
DATAFORM 「みだれ撃ちだー！」	DATAFORM 「みだれ撃ちだー！」
DATAFORM 「遅くしてやるよ！」	DATAFORM 「遅くしてやるよ！」
DATAFORM (こ、こうすれば…)	DATAFORM (こ、こうすれば…)
DATAFORM （わ、私…何して…）	DATAFORM （わ、私…何して…）
DATAFORM 「…やってくれたな」	DATAFORM 「…やってくれたな」
DATAFORM 「そこッ…ダメッ…」	DATAFORM 「そこッ…ダメッ…」
DATAFORM 「や、やめ…ひぅ！」	DATAFORM 「や、やめ…ひぅ！」
DATAFORM （うぅ…動けない…）	DATAFORM （うぅ…動けない…）
DATAFORM 「やれやれ面倒だね」	DATAFORM 「やれやれ面倒だね」
DATAFORM 「どいてもらおうか」	DATAFORM 「どいてもらおうか」
PRINTFORMW 「な、何だよ…」	PRINTFORMW 「な、何だよ…」
PRINTFORMW 「！？天邪鬼！」	PRINTFORMW 「！？天邪鬼！」
PRINTFORMW 「抜いたのか…」	PRINTFORMW 「抜いたのか…」
PRINTFORMW 「(アーッ！)」	PRINTFORMW 「(アーッ！)」
PRINTFORMW 「…刺すなよ？」	PRINTFORMW 「…刺すなよ？」
PRINTFORMW 「刺さないよ！」	PRINTFORMW 「刺さないよ！」
PRINTFORMW 「これ！正邪！」	PRINTFORMW 「これ！正邪！」
DATAFORM 「お？くれるのか？」	DATAFORM 「お？くれるのか？」
PRINTFORMW 「ふふ♪正邪♪」	PRINTFORMW 「ふふ♪正邪♪」
PRINTFORML 「うぅ、痛い…」	PRINTFORML 「うぅ、痛い…」
DATAFORM 「やり過ごすか…」	DATAFORM 「やり過ごすか…」
DATAFORM 「ほらほら来いよ」	DATAFORM 「ほらほら来いよ」
DATAFORM 「待ってました！」	DATAFORM 「待ってました！」
DATAFORM 「やっと出れたか」	DATAFORM 「やっと出れたか」
DATAFORM （今に見てろよ…）	DATAFORM （今に見てろよ…）
DATAFORM 「触んな、変態！」	DATAFORM 「触んな、変態！」
PRINTFORMW 「あ、ママー」	PRINTFORMW 「あ、ママー」
PRINTFORMW 「な、何よ…」	PRINTFORMW 「な、何よ…」
PRINTFORML 「いいザマね」	PRINTFORML 「いいザマね」
PRINTFORMW 「アオーン♪」	PRINTFORMW 「アオーン♪」
PRINTFORMW 「あ…正邪…」	PRINTFORMW 「あ…正邪…」
PRINTFORMW 「ちがーう！」	PRINTFORMW 「ちがーう！」
PRINTFORMW 「げ！？姫！」	PRINTFORMW 「げ！？姫！」
PRINTFORMW 「何ですか？」	PRINTFORMW 「何ですか？」
PRINTFORML 「何かくれ！」	PRINTFORML 「何かくれ！」
DATAFORM 「そう、さよなら」	DATAFORM 「そう、さよなら」
PRINTFORMW 「私"は"？」	PRINTFORMW 「私"は"？」
PRINTFORMW 「正邪さん♪」	PRINTFORMW 「正邪さん♪」
DATAFORM 「一網打尽だ！」	DATAFORM 「一網打尽だ！」
DATAFORM 「触…るな…！」	DATAFORM 「触…るな…！」
DATAFORM 「く、苦しい…」	DATAFORM 「く、苦しい…」
PRINTFORMW 「がうー？」	PRINTFORMW 「がうー？」
PRINTFORMW 「狼女！？」	PRINTFORMW 「狼女！？」
PRINTFORML 「こいつ…」	PRINTFORML 「こいつ…」
PRINTFORMW 「…正邪…」	PRINTFORMW 「…正邪…」
PRINTFORMW 「正邪！？」	PRINTFORMW 「正邪！？」
PRINTFORMW 「zzz…」	PRINTFORMW 「zzz…」
PRINTFORMW 「はぁ～…」	PRINTFORMW 「はぁ～…」
DATAFORM 「退くかな…」	DATAFORM 「退くかな…」
DATAFORM 「喰らいな！」	DATAFORM 「喰らいな！」
DATAFORM 「一点集中！」	DATAFORM 「一点集中！」
DATAFORM 「ひるみな！」	DATAFORM 「ひるみな！」
DATAFORM 「スキあり！」	DATAFORM 「スキあり！」
DATAFORM 「あらよっと」	DATAFORM 「あらよっと」
PRINTFORMW 「チッ…」	PRINTFORMW 「チッ…」
PRINTFORMW 「うー…」	PRINTFORMW 「うー…」
PRINTFORML 「ふんっ」	PRINTFORML 「ふんっ」
PRINTFORMW 「正邪や」	PRINTFORMW 「正邪や」
DATAFORM 「だが断る！」	DATAFORM 「だが断る！」
DATAFORM 「くそっ…」	DATAFORM 「くそっ…」
DATAFORM 「痛い！…」	DATAFORM 「痛い！…」
DATAFORM 「うぐッ…」	DATAFORM 「うぐッ…」
PRINTFORMW 「え…」	PRINTFORMW 「え…」
PRINTFORMW 「……」	PRINTFORMW 「……」
PRINTFORMW 「え？」	PRINTFORMW 「え？」
PRINTFORMW 「！？」	PRINTFORMW 「！？」
DATAFORM 「来なよ」	DATAFORM 「来なよ」
DATAFORM 「ふいー」	DATAFORM 「ふいー」
DATAFORM （うぅ…）	DATAFORM （うぅ…）
DATAFORM （くっ…）	DATAFORM （くっ…）
DATAFORM 「くっ…」	DATAFORM 「くっ…」
DATAFORM 「痛ッ！」	DATAFORM 「痛ッ！」
PRINTFORMW 「…」	PRINTFORMW 「…」
PRINTFORMW 「」	PRINTFORMW 「」
PRINTFORML 	PRINTFORML 
PRINTDATAL	PRINTDATAL
PRINTDATAW	PRINTDATAW
