//口上:

PRINTFORMDL CALLNAME:(TARGET)は小さな体を懸命に動かしている…	PRINTFORMDL CALLNAME:(TARGET)は小さな体を懸命に動かしている…	
PRINTFORMDL CALLNAME:(TARGET)は器の中に身を潜めている…	PRINTFORMDL CALLNAME:(TARGET)は器の中に身を潜めている…	
PRINTFORMW 「…うーむ、巫女も見当たらないし、とりあえず誰か探すかー」	PRINTFORMW 「…うーむ、巫女も見当たらないし、とりあえず誰か探すかー」
PRINTFORMW 「…うーむ、虫籠で寝てる間に何が起きたのやら…」	PRINTFORMW 「…うーむ、虫籠で寝てる間に何が起きたのやら…」	
PRINTFORMW 「まさか…正邪がまた何かしでかしたの？」	PRINTFORMW 「まさか…正邪がまた何かしでかしたの？」	
PRINTFORML といってもまだ台詞はほとんど無いけどね	PRINTFORML といってもまだ台詞はほとんど無いけどね	
PRINTFORML 「こ、これを倒せばめでたしなのかな…」	PRINTFORML 「こ、これを倒せばめでたしなのかな…」	
DATAFORM 「お、お尻なんか触っても汚いだけだよ！」	DATAFORM 「お、お尻なんか触っても汚いだけだよ！」	
DATAFORM 「見逃してくれると良いのだけどねー」	DATAFORM 「見逃してくれると良いのだけどねー」	
DATAFORM 「うわぁぁ！…擦らないでよぉ！…」	DATAFORM 「うわぁぁ！…擦らないでよぉ！…」	
DATAFORM （ここで使い切りたくはないな…）	DATAFORM （ここで使い切りたくはないな…）	
DATAFORM 「う、動かないで！裂けちゃう！」	DATAFORM 「う、動かないで！裂けちゃう！」	
DATAFORM 「わ！？どこ触ってるんだよ！」	DATAFORM 「わ！？どこ触ってるんだよ！」	
DATAFORM 「ほれほれ避けろ避けろー！」	DATAFORM 「ほれほれ避けろ避けろー！」	
DATAFORM 「うわー…体中がべとべと…」	DATAFORM 「うわー…体中がべとべと…」	
DATAFORM 「まさぐったら…やだぁッ…」	DATAFORM 「まさぐったら…やだぁッ…」	
DATAFORM 「つ、摘まむな！…やめッ…」	DATAFORM 「つ、摘まむな！…やめッ…」	
DATAFORM 「小人の力をなめるなよー？」	DATAFORM 「小人の力をなめるなよー？」	
DATAFORM 「お前にはこれで十分だ！」	DATAFORM 「お前にはこれで十分だ！」	
DATAFORM 「さー来るなら来いだよ！」	DATAFORM 「さー来るなら来いだよ！」	
DATAFORM （針で突けばいけるかな…）	DATAFORM （針で突けばいけるかな…）	
DATAFORM （えっと、こういう時は…）	DATAFORM （えっと、こういう時は…）	
DATAFORM （わわ！私は…何をして…）	DATAFORM （わわ！私は…何をして…）	
DATAFORM 「痛い！締めすぎだよ！…」	DATAFORM 「痛い！締めすぎだよ！…」	
DATAFORM 「ちっくちくしてやるー！」	DATAFORM 「ちっくちくしてやるー！」	
DATAFORM 「…というわけなんですー」	DATAFORM 「…というわけなんですー」	
PRINTFORML 「当てれるかなー？」	PRINTFORML 「当てれるかなー？」	
DATAFORM (早く抜け出さないと…)	DATAFORM (早く抜け出さないと…)	
DATAFORM 「ッ…今のは効いたよ…」	DATAFORM 「ッ…今のは効いたよ…」	
DATAFORM 「む、胸は！…やめッ…」	DATAFORM 「む、胸は！…やめッ…」	
DATAFORM 「やめて！いれないで！」	DATAFORM 「やめて！いれないで！」	
DATAFORM 「や、やめろぉ…ひぅ！」	DATAFORM 「や、やめろぉ…ひぅ！」	
DATAFORM 「わわ！は、放して！…」	DATAFORM 「わわ！は、放して！…」	
PRINTFORML 「来るなら来いー」	PRINTFORML 「来るなら来いー」	
DATAFORM 「これならどうだー！」	DATAFORM 「これならどうだー！」	
DATAFORM 「足元がお留守だよ！」	DATAFORM 「足元がお留守だよ！」	
DATAFORM 「どうにか出れたよ…」	DATAFORM 「どうにか出れたよ…」	
DATAFORM 「どうにか解けたよ…」	DATAFORM 「どうにか解けたよ…」	
DATAFORM （もう…だめなの？…）	DATAFORM （もう…だめなの？…）	
DATAFORM （か、体がかってに…）	DATAFORM （か、体がかってに…）	
DATAFORM 「い、痛い！やめて！」	DATAFORM 「い、痛い！やめて！」	
DATAFORM 「触っちゃやだぁ…！」	DATAFORM 「触っちゃやだぁ…！」	
PRINTFORML 「ひっ！やめて！」	PRINTFORML 「ひっ！やめて！」	
PRINTFORMW 「ここはどこー？」	PRINTFORMW 「ここはどこー？」	
DATAFORM 「防御に徹するよ…」	DATAFORM 「防御に徹するよ…」	
DATAFORM 「みだれ撃ちだー！」	DATAFORM 「みだれ撃ちだー！」	
DATAFORM (こ、こうすれば…)	DATAFORM (こ、こうすれば…)	
DATAFORM 「アタタ…関節が…」	DATAFORM 「アタタ…関節が…」	
DATAFORM 「痛ッ、よくもぉ…」	DATAFORM 「痛ッ、よくもぉ…」	
DATAFORM 「や、やめてよぉ…」	DATAFORM 「や、やめてよぉ…」	
DATAFORM 「そこッ…ダメッ…」	DATAFORM 「そこッ…ダメッ…」	
DATAFORM 「と、とんずらー！」	DATAFORM 「と、とんずらー！」	
PRINTFORML 「いざ！勝負！」	PRINTFORML 「いざ！勝負！」	
PRINTFORML 「うぅ、痛い…」	PRINTFORML 「うぅ、痛い…」	
﻿PRINTFORML 針妙丸口上です	PRINTFORML 針妙丸口上です	
DATAFORM （今に見てろー…）	DATAFORM （今に見てろー…）	
PRINTFORML 異変なのー？	PRINTFORML 異変なのー？	
DATAFORM 「耐えないと…」	DATAFORM 「耐えないと…」	
DATAFORM 「力よここにー」	DATAFORM 「力よここにー」	
DATAFORM 「避けてみろー」	DATAFORM 「避けてみろー」	
DATAFORM 「ひとまとめ！」	DATAFORM 「ひとまとめ！」	
DATAFORM 「スキありー！」	DATAFORM 「スキありー！」	
DATAFORM 「いざ！勝負！」	DATAFORM 「いざ！勝負！」	
DATAFORM 「新手なのー？」	DATAFORM 「新手なのー？」	
DATAFORM 「また会える？」	DATAFORM 「また会える？」	
DATAFORM 「逃げよう！」	DATAFORM 「逃げよう！」	
DATAFORM 「消え去れー」	DATAFORM 「消え去れー」	
DATAFORM 「喰らえー！」	DATAFORM 「喰らえー！」	
DATAFORM 「一点集中！」	DATAFORM 「一点集中！」	
DATAFORM 「そこかー！」	DATAFORM 「そこかー！」	
DATAFORM 「うわわっ！」	DATAFORM 「うわわっ！」	
DATAFORM 「危ないよ！」	DATAFORM 「危ないよ！」	
DATAFORM 「ひかえー」	DATAFORM 「ひかえー」	
DATAFORM 「ひるめ！」	DATAFORM 「ひるめ！」	
DATAFORM 「くぅっ…」	DATAFORM 「くぅっ…」	
DATAFORM 「痛い！…」	DATAFORM 「痛い！…」	
DATAFORM 「ッッ！…」	DATAFORM 「ッッ！…」	
DATAFORM 「ふぅー」	DATAFORM 「ふぅー」	
DATAFORM （うぅ…）	DATAFORM （うぅ…）	
DATAFORM （くぅ…）	DATAFORM （くぅ…）	
DATAFORM 「くっ…」	DATAFORM 「くっ…」	
DATAFORM 「痛ッ！」	DATAFORM 「痛ッ！」	
PRINTFORML 	PRINTFORML 	
PRINTDATAL	PRINTDATAL	
PRINTDATAW	PRINTDATAW	
