//口上:

PRINTFORMW 　…あ、ああ……ああああああっ。ああああああああああああああああああああああああああああああああああああああああああああああああああああああああああああああああああああああああああああああああああああ	PRINTFORMW 　…あ、ああ……ああああああっ。ああああああああああああああああああああああああああああああああああああああああああああああああああああああああああああああああああああああああああああああああああああ
PRINTFORMW 「ひぐっ…ごめんなさい…ごめんなさい……もうしません…もっといい子になります…だから許してとは言わないけど…、見放さないで…」	PRINTFORMW 「ひぐっ…ごめんなさい…ごめんなさい……もうしません…もっといい子になります…だから許してとは言わないけど…、見放さないで…」
PRINTFORMW 　ふふふ…うん、違う違う…これは違うんだ…そう…お姉様は何時も通り館で足組んで咲夜の紅茶を啜って私の帰りを待ってるんだ…	PRINTFORMW 　ふふふ…うん、違う違う…これは違うんだ…そう…お姉様は何時も通り館で足組んで咲夜の紅茶を啜って私の帰りを待ってるんだ…
PRINTFORMW 唯一つ言えるのは、それは動いていた。脈動するその塊はまるで生きているようで、部屋の中に響く音はここから出ているようだ。	PRINTFORMW 唯一つ言えるのは、それは動いていた。脈動するその塊はまるで生きているようで、部屋の中に響く音はここから出ているようだ。
PRINTFORMW 「い…や…いや…いやだ…いやだいやだいやだいやだいやだいやだいやだいやだいやだいやだいやだいやだいやだぁぁぁ！！！」	PRINTFORMW 「い…や…いや…いやだ…いやだいやだいやだいやだいやだいやだいやだいやだいやだいやだいやだいやだいやだぁぁぁ！！！」
PRINTFORMW 「こいつらは、コイツラは！私のニクを貪リ、生キ血を啜ッテ大地ニ顕現シタ忌ムベキ化物ダロォォォォガァァァァッ！！！」	PRINTFORMW 「こいつらは、コイツラは！私のニクを貪リ、生キ血を啜ッテ大地ニ顕現シタ忌ムベキ化物ダロォォォォガァァァァッ！！！」
PRINTFORMW 「うぁぁぁぁぁぁぁぁぁぁぁぁぁぁぁぁぁぁぁぁぁぁぁぁぁぁぁぁぁぁぁぁぁぁぁぁぁぁぁぁぁっ！！！！！！！！！！！！」	PRINTFORMW 「うぁぁぁぁぁぁぁぁぁぁぁぁぁぁぁぁぁぁぁぁぁぁぁぁぁぁぁぁぁぁぁぁぁぁぁぁぁぁぁぁぁっ！！！！！！！！！！！！」
PRINTFORMW 　…あはは…魔理沙ったら…もぅ、おっちょこちょいなんだから、身だしなみ位…気を付けないと…あははは…は…あはは…」	PRINTFORMW 　…あはは…魔理沙ったら…もぅ、おっちょこちょいなんだから、身だしなみ位…気を付けないと…あははは…は…あはは…」
PRINTFORMW 　あはは…咲夜ってば…一番大事にしてるヘッドドレス忘れるなんて…もぅ、しょうがないんだから……あはははは…」	PRINTFORMW 　あはは…咲夜ってば…一番大事にしてるヘッドドレス忘れるなんて…もぅ、しょうがないんだから……あはははは…」
PRINTFORMW 「っ、あ、あぁっ、あばれてるっ！痛い、痛い痛い痛い痛いいたいいたいイタイイタイイタイイタイィィィ！！！」	PRINTFORMW 「っ、あ、あぁっ、あばれてるっ！痛い、痛い痛い痛い痛いいたいいたいイタイイタイイタイイタイィィィ！！！」
PRINTFORMW 「いぎゃぁぁぁぁぁぁぁぁぁぁぁぁぁぁぁぁぁぁぁぁぁぁぁああああああああああああああっ！！！！！！！！！」	PRINTFORMW 「いぎゃぁぁぁぁぁぁぁぁぁぁぁぁぁぁぁぁぁぁぁぁぁぁぁああああああああああああああっ！！！！！！！！！」
PRINTFORMW 「…っ……うあぁぁぁぁぁぁぁぁぁぁぁぁぁぁぁぁぁぁぁぁぁぁぁぁぁぁぁぁぁぁぁぁぁぁぁぁっ！！！！！」	PRINTFORMW 「…っ……うあぁぁぁぁぁぁぁぁぁぁぁぁぁぁぁぁぁぁぁぁぁぁぁぁぁぁぁぁぁぁぁぁぁぁぁぁっ！！！！！」
PRINTFORMW 　は、はは…な訳無いよね…お姉様だもん…私のお姉様…世界で一番傲慢で強がりで最強最悪最高の吸血鬼……	PRINTFORMW 　は、はは…な訳無いよね…お姉様だもん…私のお姉様…世界で一番傲慢で強がりで最強最悪最高の吸血鬼……
PRINTFORMW 「……殺す、やっぱりお前も…あいつら化物の一人だ…いやぁぁぁぁぁぁぁぁぁぁぁぁぁぁぁぁっ！！！」	PRINTFORMW 「……殺す、やっぱりお前も…あいつら化物の一人だ…いやぁぁぁぁぁぁぁぁぁぁぁぁぁぁぁぁっ！！！」
PRINTFORMW 「何デ！ナンデ！ナンデェッ！ミンナヲ！ミンナヲッ喰ラウ！傷ツケル！壊ス！生カシチャ駄目ダッ！！」	PRINTFORMW 「何デ！ナンデ！ナンデェッ！ミンナヲ！ミンナヲッ喰ラウ！傷ツケル！壊ス！生カシチャ駄目ダッ！！」
PRINTFORMW 「お姉様…。お姉様の力で、この子を半妖で利発で心優しい子に生まれるように運命を導いてくれない？」	PRINTFORMW 「お姉様…。お姉様の力で、この子を半妖で利発で心優しい子に生まれるように運命を導いてくれない？」
PRINTFORMW 「でも…貴女は私が作り出した最初の存在なの…、だから、もう壊したくないの…自分勝手でごめんね」	PRINTFORMW 「でも…貴女は私が作り出した最初の存在なの…、だから、もう壊したくないの…自分勝手でごめんね」
PRINTFORMW 「咲夜…私怖いな…。生まれてくるのが私達見たいじゃなくてあんな化け物みたいなのだったらって…」	PRINTFORMW 「咲夜…私怖いな…。生まれてくるのが私達見たいじゃなくてあんな化け物みたいなのだったらって…」
PRINTFORMW ごめんね……っ…ごめんね……っ…ごめんねっ…………っ…護るって言ったのに……ごめんねっ……」	PRINTFORMW ごめんね……っ…ごめんね……っ…ごめんねっ…………っ…護るって言ったのに……ごめんねっ……」
PRINTFORMW 「外はどうなってるのかな…。私が居なくて皆心配してるかな…。だったら嬉しいけどね、えへへ」	PRINTFORMW 「外はどうなってるのかな…。私が居なくて皆心配してるかな…。だったら嬉しいけどね、えへへ」
PRINTFORMW 「えーっと…咲夜が使い方を教えてくれた奴だね…でもこれ人間しか使えない筈じゃ…ま、いっか」	PRINTFORMW 「えーっと…咲夜が使い方を教えてくれた奴だね…でもこれ人間しか使えない筈じゃ…ま、いっか」
PRINTFORMW 「はぁはぁ…あ、まって…まって行かないでよ……あーあ…。もう、オシオキ決定ね…クスクス♪」	PRINTFORMW 「はぁはぁ…あ、まって…まって行かないでよ……あーあ…。もう、オシオキ決定ね…クスクス♪」
PRINTFORMW 　まってぇぇぇぇぇぇぇぇぇぇぇぇぇぇぇぇぇぇぇぇぇぇぇぇぇぇぇぇぇぇぇぇぇぇぇ…！！！」	PRINTFORMW 　まってぇぇぇぇぇぇぇぇぇぇぇぇぇぇぇぇぇぇぇぇぇぇぇぇぇぇぇぇぇぇぇぇぇぇぇ…！！！」
PRINTFORMW まさに飲まれる瞬間。腰に提げていたレーヴァテインを振り上げて肉塊を一刀のもとに両断した。	PRINTFORMW まさに飲まれる瞬間。腰に提げていたレーヴァテインを振り上げて肉塊を一刀のもとに両断した。
PRINTFORML 「嫌だ…嫌だ！…もっといい子になります、錬金術も学びます、家事も咲夜顔負けな程学びます	PRINTFORML 「嫌だ…嫌だ！…もっといい子になります、錬金術も学びます、家事も咲夜顔負けな程学びます
PRINTFORML 　友達は大事にします、金策も確りこなします、もうなにも壊しません、皆の笑顔を護るために	PRINTFORML 　友達は大事にします、金策も確りこなします、もうなにも壊しません、皆の笑顔を護るために
PRINTFORMW 　………おいていかないでぇぇぇぇぇぇぇぇぇぇぇぇぇぇぇぇぇぇぇぇぇぇぇぇぇぇぇ！！！」	PRINTFORMW 　………おいていかないでぇぇぇぇぇぇぇぇぇぇぇぇぇぇぇぇぇぇぇぇぇぇぇぇぇぇぇ！！！」
PRINTFORMW 　うぁぁぁぁぁぁぁぁぁぁぁぁぁぁぁぁぁぁぁぁぁぁぁぁぁぁぁぁぁぁぁぁぁぁぁぁ…！！！」	PRINTFORMW 　うぁぁぁぁぁぁぁぁぁぁぁぁぁぁぁぁぁぁぁぁぁぁぁぁぁぁぁぁぁぁぁぁぁぁぁぁ…！！！」
PRINTFORMW 　うん…うん…そうだよ！お姉様が待ってるんだ！早く帰らなきゃ♪待っててね！お姉様…！」	PRINTFORMW 　うん…うん…そうだよ！お姉様が待ってるんだ！早く帰らなきゃ♪待っててね！お姉様…！」
PRINTFORMW 　親にとって自分の子はお宝なの！自分のお宝の心配しちゃ悪いかっ！鉄拳ッ！！…えへへ」	PRINTFORMW 　親にとって自分の子はお宝なの！自分のお宝の心配しちゃ悪いかっ！鉄拳ッ！！…えへへ」
PRINTFORMW 「おぉ、凄い凄い……って、そうやって獲物を見つけて食べに行くんだよね…そう言えば…」	PRINTFORMW 「おぉ、凄い凄い……って、そうやって獲物を見つけて食べに行くんだよね…そう言えば…」
PRINTFORMW 「いやぁっ！やめて！乱暴しないでっ！ひゃぁぁ♪あんっ♪とれちゃ♪あぁぁぁぁぁんっ…」	PRINTFORMW 「いやぁっ！やめて！乱暴しないでっ！ひゃぁぁ♪あんっ♪とれちゃ♪あぁぁぁぁぁんっ…」
PRINTFORMW 「こ…このぉ……はっ…はぁ……絶対見つけ出して…ころしてやる…コロシテヤルゥ…！！」	PRINTFORMW 「こ…このぉ……はっ…はぁ……絶対見つけ出して…ころしてやる…コロシテヤルゥ…！！」
PRINTFORMW （　はいけい　おかあさま　ごめんなさい　わたしはおかあさまといっしょにいきられません	PRINTFORMW （　はいけい　おかあさま　ごめんなさい　わたしはおかあさまといっしょにいきられません
PRINTFORML キャラは自分と大事な物に仇なす者には非情、でもメンタルは弱い。ついでにぼっちは嫌。	PRINTFORML キャラは自分と大事な物に仇なす者には非情、でもメンタルは弱い。ついでにぼっちは嫌。
PRINTFORMW 「ブレスレット型の触媒かぁ…気休めだなぁ…まぁ装飾品として付ける程度でいいかもね」	PRINTFORMW 「ブレスレット型の触媒かぁ…気休めだなぁ…まぁ装飾品として付ける程度でいいかもね」
PRINTFORMW 「前に霊夢に教えてもらったけど…、式神とかにしてアイツらも従わせられないかなぁ…」	PRINTFORMW 「前に霊夢に教えてもらったけど…、式神とかにしてアイツらも従わせられないかなぁ…」
PRINTFORMW それは隙間妖怪の仕業でもなく、人喰いの仕業でもなく、しかし一つだけ解っていることは	PRINTFORMW それは隙間妖怪の仕業でもなく、人喰いの仕業でもなく、しかし一つだけ解っていることは
PRINTFORMW 「はぁ…はぁ…はぁ……どうだぁぁぁぁっ！ザマァ見ろぉ！！！…あ、はっはっは…！」	PRINTFORMW 「はぁ…はぁ…はぁ……どうだぁぁぁぁっ！ザマァ見ろぉ！！！…あ、はっはっは…！」
PRINTFORMW 「あ、大丈夫だった？無事？怪我して無い！？陰りは無い？あざは無い？曇って無い？！	PRINTFORMW 「あ、大丈夫だった？無事？怪我して無い！？陰りは無い？あざは無い？曇って無い？！
PRINTFORMW 「露骨に罠臭い…でも大丈夫みたいだから一応持っておこう…縁起は担ぐ物よ…うん…」	PRINTFORMW 「露骨に罠臭い…でも大丈夫みたいだから一応持っておこう…縁起は担ぐ物よ…うん…」
PRINTFORMW 「蓋は…してあるね……。怖いなぁ…中からあいつらが出てきたりとかしないかなぁ…」	PRINTFORMW 「蓋は…してあるね……。怖いなぁ…中からあいつらが出てきたりとかしないかなぁ…」
PRINTFORMW 「だ、だめっ！なかはもうおかあさまにだけあげるの！！」;母子の相思相愛…イケる！	PRINTFORMW 「だ、だめっ！なかはもうおかあさまにだけあげるの！！」;母子の相思相愛…イケる！
﻿PRINTFORML 霊夢口上のマルパクリです。作者様にこの場を借りて多謝。後、構文なんて知らぬぇ。	PRINTFORML 霊夢口上のマルパクリです。作者様にこの場を借りて多謝。後、構文なんて知らぬぇ。
PRINTFORMW 「ぐっ…殺す……でも…あの子に罪は無い……いや、ちょっとは有るけど……でも…」	PRINTFORMW 「ぐっ…殺す……でも…あの子に罪は無い……いや、ちょっとは有るけど……でも…」
PRINTFORMW 「もっと身代わりしてくれないかな…なんて、ごめんごめん、言ってみただけだよ～」	PRINTFORMW 「もっと身代わりしてくれないかな…なんて、ごめんごめん、言ってみただけだよ～」
PRINTFORMW 「はぁ…はぁ…また、犯されちゃったな…もぅ…後でオシオキしなきゃ…クスクス♪」	PRINTFORMW 「はぁ…はぁ…また、犯されちゃったな…もぅ…後でオシオキしなきゃ…クスクス♪」
PRINTFORMW 「あ、ふあ、あっ、だめぇ♪おかあさまいがいとは…もぅ…しないのにぃ…あぁん♪」	PRINTFORMW 「あ、ふあ、あっ、だめぇ♪おかあさまいがいとは…もぅ…しないのにぃ…あぁん♪」
PRINTFORMW 「うあぁぁぁん！おかあさまのためにのこしてたのにぃ！！うえぇぇぇぇぇん！！！」	PRINTFORMW 「うあぁぁぁん！おかあさまのためにのこしてたのにぃ！！うえぇぇぇぇぇん！！！」
PRINTFORML そして娘にはべたぼれ…壊すことしかできないフランちゃんは作る喜びを得ました←	PRINTFORML そして娘にはべたぼれ…壊すことしかできないフランちゃんは作る喜びを得ました←
PRINTFORMW 　待って！行かないで！置いて行かないで！待って待って！置いて行かないで！！！	PRINTFORMW 　待って！行かないで！置いて行かないで！待って待って！置いて行かないで！！！
PRINTFORMW 「貴女は私の子供…、私は貴女のお母さん。生みの親よ。ていうか、言葉わかる？」	PRINTFORMW 「貴女は私の子供…、私は貴女のお母さん。生みの親よ。ていうか、言葉わかる？」
PRINTFORMW 「その時は貴女も一緒だよ。そして私の本当の住んでる世界を案内してあげるから」	PRINTFORMW 「その時は貴女も一緒だよ。そして私の本当の住んでる世界を案内してあげるから」
PRINTFORMW 「っ、なんで躊躇うんだ…いいんだ、化物なんだ…殺せば…いいじゃないかっ！！」	PRINTFORMW 「っ、なんで躊躇うんだ…いいんだ、化物なんだ…殺せば…いいじゃないかっ！！」
PRINTFORMW 「うぇえ？あの子の娘なの？うぅん、通りで化物分が強い気が…ってなんでもない！	PRINTFORMW 「うぇえ？あの子の娘なの？うぅん、通りで化物分が強い気が…ってなんでもない！
PRINTFORMW 「はぁっ、はぁっ、…もう、ちょっと…まって…せめてもうちょっとだけでも…！」	PRINTFORMW 「はぁっ、はぁっ、…もう、ちょっと…まって…せめてもうちょっとだけでも…！」
PRINTFORMW 「あ……あぁ……イっちゃった、わたし……こどもに、イかされちゃったよぉ……」	PRINTFORMW 「あ……あぁ……イっちゃった、わたし……こどもに、イかされちゃったよぉ……」
PRINTFORMW ――フランドールスカーレットはそんな中、妖精の友達と湖の周りを散歩していた。	PRINTFORMW ――フランドールスカーレットはそんな中、妖精の友達と湖の周りを散歩していた。
PRINTFORMW 「大丈夫だよ、フランちゃん…唯の洞窟だよ。多分地底に繋がってる一つの道だよ」	PRINTFORMW 「大丈夫だよ、フランちゃん…唯の洞窟だよ。多分地底に繋がってる一つの道だよ」
PRINTFORMW 「あ…つらぬいたんだ……やりすぎちゃった…おかあさまようだったのに…てへ♪」	PRINTFORMW 「あ…つらぬいたんだ……やりすぎちゃった…おかあさまようだったのに…てへ♪」
PRINTFORMW 「ナンデ、何デ！コロセ、コロセヨォォォォォォォォォォォォォォォ！！！！！」	PRINTFORMW 「ナンデ、何デ！コロセ、コロセヨォォォォォォォォォォォォォォォ！！！！！」
PRINTFORML 　もうじき５００だもんね…貴族だったら４世代目を迎えててもおかしくないって	PRINTFORML 　もうじき５００だもんね…貴族だったら４世代目を迎えててもおかしくないって
PRINTFORM 「うあぁあんっ♪おっぱいでかんじちゃ…ひぅっ♪身体じゅう吸われてる感覚ぅ…♪	PRINTFORM 「うあぁあんっ♪おっぱいでかんじちゃ…ひぅっ♪身体じゅう吸われてる感覚ぅ…♪
PRINTFORMW すると足元から突然ピンク色の霧が辺りを包みこみ、視界はそれ一色に染まった。	PRINTFORMW すると足元から突然ピンク色の霧が辺りを包みこみ、視界はそれ一色に染まった。
PRINTFORMW 「あはっ……♪　これでやめちゃやだよ……ずっとずっと、もーっとしてぇ…♪」	PRINTFORMW 「あはっ……♪　これでやめちゃやだよ……ずっとずっと、もーっとしてぇ…♪」
PRINTFORMW 「……初めてなの。自分が生み出すなんてこと…壊してばっかりだった自分が」	PRINTFORMW 「……初めてなの。自分が生み出すなんてこと…壊してばっかりだった自分が」
PRINTFORMW 「…あ、ちょっとぉ…慰めなんかいらないよぉ。……もう、しょうがない子ね」	PRINTFORMW 「…あ、ちょっとぉ…慰めなんかいらないよぉ。……もう、しょうがない子ね」
PRINTFORMW 「…ん…、じゃあ私は行くね。此処を壊して来なきゃ…。皆で脱出するために」	PRINTFORMW 「…ん…、じゃあ私は行くね。此処を壊して来なきゃ…。皆で脱出するために」
PRINTFORMW 「そうそう、咲夜の料理は美味しいんだよ。帰ったら食べさせてあげるからね」	PRINTFORMW 「そうそう、咲夜の料理は美味しいんだよ。帰ったら食べさせてあげるからね」
PRINTFORMW 「…もうこんなに…あり得ない…まぁ、あり得ない奴の子だし…そんなもんか」	PRINTFORMW 「…もうこんなに…あり得ない…まぁ、あり得ない奴の子だし…そんなもんか」
PRINTFORMW 「うぅっ、もう、動けないかも……いや、まだまだ…なんとか…しなきゃ…！」	PRINTFORMW 「うぅっ、もう、動けないかも……いや、まだまだ…なんとか…しなきゃ…！」
PRINTFORMW 「ちょ、ちょっと咲夜……ま、まって…いや…なんでもない…ごめんなさい…」	PRINTFORMW 「ちょ、ちょっと咲夜……ま、まって…いや…なんでもない…ごめんなさい…」
PRINTFORMW 　おかあさまという　りっぱなおかあさんが　わたしにはいたということを　）	PRINTFORMW 　おかあさまという　りっぱなおかあさんが　わたしにはいたということを　）
PRINTFORMW 「……っ、なんで…なんで躊躇ってるんだよぉぉぉ私ィィィィィィ！！！！」	PRINTFORMW 「……っ、なんで…なんで躊躇ってるんだよぉぉぉ私ィィィィィィ！！！！」
PRINTFORMW 「まぁ貴女見たいに生まれてくれればいいんだけどねぇ…。未来が暗いよ…」	PRINTFORMW 「まぁ貴女見たいに生まれてくれればいいんだけどねぇ…。未来が暗いよ…」
PRINTFORMW 「触手がもはや手足だねぇ、阿修羅見たい…。でも誰彼犯しちゃ駄目だよ？」	PRINTFORMW 「触手がもはや手足だねぇ、阿修羅見たい…。でも誰彼犯しちゃ駄目だよ？」
PRINTFORMW 「……おぉ…ねぇ…がい……して…い～い……？ありがと～…ぐぅ…すぅ…」	PRINTFORMW 「……おぉ…ねぇ…がい……して…い～い……？ありがと～…ぐぅ…すぅ…」
PRINTFORMW 「はぁ…なんだろう、疲れが早く為ってる気がする…気も滅入ったかなぁ…」	PRINTFORMW 「はぁ…なんだろう、疲れが早く為ってる気がする…気も滅入ったかなぁ…」
PRINTFORMW 「いぎゃぁぁぁぁぁっ！い、いだい…ぢから…でない…ぎぃぁぁぁぁっ！！」	PRINTFORMW 「いぎゃぁぁぁぁぁっ！い、いだい…ぢから…でない…ぎぃぁぁぁぁっ！！」
PRINTFORMW 「…………っ…ごめんね…こんなことしかしてあげられなくて…っ…ぅぅ…」	PRINTFORMW 「…………っ…ごめんね…こんなことしかしてあげられなくて…っ…ぅぅ…」
PRINTFORMW 気が付くと、其処は先程の洞窟とは違う…さらに禍々しさが漂う部屋だった。	PRINTFORMW 気が付くと、其処は先程の洞窟とは違う…さらに禍々しさが漂う部屋だった。
PRINTFORMW 　ねぇ！ねぇ！ドコ？！ドコにイったの？！ネェってバ！ねェェェェ？！」	PRINTFORMW 　ねぇ！ねぇ！ドコ？！ドコにイったの？！ネェってバ！ねェェェェ？！」
PRINTFORMW 「ひゃあああん♪つよ、つよひぃぃぃぃ♪だめ、イっちゃうよぉぉぉぉ♪」	PRINTFORMW 「ひゃあああん♪つよ、つよひぃぃぃぃ♪だめ、イっちゃうよぉぉぉぉ♪」
PRINTFORMW （ご…ん…さい…おね…さま…………さき……そらへ……い…き…………）	PRINTFORMW （ご…ん…さい…おね…さま…………さき……そらへ……い…き…………）
PRINTFORMW 好奇心旺盛な二人は噂の事等気にすることなく、その中に入ってしまった。	PRINTFORMW 好奇心旺盛な二人は噂の事等気にすることなく、その中に入ってしまった。
PRINTFORMW 耳の奥に聞こえた肉の弾ける音。それに釣られて振りかえるフランドール。	PRINTFORMW 耳の奥に聞こえた肉の弾ける音。それに釣られて振りかえるフランドール。
PRINTFORMW 不審がって観察していると、その肉塊の隅に見覚えのある布切れがあった。	PRINTFORMW 不審がって観察していると、その肉塊の隅に見覚えのある布切れがあった。
PRINTFORMW 胴に巻き付いたそれはきつく締めあげ、フランドールを自身に引き寄せた。	PRINTFORMW 胴に巻き付いたそれはきつく締めあげ、フランドールを自身に引き寄せた。
PRINTFORMW 何度待っても助けは来ない。きっと自分一人しか居ないのかもしれない…。	PRINTFORMW 何度待っても助けは来ない。きっと自分一人しか居ないのかもしれない…。
PRINTFORMW 　……リボンが…解けて…あって……なんか…赤くて……よごれてて………	PRINTFORMW 　……リボンが…解けて…あって……なんか…赤くて……よごれてて………
PRINTFORMW 「何デ！ナンデ！ナンデッ！コイツハワタシヲ犯シテ作ラレタ化物ダ！」	PRINTFORMW 「何デ！ナンデ！ナンデッ！コイツハワタシヲ犯シテ作ラレタ化物ダ！」
PRINTFORMW 「咲夜、大丈夫？皆で無事に帰って、咲夜の美味しいケーキ食べたいよ」	PRINTFORMW 「咲夜、大丈夫？皆で無事に帰って、咲夜の美味しいケーキ食べたいよ」
PRINTFORMW 「早く帰りたいなぁ…この子には平和な幻想郷を見せてあげたいもん…」	PRINTFORMW 「早く帰りたいなぁ…この子には平和な幻想郷を見せてあげたいもん…」
PRINTFORMW 「え？何か見つかったの？っ……何何見せて？…あ、ごめんありがと。」	PRINTFORMW 「え？何か見つかったの？っ……何何見せて？…あ、ごめんありがと。」
PRINTFORMW 「あんまり見た覚えないけど…凄い精巧だ……霊夢が落としたのかな？」	PRINTFORMW 「あんまり見た覚えないけど…凄い精巧だ……霊夢が落としたのかな？」
PRINTFORMW 「これ…スペルカードだ…ボケてるから何のカードかはわからないけど…	PRINTFORMW 「これ…スペルカードだ…ボケてるから何のカードかはわからないけど…
PRINTFORMW 「くぅ…っと、ねちゃダメダメ…。辺りに異常は無いみたいね…ふぅ…」	PRINTFORMW 「くぅ…っと、ねちゃダメダメ…。辺りに異常は無いみたいね…ふぅ…」
PRINTFORMW 「んっ、んんん…！んんむぷはぁっ…！癖になっちゃいそう…えへへ♪」	PRINTFORMW 「んっ、んんん…！んんむぷはぁっ…！癖になっちゃいそう…えへへ♪」
PRINTFORMW 「…じょ、冗談だって。流石に痛いし、それやったら死んじゃうから…」	PRINTFORMW 「…じょ、冗談だって。流石に痛いし、それやったら死んじゃうから…」
PRINTFORMW 「やっ、いやぁ！いやぁぁぁぁぁぁぁぁぁぁぁぁぁぁぁぁぁ！！！！！」	PRINTFORMW 「やっ、いやぁ！いやぁぁぁぁぁぁぁぁぁぁぁぁぁぁぁぁぁ！！！！！」
PRINTFORMW 「いってて……私だから無事だったものの…普通ならこれ死んじゃう…」	PRINTFORMW 「いってて……私だから無事だったものの…普通ならこれ死んじゃう…」
PRINTFORMW 　ね、ねぇ、ちょっと！何処にいったの？！ねぇっ！ねぇってば！！！	PRINTFORMW 　ね、ねぇ、ちょっと！何処にいったの？！ねぇっ！ねぇってば！！！
PRINTFORMW 「はぁ、はぁ…こ、ころ…っひゃっ、何？！いやぁ、吸わないで！！」	PRINTFORMW 「はぁ、はぁ…こ、ころ…っひゃっ、何？！いやぁ、吸わないで！！」
PRINTFORMW 「禁忌『フォーオブアカインド』…あとはとっとと始末するだけね…」	PRINTFORMW 「禁忌『フォーオブアカインド』…あとはとっとと始末するだけね…」
PRINTFORMW 物を理解した瞬間、突如肉塊から肉の様な帯がフランドールを襲った。	PRINTFORMW 物を理解した瞬間、突如肉塊から肉の様な帯がフランドールを襲った。
PRINTFORML 「あっん、あっはぁん♪きんもちぃぃぃぃぃぃぃぃぃぃぃぃぃぃぃ♪」	PRINTFORML 「あっん、あっはぁん♪きんもちぃぃぃぃぃぃぃぃぃぃぃぃぃぃぃ♪」
PRINTFORMW 「あ…すごくべとべとして…きもちよさ……って、だめだめぇ！！！」	PRINTFORMW 「あ…すごくべとべとして…きもちよさ……って、だめだめぇ！！！」
PRINTFORMW 「い、いや、いやだぁぁぁぁぁぁぁぁぁぁぁぁぁぁぁぁぁぁぁぁ！」	PRINTFORMW 「い、いや、いやだぁぁぁぁぁぁぁぁぁぁぁぁぁぁぁぁぁぁぁぁ！」
PRINTFORMW 「い、いや、また子供作るのはいやぁぁぁぁぁぁぁぁぁぁぁぁっ！」	PRINTFORMW 「い、いや、また子供作るのはいやぁぁぁぁぁぁぁぁぁぁぁぁっ！」
PRINTFORMW 「魔理沙、気を付けてね。とても魔理沙の手に負える所じゃないよ」	PRINTFORMW 「魔理沙、気を付けてね。とても魔理沙の手に負える所じゃないよ」
PRINTFORMW 「いざって時は…私が相手するから…。その、中に出さなきゃね？」	PRINTFORMW 「いざって時は…私が相手するから…。その、中に出さなきゃね？」
PRINTFORMW 「そう言えばこの辺で見つける食用の草とかキノコとかあるけど…」	PRINTFORMW 「そう言えばこの辺で見つける食用の草とかキノコとかあるけど…」
PRINTFORMW 「ごめんね…何もできないうえに…こんな仕打ち……ごめんね…っ」	PRINTFORMW 「ごめんね…何もできないうえに…こんな仕打ち……ごめんね…っ」
PRINTFORMW 「やっ、やめてぇっ！！私のはお前らの為にあるんじゃないの！！」	PRINTFORMW 「やっ、やめてぇっ！！私のはお前らの為にあるんじゃないの！！」
PRINTFORMW 「お腹が膨れてきてる…でも妊娠じゃない…ってことはこれは…！」	PRINTFORMW 「お腹が膨れてきてる…でも妊娠じゃない…ってことはこれは…！」
PRINTFORMW 「はぁ、なんかだるいなぁ…こんな状況で言える事じゃないけど…」	PRINTFORMW 「はぁ、なんかだるいなぁ…こんな状況で言える事じゃないけど…」
PRINTFORMW 「もぅ、焦らなくていいからぁん♪じっくり味わって…よぉぉぉ♪」	PRINTFORMW 「もぅ、焦らなくていいからぁん♪じっくり味わって…よぉぉぉ♪」
PRINTFORMW 「と、とれひゃうぅ…♪ひゅよひゅぎてひくびひょえひゃうぅぅ♪」	PRINTFORMW 「と、とれひゃうぅ…♪ひゅよひゅぎてひくびひょえひゃうぅぅ♪」
PRINTFORMW 「結界かんりょぉ…はぁ…早くお風呂…お風呂入りたいぃ…く～…」	PRINTFORMW 「結界かんりょぉ…はぁ…早くお風呂…お風呂入りたいぃ…く～…」
PRINTFORMW 友達を呼んでみる。しかし肉塊は変わらずにその場で脈打つばかり。	PRINTFORMW 友達を呼んでみる。しかし肉塊は変わらずにその場で脈打つばかり。
PRINTFORMW 絶対脱出してやる…そして、絶対友達も助けだして見せる…そして。	PRINTFORMW 絶対脱出してやる…そして、絶対友達も助けだして見せる…そして。
PRINTFORML 「はぁっ……んっ♪わたしもぉこどもつくりたいし、うみたぁい♪」	PRINTFORML 「はぁっ……んっ♪わたしもぉこどもつくりたいし、うみたぁい♪」
PRINTFORMW 「お願い！皆！助けて！私一人じゃ出来ないの！！ねぇってば！」	PRINTFORMW 「お願い！皆！助けて！私一人じゃ出来ないの！！ねぇってば！」
PRINTFORMW 「…どうしよ…どうすればいいの…？…だめ…わかんない……っ」	PRINTFORMW 「…どうしよ…どうすればいいの…？…だめ…わかんない……っ」
PRINTFORMW 「じゃあ気を付けて。何かあったら直ぐにお母さんを呼んでね？」	PRINTFORMW 「じゃあ気を付けて。何かあったら直ぐにお母さんを呼んでね？」
PRINTFORMW 「これ魔理沙のじゃないの？え？使っていいの？うん、ありがと」	PRINTFORMW 「これ魔理沙のじゃないの？え？使っていいの？うん、ありがと」
PRINTFORMW 「――――よし、契約完了。これで私の僕として働いてもらうわ」	PRINTFORMW 「――――よし、契約完了。これで私の僕として働いてもらうわ」
PRINTFORMW 「…ふぅ…んっ…誰も…んっ、見てない…あんっ…よね……っ♪」	PRINTFORMW 「…ふぅ…んっ…誰も…んっ、見てない…あんっ…よね……っ♪」
PRINTFORMW 「ん…治ったかな？ほっ、これからは病魔にも気を付けなきゃ…」	PRINTFORMW 「ん…治ったかな？ほっ、これからは病魔にも気を付けなきゃ…」
PRINTFORMW 「あ、あはは……あんな化物の子が……私の中に……あははは…」	PRINTFORMW 「あ、あはは……あんな化物の子が……私の中に……あははは…」
PRINTFORMW （今わかった事…私の中に居る子は…一応人型だということだ…）	PRINTFORMW （今わかった事…私の中に居る子は…一応人型だということだ…）
PRINTFORMW 「こ、このっ…ひぃうっ？！だめっ…目を…目を壊さなきゃぁ！」	PRINTFORMW 「こ、このっ…ひぃうっ？！だめっ…目を…目を壊さなきゃぁ！」
PRINTFORMW 「ひぃうっ？！い、いきなり…あぁん♪目、目を…目をぉぉ…！」	PRINTFORMW 「ひぃうっ？！い、いきなり…あぁん♪目、目を…目をぉぉ…！」
PRINTFORMW 「そ、そうかなぁ…なんか変なにおいもするし…変な空気だし…」	PRINTFORMW 「そ、そうかなぁ…なんか変なにおいもするし…変な空気だし…」
PRINTFORMW 「ばくやほうけん！！」;元ネタは光栄封神演技の天化様の糞宝具	PRINTFORMW 「ばくやほうけん！！」;元ネタは光栄封神演技の天化様の糞宝具
PRINTFORMW 「でもぉ♪もっときもちよいやりかたぁ…みつけもしたいぃ…♪」	PRINTFORMW 「でもぉ♪もっときもちよいやりかたぁ…みつけもしたいぃ…♪」
PRINTFORMW 「皆！其処に居るんでしょ？！ねぇってば！ねぇ！ねぇ！！！」	PRINTFORMW 「皆！其処に居るんでしょ？！ねぇってば！ねぇ！ねぇ！！！」
PRINTFORMW 　どうしよ…一気にこんなに連れ帰っちゃお姉様怒るよねぇ…」	PRINTFORMW 　どうしよ…一気にこんなに連れ帰っちゃお姉様怒るよねぇ…」
PRINTFORMW 「はぁ、早く帰って私の居るべき世界を紹介してあげるからね」	PRINTFORMW 「はぁ、早く帰って私の居るべき世界を紹介してあげるからね」
PRINTFORMW 「ごめんなさい…、私が全てを壊してくるから…それまで…ね」	PRINTFORMW 「ごめんなさい…、私が全てを壊してくるから…それまで…ね」
PRINTFORMW 「これが夢だったらいいなぁ…まぁそんな訳無いだろうけど…」	PRINTFORMW 「これが夢だったらいいなぁ…まぁそんな訳無いだろうけど…」
PRINTFORMW 「はぁんっ……あぁぁぁっああ、あああああああああぁん…♪」	PRINTFORMW 「はぁんっ……あぁぁぁっああ、あああああああああぁん…♪」
PRINTFORMW 「そんな…確かにアレだけ出されてたら…でも妊娠だなんて…」	PRINTFORMW 「そんな…確かにアレだけ出されてたら…でも妊娠だなんて…」
PRINTFORMW 「あ、ごめんなさい、決して他意は…あ、いや、ちょ…まっ…」	PRINTFORMW 「あ、ごめんなさい、決して他意は…あ、いや、ちょ…まっ…」
PRINTFORMW そんな他愛もない会話をしながら涼しい畔を歩きまわっていた。	PRINTFORMW そんな他愛もない会話をしながら涼しい畔を歩きまわっていた。
PRINTFORMW 「……ぷはっ、…はぁ、はぁ……だめ…力…はいんない……っ」	PRINTFORMW 「……ぷはっ、…はぁ、はぁ……だめ…力…はいんない……っ」
PRINTFORMW 「わたしにはおかあさまみたいにみえないけど…だぁぁぁっ！」	PRINTFORMW 「わたしにはおかあさまみたいにみえないけど…だぁぁぁっ！」
PRINTFORMW 「はぁっ、いいっ……じぶんだけでもきもちよかったぁ……♪」	PRINTFORMW 「はぁっ、いいっ……じぶんだけでもきもちよかったぁ……♪」
PRINTFORMW 「あはっ……♪　これでやめちゃ、やだよ……もっとぉ……♪」	PRINTFORMW 「あはっ……♪　これでやめちゃ、やだよ……もっとぉ……♪」
PRINTFORMW 「んっ、今はそれどころじゃ……あっ、ないのに…んふっ♪」	PRINTFORMW 「んっ、今はそれどころじゃ……あっ、ないのに…んふっ♪」
PRINTFORMW 「ふぁぁぁ…もぅ、安全な場所に…いってから、ひぐぅっ♪」	PRINTFORMW 「ふぁぁぁ…もぅ、安全な場所に…いってから、ひぐぅっ♪」
PRINTFORMW 「んっ？！いやっ、中出されてる！…だめ、きもぢぃぃ…♪」	PRINTFORMW 「んっ？！いやっ、中出されてる！…だめ、きもぢぃぃ…♪」
PRINTFORMW 「ひっ……まさか…いやだいやだいやだいやだぁぁぁぁ！！」	PRINTFORMW 「ひっ……まさか…いやだいやだいやだいやだぁぁぁぁ！！」
PRINTFORMW 「はぁっ……まだ…それどころじゃ…ないでしょ……うっ♪」	PRINTFORMW 「はぁっ……まだ…それどころじゃ…ないでしょ……うっ♪」
PRINTFORMW 「こうなったら元を締めに行かないと埒が明かないかもね…」	PRINTFORMW 「こうなったら元を締めに行かないと埒が明かないかもね…」
PRINTFORMW 　待って！置いていかないで！待って、まってってばぁ！！！	PRINTFORMW 　待って！置いていかないで！待って、まってってばぁ！！！
PRINTFORMW 「ねぇっ！早く！早く助けて！！出してっ！助けてよぉ！！」	PRINTFORMW 「ねぇっ！早く！早く助けて！！出してっ！助けてよぉ！！」
PRINTFORMW 「あがー……面影しかないけど、どう考えてもあの子の娘だ…	PRINTFORMW 「あがー……面影しかないけど、どう考えてもあの子の娘だ…
PRINTFORMW 「……ごめんね…ごめんね…私…何もしてあげられなくて…」	PRINTFORMW 「……ごめんね…ごめんね…私…何もしてあげられなくて…」
PRINTFORMW 「気休めだけど…結界……置いておくから……ごめんね…っ」	PRINTFORMW 「気休めだけど…結界……置いておくから……ごめんね…っ」
PRINTFORMW 「衣？うわっ、腕に巻き付いた！…へぇ武器になるんだね…」	PRINTFORMW 「衣？うわっ、腕に巻き付いた！…へぇ武器になるんだね…」
PRINTFORMW 　魔法触媒としても使えるわね…ま、私には唯の剣だけど…」	PRINTFORMW 　魔法触媒としても使えるわね…ま、私には唯の剣だけど…」
PRINTFORMW 「う、裁縫道具…嬉しいけど私は……って、一人でに動く？」	PRINTFORMW 「う、裁縫道具…嬉しいけど私は……って、一人でに動く？」
PRINTFORMW 　ふぇ？やっぱいいって？うん…じゃあ寝るー…すぅ…すぅ」	PRINTFORMW 　ふぇ？やっぱいいって？うん…じゃあ寝るー…すぅ…すぅ」
PRINTFORMW 　…よかったぁ…そうそう何度もあってたまるもんですか…」	PRINTFORMW 　…よかったぁ…そうそう何度もあってたまるもんですか…」
PRINTFORMW 「…あれ？なんだかお腹周りが大きい…っ、もしかして…！」	PRINTFORMW 「…あれ？なんだかお腹周りが大きい…っ、もしかして…！」
PRINTFORMW 「あぐぅぅっ！こ、このぉ！出るなら出てこいよぉぉぉ！！」	PRINTFORMW 「あぐぅぅっ！こ、このぉ！出るなら出てこいよぉぉぉ！！」
PRINTFORMW 「あぐぅ…い、いまだよ…出るなら出て…っいぐぅぅぅ…！」	PRINTFORMW 「あぐぅ…い、いまだよ…出るなら出て…っいぐぅぅぅ…！」
PRINTFORMW 「ま、いっか……。好きな人にあげられないかもしれないし」	PRINTFORMW 「ま、いっか……。好きな人にあげられないかもしれないし」
PRINTFORMW 「な、お、お姉様何よそれ！！もういいわよ！知らない！！」	PRINTFORMW 「な、お、お姉様何よそれ！！もういいわよ！知らない！！」
PRINTFORMW 「壁もこんなんじゃ…あんまり隅っこに居るのは危険だね…」	PRINTFORMW 「壁もこんなんじゃ…あんまり隅っこに居るのは危険だね…」
PRINTFORMW 「いいっ、きもちいぃっ♪　やっぱりわたし…ふぁあんっ！」	PRINTFORMW 「いいっ、きもちいぃっ♪　やっぱりわたし…ふぁあんっ！」
PRINTFORMW 「早く…はやくシネェェェェェェェェェェェェ！！！！！」	PRINTFORMW 「早く…はやくシネェェェェェェェェェェェェ！！！！！」
PRINTFORMW 「いやぁぁぁぁ！！離せ、離せぇぇぇぇぇぇぇぇぇ！！！」	PRINTFORMW 「いやぁぁぁぁ！！離せ、離せぇぇぇぇぇぇぇぇぇ！！！」
PRINTFORMW 「はぁ…はぁ…えへへ…、何故かお腹だけは護ってる私…」	PRINTFORMW 「はぁ…はぁ…えへへ…、何故かお腹だけは護ってる私…」
PRINTFORMW 「あうっ…らめ、らよぉ！！赤ちゃんしんじゃ…ひぅっ♪」	PRINTFORMW 「あうっ…らめ、らよぉ！！赤ちゃんしんじゃ…ひぅっ♪」
PRINTFORMW 「だめ…勝てない……わたしじゃ……マモレナイ…………」	PRINTFORMW 「だめ…勝てない……わたしじゃ……マモレナイ…………」
PRINTFORMW 「ひっ…ふぅん…だめ…がまん……しなきゃぁ…ふぁぁ♪」	PRINTFORMW 「ひっ…ふぅん…だめ…がまん……しなきゃぁ…ふぁぁ♪」
PRINTFORMW 「見ないで…魔理沙…。確かに化物がお腹に居るけどね…」	PRINTFORMW 「見ないで…魔理沙…。確かに化物がお腹に居るけどね…」
PRINTFORMW 「…作るってこんな感じなのかな…いや、なんでもない…」	PRINTFORMW 「…作るってこんな感じなのかな…いや、なんでもない…」
PRINTFORMW 「えへへ…こんなんでよろしければ…おねがいしまーす…」	PRINTFORMW 「えへへ…こんなんでよろしければ…おねがいしまーす…」
PRINTFORMW 「すぅ…すぅ…はっ。ダメダメ！こんなところで転寝は！」	PRINTFORMW 「すぅ…すぅ…はっ。ダメダメ！こんなところで転寝は！」
PRINTFORMW 「ふぁ～…眠い……じゃあ、お願いします…おやすみぃ…」	PRINTFORMW 「ふぁ～…眠い……じゃあ、お願いします…おやすみぃ…」
PRINTFORMW 「…疲れがとれない…あんまり無理しないようにしよう…」	PRINTFORMW 「…疲れがとれない…あんまり無理しないようにしよう…」
PRINTFORMW 　…唯の杞憂か…まぁ、そうそう何度もあるわけないよね」	PRINTFORMW 　…唯の杞憂か…まぁ、そうそう何度もあるわけないよね」
PRINTFORMW 「いったたたた……って、全然無事ってどういうこと？！」	PRINTFORMW 「いったたたた……って、全然無事ってどういうこと？！」
PRINTFORMW しかし、そんな空間に奇妙な洞窟の入口の様な物が現れた。	PRINTFORMW しかし、そんな空間に奇妙な洞窟の入口の様な物が現れた。
PRINTFORMW 体液を被ることなくその場を離れ、崩れる肉塊を見守った。	PRINTFORMW 体液を被ることなくその場を離れ、崩れる肉塊を見守った。
PRINTFORMW 「ばつぼたんぎり！」;元ネタはるろ剣の聖攻撃モーション	PRINTFORMW 「ばつぼたんぎり！」;元ネタはるろ剣の聖攻撃モーション
PRINTFORMW 「んんっ…だめぇ、やっぱりやめられないよぉ…うふん♪」	PRINTFORMW 「んんっ…だめぇ、やっぱりやめられないよぉ…うふん♪」
PRINTFORMW 「だ、だめぇ……がまん、できなくなっちゃうよぉ……！」	PRINTFORMW 「だ、だめぇ……がまん、できなくなっちゃうよぉ……！」
PRINTFORM 「はぁっ……♪だめぇ…おかあさまとしたいよぉ…うぅん…っ	PRINTFORM 「はぁっ……♪だめぇ…おかあさまとしたいよぉ…うぅん…っ
PRINTFORM 「きたぁっ♪イっちゃう、みんなとこーびしてイっちゃうよぉ	PRINTFORM 「きたぁっ♪イっちゃう、みんなとこーびしてイっちゃうよぉ
PRINTFORMW 　　　　　　　　　　　　　　　　　　　　　助けて……	PRINTFORMW 　　　　　　　　　　　　　　　　　　　　　助けて……
PRINTFORMW 「やだ、やだ…！こいつらなんかに奪われたくない…！」	PRINTFORMW 「やだ、やだ…！こいつらなんかに奪われたくない…！」
PRINTFORMW 「あ、あぁっ……だめぇ、また子供できちゃうぅ……♪」	PRINTFORMW 「あ、あぁっ……だめぇ、また子供できちゃうぅ……♪」
PRINTFORMW 「ねぇ、聞こえてるんでしょ？！ねぇってばねぇっ！！」	PRINTFORMW 「ねぇ、聞こえてるんでしょ？！ねぇってばねぇっ！！」
PRINTFORMW 「……え？酷いことしたのになんで倒さないのかって？」	PRINTFORMW 「……え？酷いことしたのになんで倒さないのかって？」
PRINTFORMW 「言ったでしょ？貴女は私の子供、私はお母さん………」	PRINTFORMW 「言ったでしょ？貴女は私の子供、私はお母さん………」
PRINTFORMW 　　　　　　　　貴女のこと　　絶対護るからね　　　！	PRINTFORMW 　　　　　　　　貴女のこと　　絶対護るからね　　　！
PRINTFORMW 「せめて痛くしない様にってお願いしていってくれる？」	PRINTFORMW 「せめて痛くしない様にってお願いしていってくれる？」
PRINTFORMW 「リリカル☆マジカル☆プリティフランちゃん、参上☆」	PRINTFORMW 「リリカル☆マジカル☆プリティフランちゃん、参上☆」
PRINTFORMW 「持ってて損は無いかも…使えるかどうかは別として…」	PRINTFORMW 「持ってて損は無いかも…使えるかどうかは別として…」
PRINTFORMW 「こんな所じゃ自由に飛びまわれないし…不憫だなぁ…」	PRINTFORMW 「こんな所じゃ自由に飛びまわれないし…不憫だなぁ…」
PRINTFORMW 　うん、わかったー…見張りしてるからねてていーよー…	PRINTFORMW 　うん、わかったー…見張りしてるからねてていーよー…
PRINTFORMW 「……そうだよね、あれだけ中に出されたんだもん……」	PRINTFORMW 「……そうだよね、あれだけ中に出されたんだもん……」
PRINTFORMW 「あぅぅっ！いぎぃぃっ…だめ、痛すぎて立てない…！」	PRINTFORMW 「あぅぅっ！いぎぃぃっ…だめ、痛すぎて立てない…！」
PRINTFORMW 「あ、あぁ、うぅ、出てくる…！中から…くぅぅっ！！」	PRINTFORMW 「あ、あぁ、うぅ、出てくる…！中から…くぅぅっ！！」
PRINTFORMW 「ほらっ、起きなさい。大丈夫だよ、私が居るからね！」	PRINTFORMW 「ほらっ、起きなさい。大丈夫だよ、私が居るからね！」
PRINTFORMW （あぁ…もう…だめぇ……なにも…かんが…られ…い…）	PRINTFORMW （あぁ…もう…だめぇ……なにも…かんが…られ…い…）
PRINTFORMW 「うぶっ…ぷはっ、っていやっなに？溶けて…きゃっ！」	PRINTFORMW 「うぶっ…ぷはっ、っていやっなに？溶けて…きゃっ！」
PRINTFORMW 「っ…こ、こんなのに潰されたら……し、死んじゃう…」	PRINTFORMW 「っ…こ、こんなのに潰されたら……し、死んじゃう…」
PRINTFORMW 「だめぇ、やっぱすきぃ…こういうのだいすきぃぃ…♪」	PRINTFORMW 「だめぇ、やっぱすきぃ…こういうのだいすきぃぃ…♪」
PRINTFORMW 「い、いいよ、そのまま――あ、ああああああぁんっ♪」	PRINTFORMW 「い、いいよ、そのまま――あ、ああああああぁんっ♪」
PRINTFORMW 「アンタなんか、遠慮する必要は皆無なんだからね！」	PRINTFORMW 「アンタなんか、遠慮する必要は皆無なんだからね！」
PRINTFORMW 「消えろォォォォォォォォォォォォォォォォ！！！！」	PRINTFORMW 「消えろォォォォォォォォォォォォォォォォ！！！！」
PRINTFORMW 「スタァァァァァァァボウブレェェェェェェイク！！」	PRINTFORMW 「スタァァァァァァァボウブレェェェェェェイク！！」
PRINTFORMW 「ひぃっ！あっ、い、いやぁいやぁぁぁぁぁぁぁ！！」	PRINTFORMW 「ひぃっ！あっ、い、いやぁいやぁぁぁぁぁぁぁ！！」
PRINTFORMW 「あうっ…らめぇぇぇぇぇっ…赤ちゃんできひゃっ♪」	PRINTFORMW 「あうっ…らめぇぇぇぇぇっ…赤ちゃんできひゃっ♪」
PRINTFORMW 「んうっ、びゅくびゅくって…いやらぁぁぁ……っ♪」	PRINTFORMW 「んうっ、びゅくびゅくって…いやらぁぁぁ……っ♪」
PRINTFORMW 「ん、何処で覚えたのかしらないけどいい子いい子…」	PRINTFORMW 「ん、何処で覚えたのかしらないけどいい子いい子…」
PRINTFORMW 「うん、元気そうで何より……ってのもおかしいかな」	PRINTFORMW 「うん、元気そうで何より……ってのもおかしいかな」
PRINTFORMW 「気を付けて、今まで見たいな遊びじゃないからね…」	PRINTFORMW 「気を付けて、今まで見たいな遊びじゃないからね…」
PRINTFORMW 「まぁ、修羅場の数が違うし、大丈夫だよね♪…ね？」	PRINTFORMW 「まぁ、修羅場の数が違うし、大丈夫だよね♪…ね？」
PRINTFORMW 「私の様子が変だったら起こしてね…、こんなだし…」	PRINTFORMW 「私の様子が変だったら起こしてね…、こんなだし…」
PRINTFORMW 「あ、動いてる。足かな？よかった…普通に人型だ…」	PRINTFORMW 「あ、動いてる。足かな？よかった…普通に人型だ…」
PRINTFORMW 「うん…っ？！あれ…なんかめまいが…皆は？そう…」	PRINTFORMW 「うん…っ？！あれ…なんかめまいが…皆は？そう…」
PRINTFORMW 「あ…あれだけ出されたんだ……ないことは…ない…」	PRINTFORMW 「あ…あれだけ出されたんだ……ないことは…ない…」
PRINTFORMW 「ま、待ってよ、もうちょっとゆっくり…お願いぃ…」	PRINTFORMW 「ま、待ってよ、もうちょっとゆっくり…お願いぃ…」
PRINTFORMW 「霊夢みたいに簡単に結界を張れればいいのにな～…」	PRINTFORMW 「霊夢みたいに簡単に結界を張れればいいのにな～…」
PRINTFORMW 「さてっと…敵が来ても応戦できる様にしておけば…」	PRINTFORMW 「さてっと…敵が来ても応戦できる様にしておけば…」
PRINTFORMW 「うぶっ…ぷはっ…って、きゃっ！ふ、服が無い！！」	PRINTFORMW 「うぶっ…ぷはっ…って、きゃっ！ふ、服が無い！！」
PRINTFORMW 「こういうときこそ…しゅうちゅう…しゅうちゅう…」	PRINTFORMW 「こういうときこそ…しゅうちゅう…しゅうちゅう…」
PRINTFORM 「おかあさまのじゃまするなぁぁぁぁぁぁぁぁぁ！！！」	PRINTFORM 「おかあさまのじゃまするなぁぁぁぁぁぁぁぁぁ！！！」
PRINTFORMW 「うぅ…おかあさまも…わたしをかかえてこんな……」	PRINTFORMW 「うぅ…おかあさまも…わたしをかかえてこんな……」
PRINTFORMW 「だ、だめだよ！なかはみんなにはあげられないの！」	PRINTFORMW 「だ、だめだよ！なかはみんなにはあげられないの！」
PRINTFORMW 「一つ一つじゃ埒が明かないね！そりゃぁぁぁ！！」	PRINTFORMW 「一つ一つじゃ埒が明かないね！そりゃぁぁぁ！！」
PRINTFORMW 「あっぐ、…え？あ、ちょっとまって！何やって…っ	PRINTFORMW 「あっぐ、…え？あ、ちょっとまって！何やって…っ
PRINTFORMW 「安心していいよ…もう殺すなんて言わないから…」	PRINTFORMW 「安心していいよ…もう殺すなんて言わないから…」
PRINTFORMW 　え？何でまるで美術品心配する様な心配するって？	PRINTFORMW 　え？何でまるで美術品心配する様な心配するって？
PRINTFORMW 「はぁ…でも中絶する気にもならないのが怖いよ…」	PRINTFORMW 「はぁ…でも中絶する気にもならないのが怖いよ…」
PRINTFORMW 「なんだろこれ…まぁ後でいいか…もう休みたい…」	PRINTFORMW 「なんだろこれ…まぁ後でいいか…もう休みたい…」
PRINTFORMW 「これ…霊夢が使ってる神具だよね…使えるかも…」	PRINTFORMW 「これ…霊夢が使ってる神具だよね…使えるかも…」
PRINTFORMW 「出来れば使う破目にならないようにしたいなぁ…」	PRINTFORMW 「出来れば使う破目にならないようにしたいなぁ…」
PRINTFORMW 「よし、大丈夫そうね…じゃあ、おやすみなさい…」	PRINTFORMW 「よし、大丈夫そうね…じゃあ、おやすみなさい…」
PRINTFORMW 「あっはっはははははははははははははははは……」	PRINTFORMW 「あっはっはははははははははははははははは……」
PRINTFORMW 「あんうぅぅ、こすってきちゃ…らめぇぇぇぇ…♪」	PRINTFORMW 「あんうぅぅ、こすってきちゃ…らめぇぇぇぇ…♪」
PRINTFORMW そのまま口の様な物を開き、中へいざなおうとする。	PRINTFORMW そのまま口の様な物を開き、中へいざなおうとする。
PRINTFORMW フランドールは荒い動悸を抑えつつ状況を把握する。	PRINTFORMW フランドールは荒い動悸を抑えつつ状況を把握する。
PRINTFORMW 「貴女達と居ても無意味ね…私は別行動するから…」	PRINTFORMW 「貴女達と居ても無意味ね…私は別行動するから…」
PRINTFORMW 「ざんね～ん♪わたしにだってできるもんね、ソレ」	PRINTFORMW 「ざんね～ん♪わたしにだってできるもんね、ソレ」
PRINTFORMW 「……もっと……きもちいいの、ほしいよぉ……♪」	PRINTFORMW 「……もっと……きもちいいの、ほしいよぉ……♪」
PRINTFORMW 「うあぁっ、したい……みんなとしたくてぇ…あぁん	PRINTFORMW 「うあぁっ、したい……みんなとしたくてぇ…あぁん
PRINTFORMW 「あ、あぁっ……赤ちゃんしんじゃ……ひぅっ！」	PRINTFORMW 「あ、あぁっ……赤ちゃんしんじゃ……ひぅっ！」
PRINTFORMW 「……あぁ…なにやってんだろ……ま、いっか…」	PRINTFORMW 「……あぁ…なにやってんだろ……ま、いっか…」
PRINTFORMW 「そんなに広くないみたいだけど…まだ居るの？」	PRINTFORMW 「そんなに広くないみたいだけど…まだ居るの？」
PRINTFORMW 「なんだってこんなのばっかなの…もういや……」	PRINTFORMW 「なんだってこんなのばっかなの…もういや……」
PRINTFORMW 　　　　　　　　その子は…私の子だもん！！！！	PRINTFORMW 　　　　　　　　その子は…私の子だもん！！！！
PRINTFORMW 「妹が出来るんだよ？頑張ってね、お姉ちゃん♪」	PRINTFORMW 「妹が出来るんだよ？頑張ってね、お姉ちゃん♪」
PRINTFORMW 「私？……えーっとぉ……ま、まぁまぁ…かな…」	PRINTFORMW 「私？……えーっとぉ……ま、まぁまぁ…かな…」
PRINTFORMW 「咲夜、大丈夫？人間にはキツイよ？この瘴気…」	PRINTFORMW 「咲夜、大丈夫？人間にはキツイよ？この瘴気…」
PRINTFORMW 「ありがとう……これで、なんとかなるかも……」	PRINTFORMW 「ありがとう……これで、なんとかなるかも……」
PRINTFORMW 「あはは…自分の子に世話になっちゃうなんて…」	PRINTFORMW 「あはは…自分の子に世話になっちゃうなんて…」
PRINTFORMW 「年かな？って、ううん！そんなことないもん！」	PRINTFORMW 「年かな？って、ううん！そんなことないもん！」
PRINTFORMW 「ありがと魔理沙♪魔理沙は物探し得意だよね♪」	PRINTFORMW 「ありがと魔理沙♪魔理沙は物探し得意だよね♪」
PRINTFORMW 「そう…うん、咲夜なら大丈夫だよ。気を付けて」	PRINTFORMW 「そう…うん、咲夜なら大丈夫だよ。気を付けて」
PRINTFORMW 「ロンドンに居た頃に見たなぁ…懐かしいなぁ…」	PRINTFORMW 「ロンドンに居た頃に見たなぁ…懐かしいなぁ…」
PRINTFORMW 「これって…わっと…わぁ…こういう奴なんだ…」	PRINTFORMW 「これって…わっと…わぁ…こういう奴なんだ…」
PRINTFORMW 「うぅっ…早く出てこい…直ぐに殺してやる…！」	PRINTFORMW 「うぅっ…早く出てこい…直ぐに殺してやる…！」
PRINTFORMW 「はぁっ…はぁっ…どうすれば…どうしよう…！」	PRINTFORMW 「はぁっ…はぁっ…どうすれば…どうしよう…！」
PRINTFORMW 「うっ、なんかめまいが…体調でも崩したかな…」	PRINTFORMW 「うっ、なんかめまいが…体調でも崩したかな…」
PRINTFORMW 「ふぅ…戦いに支障はないみたいだからいっか…」	PRINTFORMW 「ふぅ…戦いに支障はないみたいだからいっか…」
PRINTFORMW 「お、おおぎすぎる…よぉ…こわれちゃうよぉ…」	PRINTFORMW 「お、おおぎすぎる…よぉ…こわれちゃうよぉ…」
PRINTFORMW 「状況が状況なだけに、一番疲れるかもね…これ」	PRINTFORMW 「状況が状況なだけに、一番疲れるかもね…これ」
PRINTFORMW 「ほ～ら洗いっこ洗いっこ～♪…柔らかいなぁ…」	PRINTFORMW 「ほ～ら洗いっこ洗いっこ～♪…柔らかいなぁ…」
PRINTFORMW 「女の子なんだから、きれいにしましょ～ね～♪」	PRINTFORMW 「女の子なんだから、きれいにしましょ～ね～♪」
PRINTFORMW どうなったのか解らない。何が何だか分からない。	PRINTFORMW どうなったのか解らない。何が何だか分からない。
PRINTFORMW フランドールは部屋の隅で膝を抱えて蹲っていた。	PRINTFORMW フランドールは部屋の隅で膝を抱えて蹲っていた。
PRINTFORMW 「はぁ…あぶなかったぁ…うぇ…地獄が其処に…」	PRINTFORMW 「はぁ…あぶなかったぁ…うぇ…地獄が其処に…」
PRINTFORMW 「はぁぁぁぁぁぁ、はぁぁぁぁぁぁぁぁぁ！！！」	PRINTFORMW 「はぁぁぁぁぁぁ、はぁぁぁぁぁぁぁぁぁ！！！」
PRINTFORMW 「こ、こういうの、やめなきゃっ…いけないの！」	PRINTFORMW 「こ、こういうの、やめなきゃっ…いけないの！」
PRINTFORMW 　やっぱり　ばけもののこは　ばけものみたいです	PRINTFORMW 　やっぱり　ばけもののこは　ばけものみたいです
PRINTFORMW 「レーヴァテイン、『ブラスターブレード』！」	PRINTFORMW 「レーヴァテイン、『ブラスターブレード』！」
PRINTFORMW 「こういう時こそ…ふてぶてしく…狙い撃つ！」	PRINTFORMW 「こういう時こそ…ふてぶてしく…狙い撃つ！」
PRINTFORMW 「咲夜直伝！インスクライブレッドソウル！！」	PRINTFORMW 「咲夜直伝！インスクライブレッドソウル！！」
PRINTFORMW 「あん、ふあぁんっ、らめ…らめなのぉ……♪」	PRINTFORMW 「あん、ふあぁんっ、らめ…らめなのぉ……♪」
PRINTFORMW 「っ…や…いやぁ…っく、いややぁ……ぁぁ…」	PRINTFORMW 「っ…や…いやぁ…っく、いややぁ……ぁぁ…」
PRINTFORMW 「コイツ…コイツさえ倒せば……でも今は…！」	PRINTFORMW 「コイツ…コイツさえ倒せば……でも今は…！」
PRINTFORMW 　はやく……どこかに隠れて……っ…ふぁっ♪」	PRINTFORMW 　はやく……どこかに隠れて……っ…ふぁっ♪」
PRINTFORMW 「お姉様？！よかったぁ…ホントによかった…」	PRINTFORMW 「お姉様？！よかったぁ…ホントによかった…」
PRINTFORMW 「貴女より若い叔母さんだよ～…あはは…はぁ」	PRINTFORMW 「貴女より若い叔母さんだよ～…あはは…はぁ」
PRINTFORMW 「貴女はこの私のお乳で育ったんだからね～♪」	PRINTFORMW 「貴女はこの私のお乳で育ったんだからね～♪」
PRINTFORMW 「これってたしか…そうそう、これで発射だね」	PRINTFORMW 「これってたしか…そうそう、これで発射だね」
PRINTFORMW 「こんなにたくさん……大丈夫かなぁ…霊夢…」	PRINTFORMW 「こんなにたくさん……大丈夫かなぁ…霊夢…」
PRINTFORMW 「……なんて言っても唯の鈍器だよね、これ…」	PRINTFORMW 「……なんて言っても唯の鈍器だよね、これ…」
PRINTFORMW 「ふんふ～ん♪服を編んでくれて嬉しいな～♪」	PRINTFORMW 「ふんふ～ん♪服を編んでくれて嬉しいな～♪」
PRINTFORMW 「目を護れて便利だねぇ…でも目が乾くわね…」	PRINTFORMW 「目を護れて便利だねぇ…でも目が乾くわね…」
PRINTFORMW 「なるべく隅っこで…じゃ、おやすみなさい…」	PRINTFORMW 「なるべく隅っこで…じゃ、おやすみなさい…」
PRINTFORMW 「私の様子がおかしかったら、すぐ起こしてね」	PRINTFORMW 「私の様子がおかしかったら、すぐ起こしてね」
PRINTFORMW 「…っ…あぁ……おっぱい…じゅぷじゅぷ……」	PRINTFORMW 「…っ…あぁ……おっぱい…じゅぷじゅぷ……」
PRINTFORMW 「どっちでもいいよ…出て気次第殺してやる…」	PRINTFORMW 「どっちでもいいよ…出て気次第殺してやる…」
PRINTFORMW 「はぁ…大変…ちょっとゆっくりしようかな…」	PRINTFORMW 「はぁ…大変…ちょっとゆっくりしようかな…」
PRINTFORMW 「はぅっ…んっ…つぅ……あ、貫いちゃった…」	PRINTFORMW 「はぅっ…んっ…つぅ……あ、貫いちゃった…」
PRINTFORMW 「結界終わったよ～。早くお風呂入ろうよ～♪」	PRINTFORMW 「結界終わったよ～。早くお風呂入ろうよ～♪」
PRINTFORMW 「あれ………わた…し………いき…てる……？」	PRINTFORMW 「あれ………わた…し………いき…てる……？」
PRINTFORMW ――ある日、幻想郷では謎の神隠しが起きていた	PRINTFORMW ――ある日、幻想郷では謎の神隠しが起きていた
PRINTFORMW 「あぶっ、ぷはっ…ふぅ、服なくても水圧が…」	PRINTFORMW 「あぶっ、ぷはっ…ふぅ、服なくても水圧が…」
PRINTFORMW 「もうおかあさまいがいはうけつけませーん！」	PRINTFORMW 「もうおかあさまいがいはうけつけませーん！」
PRINTFORM 「や、やめてよ、やめっ――や、やああぁぁぁぁっ	PRINTFORM 「や、やめてよ、やめっ――や、やああぁぁぁぁっ
PRINTFORMW 「全員消えろォォォォォォォォォォォ！！！」	PRINTFORMW 「全員消えろォォォォォォォォォォォ！！！」
PRINTFORMW 　　　　　　嫌だ…嫌だ…まだ死にたくない…	PRINTFORMW 　　　　　　嫌だ…嫌だ…まだ死にたくない…
PRINTFORMW 「あ…あぁ……ちょっと……かた、かして…」	PRINTFORMW 「あ…あぁ……ちょっと……かた、かして…」
PRINTFORMW 「孫や姪より若い妹だよ？流石に無いよね～」	PRINTFORMW 「孫や姪より若い妹だよ？流石に無いよね～」
PRINTFORMW 「せめて貴女だけでも純潔は守り通してね…」	PRINTFORMW 「せめて貴女だけでも純潔は守り通してね…」
PRINTFORMW 「魔理沙、大丈夫？人間には辛い空気だよ？」	PRINTFORMW 「魔理沙、大丈夫？人間には辛い空気だよ？」
PRINTFORML 「もーう、知らないからね！どうなっても！」	PRINTFORML 「もーう、知らないからね！どうなっても！」
PRINTFORMW 「これ…軽さと言い強度と言い…申し分ない…	PRINTFORMW 「これ…軽さと言い強度と言い…申し分ない…
PRINTFORMW 「……ご飯、いらない。食欲が湧かないの…」	PRINTFORMW 「……ご飯、いらない。食欲が湧かないの…」
PRINTFORMW 「うっ、吐きそう…。また、なのかなぁ……」	PRINTFORMW 「うっ、吐きそう…。また、なのかなぁ……」
PRINTFORMW 「うぅん…また前見たいな子ならいいなぁ…」	PRINTFORMW 「うぅん…また前見たいな子ならいいなぁ…」
PRINTFORMW 「動ける今のうちに安全圏を作らなきゃ…！」	PRINTFORMW 「動ける今のうちに安全圏を作らなきゃ…！」
PRINTFORMW 「ん、あぁんまって、そんな強っ！ひゅん♪」	PRINTFORMW 「ん、あぁんまって、そんな強っ！ひゅん♪」
PRINTFORMW 「禁忌『カゴメカゴメ』…全部消えちゃえ…」	PRINTFORMW 「禁忌『カゴメカゴメ』…全部消えちゃえ…」
PRINTFORMW 神隠しにあった者は誰一人帰ってこなかった。	PRINTFORMW 神隠しにあった者は誰一人帰ってこなかった。
PRINTFORMW 「此処は一番安全そうだね。拠点にしちゃえ」	PRINTFORMW 「此処は一番安全そうだね。拠点にしちゃえ」
PRINTFORMW 「おっとと…水滴落ちてくれてよかったぁ…」	PRINTFORMW 「おっとと…水滴落ちてくれてよかったぁ…」
PRINTFORMW 「あったれぇぇぇぇぇぇぇぇぇぇぇぇ！！！」	PRINTFORMW 「あったれぇぇぇぇぇぇぇぇぇぇぇぇ！！！」
PRINTFORMW 「あはっ……も、もっとぉ、もっとぉん…♪」	PRINTFORMW 「あはっ……も、もっとぉ、もっとぉん…♪」
PRINTFORM 「イっちゃうぅ…♪うへへぇ…イっちゃうよぉ…	PRINTFORM 「イっちゃうぅ…♪うへへぇ…イっちゃうよぉ…
PRINTFORMW 「うぁぁぁぁぁぁぁぁぁぁぁぁぁぁぁぁ！」	PRINTFORMW 「うぁぁぁぁぁぁぁぁぁぁぁぁぁぁぁぁ！」
PRINTFORMW 「うぁぁぁぁぁぁ、ぁぁぁぁぁぁぁっ！！」	PRINTFORMW 「うぁぁぁぁぁぁ、ぁぁぁぁぁぁぁっ！！」
PRINTFORMW 「この位…で…、止まれるかぁぁぁぁぁ！」	PRINTFORMW 「この位…で…、止まれるかぁぁぁぁぁ！」
PRINTFORMW 「お姉様直伝！クレイドルスクリュー！！」	PRINTFORMW 「お姉様直伝！クレイドルスクリュー！！」
PRINTFORMW 「んぅんっ、らめ…しゅ…しゅごい……♪」	PRINTFORMW 「んぅんっ、らめ…しゅ…しゅごい……♪」
PRINTFORMW 「あっ…うあぁぁ…ダメ…出られない…！」	PRINTFORMW 「あっ…うあぁぁ…ダメ…出られない…！」
PRINTFORMW 「はぁ…はぁ…っ…どっか…安全な場所…」	PRINTFORMW 「はぁ…はぁ…っ…どっか…安全な場所…」
PRINTFORMW 「そうだったら……愛せる自信ないもん…」	PRINTFORMW 「そうだったら……愛せる自信ないもん…」
PRINTFORMW 「うぅ…、だ、大丈夫♪…私は…大丈夫…」	PRINTFORMW 「うぅ…、だ、大丈夫♪…私は…大丈夫…」
PRINTFORMW 「皆どうしてるかな…無事だと良いけど…」	PRINTFORMW 「皆どうしてるかな…無事だと良いけど…」
PRINTFORMW 「ねね、周りの状況とかってわからない？」	PRINTFORMW 「ねね、周りの状況とかってわからない？」
PRINTFORMW 「お姉様。…うん、ありがとうございます」	PRINTFORMW 「お姉様。…うん、ありがとうございます」
PRINTFORMW 「ぎょくろ…だっけ？あの美味しいお茶…」	PRINTFORMW 「ぎょくろ…だっけ？あの美味しいお茶…」
PRINTFORMW 「せめて寝てる間は陣痛起こさないでね？」	PRINTFORMW 「せめて寝てる間は陣痛起こさないでね？」
PRINTFORMW 「大丈夫、私も見張りは出来るから…ね？」	PRINTFORMW 「大丈夫、私も見張りは出来るから…ね？」
PRINTFORMW 「や、やめてぇっ！飲まないでよぉぉぉ！」	PRINTFORMW 「や、やめてぇっ！飲まないでよぉぉぉ！」
PRINTFORMW 「うぁっ、な、何吸ってるんだコイツ…！」	PRINTFORMW 「うぁっ、な、何吸ってるんだコイツ…！」
PRINTFORMW 「今はなるべく敵と会いたくないからね…」	PRINTFORMW 「今はなるべく敵と会いたくないからね…」
PRINTFORMW 「確り…ほら確りして！眼を開けてよ！！」	PRINTFORMW 「確り…ほら確りして！眼を開けてよ！！」
PRINTFORMW 其処でフッと、巷の噂の事を漸く思い返す。	PRINTFORMW 其処でフッと、巷の噂の事を漸く思い返す。
PRINTFORMW 「そう…うん…わかった…ごめんなさい…」	PRINTFORMW 「そう…うん…わかった…ごめんなさい…」
PRINTFORMW 「此処は良い場所ね…拠点にしようかな…」	PRINTFORMW 「此処は良い場所ね…拠点にしようかな…」
PRINTFORMW 「あぶっ…いてて…服は無いけど圧力が…」	PRINTFORMW 「あぶっ…いてて…服は無いけど圧力が…」
PRINTFORMW 「…息が…続か………ぷはっ…だめっ…！」	PRINTFORMW 「…息が…続か………ぷはっ…だめっ…！」
PRINTFORMW 「？言ってることがよく判んない…ごめん」	PRINTFORMW 「？言ってることがよく判んない…ごめん」
PRINTFORMW 「ん……んぷ……だめっ！我慢できない！」	PRINTFORMW 「ん……んぷ……だめっ！我慢できない！」
PRINTFORMW 「え、そ、それは……し、知らないなぁ…」	PRINTFORMW 「え、そ、それは……し、知らないなぁ…」
PRINTFORMW 「禁忌『クランベリートラップ・デルタ』」	PRINTFORMW 「禁忌『クランベリートラップ・デルタ』」
PRINTFORMW 「もうちょっとつよめがおのぞみかしら？」	PRINTFORMW 「もうちょっとつよめがおのぞみかしら？」
PRINTFORMW 「ん、きもちぃのはぼんのーでだめなの！」	PRINTFORMW 「ん、きもちぃのはぼんのーでだめなの！」
PRINTFORMW 「だめ、ぜったい…いまはだめだかんね…」	PRINTFORMW 「だめ、ぜったい…いまはだめだかんね…」
PRINTFORMW 「あぁ、もっとみんなとふれあえるぅ…♪」	PRINTFORMW 「あぁ、もっとみんなとふれあえるぅ…♪」
PRINTFORM 「や、やぁっ…もうやだ、やだぁぁぁぁぁぁっ	PRINTFORM 「や、やぁっ…もうやだ、やだぁぁぁぁぁぁっ
PRINTFORMW 「と、兎に角削らなきゃ！…たぁぁっ！」	PRINTFORMW 「と、兎に角削らなきゃ！…たぁぁっ！」
PRINTFORMW 「ぁぁ…あぁ…あああああああああ！！」	PRINTFORMW 「ぁぁ…あぁ…あああああああああ！！」
PRINTFORMW 「引き寄せられなくても、点を狙えば！」	PRINTFORMW 「引き寄せられなくても、点を狙えば！」
PRINTFORMW 「いやっ！こんな所に裸で居たくない！」	PRINTFORMW 「いやっ！こんな所に裸で居たくない！」
PRINTFORMW 「こんなとこにも……殺す…殺すっ！！」	PRINTFORMW 「こんなとこにも……殺す…殺すっ！！」
PRINTFORMW 「骨とか屍人形の方がまだましだよ……」	PRINTFORMW 「骨とか屍人形の方がまだましだよ……」
PRINTFORMW 「……アレは早めに倒さないと、皆が…」	PRINTFORMW 「……アレは早めに倒さないと、皆が…」
PRINTFORMW 「やりづらい…目を操れないから尚更…」	PRINTFORMW 「やりづらい…目を操れないから尚更…」
PRINTFORMW 「まぁ相手が化物なのは不本意だけど…」	PRINTFORMW 「まぁ相手が化物なのは不本意だけど…」
PRINTFORMW 「お姉様。どうすれば脱出できるかな…」	PRINTFORMW 「お姉様。どうすれば脱出できるかな…」
PRINTFORMW 「早く帰って咲夜のお茶が飲みたいね…」	PRINTFORMW 「早く帰って咲夜のお茶が飲みたいね…」
PRINTFORMW 「あんまり無茶はしないでね。約束だよ」	PRINTFORMW 「あんまり無茶はしないでね。約束だよ」
PRINTFORMW 「咲夜、ありがとう。無理しないでね？」	PRINTFORMW 「咲夜、ありがとう。無理しないでね？」
PRINTFORMW 「お母さんの戦いっぷり、見ててよ～♪」	PRINTFORMW 「お母さんの戦いっぷり、見ててよ～♪」
PRINTFORMW 「私の戦いっぷりをとくと見てなさい～」	PRINTFORMW 「私の戦いっぷりをとくと見てなさい～」
PRINTFORMW 「うん、貴女の背中は私が護るからね♪」	PRINTFORMW 「うん、貴女の背中は私が護るからね♪」
PRINTFORMW 「すぅ…すぅ…はっ。ごめん、寝てた…」	PRINTFORMW 「すぅ…すぅ…はっ。ごめん、寝てた…」
PRINTFORMW 「へぇ～。でもあんまり使わないかも…」	PRINTFORMW 「へぇ～。でもあんまり使わないかも…」
PRINTFORMW 「わら人形…小茶碗見たいなものかな？」	PRINTFORMW 「わら人形…小茶碗見たいなものかな？」
PRINTFORMW 「ゴーグル？水中眼鏡？中々面白そう！」	PRINTFORMW 「ゴーグル？水中眼鏡？中々面白そう！」
PRINTFORMW 「……変なの混ざってたらいやだなぁ…」	PRINTFORMW 「……変なの混ざってたらいやだなぁ…」
PRINTFORMW 「少しは楽になれればいいなぁ……すぅ」	PRINTFORMW 「少しは楽になれればいいなぁ……すぅ」
PRINTFORMW 「ふぁぁぁっひゃぁぁぁぁぁぁぁ！！！」	PRINTFORMW 「ふぁぁぁっひゃぁぁぁぁぁぁぁ！！！」
PRINTFORMW 「だ、だめっだめ！だめぇぇぇぇぇっ♪」	PRINTFORMW 「だ、だめっだめ！だめぇぇぇぇぇっ♪」
PRINTFORMW 「あぁぁ、あああ！うああぁぁぁぁっ！」	PRINTFORMW 「あぁぁ、あああ！うああぁぁぁぁっ！」
PRINTFORMW （……なに、この感覚？嫌だ…怖い…！）	PRINTFORMW （……なに、この感覚？嫌だ…怖い…！）
PRINTFORMW 「この子は私の子だし、罪は無いしね…」	PRINTFORMW 「この子は私の子だし、罪は無いしね…」
PRINTFORMW 「どうしよう……お腹裂いてでも殺す？」	PRINTFORMW 「どうしよう……お腹裂いてでも殺す？」
PRINTFORMW 「うっ…あれ、なにか胸から…これって」	PRINTFORMW 「うっ…あれ、なにか胸から…これって」
PRINTFORMW 「や、やぁっ、おっぱい、やめてぇっ！」	PRINTFORMW 「や、やぁっ、おっぱい、やめてぇっ！」
PRINTFORMW 「時間掛ければ出来るわ、これ位なら…」	PRINTFORMW 「時間掛ければ出来るわ、これ位なら…」
PRINTFORMW 「…こいつら全員……私がぶっ壊す……」	PRINTFORMW 「…こいつら全員……私がぶっ壊す……」
PRINTFORMW 「すごい…気持ちいい……落ち付く……」	PRINTFORMW 「すごい…気持ちいい……落ち付く……」
PRINTFORMW 「っ、いやっ、なにこれ！は、離せ！！」	PRINTFORMW 「っ、いやっ、なにこれ！は、離せ！！」
PRINTFORMW 「息…つづか……ぷはぁ…はっ…うぅ…」	PRINTFORMW 「息…つづか……ぷはぁ…はっ…うぅ…」
PRINTFORMW 「つかれしらずだもんね、しってるよ！」	PRINTFORMW 「つかれしらずだもんね、しってるよ！」
PRINTFORMW 「こっちのこでもあるから…わたし……」	PRINTFORMW 「こっちのこでもあるから…わたし……」
PRINTFORML 「えっと、そっちはだいじょうぶなの？」	PRINTFORML 「えっと、そっちはだいじょうぶなの？」
PRINTFORMW 「当たれぇぇぇぇぇぇぇぇぇぇ！！！」	PRINTFORMW 「当たれぇぇぇぇぇぇぇぇぇぇ！！！」
PRINTFORMW でも…もう身体も思う様に動かない……	PRINTFORMW でも…もう身体も思う様に動かない……
PRINTFORMW 「嫌！吸うんじゃない！！来るなぁ！」	PRINTFORMW 「嫌！吸うんじゃない！！来るなぁ！」
PRINTFORMW 「んあぁ……あ…あぁ…あぁぁぁぁ…」	PRINTFORMW 「んあぁ……あ…あぁ…あぁぁぁぁ…」
PRINTFORMW 「こいつらに捕まってなるものか…！」	PRINTFORMW 「こいつらに捕まってなるものか…！」
PRINTFORMW 「な、なんとか……なった…っはぁ…」	PRINTFORMW 「な、なんとか……なった…っはぁ…」
PRINTFORMW 　あれ、…皆…何処…？何処にいるの？	PRINTFORMW 　あれ、…皆…何処…？何処にいるの？
PRINTFORMW 「あ…っ……ぁぁ…っ………。………」	PRINTFORMW 「あ…っ……ぁぁ…っ………。………」
PRINTFORMW 「…私そっくり…っ、まさか貴女…！」	PRINTFORMW 「…私そっくり…っ、まさか貴女…！」
PRINTFORMW 　どうしよう…どうすればいいの…？」	PRINTFORMW 　どうしよう…どうすればいいの…？」
PRINTFORMW 「ありがとう…。うん、頑張るから！」	PRINTFORMW 「ありがとう…。うん、頑張るから！」
PRINTFORMW 「ごめん…なさい……お願いします…」	PRINTFORMW 「ごめん…なさい……お願いします…」
PRINTFORMW 「魔理沙…幾らなんでも落とし過ぎ…」	PRINTFORMW 「魔理沙…幾らなんでも落とし過ぎ…」
PRINTFORMW 「こんなにたくさん…大丈夫かなぁ…」	PRINTFORMW 「こんなにたくさん…大丈夫かなぁ…」
PRINTFORMW 「ベッドが欲しいなぁ…すぅ…すぅ…」	PRINTFORMW 「ベッドが欲しいなぁ…すぅ…すぅ…」
PRINTFORMW 「ん、じゃあおやすみ…くぁ…すぅ…」	PRINTFORMW 「ん、じゃあおやすみ…くぁ…すぅ…」
PRINTFORMW 「あぁぁ…ァァァァァ…あははは…♪」	PRINTFORMW 「あぁぁ…ァァァァァ…あははは…♪」
PRINTFORMW ひゃんっ…つ、つよいよぉ…うんっ♪」	PRINTFORMW ひゃんっ…つ、つよいよぉ…うんっ♪」
PRINTFORMW 「うぐっ…あぅ…だれか…たすけて…」	PRINTFORMW 「うぐっ…あぅ…だれか…たすけて…」
PRINTFORMW 「食欲が出ない…疲れてるのかなぁ…」	PRINTFORMW 「食欲が出ない…疲れてるのかなぁ…」
PRINTFORMW 「一人居れば十分だよ…どうしよう…」	PRINTFORMW 「一人居れば十分だよ…どうしよう…」
PRINTFORMW 「育ってる…幾らなんでも早いよぉ…」	PRINTFORMW 「育ってる…幾らなんでも早いよぉ…」
PRINTFORMW 「……ご飯、いらない。食欲ないの…」	PRINTFORMW 「……ご飯、いらない。食欲ないの…」
PRINTFORMW 「や、やぁっ、目…撃て…ひゃんっ！」	PRINTFORMW 「や、やぁっ、目…撃て…ひゃんっ！」
PRINTFORMW 「はぁ…はぁ…よし、出来た…すぅ…」	PRINTFORMW 「はぁ…はぁ…よし、出来た…すぅ…」
PRINTFORMW 「はぁっはぁ…身体が重い…はぁっ…」	PRINTFORMW 「はぁっはぁ…身体が重い…はぁっ…」
PRINTFORMW 「はぁっ、はぁっ……隠れて…っと…」	PRINTFORMW 「はぁっ、はぁっ……隠れて…っと…」
PRINTFORMDW 「うぅ、眠い…寝たい…すぅ…ハッ」	PRINTFORMDW 「うぅ、眠い…寝たい…すぅ…ハッ」
PRINTFORMW 「ふぅ、次はお風呂だね…水水っと…」	PRINTFORMW 「ふぅ、次はお風呂だね…水水っと…」
PRINTFORMW 「水風呂もいいなぁ…き～もち～…♪」	PRINTFORMW 「水風呂もいいなぁ…き～もち～…♪」
PRINTFORMW 「え、ちょ…ま、まって…ひゃんっ♪」	PRINTFORMW 「え、ちょ…ま、まって…ひゃんっ♪」
PRINTFORMW 「あてるだけならいつでもできるよ！」	PRINTFORMW 「あてるだけならいつでもできるよ！」
PRINTFORMW 「わーん…きれいななおよーふくが…」	PRINTFORMW 「わーん…きれいななおよーふくが…」
PRINTFORMW 「だいじょうぶ、わたしはつよいよ！」	PRINTFORMW 「だいじょうぶ、わたしはつよいよ！」
PRINTFORMW 「パチュリー直伝！本角アタック！」	PRINTFORMW 「パチュリー直伝！本角アタック！」
PRINTFORMW 「離してぇぇぇぇぇぇぇぇぇぇ！！」	PRINTFORMW 「離してぇぇぇぇぇぇぇぇぇぇ！！」
PRINTFORMW 「あぁ……なんか…あったかい…？」	PRINTFORMW 「あぁ……なんか…あったかい…？」
PRINTFORMW 「はっ…はぁ…なんかとか…避けた」	PRINTFORMW 「はっ…はぁ…なんかとか…避けた」
PRINTFORMW 「コイツを…コイツさえ倒せば！！」	PRINTFORMW 「コイツを…コイツさえ倒せば！！」
PRINTFORMW 「ふぅ、どう料理すればいいかな…」	PRINTFORMW 「ふぅ、どう料理すればいいかな…」
PRINTFORMW 「えっ？あ、ちょ、ちょっとまって！	PRINTFORMW 「えっ？あ、ちょ、ちょっとまって！
PRINTFORMW （…………！皆の気配が消えた？！）	PRINTFORMW （…………！皆の気配が消えた？！）
PRINTFORMDW 「あはは……だめ…ふらふら～…」	PRINTFORMDW 「あはは……だめ…ふらふら～…」
PRINTFORMW 「うん、今の私こんなんなんだ～…」	PRINTFORMW 「うん、今の私こんなんなんだ～…」
PRINTFORMW 「はぁ…もう気が滅入りそうだよ…」	PRINTFORMW 「はぁ…もう気が滅入りそうだよ…」
PRINTFORMW 「大丈夫…私が、護って見せる…！」	PRINTFORMW 「大丈夫…私が、護って見せる…！」
PRINTFORMW 「え？ちょ、ちょっと…そんなぁ…」	PRINTFORMW 「え？ちょ、ちょっと…そんなぁ…」
PRINTFORMW 　貴女は貴女の心配をしていなさい」	PRINTFORMW 　貴女は貴女の心配をしていなさい」
PRINTFORMW 「魔理沙…さっきから凄い量だね…」	PRINTFORMW 「魔理沙…さっきから凄い量だね…」
PRINTFORMW 　霊撃ぐらいにだったら使えるね…」	PRINTFORMW 　霊撃ぐらいにだったら使えるね…」
PRINTFORMW 「なんであるんだろ……ま、いいか」	PRINTFORMW 「なんであるんだろ……ま、いいか」
PRINTFORMW 「問題無し…、そろそろ時間だよー」	PRINTFORMW 「問題無し…、そろそろ時間だよー」
PRINTFORMW 「お願いします、おやすみなさい…」	PRINTFORMW 「お願いします、おやすみなさい…」
PRINTFORMW 「ふぁぁぁ…赤ちゃん…いるの…？」	PRINTFORMW 「ふぁぁぁ…赤ちゃん…いるの…？」
PRINTFORMW 「づっ、前と違う…違う…これは…」	PRINTFORMW 「づっ、前と違う…違う…これは…」
PRINTFORMW 「食欲出ないなぁ…疲れたかなぁ…」	PRINTFORMW 「食欲出ないなぁ…疲れたかなぁ…」
PRINTFORMW 「くぁぁ…だめ…眠過ぎてだるい…」	PRINTFORMW 「くぁぁ…だめ…眠過ぎてだるい…」
PRINTFORMW 「近くに何かいそう…隠れてよっと」	PRINTFORMW 「近くに何かいそう…隠れてよっと」
PRINTFORMW 「は～い、おまたせ。お風呂だよ～」	PRINTFORMW 「は～い、おまたせ。お風呂だよ～」
PRINTFORMW 「あれ…？おーい、ねぇ…何処…？」	PRINTFORMW 「あれ…？おーい、ねぇ…何処…？」
PRINTFORMW あれからどれくらい経っただろうか。	PRINTFORMW あれからどれくらい経っただろうか。
PRINTFORMW 何度目かの空腹の訴えで立ち上がる。	PRINTFORMW 何度目かの空腹の訴えで立ち上がる。
PRINTFORMW そして同時に決意したこともあった。	PRINTFORMW そして同時に決意したこともあった。
PRINTFORMW 「んっ、んっ…ぷはぁ…美味しい…」	PRINTFORMW 「んっ、んっ…ぷはぁ…美味しい…」
PRINTFORMW 「水風呂でもいいなぁ…気持ちぃ…」	PRINTFORMW 「水風呂でもいいなぁ…気持ちぃ…」
PRINTFORMW 「ひゃっ、やめっ、らめてぇぇ……」	PRINTFORMW 「ひゃっ、やめっ、らめてぇぇ……」
PRINTFORMW 「よっと…飛べるからラクチンね…」	PRINTFORMW 「よっと…飛べるからラクチンね…」
PRINTFORMW 「……これ………魔理沙…の………。	PRINTFORMW 「……これ………魔理沙…の………。
PRINTFORMW 「あたるのはだめ…まもらなきゃ！」	PRINTFORMW 「あたるのはだめ…まもらなきゃ！」
PRINTFORMW 「禁弾『スターボゥブレイク』！！」	PRINTFORMW 「禁弾『スターボゥブレイク』！！」
PRINTFORMW 「おかあさまのおとおりだぁい！！」	PRINTFORMW 「おかあさまのおとおりだぁい！！」
PRINTFORMW 「いちげきひっさぁぁぁぁつぅ！！」	PRINTFORMW 「いちげきひっさぁぁぁぁつぅ！！」
PRINTFORMW 「わたしこのかんしょくきらーい…」	PRINTFORMW 「わたしこのかんしょくきらーい…」
PRINTFORMW 「いぁっ！…うぅ…っもういや…！」	PRINTFORMW 「いぁっ！…うぅ…っもういや…！」
PRINTFORMW 「おかあさまはわたしがまもる！！」	PRINTFORMW 「おかあさまはわたしがまもる！！」
PRINTFORMW 「はぁ、はぁ…うん…ぐっ…っ…？」	PRINTFORMW 「はぁ、はぁ…うん…ぐっ…っ…？」
PRINTFORMW 「来るなぁぁぁぁぁぁぁぁ！！！」	PRINTFORMW 「来るなぁぁぁぁぁぁぁぁ！！！」
PRINTFORMW 「早く倒さなきゃ…たぁぁぁ！！」	PRINTFORMW 「早く倒さなきゃ…たぁぁぁ！！」
PRINTFORMW 「無駄なく動く…無駄なく動く…」	PRINTFORMW 「無駄なく動く…無駄なく動く…」
PRINTFORMW 「すれ違いざまに…たぁぁぁっ！」	PRINTFORMW 「すれ違いざまに…たぁぁぁっ！」
PRINTFORMW 「はやく……早くしなきゃ……！」	PRINTFORMW 「はやく……早くしなきゃ……！」
PRINTFORMW 「ぁぁぁぁぁぁぁアアアッ…！！」	PRINTFORMW 「ぁぁぁぁぁぁぁアアアッ…！！」
PRINTFORMW 「はぁぁぁぁぁぁぁぁぁぁっ！！」	PRINTFORMW 「はぁぁぁぁぁぁぁぁぁぁっ！！」
PRINTFORMW 「もう嫌…絶対挿入れさせない！」	PRINTFORMW 「もう嫌…絶対挿入れさせない！」
PRINTFORMW 「ここは三十六計逃げるが勝ち！」	PRINTFORMW 「ここは三十六計逃げるが勝ち！」
PRINTFORMW 「……漸く…大人しくなったね…」	PRINTFORMW 「……漸く…大人しくなったね…」
PRINTFORMW 「おっぱい飲む？こっちおいで…」	PRINTFORMW 「おっぱい飲む？こっちおいで…」
PRINTFORMW 「ん、約束するからね……それと」	PRINTFORMW 「ん、約束するからね……それと」
PRINTFORMW 「損害軽微、まだまだイケるわね」	PRINTFORMW 「損害軽微、まだまだイケるわね」
PRINTFORMW 「…ねぇ、ちょっと！確りしてよ！	PRINTFORMW 「…ねぇ、ちょっと！確りしてよ！
PRINTFORMW 「よかったぁ、無事だったんだね」	PRINTFORMW 「よかったぁ、無事だったんだね」
PRINTFORMW 「ごめんなさい…今は護れない…」	PRINTFORMW 「ごめんなさい…今は護れない…」
PRINTFORMW 「咲夜、バックアップお願いね！」	PRINTFORMW 「咲夜、バックアップお願いね！」
PRINTFORMW 「お姉様、背中はお願いします！」	PRINTFORMW 「お姉様、背中はお願いします！」
PRINTFORML 「うー…意地悪……いじわる～！」	PRINTFORML 「うー…意地悪……いじわる～！」
PRINTFORMW 「へぇ～中々勝手は良さそうだね」	PRINTFORMW 「へぇ～中々勝手は良さそうだね」
PRINTFORMW 「魔理沙のだ…ってことは……っ」	PRINTFORMW 「魔理沙のだ…ってことは……っ」
PRINTFORMW 「またある…触手の亜種かなぁ…」	PRINTFORMW 「またある…触手の亜種かなぁ…」
PRINTFORMW 「うげぇ…なんでこんな泥水が…」	PRINTFORMW 「うげぇ…なんでこんな泥水が…」
PRINTFORMW 「咲夜の好きなお茶だったよね～」	PRINTFORMW 「咲夜の好きなお茶だったよね～」
PRINTFORM 「あ、あぁっ、ああああああぁっ……	PRINTFORM 「あ、あぁっ、ああああああぁっ……
PRINTFORMW 「前も浄化した気が…まいっか…」	PRINTFORMW 「前も浄化した気が…まいっか…」
PRINTFORMW 「隣は…どうなってるのかな…？」	PRINTFORMW 「隣は…どうなってるのかな…？」
PRINTFORMW 「ふぁぁ…集中しないと…寝む…」	PRINTFORMW 「ふぁぁ…集中しないと…寝む…」
PRINTFORMW それは友達の着ていた衣服だった。	PRINTFORMW それは友達の着ていた衣服だった。
PRINTFORMW ――二度と帰ってこれない神隠し。	PRINTFORMW ――二度と帰ってこれない神隠し。
PRINTFORMW 「あ、あぁ…なくなっちゃった…」	PRINTFORMW 「あ、あぁ…なくなっちゃった…」
PRINTFORMW 「んっ………ふぅ…危なかった…」	PRINTFORMW 「んっ………ふぅ…危なかった…」
PRINTFORMW 「こく、こく…ふぅ、美味しい♪」	PRINTFORMW 「こく、こく…ふぅ、美味しい♪」
PRINTFORMW 「あ、危ない！！壁も危険だね…」	PRINTFORMW 「あ、危ない！！壁も危険だね…」
PRINTFORMW 「っ！…あ、あぶなかった………」	PRINTFORMW 「っ！…あ、あぶなかった………」
PRINTFORMW 「…これ………咲夜…の…………。	PRINTFORMW 「…これ………咲夜…の…………。
PRINTFORMW 「おかあさまをじゃまするな！！」	PRINTFORMW 「おかあさまをじゃまするな！！」
PRINTFORMW 「まとめてぶっつぶしてやる！！」	PRINTFORMW 「まとめてぶっつぶしてやる！！」
PRINTFORMW 「これくらいならできるかな……」	PRINTFORMW 「これくらいならできるかな……」
PRINTFORMW 「まとめて……ドッカーン！！！」	PRINTFORMW 「まとめて……ドッカーン！！！」
PRINTFORMW 「ドッカーン☆ドッカーン☆！！」	PRINTFORMW 「ドッカーン☆ドッカーン☆！！」
PRINTFORMW 「てやぁぁぁぁぁぁぁぁぁっ！！」	PRINTFORMW 「てやぁぁぁぁぁぁぁぁぁっ！！」
PRINTFORMW 「撃ち抜くだけ！はぁぁぁ！！」	PRINTFORMW 「撃ち抜くだけ！はぁぁぁ！！」
PRINTFORMW 「狙う所狙えば…一発だって！」	PRINTFORMW 「狙う所狙えば…一発だって！」
PRINTFORMW 「全員射程だぁぁぁぁぁ！！！」	PRINTFORMW 「全員射程だぁぁぁぁぁ！！！」
PRINTFORMW 「焼け焦げるまで撃ち続ける！」	PRINTFORMW 「焼け焦げるまで撃ち続ける！」
PRINTFORMW 「上手く…脱出できれば…！！」	PRINTFORMW 「上手く…脱出できれば…！！」
PRINTFORMW 「だめ！おっぱいはだめぇ！！」	PRINTFORMW 「だめ！おっぱいはだめぇ！！」
PRINTFORMW 「やめで…もぅ……ゆるじで…」	PRINTFORMW 「やめで…もぅ……ゆるじで…」
PRINTFORMW 「うぶぅっ…げほっごほっ……」	PRINTFORMW 「うぶぅっ…げほっごほっ……」
PRINTFORMW 「ひっ…だめ、いま…は…っ♪」	PRINTFORMW 「ひっ…だめ、いま…は…っ♪」
PRINTFORMW 「あうっ！　な、なに……！？」	PRINTFORMW 「あうっ！　な、なに……！？」
PRINTFORMW 「アイツらも食べるのかな…？」	PRINTFORMW 「アイツらも食べるのかな…？」
PRINTFORMW 「他………どうなってるの…？」	PRINTFORMW 「他………どうなってるの…？」
PRINTFORMW 「え？うーん、わかったよぉ…」	PRINTFORMW 「え？うーん、わかったよぉ…」
PRINTFORMW 「うわっと…ツルツル滑る…！」	PRINTFORMW 「うわっと…ツルツル滑る…！」
PRINTFORMW 「うぅっ、ごめん…肩貸して…」	PRINTFORMW 「うぅっ、ごめん…肩貸して…」
PRINTFORMW 「うぅ…集中…集中……うぅ…」	PRINTFORMW 「うぅ…集中…集中……うぅ…」
PRINTFORMW 其処に映ったのは肉の塊だった。	PRINTFORMW 其処に映ったのは肉の塊だった。
PRINTFORMW 「わっきゃっ…は、離せぇぇ！」	PRINTFORMW 「わっきゃっ…は、離せぇぇ！」
PRINTFORMW 「うごくな！のんすとっぷ！！」	PRINTFORMW 「うごくな！のんすとっぷ！！」
PRINTFORMW 「うわっと…えっと…こう…？」	PRINTFORMW 「うわっと…えっと…こう…？」
PRINTFORMW 「そろそろフィナーレだよっ！」	PRINTFORMW 「そろそろフィナーレだよっ！」
PRINTFORMW 「くらえ！えくすぷろーど！！」	PRINTFORMW 「くらえ！えくすぷろーど！！」
PRINTFORMW 「うぶっ……もう、やだ……！」	PRINTFORMW 「うぶっ……もう、やだ……！」
PRINTFORMW 「うーん、ふくじゃまだなー…」	PRINTFORMW 「うーん、ふくじゃまだなー…」
PRINTFORMW 「え？…うん…わかった……？」	PRINTFORMW 「え？…うん…わかった……？」
PRINTFORMW 「今は直撃は避けないと…っ」	PRINTFORMW 「今は直撃は避けないと…っ」
PRINTFORMW 「うぁぁぁぁぁぁぁぁぁ！！」	PRINTFORMW 「うぁぁぁぁぁぁぁぁぁ！！」
PRINTFORMW 「啼け、レーヴァテイン！！」	PRINTFORMW 「啼け、レーヴァテイン！！」
PRINTFORMW 「デカイの一発必要かな…！」	PRINTFORMW 「デカイの一発必要かな…！」
PRINTFORMW 「――――、set up！」	PRINTFORMW 「――――、set up！」
PRINTFORMW 「止めたら負けだ！撃つ！！」	PRINTFORMW 「止めたら負けだ！撃つ！！」
PRINTFORMW 「美鈴直伝！下弦・円月輪！」	PRINTFORMW 「美鈴直伝！下弦・円月輪！」
PRINTFORML 　　そんな……ダメ…かも……	PRINTFORML 　　そんな……ダメ…かも……
PRINTFORMW 「がはっ…、うっうぇ……っ」	PRINTFORMW 「がはっ…、うっうぇ……っ」
PRINTFORMW 「うぐ……力が湧かない…っ」	PRINTFORMW 「うぐ……力が湧かない…っ」
PRINTFORMW 「あ！気に入ってたのに！！」	PRINTFORMW 「あ！気に入ってたのに！！」
PRINTFORMW 「私が…皆を助けるんだ！！」	PRINTFORMW 「私が…皆を助けるんだ！！」
PRINTFORMW 「あぅ…うぁ……み、皆ぁ…っ	PRINTFORMW 「あぅ…うぁ……み、皆ぁ…っ
PRINTFORMW 「なんとか…なった…かな？」	PRINTFORMW 「なんとか…なった…かな？」
PRINTFORMW 「ふぅ、他の皆は無事かな…」	PRINTFORMW 「ふぅ、他の皆は無事かな…」
PRINTFORMW 「あ、ありがとう……うん…」	PRINTFORMW 「あ、ありがとう……うん…」
PRINTFORMW 「魔理沙、後ろはお願いね！」	PRINTFORMW 「魔理沙、後ろはお願いね！」
PRINTFORMW 「そう…うん、気を付けてね」	PRINTFORMW 「そう…うん、気を付けてね」
PRINTFORMW 「ひぃやぁぁぁぁぁぁぁ…！」	PRINTFORMW 「ひぃやぁぁぁぁぁぁぁ…！」
PRINTFORMW 「他の形のは無いのかなぁ…」	PRINTFORMW 「他の形のは無いのかなぁ…」
PRINTFORMW 「へぇ～変わった和服だね…」	PRINTFORMW 「へぇ～変わった和服だね…」
PRINTFORMW 「ひっ♪　あっん！うぅっ！」	PRINTFORMW 「ひっ♪　あっん！うぅっ！」
PRINTFORM 「んっ♪おっぱい…おいしいの？	PRINTFORM 「んっ♪おっぱい…おいしいの？
PRINTFORMW 「このっ…目が見えない…っ」	PRINTFORMW 「このっ…目が見えない…っ」
PRINTFORMW 「づっ…なに、これぇ…！？」	PRINTFORMW 「づっ…なに、これぇ…！？」
PRINTFORMW 「あぁ…やっぱそうなんだ…」	PRINTFORMW 「あぁ…やっぱそうなんだ…」
PRINTFORMW 「ははは………どうしよう…」	PRINTFORMW 「ははは………どうしよう…」
PRINTFORMW 「これで…よし………すぅ…」	PRINTFORMW 「これで…よし………すぅ…」
PRINTFORMW 「早く…はやく安全圏へ…っ」	PRINTFORMW 「早く…はやく安全圏へ…っ」
PRINTFORMW 「なんだか薄気味悪いなぁ…」	PRINTFORMW 「なんだか薄気味悪いなぁ…」
PRINTFORMW 「っ！あぁ…だめ…ぇぇ…っ」	PRINTFORMW 「っ！あぁ…だめ…ぇぇ…っ」
PRINTFORMW 「あ、あぁ…消えちゃった…」	PRINTFORMW 「あ、あぁ…消えちゃった…」
PRINTFORMW 「んっ……ふぅ…危なかった」	PRINTFORMW 「んっ……ふぅ…危なかった」
PRINTFORMW 「いぃぃやぁぁぁぁぁぁっ！」	PRINTFORMW 「いぃぃやぁぁぁぁぁぁっ！」
PRINTFORMW 「きえちゃえぇぇぇぇぇ！！」	PRINTFORMW 「きえちゃえぇぇぇぇぇ！！」
PRINTFORMW 「これはきついんじゃない？」	PRINTFORMW 「これはきついんじゃない？」
PRINTFORMW 「いっぱつ…にゅうこんっ！」	PRINTFORMW 「いっぱつ…にゅうこんっ！」
PRINTFORMW 「ばくれつさいがんしゅう！」	PRINTFORMW 「ばくれつさいがんしゅう！」
PRINTFORMW 「やぁー！にんじゃぎりー！」	PRINTFORMW 「やぁー！にんじゃぎりー！」
PRINTFORMW 「あうぅっ……はなしてぇ！」	PRINTFORMW 「あうぅっ……はなしてぇ！」
PRINTFORMW 「いぎぎぃ…はなせぇぇぇ！」	PRINTFORMW 「いぎぎぃ…はなせぇぇぇ！」
PRINTFORMW 「ごめんなさいおかあさま…」	PRINTFORMW 「ごめんなさいおかあさま…」
PRINTFORMW 「お、おなかは…だめ…っ！」	PRINTFORMW 「お、おなかは…だめ…っ！」
PRINTFORMW 「いつものかっこうだもん！」	PRINTFORMW 「いつものかっこうだもん！」
PRINTFORMW 　でも　わたしはわすれません	PRINTFORMW 　でも　わたしはわすれません
PRINTFORMW 「上手くかわせないかな…」	PRINTFORMW 「上手くかわせないかな…」
PRINTFORMW 「てやぁぁぁぁぁぁぁ！！」	PRINTFORMW 「てやぁぁぁぁぁぁぁ！！」
PRINTFORMW 「打ち出すだけなら…楽！」	PRINTFORMW 「打ち出すだけなら…楽！」
PRINTFORMW 「霊夢直伝！エアリアル！」	PRINTFORMW 「霊夢直伝！エアリアル！」
PRINTFORMW 　　　　誰か…誰か……… 	PRINTFORMW 　　　　誰か…誰か……… 
PRINTFORMW 「うっ、ちくしょう！！！」	PRINTFORMW 「うっ、ちくしょう！！！」
PRINTFORMW （え、そんな…それって…）	PRINTFORMW （え、そんな…それって…）
PRINTFORMW 「……………………………」	PRINTFORMW 「……………………………」
PRINTFORMW 　はぁ…大丈夫みたいだね…	PRINTFORMW 　はぁ…大丈夫みたいだね…
PRINTFORMW 「大体そんな感じ。後は？」	PRINTFORMW 「大体そんな感じ。後は？」
PRINTFORMW 「解った。無茶しないでね」	PRINTFORMW 「解った。無茶しないでね」
PRINTFORMW 「お姉様……。はーい……」	PRINTFORMW 「お姉様……。はーい……」
PRINTFORMW 「ザ・二刀流！なんちて…」	PRINTFORMW 「ザ・二刀流！なんちて…」
PRINTFORMW 「帰ったら咲夜にあげよ♪」	PRINTFORMW 「帰ったら咲夜にあげよ♪」
PRINTFORMW 「無理…ぐー…すぅ…すぅ」	PRINTFORMW 「無理…ぐー…すぅ…すぅ」
PRINTFORMW 「眠い…おやすみなさい…」	PRINTFORMW 「眠い…おやすみなさい…」
PRINTFORMW 「づっ…頭、いだぃ……！」	PRINTFORMW 「づっ…頭、いだぃ……！」
PRINTFORMW 「うん、決めた。産もう…」	PRINTFORMW 「うん、決めた。産もう…」
PRINTFORMW 「目も見えないし…最悪…」	PRINTFORMW 「目も見えないし…最悪…」
PRINTFORMW 「ふぁぁ、さっさと休もう」	PRINTFORMW 「ふぁぁ、さっさと休もう」
PRINTFORMW 「強行しようか…いくよ！」	PRINTFORMW 「強行しようか…いくよ！」
PRINTFORMW 「気を張る方が辛いなぁ…」	PRINTFORMW 「気を張る方が辛いなぁ…」
PRINTFORMW フランドールは友達を呼ぶ。	PRINTFORMW フランドールは友達を呼ぶ。
PRINTFORMW 「わわわっ！危なかった…」	PRINTFORMW 「わわわっ！危なかった…」
PRINTFORMW 「この帽子…お姉様の………	PRINTFORMW 「この帽子…お姉様の………
PRINTFORMW 「わたしにさわらない！！」	PRINTFORMW 「わたしにさわらない！！」
PRINTFORMW 「うりゃりゃりゃりゃー！」	PRINTFORMW 「うりゃりゃりゃりゃー！」
PRINTFORMW 「も～、ちょこまかと！！」	PRINTFORMW 「も～、ちょこまかと！！」
PRINTFORMW 「いっぱつにゅうこん！！」	PRINTFORMW 「いっぱつにゅうこん！！」
PRINTFORMW 「こ、このきょりなら…！」	PRINTFORMW 「こ、このきょりなら…！」
PRINTFORMW 「はぁ…はぁ…そりゃ！！」	PRINTFORMW 「はぁ…はぁ…そりゃ！！」
PRINTFORMW 「ぎぎ…いぎぎぎぎ…っ！」	PRINTFORMW 「ぎぎ…いぎぎぎぎ…っ！」
PRINTFORMW 「あ、あぶなかったぁ……」	PRINTFORMW 「あ、あぶなかったぁ……」
PRINTFORMW 「がんばろ！おかあさま！」	PRINTFORMW 「がんばろ！おかあさま！」
PRINTFORMW 「うん、わたしはへーき！」	PRINTFORMW 「うん、わたしはへーき！」
PRINTFORMW 「来ないでよぉぉぉ！！」	PRINTFORMW 「来ないでよぉぉぉ！！」
PRINTFORMW 「はぁ…はぁ…集中…！」	PRINTFORMW 「はぁ…はぁ…集中…！」
PRINTFORMW 「はぁ…はぁ…はぁっ！」	PRINTFORMW 「はぁ…はぁ…はぁっ！」
PRINTFORMW 「美鈴直伝！三散連打！」	PRINTFORMW 「美鈴直伝！三散連打！」
PRINTFORMW 「死ねよ、死んでよ！！」	PRINTFORMW 「死ねよ、死んでよ！！」
PRINTFORMW 「目を……！砕くッ…！」	PRINTFORMW 「目を……！砕くッ…！」
PRINTFORMW 　聞いたことあるけど…」	PRINTFORMW 　聞いたことあるけど…」
PRINTFORMW 「…み、みないでよぉ…」	PRINTFORMW 「…み、みないでよぉ…」
PRINTFORMW 「大丈夫？よかったぁ…」	PRINTFORMW 「大丈夫？よかったぁ…」
PRINTFORMW 「私が…護らなきゃ…！」	PRINTFORMW 「私が…護らなきゃ…！」
PRINTFORMW 「こんなにあるなんて…」	PRINTFORMW 「こんなにあるなんて…」
PRINTFORMW 「なんだか新鮮な洋服…」	PRINTFORMW 「なんだか新鮮な洋服…」
PRINTFORMW 「……ふぅ、頭が痛い…」	PRINTFORMW 「……ふぅ、頭が痛い…」
PRINTFORMW 「また、体の中に……！」	PRINTFORMW 「また、体の中に……！」
PRINTFORMW 「あれ？特に違和感なし…	PRINTFORMW 「あれ？特に違和感なし…
PRINTFORMW 「でも…どうしよう……」	PRINTFORMW 「でも…どうしよう……」
PRINTFORML 「せーのっりゃぁぁっ！」	PRINTFORML 「せーのっりゃぁぁっ！」
PRINTFORMW 「うぅぅ、そんなぁ……」	PRINTFORMW 「うぅぅ、そんなぁ……」
PRINTFORMW 「はぁ…はぁ…フンっ！」	PRINTFORMW 「はぁ…はぁ…フンっ！」
PRINTFORMW 「はぁ、はぁ…はぁ……」	PRINTFORMW 「はぁ、はぁ…はぁ……」
PRINTFORMW 「はぁぁ…心地よい……」	PRINTFORMW 「はぁぁ…心地よい……」
PRINTFORMW 「え……こ、これ…って…	PRINTFORMW 「え……こ、これ…って…
PRINTFORM 「がーど！！まけるかぁ！」	PRINTFORM 「がーど！！まけるかぁ！」
PRINTFORMW 「まずはあてないと…！」	PRINTFORMW 「まずはあてないと…！」
PRINTFORMW 「いっちゃぇぇぇぇぇ！」	PRINTFORMW 「いっちゃぇぇぇぇぇ！」
PRINTFORMW 「エンドオブハート！！」	PRINTFORMW 「エンドオブハート！！」
PRINTFORMW 「いいかげんにしてよ！」	PRINTFORMW 「いいかげんにしてよ！」
PRINTFORMW 「いやぁぁぁっ！！！！」	PRINTFORMW 「いやぁぁぁっ！！！！」
PRINTFORMW 「かいほーせよーっ！！」	PRINTFORMW 「かいほーせよーっ！！」
PRINTFORMW 「牽制程度だけど…！」	PRINTFORMW 「牽制程度だけど…！」
PRINTFORMW 「てぁぁぁぁぁぁっ！」	PRINTFORMW 「てぁぁぁぁぁぁっ！」
PRINTFORMW 「当たる…もんかぁ！」	PRINTFORMW 「当たる…もんかぁ！」
PRINTFORMW 「服狙いなら容易い！」	PRINTFORMW 「服狙いなら容易い！」
PRINTFORMW 「ひっ、危なかった…」	PRINTFORMW 「ひっ、危なかった…」
PRINTFORMW 「やぁ…眼、覚めた？」	PRINTFORMW 「やぁ…眼、覚めた？」
PRINTFORMW 「…………っ……ねぇ」	PRINTFORMW 「…………っ……ねぇ」
PRINTFORMW 「もう…誰も……っ！」	PRINTFORMW 「もう…誰も……っ！」
PRINTFORMW 「うん、一緒にいこ♪」	PRINTFORMW 「うん、一緒にいこ♪」
PRINTFORMW 「えー、ダメなの…？」	PRINTFORMW 「えー、ダメなの…？」
PRINTFORML 「そ…じゃあ任せるから	PRINTFORML 「そ…じゃあ任せるから
PRINTFORMW 「あ、またみーっけ♪」	PRINTFORMW 「あ、またみーっけ♪」
PRINTFORMW 「……また…なの…？」	PRINTFORMW 「……また…なの…？」
PRINTFORMW 「……ああ、やっぱり」	PRINTFORMW 「……ああ、やっぱり」
PRINTFORMW 「うぅ、身体が重い…」	PRINTFORMW 「うぅ、身体が重い…」
PRINTFORMW 「ふぅ…先を急ごう…」	PRINTFORMW 「ふぅ…先を急ごう…」
PRINTFORMW 「誰か待ち伏せは……」	PRINTFORMW 「誰か待ち伏せは……」
PRINTFORMW 「此処に隠れよう……」	PRINTFORMW 「此処に隠れよう……」
PRINTFORMW 「もしもし、大丈夫？」	PRINTFORMW 「もしもし、大丈夫？」
PRINTFORMW ……犯されかけました。	PRINTFORMW ……犯されかけました。
PRINTFORMW 「今日はいい天気だね」	PRINTFORMW 「今日はいい天気だね」
PRINTFORMW 二人は洞窟の中を進む。	PRINTFORMW 二人は洞窟の中を進む。
PRINTFORMW 「何が入ってるかな…」	PRINTFORMW 「何が入ってるかな…」
PRINTFORMW 「わわわっ、わっ！！」	PRINTFORMW 「わわわっ、わっ！！」
PRINTFORMW 「もうゆるさないよ…」	PRINTFORMW 「もうゆるさないよ…」
PRINTFORMW 「にがすもんかぁぁ！」	PRINTFORMW 「にがすもんかぁぁ！」
PRINTFORMW 「きみもしんじゃえ！」	PRINTFORMW 「きみもしんじゃえ！」
PRINTFORMW 「はぁ…はぁ…はっ！」	PRINTFORMW 「はぁ…はぁ…はっ！」
PRINTFORMW 「っ、いまはだめぇ！」	PRINTFORMW 「っ、いまはだめぇ！」
PRINTFORMW 「げほっ…ごっほっ…」	PRINTFORMW 「げほっ…ごっほっ…」
PRINTFORMW 「いやっ！やめて！！」	PRINTFORMW 「いやっ！やめて！！」
PRINTFORMW 「ふぇ？っひゃい？！」	PRINTFORMW 「ふぇ？っひゃい？！」
PRINTFORMW 「狙いが…ぶれる…」	PRINTFORMW 「狙いが…ぶれる…」
PRINTFORMW 「すぅ…はぁ…っ！」	PRINTFORMW 「すぅ…はぁ…っ！」
PRINTFORMW 「く、来るなッ！！」	PRINTFORMW 「く、来るなッ！！」
PRINTFORMW 「いやっ、来るな！」	PRINTFORMW 「いやっ、来るな！」
PRINTFORMW 「…………すぅ……」	PRINTFORMW 「…………すぅ……」
PRINTFORMW 「行くよ！皆！！！」	PRINTFORMW 「行くよ！皆！！！」
PRINTFORMW 「に、逃げ切れた……	PRINTFORMW 「に、逃げ切れた……
PRINTFORML 　戦います、だから…	PRINTFORML 　戦います、だから…
PRINTFORMW 「皆……ゴメン……」	PRINTFORMW 「皆……ゴメン……」
PRINTFORMW 「あ、何か見つけた」	PRINTFORMW 「あ、何か見つけた」
PRINTFORMW 「…？何か変だな…」	PRINTFORMW 「…？何か変だな…」
PRINTFORMW 「安全そうね。突撃」	PRINTFORMW 「安全そうね。突撃」
PRINTFORMW 「隣の様子はっと…」	PRINTFORMW 「隣の様子はっと…」
PRINTFORMW 「なっ、なにっ？！」	PRINTFORMW 「なっ、なにっ？！」
PRINTFORMW 「もうやられてよ！」	PRINTFORMW 「もうやられてよ！」
PRINTFORMW 「もう、じゃま！！」	PRINTFORMW 「もう、じゃま！！」
PRINTFORMW 「もうおこったよ！」	PRINTFORMW 「もうおこったよ！」
PRINTFORMW 「うぉぉぉぉぉぉ！」	PRINTFORMW 「うぉぉぉぉぉぉ！」
PRINTFORMW 「ぁ…このぉっ！」	PRINTFORMW 「ぁ…このぉっ！」
PRINTFORMW 「この一撃で…！」	PRINTFORMW 「この一撃で…！」
PRINTFORMW 「二発で仕留める」	PRINTFORMW 「二発で仕留める」
PRINTFORMW 「すぅ…はぁ…！」	PRINTFORMW 「すぅ…はぁ…！」
PRINTFORMW 「一発…入魂！！」	PRINTFORMW 「一発…入魂！！」
PRINTFORMW 「目が…霞む…っ」	PRINTFORMW 「目が…霞む…っ」
PRINTFORMW 「もう来るなぁ！」	PRINTFORMW 「もう来るなぁ！」
PRINTFORMW 「ひっ…やぁっ！」	PRINTFORMW 「ひっ…やぁっ！」
PRINTFORMW 「あ……服………」	PRINTFORMW 「あ……服………」
PRINTFORMW 「はぁ…いくよ！」	PRINTFORMW 「はぁ…いくよ！」
PRINTFORMW 「今すぐ殺すよ！」	PRINTFORMW 「今すぐ殺すよ！」
PRINTFORMW 「あはは…やぁ…」	PRINTFORMW 「あはは…やぁ…」
PRINTFORMW 「ふぇ？…私の番？	PRINTFORMW 「ふぇ？…私の番？
PRINTFORMW 「う……あ……？」	PRINTFORMW 「う……あ……？」
PRINTFORMW 「…！！！！！！」	PRINTFORMW 「…！！！！！！」
PRINTFORMW 「はじけてぇ！！」	PRINTFORMW 「はじけてぇ！！」
PRINTFORMW 「…………あは♪」	PRINTFORMW 「…………あは♪」
PRINTFORMW 「あらよーっと！」	PRINTFORMW 「あらよーっと！」
PRINTFORMW 「動くなぁ！！」	PRINTFORMW 「動くなぁ！！」
PRINTFORMW 「逃がさない！」	PRINTFORMW 「逃がさない！」
PRINTFORMW 「極彩と散れ…」	PRINTFORMW 「極彩と散れ…」
PRINTFORMW 「や、やぁっ！」	PRINTFORMW 「や、やぁっ！」
PRINTFORMW 「…………ぁ…」	PRINTFORMW 「…………ぁ…」
PRINTFORMW 「い、いやっ！」	PRINTFORMW 「い、いやっ！」
PRINTFORMW 「うっ、寒い…」	PRINTFORMW 「うっ、寒い…」
PRINTFORMW 　　　　　嫌だ！	PRINTFORMW 　　　　　嫌だ！
PRINTFORMW 　嫌だ！嫌だ！！	PRINTFORMW 　嫌だ！嫌だ！！
PRINTFORMW 　それでも、……	PRINTFORMW 　それでも、……
PRINTFORMW 「っ……………」	PRINTFORMW 「っ……………」
PRINTFORMW 「…？おーい！」	PRINTFORMW 「…？おーい！」
PRINTFORMW 「う…やぁっ！」	PRINTFORMW 「う…やぁっ！」
PRINTFORMW 「ちょいさー！」	PRINTFORMW 「ちょいさー！」
PRINTFORMW 「う～………！」	PRINTFORMW 「う～………！」
PRINTFORMW 「や、やだぁ！」	PRINTFORMW 「や、やだぁ！」
PRINTFORMW 「……ひくっ」	PRINTFORMW 「……ひくっ」
PRINTFORMW 「あっ…！？」	PRINTFORMW 「あっ…！？」
PRINTFORMW 「見切った！」	PRINTFORMW 「見切った！」
PRINTFORMW 「……………」	PRINTFORMW 「……………」
PRINTFORMW 「にゅう……」	PRINTFORMW 「にゅう……」
PRINTFORMW 「……あぅっ」	PRINTFORMW 「……あぅっ」
PRINTFORMW 「う…うく…」	PRINTFORMW 「う…うく…」
PRINTFORMW 「ひぎぃっ！」	PRINTFORMW 「ひぎぃっ！」
PRINTFORMW 「あぅ…っ」	PRINTFORMW 「あぅ…っ」
PRINTFORMW 「ふんっ！」	PRINTFORMW 「ふんっ！」
PRINTFORMW 「当てる！」	PRINTFORMW 「当てる！」
PRINTFORMW 「今だ！！」	PRINTFORMW 「今だ！！」
PRINTFORMW 「コロス…」	PRINTFORMW 「コロス…」
PRINTFORMW 「あぐっ！」	PRINTFORMW 「あぐっ！」
PRINTFORMW 「あうっ！」	PRINTFORMW 「あうっ！」
PRINTFORMW 「ぶぇっ！」	PRINTFORMW 「ぶぇっ！」
PRINTFORMW 「えっ？！」	PRINTFORMW 「えっ？！」
PRINTFORMW 「やぁっ！」	PRINTFORMW 「やぁっ！」
PRINTFORMW 「えいっ！」	PRINTFORMW 「えいっ！」
PRINTFORMW 「そこだ！」	PRINTFORMW 「そこだ！」
PRINTFORMW 「いね！！」	PRINTFORMW 「いね！！」
PRINTFORMW 「えーい！」	PRINTFORMW 「えーい！」
PRINTFORMW 「ちぇい！」	PRINTFORMW 「ちぇい！」
PRINTFORMW 「いたっ！」	PRINTFORMW 「いたっ！」
PRINTFORMW 「んぁ…」	PRINTFORMW 「んぁ…」
PRINTFORMW 「削れ！」	PRINTFORMW 「削れ！」
PRINTFORMW 「其処！」	PRINTFORMW 「其処！」
PRINTFORMW 「えっ？」	PRINTFORMW 「えっ？」
PRINTFORMW 「え……」	PRINTFORMW 「え……」
PRINTFORMW 「あがっ」	PRINTFORMW 「あがっ」
PRINTFORMW 「ちっ！」	PRINTFORMW 「ちっ！」
PRINTFORMW 「次…」	PRINTFORMW 「次…」
PRINTFORMW 「ん～」	PRINTFORMW 「ん～」
PRINTFORMW ドガッ	PRINTFORMW ドガッ
PRINTFORMW ひた	PRINTFORMW ひた
PRINTFORMW 」	PRINTFORMW 」
PRINTFORMW 	PRINTFORMW 
PRINTFORML 	PRINTFORML 
PRINTFORML	PRINTFORML
PRINTFORMW	PRINTFORMW
