//口上:

PRINTFORML 「ここは……？ただならぬ『あしきゆめ』達の気配を感じます。私では抑えきれないかもしれません……」	PRINTFORML 「ここは……？ただならぬ『あしきゆめ』達の気配を感じます。私では抑えきれないかもしれません……」
PRINTFORML 「現の自分はどこか遠慮しているものです。でも、思った通りに叫ばないと、願いは空まで届きません」	PRINTFORML 「現の自分はどこか遠慮しているものです。でも、思った通りに叫ばないと、願いは空まで届きません」
PRINTFORML 「心は傷ついても血を流しません。だからどこがどうして傷ついたのか本人にさえわからないの」	PRINTFORML 「心は傷ついても血を流しません。だからどこがどうして傷ついたのか本人にさえわからないの」
PRINTFORML 「悪夢でお腹いっぱい。どうせいっぱいになるなら、楽しいことや夢見ることの方がいいですね」	PRINTFORML 「悪夢でお腹いっぱい。どうせいっぱいになるなら、楽しいことや夢見ることの方がいいですね」
PRINTFORMDL そう判断した%CALLNAME:1%は苦渋の決断でドレミーをおいていくことにした……	PRINTFORMDL そう判断した%CALLNAME:1%は苦渋の決断でドレミーをおいていくことにした……
PRINTFORML 「この手の夢の中の女性は抜け出せずに堕ちるけど、実際はそう甘くないことを……！」	PRINTFORML 「この手の夢の中の女性は抜け出せずに堕ちるけど、実際はそう甘くないことを……！」
PRINTFORML 「……ごめんなさい。夢世界の住民が暴れているようなの。止めにいってくるわね」	PRINTFORML 「……ごめんなさい。夢世界の住民が暴れているようなの。止めにいってくるわね」
PRINTFORML 「明日はあなたに汚されることを望んでいない。沈みなさい。『あしきゆめ』よ」	PRINTFORML 「明日はあなたに汚されることを望んでいない。沈みなさい。『あしきゆめ』よ」
PRINTFORML 「良い武器とは破壊力の高い武器ではありません。信頼できる武器のことです」	PRINTFORML 「良い武器とは破壊力の高い武器ではありません。信頼できる武器のことです」
PRINTFORML （どこが気持ちいいかを言っては駄目……　連想は相手を調子づかせるだけ…）	PRINTFORML （どこが気持ちいいかを言っては駄目……　連想は相手を調子づかせるだけ…）
PRINTFORML 「……帽子が。女の髪に潜む闇、その深さにあなたは耐えられるでしょうか？」	PRINTFORML 「……帽子が。女の髪に潜む闇、その深さにあなたは耐えられるでしょうか？」
PRINTFORML 「悪夢から逃れる方法は……ありません。だから、正面から打ち砕きます！」	PRINTFORML 「悪夢から逃れる方法は……ありません。だから、正面から打ち砕きます！」
PRINTFORML 「相手を喜ばせることになろうと、これはさすがに抵抗しないわけには……」	PRINTFORML 「相手を喜ばせることになろうと、これはさすがに抵抗しないわけには……」
PRINTFORML 「『あしきゆめ』よ。あなた達を完全に作り変えるのが今の私の役目です」	PRINTFORML 「『あしきゆめ』よ。あなた達を完全に作り変えるのが今の私の役目です」
PRINTFORML 「服だけを狙えるずいぶんと都合のいい攻撃……。『あしきゆめ』の象徴」	PRINTFORML 「服だけを狙えるずいぶんと都合のいい攻撃……。『あしきゆめ』の象徴」
PRINTFORML 「心が忍の一字となりたる時、いかなる者にも心を犯される事はなし……」	PRINTFORML 「心が忍の一字となりたる時、いかなる者にも心を犯される事はなし……」
PRINTFORML 「この先は必要以上に気を付けてね。それでは貴方に吉夢が訪れん事を。」	PRINTFORML 「この先は必要以上に気を付けてね。それでは貴方に吉夢が訪れん事を。」
PRINTFORML 「『あしきゆめ』よ、恐れなさい。こざかしい手妻は、もう通用しません」	PRINTFORML 「『あしきゆめ』よ、恐れなさい。こざかしい手妻は、もう通用しません」
PRINTFORML 「寝るたびに夢の中に遊びに行っていたのが問題だったのでしょうか……」	PRINTFORML 「寝るたびに夢の中に遊びに行っていたのが問題だったのでしょうか……」
PRINTFORML 「『あしきゆめ』の暴走。叶えられていく良い願いの反動でしょうか……」	PRINTFORML 「『あしきゆめ』の暴走。叶えられていく良い願いの反動でしょうか……」
PRINTFORML 「『あしきゆめ』の暴走。私にはこの戦いを終わらせる義務があります」	PRINTFORML 「『あしきゆめ』の暴走。私にはこの戦いを終わらせる義務があります」
PRINTFORML 「撃てば必中　守りは固く　進む姿は乱れなし。そう行きたいものです」	PRINTFORML 「撃てば必中　守りは固く　進む姿は乱れなし。そう行きたいものです」
PRINTFORML 「そんな……。今はただ、だれかの夢オチで終わることを願うのみ……」	PRINTFORML 「そんな……。今はただ、だれかの夢オチで終わることを願うのみ……」
PRINTFORML 「ワンパターンな反応をし続ければ、『あしきゆめ』も飽きるはず……」	PRINTFORML 「ワンパターンな反応をし続ければ、『あしきゆめ』も飽きるはず……」
PRINTFORML 「夢のため、見えぬものを見、縛り得ぬものを縛るのが私の務めです」	PRINTFORML 「夢のため、見えぬものを見、縛り得ぬものを縛るのが私の務めです」
PRINTFORML 「『ゆめ』は、夜の無明に生まれ、朝日とともに消えゆくのがさだめ」	PRINTFORML 「『ゆめ』は、夜の無明に生まれ、朝日とともに消えゆくのがさだめ」
PRINTFORML 「これが最後の戦いになるかもしれない以上、悔いの残らないように」	PRINTFORML 「これが最後の戦いになるかもしれない以上、悔いの残らないように」
PRINTFORML 「多少の飛行能力を奪われたところで、私にはこの夢風船があります」	PRINTFORML 「多少の飛行能力を奪われたところで、私にはこの夢風船があります」
PRINTFORML 「夢は現実以上に精神を侵します。不自然に用意された夢は危険です」	PRINTFORML 「夢は現実以上に精神を侵します。不自然に用意された夢は危険です」
PRINTFORML 「何度も他人の夢で見たシーンとはいえ、自分がこうなるとは……」	PRINTFORML 「何度も他人の夢で見たシーンとはいえ、自分がこうなるとは……」
PRINTFORML 「『あしきゆめ』の集合体、すでにここまで成長しているとは……」	PRINTFORML 「『あしきゆめ』の集合体、すでにここまで成長しているとは……」
PRINTFORML 「性欲に対するさまざまな悪意が融合しているのを感じます……」	PRINTFORML 「性欲に対するさまざまな悪意が融合しているのを感じます……」
PRINTFORML 「この世界では、相手が喜ぶ反応をしないことが何より大切です」	PRINTFORML 「この世界では、相手が喜ぶ反応をしないことが何より大切です」
PRINTFORML 「『あしきゆめ』がいくら来ようと、吸引力は変わりません！」	PRINTFORML 「『あしきゆめ』がいくら来ようと、吸引力は変わりません！」
PRINTFORML 「ベッドの上で倒れるのなら本望でしょう？ベッドシュート！」	PRINTFORML 「ベッドの上で倒れるのなら本望でしょう？ベッドシュート！」
PRINTFORMDL ドレミーは言葉にならない声をあげ全身を痙攣させている……	PRINTFORMDL ドレミーは言葉にならない声をあげ全身を痙攣させている……
PRINTFORML 「……帽子が。女の髪には魔が潜む……それを教えてあげます」	PRINTFORML 「……帽子が。女の髪には魔が潜む……それを教えてあげます」
PRINTFORML 「『あしきゆめ』よ、あなたたちの思い通りにはなりません！」	PRINTFORML 「『あしきゆめ』よ、あなたたちの思い通りにはなりません！」
PRINTFORML 「泥にまみれようとも、戦い続けることこそが、大切ですから」	PRINTFORML 「泥にまみれようとも、戦い続けることこそが、大切ですから」
PRINTFORML 「ここは悪夢の世界と同様。常識は通用しそうにありませんね」	PRINTFORML 「ここは悪夢の世界と同様。常識は通用しそうにありませんね」
PRINTFORML 「攻撃を打ち込むには、絶好の一瞬と絶妙の一点があります」	PRINTFORML 「攻撃を打ち込むには、絶好の一瞬と絶妙の一点があります」
PRINTFORMDL ドレミーはだらしなく顔をゆるませ甘えるような声をあげた	PRINTFORMDL ドレミーはだらしなく顔をゆるませ甘えるような声をあげた
PRINTFORML 「くっ、『あしきゆめ』を一番喜ばせてしまう状態に……！」	PRINTFORML 「くっ、『あしきゆめ』を一番喜ばせてしまう状態に……！」
PRINTFORML 「はぁ…はぁ…♥　……こんなときに甘い悪夢の処理なんて」	PRINTFORML 「はぁ…はぁ…♥　……こんなときに甘い悪夢の処理なんて」
PRINTFORMDL 完全に力尽きたドレミーを守りながら探索は出来そうにない	PRINTFORMDL 完全に力尽きたドレミーを守りながら探索は出来そうにない
PRINTFORML 「夢の世界はいつでも摩訶不思議アドベンチャーですが……」	PRINTFORML 「夢の世界はいつでも摩訶不思議アドベンチャーですが……」
PRINTFORML 「闇雲に狙っても効き目はないけど……ここならどう！？」	PRINTFORML 「闇雲に狙っても効き目はないけど……ここならどう！？」
PRINTFORML 「夢の国を奪う悪魔の所業、見逃すわけにはいきません！」	PRINTFORML 「夢の国を奪う悪魔の所業、見逃すわけにはいきません！」
PRINTFORMDL 虚ろな瞳で何かを呟くドレミーを放置することはできない	PRINTFORMDL 虚ろな瞳で何かを呟くドレミーを放置することはできない
PRINTFORMDL %CALLNAME:1%はドレミーの綺麗な手を取った	PRINTFORMDL %CALLNAME:1%はドレミーの綺麗な手を取った
PRINTFORML 「聖夜の衣装を…連想させては…駄目なのに……んっ……」	PRINTFORML 「聖夜の衣装を…連想させては…駄目なのに……んっ……」
PRINTFORML 「色とりどりの夢がどっさり……落ちてるわけないですね」	PRINTFORML 「色とりどりの夢がどっさり……落ちてるわけないですね」
PRINTFORML 「夢の世界では、欲望がそのまま現れる事がよくあります」	PRINTFORML 「夢の世界では、欲望がそのまま現れる事がよくあります」
PRINTFORML 「私では敵わないのかもしれませんが……　それでも！」	PRINTFORML 「私では敵わないのかもしれませんが……　それでも！」
PRINTFORML 「きちゃうっ♥ きもちいいのがっ♥♥ あひぃ♥♥♥」	PRINTFORML 「きちゃうっ♥ きもちいいのがっ♥♥ あひぃ♥♥♥」
PRINTFORML 「むりっ♥ これ無理ぃ♥♥ もう無理だからぁ♥♥♥」	PRINTFORML 「むりっ♥ これ無理ぃ♥♥ もう無理だからぁ♥♥♥」
PRINTFORML 「……帽子が。女の髪には魔性が宿っているんですよ？」	PRINTFORML 「……帽子が。女の髪には魔性が宿っているんですよ？」
PRINTFORML 「あと一歩が逃げていく感覚はどう？『あしきゆめ』よ」	PRINTFORML 「あと一歩が逃げていく感覚はどう？『あしきゆめ』よ」
PRINTFORML 「『あしきゆめ』を払い、これよりここに朝を呼びます」	PRINTFORML 「『あしきゆめ』を払い、これよりここに朝を呼びます」
PRINTFORML 「恐怖や絶望の感情が、『あしきゆめ』の糧になります」	PRINTFORML 「恐怖や絶望の感情が、『あしきゆめ』の糧になります」
PRINTFORML 「大人のふりして諦めていたら、奇跡の謎はとけません」	PRINTFORML 「大人のふりして諦めていたら、奇跡の謎はとけません」
PRINTFORML 「私の手帖は夢日記。全ての人の夢が記録されています」	PRINTFORML 「私の手帖は夢日記。全ての人の夢が記録されています」
PRINTFORML 「武器に関する夢だって、たくさん見てきましたので」	PRINTFORML 「武器に関する夢だって、たくさん見てきましたので」
PRINTFORML 「いっちゃう♥ イっちゃう♥♥ イッちゃう♥♥♥」	PRINTFORML 「いっちゃう♥ イっちゃう♥♥ イッちゃう♥♥♥」
PRINTFORML 「あっ♥ あっ♥♥ ゆるしてっ♥ ゆるしてぇ♥♥」	PRINTFORML 「あっ♥ あっ♥♥ ゆるしてっ♥ ゆるしてぇ♥♥」
PRINTFORML 「かんじてるっ♥ かんじちゃう♥♥ あーッ♥♥♥」	PRINTFORML 「かんじてるっ♥ かんじちゃう♥♥ あーッ♥♥♥」
PRINTFORML 「しらないっ♥ こんなのっ♥♥ 気持ちいい♥♥♥」	PRINTFORML 「しらないっ♥ こんなのっ♥♥ 気持ちいい♥♥♥」
PRINTFORML 「時間がありません。心臓が破れるまで走りましょう」	PRINTFORML 「時間がありません。心臓が破れるまで走りましょう」
PRINTFORML 「このままでは安眠枕の売り上げが落ちてしまいます」	PRINTFORML 「このままでは安眠枕の売り上げが落ちてしまいます」
PRINTFORML 「ふぅ……。この髪を切るなんてとんでもないですね」	PRINTFORML 「ふぅ……。この髪を切るなんてとんでもないですね」
PRINTFORML 「はぁぁ……。気持ちいい…。眠ってしまいそうです」	PRINTFORML 「はぁぁ……。気持ちいい…。眠ってしまいそうです」
PRINTFORML 「『あしきゆめ』に力を利用されたくはないけど……」	PRINTFORML 「『あしきゆめ』に力を利用されたくはないけど……」
PRINTFORML 「『好き』という感情さえあれば『夢』が見られます」	PRINTFORML 「『好き』という感情さえあれば『夢』が見られます」
PRINTFORML 「通常弾幕とはいえ、昇華させれば必殺となります」	PRINTFORML 「通常弾幕とはいえ、昇華させれば必殺となります」
PRINTFORML 「制空権をおさえましょう。バルーンファイトです」	PRINTFORML 「制空権をおさえましょう。バルーンファイトです」
PRINTFORML 「空間に閉じ込める方法と脱出方法は表裏一体よ！」	PRINTFORML 「空間に閉じ込める方法と脱出方法は表裏一体よ！」
PRINTFORML 「夢魔にこんなことをしても無駄と知りなさい……」	PRINTFORML 「夢魔にこんなことをしても無駄と知りなさい……」
PRINTFORML 「やめ……元の『やさしいゆめ』にもどってぇ……」	PRINTFORML 「やめ……元の『やさしいゆめ』にもどってぇ……」
PRINTFORML 「あらあら、随分と悪夢にうなされているみたいね」	PRINTFORML 「あらあら、随分と悪夢にうなされているみたいね」
PRINTFORML 「覗き見していた罰かもしれませんね……んっ……」	PRINTFORML 「覗き見していた罰かもしれませんね……んっ……」
PRINTFORML (余計な敵を起こさないように……　忍び足で……)	PRINTFORML (余計な敵を起こさないように……　忍び足で……)
PRINTFORMDL ドレミーはふらつく足取りで必死に逃げ出した……	PRINTFORMDL ドレミーはふらつく足取りで必死に逃げ出した……
PRINTFORML 「できることは……ぜんぶやっておかないと……！」	PRINTFORML 「できることは……ぜんぶやっておかないと……！」
PRINTFORML (あっ♥ あっ♥ 夢世界に入って慰めたいのに♥)	PRINTFORML (あっ♥ あっ♥ 夢世界に入って慰めたいのに♥)
PRINTFORML 「相手の技を、より知っている方が勝つものです」	PRINTFORML 「相手の技を、より知っている方が勝つものです」
PRINTFORML 「ヒツジとて、命の危機には狼をも凌ぎましょう」	PRINTFORML 「ヒツジとて、命の危機には狼をも凌ぎましょう」
PRINTFORML 「悪夢と狂夢の切り替わるタイミングを狙うのみ」	PRINTFORML 「悪夢と狂夢の切り替わるタイミングを狙うのみ」
PRINTFORML 「あっ♥ あっ♥♥ ごめんっ♥ なさいっ♥♥」	PRINTFORML 「あっ♥ あっ♥♥ ごめんっ♥ なさいっ♥♥」
PRINTFORML 「ダメっ♥ これダメっ♥♥ ダメなのぉ♥♥♥」	PRINTFORML 「ダメっ♥ これダメっ♥♥ ダメなのぉ♥♥♥」
PRINTFORML 「ズルイっ♥ これズルイっ♥♥ あーっ♥♥♥」	PRINTFORML 「ズルイっ♥ これズルイっ♥♥ あーっ♥♥♥」
PRINTFORML 「まっ♥ まってぇ♥♥ これダメなのぉ♥♥♥」	PRINTFORML 「まっ♥ まってぇ♥♥ これダメなのぉ♥♥♥」
PRINTFORML 「やめっ♥ やめてぇ♥♥ イっちゃうぅ♥♥♥」	PRINTFORML 「やめっ♥ やめてぇ♥♥ イっちゃうぅ♥♥♥」
PRINTFORML 「こわれる♥ こわされるっ♥♥ あーっ♥♥♥」	PRINTFORML 「こわれる♥ こわされるっ♥♥ あーっ♥♥♥」
PRINTFORML 「だめっ♥ たえられないっ♥♥ あーっ♥♥♥」	PRINTFORML 「だめっ♥ たえられないっ♥♥ あーっ♥♥♥」
PRINTFORML 「むりっ♥ たえられないっ♥♥ いくぅ♥♥♥」	PRINTFORML 「むりっ♥ たえられないっ♥♥ いくぅ♥♥♥」
PRINTFORML 「……あいにく、ふしだらな夢には慣れています」	PRINTFORML 「……あいにく、ふしだらな夢には慣れています」
PRINTFORML 「良いでしょう。その狂夢、私が処理しましょう」	PRINTFORML 「良いでしょう。その狂夢、私が処理しましょう」
PRINTFORML 「希望は……絶望の中から産まれるものだから…」	PRINTFORML 「希望は……絶望の中から産まれるものだから…」
PRINTFORML 「パート１、パート２、ゴー！パート３、ゴー！」	PRINTFORML 「パート１、パート２、ゴー！パート３、ゴー！」
PRINTFORML 「『あしきゆめ』の好みそうなことですね……！」	PRINTFORML 「『あしきゆめ』の好みそうなことですね……！」
PRINTFORMDL ドレミーは濁った瞳でふらふらと立ち上がった…	PRINTFORMDL ドレミーは濁った瞳でふらふらと立ち上がった…
PRINTFORML 「ベッド自体はいつでも用意できるのですが……」	PRINTFORML 「ベッド自体はいつでも用意できるのですが……」
PRINTFORML 「……このまま私の中に閉じ込めておきたいけど」	PRINTFORML 「……このまま私の中に閉じ込めておきたいけど」
PRINTFORML (今眠ったらすごいことになりそうだけど……♥)	PRINTFORML (今眠ったらすごいことになりそうだけど……♥)
PRINTFORML 「仕事がハードなのはいつものこととはいえ……」	PRINTFORML 「仕事がハードなのはいつものこととはいえ……」
PRINTFORML （こ、これはたべたらダメ、ダメなのに……♥）	PRINTFORML （こ、これはたべたらダメ、ダメなのに……♥）
PRINTFORML 「心を乱しては駄目、必ず好機は訪れるはず…」	PRINTFORML 「心を乱しては駄目、必ず好機は訪れるはず…」
PRINTFORML 「入れたときの想像すらさせるわけには……！」	PRINTFORML 「入れたときの想像すらさせるわけには……！」
PRINTFORML 「くるっ♥ なにかくるっ♥♥ あーッ♥♥♥」	PRINTFORML 「くるっ♥ なにかくるっ♥♥ あーッ♥♥♥」
PRINTFORML 「こんなっ♥ こんなのぉ♥♥ むりぃ♥♥♥」	PRINTFORML 「こんなっ♥ こんなのぉ♥♥ むりぃ♥♥♥」
PRINTFORML 「こんなっ♥ されたらぁ♥♥ むりぃ♥♥♥」	PRINTFORML 「こんなっ♥ されたらぁ♥♥ むりぃ♥♥♥」
PRINTFORML 「狂う♥ くるわされるっ♥♥ あーっ♥♥♥」	PRINTFORML 「狂う♥ くるわされるっ♥♥ あーっ♥♥♥」
PRINTFORML 「も、もういらないです、いらないからぁ……」	PRINTFORML 「も、もういらないです、いらないからぁ……」
PRINTFORML 「これってぇ……思考が何倍にも増幅されて…」	PRINTFORML 「これってぇ……思考が何倍にも増幅されて…」
PRINTFORML 「しないでぇ……私の思考を表現しないでぇ…」	PRINTFORML 「しないでぇ……私の思考を表現しないでぇ…」
PRINTFORML 「あなた達の闇は、全部私が受け止めましょう」	PRINTFORML 「あなた達の闇は、全部私が受け止めましょう」
PRINTFORML 「『あしきゆめ』の波動が高まったわね……！」	PRINTFORML 「『あしきゆめ』の波動が高まったわね……！」
PRINTFORML 「ここまでの悪夢、全て処理させて頂きました」	PRINTFORML 「ここまでの悪夢、全て処理させて頂きました」
PRINTFORML 「『あしきゆめ』を喜ばせないことが大切です」	PRINTFORML 「『あしきゆめ』を喜ばせないことが大切です」
PRINTFORML 「暴走しないための…発散だから……んっ……」	PRINTFORML 「暴走しないための…発散だから……んっ……」
PRINTFORML 「安眠枕が気に入らなかったのでしょうか……」	PRINTFORML 「安眠枕が気に入らなかったのでしょうか……」
PRINTFORML 「ドレ顔が気に入らなかったのでしょうか……」	PRINTFORML 「ドレ顔が気に入らなかったのでしょうか……」
PRINTFORML 「今の私はドリームハンタードレミーですかね」	PRINTFORML 「今の私はドリームハンタードレミーですかね」
PRINTFORML 「戦場のラッパといえば……そう、突撃よ！」	PRINTFORML 「戦場のラッパといえば……そう、突撃よ！」
PRINTFORML 「さすがに純粋な腕力では分が悪いけど……」	PRINTFORML 「さすがに純粋な腕力では分が悪いけど……」
PRINTFORML 「いつまでも同じ手が通用するとでも……！」	PRINTFORML 「いつまでも同じ手が通用するとでも……！」
PRINTFORML 「避けきれない……なんて広い攻撃範囲なの」	PRINTFORML 「避けきれない……なんて広い攻撃範囲なの」
PRINTFORML 「こんなもの……効いてたまるものですか！」	PRINTFORML 「こんなもの……効いてたまるものですか！」
PRINTFORML 「やはり徐々に脱がすことを楽しんでる……」	PRINTFORML 「やはり徐々に脱がすことを楽しんでる……」
PRINTFORML 「そ、そんなに私の髪型が気になりますか？」	PRINTFORML 「そ、そんなに私の髪型が気になりますか？」
PRINTFORML 「ひぃっ♥ ひぃぃん♥♥ イくぅっ♥♥♥」	PRINTFORML 「ひぃっ♥ ひぃぃん♥♥ イくぅっ♥♥♥」
PRINTFORML 「これっ♥ これダメっ♥♥ ダメぇ♥♥♥」	PRINTFORML 「これっ♥ これダメっ♥♥ ダメぇ♥♥♥」
PRINTFORML 「私が分身できればよかったのだけれど……」	PRINTFORML 「私が分身できればよかったのだけれど……」
PRINTFORML 「見るものを喜ばせないように……んっ……」	PRINTFORML 「見るものを喜ばせないように……んっ……」
PRINTFORML 「中古の獏の自慰なんて見ても……んっ……」	PRINTFORML 「中古の獏の自慰なんて見ても……んっ……」
PRINTFORML 「『あしきゆめ』を払い、ここに朝の光を！」	PRINTFORML 「『あしきゆめ』を払い、ここに朝の光を！」
PRINTFORML 「いままでも……これからも…わたしは……」	PRINTFORML 「いままでも……これからも…わたしは……」
PRINTFORML 「夢の掃除機は……なんでも吸い込める！」	PRINTFORML 「夢の掃除機は……なんでも吸い込める！」
PRINTFORML 「こっちは一方通行です。絶対に嫌……！」	PRINTFORML 「こっちは一方通行です。絶対に嫌……！」
PRINTFORML 「牛相手にしなさい。私は絶対に嫌……！」	PRINTFORML 「牛相手にしなさい。私は絶対に嫌……！」
PRINTFORML 「ひぃっ♥ んひっ♥♥ んあーっ♥♥♥」	PRINTFORML 「ひぃっ♥ んひっ♥♥ んあーっ♥♥♥」
PRINTFORML 「おっ♥ 犯されてぇ♥♥ やめぇ♥♥♥」	PRINTFORML 「おっ♥ 犯されてぇ♥♥ やめぇ♥♥♥」
PRINTFORML 「私にそのようなことをしても、無駄です」	PRINTFORML 「私にそのようなことをしても、無駄です」
PRINTFORML 「あぁっ！？でも、まだ終わるわけには！」	PRINTFORML 「あぁっ！？でも、まだ終わるわけには！」
PRINTFORML 「夢塊が…なくなる…消えては…ダメ……」	PRINTFORML 「夢塊が…なくなる…消えては…ダメ……」
PRINTFORMDL 誰かの弱々しい息遣いが聞えた気がした。	PRINTFORMDL 誰かの弱々しい息遣いが聞えた気がした。
PRINTFORML 「どう行動しようが危険は危険だけど……」	PRINTFORML 「どう行動しようが危険は危険だけど……」
PRINTFORMDL ドレミーは幸せそうに湯船に浸かっている	PRINTFORMDL ドレミーは幸せそうに湯船に浸かっている
PRINTFORML （しゅうちゅうして……平常心を……♥）	PRINTFORML （しゅうちゅうして……平常心を……♥）
PRINTFORML 「植物成分を強制的に眠らせましょう！」	PRINTFORML 「植物成分を強制的に眠らせましょう！」
PRINTFORML 「あーっ♥ あーっ♥♥ あーっ♥♥♥」	PRINTFORML 「あーっ♥ あーっ♥♥ あーっ♥♥♥」
PRINTFORML 「お…お願いっ！言うとおりにしてぇ！」	PRINTFORML 「お…お願いっ！言うとおりにしてぇ！」
PRINTFORML 「私にそのようなまやかしは効きません」	PRINTFORML 「私にそのようなまやかしは効きません」
PRINTFORML 「っ…『あしきゆめ』よ、鎮まりなさい」	PRINTFORML 「っ…『あしきゆめ』よ、鎮まりなさい」
PRINTFORML 「どうやらタイムリミットのようですね」	PRINTFORML 「どうやらタイムリミットのようですね」
PRINTFORML 「探して、追いかけて、手に入れる……」	PRINTFORML 「探して、追いかけて、手に入れる……」
PRINTFORML 「純粋な精神の波動を感じるような……」	PRINTFORML 「純粋な精神の波動を感じるような……」
PRINTFORML 「私がお手本を見せないといけませんね」	PRINTFORML 「私がお手本を見せないといけませんね」
PRINTFORML 「……すぅ～……あっ……すぅ～……」	PRINTFORML 「……すぅ～……あっ……すぅ～……」
PRINTFORML 「時には待つのも、勝機を得る為の手」	PRINTFORML 「時には待つのも、勝機を得る為の手」
PRINTFORML 「『あしきゆめ』よ、覚悟しなさい！」	PRINTFORML 「『あしきゆめ』よ、覚悟しなさい！」
PRINTFORML 「はやく、避ける手を考えないと……」	PRINTFORML 「はやく、避ける手を考えないと……」
PRINTFORML 「ぉっ♥ おぅっ♥♥ あーっ♥♥♥」	PRINTFORML 「ぉっ♥ おぅっ♥♥ あーっ♥♥♥」
PRINTFORML （ば、ばれないようにしないとぉ……）	PRINTFORML （ば、ばれないようにしないとぉ……）
PRINTFORML 「む、無意味なことはおやめなさい！」	PRINTFORML 「む、無意味なことはおやめなさい！」
PRINTFORML 「ゆ、夢で見たものよりずっと粗末ね」	PRINTFORML 「ゆ、夢で見たものよりずっと粗末ね」
PRINTFORML 「からだが……もう…うごかない……」	PRINTFORML 「からだが……もう…うごかない……」
PRINTFORML 「男の子の夢の知識が役に立ちますね」	PRINTFORML 「男の子の夢の知識が役に立ちますね」
PRINTFORML 「悪夢の暴走……私が止めないと……」	PRINTFORML 「悪夢の暴走……私が止めないと……」
PRINTFORML 「夢ですら心の傷は癒しきれない……」	PRINTFORML 「夢ですら心の傷は癒しきれない……」
PRINTFORML 「眠りの精霊が夜を運んでいます……」	PRINTFORML 「眠りの精霊が夜を運んでいます……」
PRINTFORML 「少年の夢、ここで役立てましょう」	PRINTFORML 「少年の夢、ここで役立てましょう」
PRINTFORML 「このラッパで目を覚ましなさい！」	PRINTFORML 「このラッパで目を覚ましなさい！」
PRINTFORML （このままじゃ堕ちてしまう……♥）	PRINTFORML （このままじゃ堕ちてしまう……♥）
PRINTFORML （あ、あと一押しされたらぁ……！）	PRINTFORML （あ、あと一押しされたらぁ……！）
PRINTFORML 「こ、こんなにすごいなんてぇ……」	PRINTFORML 「こ、こんなにすごいなんてぇ……」
PRINTFORML 「ま、まって…少し休ませてぇ……」	PRINTFORML 「ま、まって…少し休ませてぇ……」
PRINTFORML 「あ、危ない……平常心、平常心…」	PRINTFORML 「あ、危ない……平常心、平常心…」
PRINTFORML 「き、気をしっかり持たないと……」	PRINTFORML 「き、気をしっかり持たないと……」
PRINTFORML 「！？どうやら手遅れのようね……」	PRINTFORML 「！？どうやら手遅れのようね……」
PRINTFORML 「にっちもさっちもいきませんか…」	PRINTFORML 「にっちもさっちもいきませんか…」
PRINTFORML 「勝ってくるから、ここで待ってて」	PRINTFORML 「勝ってくるから、ここで待ってて」
PRINTFORML 「力が吸われているのがわかる……」	PRINTFORML 「力が吸われているのがわかる……」
PRINTFORMDL ドレミーの呼吸が乱れている……	PRINTFORMDL ドレミーの呼吸が乱れている……
PRINTFORML 「控えなさい。『あしきゆめ』よ」	PRINTFORML 「控えなさい。『あしきゆめ』よ」
PRINTFORML 「祟り為す悪鬼の同類よ、覚悟！」	PRINTFORML 「祟り為す悪鬼の同類よ、覚悟！」
PRINTFORML 「このラッパの音で痺れなさい！」	PRINTFORML 「このラッパの音で痺れなさい！」
PRINTFORML 「わたしのちからでは……むり…」	PRINTFORML 「わたしのちからでは……むり…」
PRINTFORML 「悪夢からは……逃げられない…」	PRINTFORML 「悪夢からは……逃げられない…」
PRINTFORML 「これじゃ、相手のペースに……」	PRINTFORML 「これじゃ、相手のペースに……」
PRINTFORML （あっけなくイクわけには……！）	PRINTFORML （あっけなくイクわけには……！）
PRINTFORML 「駄目っ、流されては……駄目ぇ」	PRINTFORML 「駄目っ、流されては……駄目ぇ」
PRINTFORML 「そ、そういう趣味はないのよ？」	PRINTFORML 「そ、そういう趣味はないのよ？」
PRINTFORML 「遅かれ早かれこうなるのは……」	PRINTFORML 「遅かれ早かれこうなるのは……」
PRINTFORML 「ど、どんなことをされても……」	PRINTFORML 「ど、どんなことをされても……」
PRINTFORML 「べ、別にどうってことは……！」	PRINTFORML 「べ、別にどうってことは……！」
PRINTFORML 「クッションで凌がないと……！」	PRINTFORML 「クッションで凌がないと……！」
PRINTFORML 「まだ…わたしの……しごと……」	PRINTFORML 「まだ…わたしの……しごと……」
PRINTFORML 「ボンボンが少し落ちただけ……」	PRINTFORML 「ボンボンが少し落ちただけ……」
PRINTFORML 「！？仕事が増えたみたいね……」	PRINTFORML 「！？仕事が増えたみたいね……」
PRINTFORML 「……貴方に吉夢が訪れん事を。」	PRINTFORML 「……貴方に吉夢が訪れん事を。」
PRINTFORMW 「悪夢は……終わらないのね……」	PRINTFORMW 「悪夢は……終わらないのね……」
PRINTFORML 「う、うぅぅ……あ、ありがとう」	PRINTFORML 「う、うぅぅ……あ、ありがとう」
PRINTFORML 「なんだか嫌な予感がします……」	PRINTFORML 「なんだか嫌な予感がします……」
PRINTFORML （ヨダレがでちゃってる……♥）	PRINTFORML （ヨダレがでちゃってる……♥）
PRINTFORML 「私こそが夢世界の支配者……」	PRINTFORML 「私こそが夢世界の支配者……」
PRINTFORML 「もう目覚めなくてよいのよ？」	PRINTFORML 「もう目覚めなくてよいのよ？」
PRINTFORML 「予知夢が使えなくとも……！」	PRINTFORML 「予知夢が使えなくとも……！」
PRINTFORML 「あぁっ！？見切れなかった！」	PRINTFORML 「あぁっ！？見切れなかった！」
PRINTFORML 「こ、こんなことをしても……」	PRINTFORML 「こ、こんなことをしても……」
PRINTFORML 「力、抜けてく…ごめん、ね…」	PRINTFORML 「力、抜けてく…ごめん、ね…」
PRINTFORML 「！？また悪夢が……くっ……」	PRINTFORML 「！？また悪夢が……くっ……」
PRINTFORML 「『あしきゆめ』の沈黙を確認」	PRINTFORML 「『あしきゆめ』の沈黙を確認」
PRINTFORML 「ハーイ。まだ無事みたいね。」	PRINTFORML 「ハーイ。まだ無事みたいね。」
PRINTFORML 「わたしは……獏ですから……」	PRINTFORML 「わたしは……獏ですから……」
PRINTFORML 「も、もしかしてこのお腹……」	PRINTFORML 「も、もしかしてこのお腹……」
PRINTFORML 「こ、こんな状態じゃ……♥」	PRINTFORML 「こ、こんな状態じゃ……♥」
PRINTFORML （カラダ、火照ってる……♥）	PRINTFORML （カラダ、火照ってる……♥）
PRINTFORML （夢えっちは駄目なの……♥）	PRINTFORML （夢えっちは駄目なの……♥）
PRINTFORML 「夢魔物図鑑で確認を……！」	PRINTFORML 「夢魔物図鑑で確認を……！」
PRINTFORML 「何かあったはずだけど……」	PRINTFORML 「何かあったはずだけど……」
PRINTFORML 「もう少し調べてみましょう」	PRINTFORML 「もう少し調べてみましょう」
PRINTFORML 「では、掃除を始めましょう」	PRINTFORML 「では、掃除を始めましょう」
PRINTFORML 「焦りの表情は相手の餌……」	PRINTFORML 「焦りの表情は相手の餌……」
PRINTFORML 「お、おとなしくしてぇ……」	PRINTFORML 「お、おとなしくしてぇ……」
PRINTFORML 「しょ、正気にもどってぇ…」	PRINTFORML 「しょ、正気にもどってぇ…」
PRINTFORML 「……それ以上はいけません」	PRINTFORML 「……それ以上はいけません」
PRINTFORML 「そ、騒々しいことですね！」	PRINTFORML 「そ、騒々しいことですね！」
PRINTFORML 「ええっ！？間に合わない！」	PRINTFORML 「ええっ！？間に合わない！」
PRINTFORML 「ま、間に合わなかった……」	PRINTFORML 「ま、間に合わなかった……」
PRINTFORML 「くっ、分身にも限界が……」	PRINTFORML 「くっ、分身にも限界が……」
PRINTFORML 「この位置だとやられるっ！」	PRINTFORML 「この位置だとやられるっ！」
PRINTFORML 「観察力には自信があります」	PRINTFORML 「観察力には自信があります」
PRINTFORML 「…こ、こんなことくらい！」	PRINTFORML 「…こ、こんなことくらい！」
PRINTFORML 「ちょっと…こんなのって…」	PRINTFORML 「ちょっと…こんなのって…」
PRINTFORML 「終わることのない悪夢……」	PRINTFORML 「終わることのない悪夢……」
PRINTFORML （はぁ……♥ はぁ……♥）	PRINTFORML （はぁ……♥ はぁ……♥）
PRINTFORML （感度が増幅されてるぅ♥）	PRINTFORML （感度が増幅されてるぅ♥）
PRINTFORML （は、はめられてる……♥）	PRINTFORML （は、はめられてる……♥）
PRINTFORML 「こんなこともあろうかと」	PRINTFORML 「こんなこともあろうかと」
PRINTFORML 「悪夢は……終わらない…」	PRINTFORML 「悪夢は……終わらない…」
PRINTFORML （あ、喘ぐわけには……！）	PRINTFORML （あ、喘ぐわけには……！）
PRINTFORML 「は…はやく終わってぇ…」	PRINTFORML 「は…はやく終わってぇ…」
PRINTFORML 「お、おとなしくしなさい」	PRINTFORML 「お、おとなしくしなさい」
PRINTFORML 「そ、そのような真似を！」	PRINTFORML 「そ、そのような真似を！」
PRINTFORML 「きゃぁ！どこを触って！」	PRINTFORML 「きゃぁ！どこを触って！」
PRINTFORML 「うそっ！？捕まった！？」	PRINTFORML 「うそっ！？捕まった！？」
PRINTFORML 「ギリギリでしたけど……」	PRINTFORML 「ギリギリでしたけど……」
PRINTFORML 「もぅ……もどれない……」	PRINTFORML 「もぅ……もどれない……」
PRINTFORML 「もどれなく…されて……」	PRINTFORML 「もどれなく…されて……」
PRINTFORML 「ゆめが……まいごに……」	PRINTFORML 「ゆめが……まいごに……」
PRINTFORML 「みんなの……ゆめが……」	PRINTFORML 「みんなの……ゆめが……」
PRINTFORML 「う、ウールガード……！」	PRINTFORML 「う、ウールガード……！」
PRINTFORML 「！？狂夢のつづきね……」	PRINTFORML 「！？狂夢のつづきね……」
PRINTFORML 「夢魂が…残り少ない……」	PRINTFORML 「夢魂が…残り少ない……」
PRINTFORML では、よい触手ライフを…	PRINTFORML では、よい触手ライフを…
PRINTFORML （おちつかないと……♥）	PRINTFORML （おちつかないと……♥）
PRINTFORML （これくらいでぇ……♥）	PRINTFORML （これくらいでぇ……♥）
PRINTFORML （む、胸が擦れて……♥）	PRINTFORML （む、胸が擦れて……♥）
PRINTFORML （いま、ジワって……♥）	PRINTFORML （いま、ジワって……♥）
PRINTFORML （慣れてるけどぉ……♥）	PRINTFORML （慣れてるけどぉ……♥）
PRINTFORML 「おやすみの時間ですよ」	PRINTFORML 「おやすみの時間ですよ」
PRINTFORML 「うっ、何をしたの……」	PRINTFORML 「うっ、何をしたの……」
PRINTFORML 「や…やめて…やめて！」	PRINTFORML 「や…やめて…やめて！」
PRINTFORML 「し、鎮まってよぉ……」	PRINTFORML 「し、鎮まってよぉ……」
PRINTFORML 「きゃっ…離れなさい！」	PRINTFORML 「きゃっ…離れなさい！」
PRINTFORML 「これじゃ動けない！？」	PRINTFORML 「これじゃ動けない！？」
PRINTFORML 「うっ、こんな手に！？」	PRINTFORML 「うっ、こんな手に！？」
PRINTFORML 「だ、だされた……！？」	PRINTFORML 「だ、だされた……！？」
PRINTFORML 「ナカにだされたか……」	PRINTFORML 「ナカにだされたか……」
PRINTFORML 「好き勝手なことを……」	PRINTFORML 「好き勝手なことを……」
PRINTFORML （あし、うごいて……♥）	PRINTFORML （あし、うごいて……♥）
PRINTFORML 「ぜんぶお見通しです！」	PRINTFORML 「ぜんぶお見通しです！」
PRINTFORML 「ごめん……なさい……」	PRINTFORML 「ごめん……なさい……」
PRINTFORML 「このくらいは平気……」	PRINTFORML 「このくらいは平気……」
PRINTFORML 「ど、どうにかぁ……♥」	PRINTFORML 「ど、どうにかぁ……♥」
PRINTFORML 「少し休みましょう……」	PRINTFORML 「少し休みましょう……」
PRINTFORML 「……すぅ……あっ…」	PRINTFORML 「……すぅ……あっ…」
PRINTFORML （ア、アソコが……♥）	PRINTFORML （ア、アソコが……♥）
PRINTFORML 「そこをどきなさい！」	PRINTFORML 「そこをどきなさい！」
PRINTFORML 「ベッドの数は十分！」	PRINTFORML 「ベッドの数は十分！」
PRINTFORML 「絶対に駄目よ……！」	PRINTFORML 「絶対に駄目よ……！」
PRINTFORML （くううぅぅぅ……！）	PRINTFORML （くううぅぅぅ……！）
PRINTFORML 「くぅぅぅ……んッ！」	PRINTFORML 「くぅぅぅ……んッ！」
PRINTFORML 「な、何をしますか！」	PRINTFORML 「な、何をしますか！」
PRINTFORML 「さ、下がりなさい！」	PRINTFORML 「さ、下がりなさい！」
PRINTFORML 「うっ、甘かった！？」	PRINTFORML 「うっ、甘かった！？」
PRINTFORML 「ぁーっ…あーっ……」	PRINTFORML 「ぁーっ…あーっ……」
PRINTFORML 「さすがにこれは……」	PRINTFORML 「さすがにこれは……」
PRINTFORML 「ぬ、抜きなさい……」	PRINTFORML 「ぬ、抜きなさい……」
PRINTFORML 「動いて、私の身体！」	PRINTFORML 「動いて、私の身体！」
PRINTFORML 「当たりはしません！」	PRINTFORML 「当たりはしません！」
PRINTFORML 「……たすかったの？」	PRINTFORML 「……たすかったの？」
PRINTFORML 「肩を見せただけ……」	PRINTFORML 「肩を見せただけ……」
PRINTFORML 「痛ッ、痛ぁぁぁっ！」	PRINTFORML 「痛ッ、痛ぁぁぁっ！」
PRINTFORML 「……あ、ありがとう」	PRINTFORML 「……あ、ありがとう」
PRINTFORML 「どこかで睡眠を……」	PRINTFORML 「どこかで睡眠を……」
PRINTFORML 「順調に育ってる……」	PRINTFORML 「順調に育ってる……」
PRINTFORML 「もうすぐなのね……」	PRINTFORML 「もうすぐなのね……」
PRINTFORML (はぁ…♥ はぁ…♥)	PRINTFORML (はぁ…♥ はぁ…♥)
﻿PRINTFORML 簡易系ドレミーさん。	PRINTFORML 簡易系ドレミーさん。
PRINTFORML 「すぅ……すぅ……」	PRINTFORML 「すぅ……すぅ……」
PRINTFORML （もう濡れて……♥）	PRINTFORML （もう濡れて……♥）
PRINTFORML （ク、クリが……♥）	PRINTFORML （ク、クリが……♥）
PRINTFORML 「ま、守りを……♥」	PRINTFORML 「ま、守りを……♥」
PRINTFORML 「もう十分でしょう」	PRINTFORML 「もう十分でしょう」
PRINTFORML 「沈黙させましょう」	PRINTFORML 「沈黙させましょう」
PRINTFORML 「全てを忘れなさい」	PRINTFORML 「全てを忘れなさい」
PRINTFORML 「まとめて掃除を！」	PRINTFORML 「まとめて掃除を！」
PRINTFORML 「はぁ……はぁ……」	PRINTFORML 「はぁ……はぁ……」
PRINTFORML 「げほっげほっ……」	PRINTFORML 「げほっげほっ……」
PRINTFORML 「ああああああっ！」	PRINTFORML 「ああああああっ！」
PRINTFORML 「やっ、やめぇぇ！」	PRINTFORML 「やっ、やめぇぇ！」
PRINTFORML 「先に倒すしか……」	PRINTFORML 「先に倒すしか……」
PRINTFORML 「……長期戦は不利」	PRINTFORML 「……長期戦は不利」
PRINTFORML 「反応が遅れた！？」	PRINTFORML 「反応が遅れた！？」
PRINTFORML 「誘い込まれた！？」	PRINTFORML 「誘い込まれた！？」
PRINTFORML 「い、今のって……」	PRINTFORML 「い、今のって……」
PRINTFORML 「あああああっ……」	PRINTFORML 「あああああっ……」
PRINTFORML 「む、無駄です……」	PRINTFORML 「む、無駄です……」
PRINTFORML 「……ごめんなさい」	PRINTFORML 「……ごめんなさい」
PRINTFORML （疼いてる……♥）	PRINTFORML （疼いてる……♥）
PRINTFORML （くぅぅぅ……♥）	PRINTFORML （くぅぅぅ……♥）
PRINTFORML （思春期の……♥）	PRINTFORML （思春期の……♥）
PRINTFORML 「まとめて永眠！」	PRINTFORML 「まとめて永眠！」
PRINTFORML 「絶対に嫌……！」	PRINTFORML 「絶対に嫌……！」
PRINTFORML 「何をしてぇ……」	PRINTFORML 「何をしてぇ……」
PRINTFORML 「げほっげほっ…」	PRINTFORML 「げほっげほっ…」
PRINTFORML 「く、苦しい……」	PRINTFORML 「く、苦しい……」
PRINTFORML 「や、やめっ……」	PRINTFORML 「や、やめっ……」
PRINTFORML 「やっ、やめっ！」	PRINTFORML 「やっ、やめっ！」
PRINTFORML 「んんんッ……！」	PRINTFORML 「んんんッ……！」
PRINTFORML 「ッ……それで？」	PRINTFORML 「ッ……それで？」
PRINTFORML 「ッ……だから？」	PRINTFORML 「ッ……だから？」
PRINTFORML 「あっ……ふあぁ」	PRINTFORML 「あっ……ふあぁ」
PRINTFORML 「ひぃ…ひぃッ…」	PRINTFORML 「ひぃ…ひぃッ…」
PRINTFORML 「最低の夢ね……」	PRINTFORML 「最低の夢ね……」
PRINTFORML 「最低の感触……」	PRINTFORML 「最低の感触……」
PRINTFORML 「そんなもので！」	PRINTFORML 「そんなもので！」
PRINTFORML （休憩したい……）	PRINTFORML （休憩したい……）
PRINTFORML 「すぅ…zzz」	PRINTFORML 「すぅ…zzz」
PRINTFORML 「そこまでよ！」	PRINTFORML 「そこまでよ！」
PRINTFORML 「きゃぁぁぁ！」	PRINTFORML 「きゃぁぁぁ！」
PRINTFORML 「あああぁ……」	PRINTFORML 「あああぁ……」
PRINTFORML 「それだめぇ…」	PRINTFORML 「それだめぇ…」
PRINTFORML 「わたひぃ……」	PRINTFORML 「わたひぃ……」
PRINTFORML 「呑まれる！？」	PRINTFORML 「呑まれる！？」
PRINTFORML 「ぉっ…おッ…」	PRINTFORML 「ぉっ…おッ…」
PRINTFORML 「ぅ…ぁぁ……」	PRINTFORML 「ぅ…ぁぁ……」
PRINTFORML 「……ドレェ…」	PRINTFORML 「……ドレェ…」
PRINTFORML 「ドレェ……♪」	PRINTFORML 「ドレェ……♪」
PRINTFORML 「げほっ……」	PRINTFORML 「げほっ……」
PRINTFORML 「うぇぇ……」	PRINTFORML 「うぇぇ……」
PRINTFORML 「かはっ……」	PRINTFORML 「かはっ……」
PRINTFORML 「ごほっ……」	PRINTFORML 「ごほっ……」
PRINTFORML 「しまった！」	PRINTFORML 「しまった！」
PRINTFORML 「速いっ！？」	PRINTFORML 「速いっ！？」
PRINTFORML 「そんな！？」	PRINTFORML 「そんな！？」
PRINTFORML 「精液が……」	PRINTFORML 「精液が……」
PRINTFORML 「無駄です！」	PRINTFORML 「無駄です！」
PRINTFORML 「悪鬼退散！」	PRINTFORML 「悪鬼退散！」
PRINTFORML 「処理完了！」	PRINTFORML 「処理完了！」
PRINTFORML 「……ぐぅ」	PRINTFORML 「……ぐぅ」
PRINTFORML 「ゃぁ……」	PRINTFORML 「ゃぁ……」
PRINTFORML 「ぉぇ……」	PRINTFORML 「ぉぇ……」
PRINTFORML 「……ぅぅ」	PRINTFORML 「……ぅぅ」
PRINTFORML 「力がっ…」	PRINTFORML 「力がっ…」
PRINTFORML 「瘴気！？」	PRINTFORML 「瘴気！？」
PRINTFORML 「すごぃ…」	PRINTFORML 「すごぃ…」
PRINTFORML 「あひぃ…」	PRINTFORML 「あひぃ…」
PRINTFORML 「はひっ…」	PRINTFORML 「はひっ…」
PRINTFORML 「むりぃ…」	PRINTFORML 「むりぃ…」
PRINTFORML 「いぃ……」	PRINTFORML 「いぃ……」
PRINTFORML 「あっ……」	PRINTFORML 「あっ……」
PRINTFORML 「うぅ……」	PRINTFORML 「うぅ……」
PRINTFORML 「……ぅ」	PRINTFORML 「……ぅ」
PRINTFORML 「……っ」	PRINTFORML 「……っ」
PRINTFORML 「痛っ…」	PRINTFORML 「痛っ…」
PRINTFORML 「きゃぁ」	PRINTFORML 「きゃぁ」
PRINTFORML 「………」	PRINTFORML 「………」
PRINTFORML 「……」	PRINTFORML 「……」
PRINTFORMDL …？	PRINTFORMDL …？
PRINTFORML 「」	PRINTFORML 「」
PRINTL 	PRINTL 
