﻿PRINTFORML エロス重点のクラウンピース口上です。		PRINTFORML エロス重点のクラウンピース口上です。
PRINTFORML 詳しい性格付けなどはリードミーにて。		PRINTFORML 詳しい性格付けなどはリードミーにて。
PRINTFORMW 「………うぎゅぅ」	!#!PRINTFORMW 「………うぎゅぅ」
PRINTFORMW 「…んむ…うっ……」	!#!PRINTFORMW 「…んむ…うっ……」
PRINTFORMW 「……うぅ～…zz…」	!#!PRINTFORMW 「……うぅ～…zz…」
PRINTFORMDW しかし%CALLNAME:TARGET%は眠っている！	!#!PRINTFORMDW しかし%CALLNAME:TARGET%は眠っている！
PRINTFORMW 「やめろ…触るなぁ…❤」	!#!PRINTFORMW 「やめろ…触るなぁ…❤」
PRINTFORMW （変に動くと逆効果か…）	!#!PRINTFORMW （変に動くと逆効果か…）
PRINTFORMW 「これ以上はまずい…」	!#!PRINTFORMW 「これ以上はまずい…」
PRINTFORMW 「こっち来るなよ…！」	!#!PRINTFORMW 「こっち来るなよ…！」
PRINTFORMW 「こっち来んな！」	!#!PRINTFORMW 「こっち来んな！」
PRINTFORMW （あえて打たせて様子見するかな…）	!#!PRINTFORMW （あえて打たせて様子見するかな…）
PRINTFORMW （集中しにくい…っ❤）	!#!PRINTFORMW （集中しにくい…っ❤）
PRINTFORML （このくらいなら支障は無し！）		PRINTFORML （このくらいなら支障は無し！）
PRINTFORMW 「そらっ！」	!#!PRINTFORMW 「そらっ！」
PRINTFORMW （まずい、想定より軽かった…！）	!#!PRINTFORMW （まずい、想定より軽かった…！）
PRINTFORMW 「うらぁっ…！」	!#!PRINTFORMW 「うらぁっ…！」
PRINTFORMW 「軽くいくぞ！」	!#!PRINTFORMW 「軽くいくぞ！」
PRINTFORMW 「そうりゃ！」	!#!PRINTFORMW 「そうりゃ！」
PRINTFORMW （思ってたほど撃てない…！）	!#!PRINTFORMW （思ってたほど撃てない…！）
PRINTFORMW 「お…らぁっ！」	!#!PRINTFORMW 「お…らぁっ！」
PRINTFORMW 「逃げてみろ！」	!#!PRINTFORMW 「逃げてみろ！」
PRINTFORMW 「地獄の炎に……んふぁ！❤」	!#!PRINTFORMW 「地獄の炎に……んふぁ！❤」
PRINTFORMW 「撃墜してや…りゅぅっ❤」	!#!PRINTFORMW 「撃墜してや…りゅぅっ❤」
PRINTFORMW 「一気に倒す…！」	!#!PRINTFORMW 「一気に倒す…！」
PRINTFORML 「ぐ…うりゃあ！」		PRINTFORML 「ぐ…うりゃあ！」
PRINTFORMW （頼む…当たれ！）	!#!PRINTFORMW （頼む…当たれ！）
PRINTFORMW 「地獄の炎に焼かれろ！」	!#!PRINTFORMW 「地獄の炎に焼かれろ！」
PRINTFORMW 「撃墜してやる！」	!#!PRINTFORMW 「撃墜してやる！」
PRINTFORML 「ふぅ、ふぅ…❤」		PRINTFORML 「ふぅ、ふぅ…❤」
PRINTFORMW （くそ…集中しにくい…❤）	!#!PRINTFORMW （くそ…集中しにくい…❤）
PRINTFORMW 「いけるか？…あぅっ…❤」	!#!PRINTFORMW 「いけるか？…あぅっ…❤」
PRINTFORMW 「この一発で沈める…！」	!#!PRINTFORMW 「この一発で沈める…！」
PRINTFORML 「……痛っ…」		PRINTFORML 「……痛っ…」
PRINTFORMW （このまま溜めきれるか…？）	!#!PRINTFORMW （このまま溜めきれるか…？）
PRINTFORMW 「今のうちに、逃げなくていいのか？」	!#!PRINTFORMW 「今のうちに、逃げなくていいのか？」
PRINTFORMW 「地獄を見せてやるよ…！」	!#!PRINTFORMW 「地獄を見せてやるよ…！」
PRINTFORMW 「くぅらえ、地獄『ストライプドアビス』うぅう…❤」	!#!PRINTFORMW 「くぅらえ、地獄『ストライプドアビス』うぅう…❤」
PRINTFORMW 「も、燃えろ！獄炎『グレイズインフェルのおぉ❤」（は、反動がぁ…❤）	!#!PRINTFORMW 「も、燃えろ！獄炎『グレイズインフェルのおぉ❤」（は、反動がぁ…❤）
PRINTFORMW （た、溜まった！）「…いっけぇっ！地獄『ストライプドアビス』！」	!#!PRINTFORMW （た、溜まった！）「…いっけぇっ！地獄『ストライプドアビス』！」
PRINTFORMW 「避けるなよ…獄炎『グレイズインフェルノ』！」	!#!PRINTFORMW 「避けるなよ…獄炎『グレイズインフェルノ』！」
PRINTFORMW 「Are you ready?…喰らえっ！地獄『ストライプドアビス』！」	!#!PRINTFORMW 「Are you ready?…喰らえっ！地獄『ストライプドアビス』！」
PRINTFORMW 「燃え尽きろ！獄炎『グレイズインフェルノ』！」	!#!PRINTFORMW 「燃え尽きろ！獄炎『グレイズインフェルノ』！」
PRINTFORML 「お…おりゃりゃりゃ…」（ﾊﾟﾗﾊﾟﾗﾊﾟﾗ…）		PRINTFORML 「お…おりゃりゃりゃ…」（ﾊﾟﾗﾊﾟﾗﾊﾟﾗ…）
PRINTFORMW （くぅ…いつもより弾数少ないっ…❤）	!#!PRINTFORMW （くぅ…いつもより弾数少ないっ…❤）
PRINTFORMW 「鈍くさせれば、弾も当たるだろ…！」	!#!PRINTFORMW 「鈍くさせれば、弾も当たるだろ…！」
PRINTFORMW 「うりゃりゃりゃ！」（ﾊﾞﾗﾗﾗﾗ…！）	!#!PRINTFORMW 「うりゃりゃりゃ！」（ﾊﾞﾗﾗﾗﾗ…！）
PRINTFORMW 「まとめる！…獄符『フラッシュアンドストラいひぃっ❤」	!#!PRINTFORMW 「まとめる！…獄符『フラッシュアンドストラいひぃっ❤」
PRINTFORML 「うおおっ、貫けぇ…ふひ？！」		PRINTFORML 「うおおっ、貫けぇ…ふひ？！」
PRINTFORMW （やっぱちょっと負担がぁ…うっ❤）	!#!PRINTFORMW （やっぱちょっと負担がぁ…うっ❤）
PRINTFORMW 「まとめて倒す…獄符『フラッシュアンドストライプ』…！」	!#!PRINTFORMW 「まとめて倒す…獄符『フラッシュアンドストライプ』…！」
PRINTFORMW 「っ、貫けぇっ…！」	!#!PRINTFORMW 「っ、貫けぇっ…！」
PRINTFORMW 「まとめて相手してやる！獄符『フラッシュアンドストライプ』！」	!#!PRINTFORMW 「まとめて相手してやる！獄符『フラッシュアンドストライプ』！」
PRINTFORMW 「うおおっ、貫けぇ！」	!#!PRINTFORMW 「うおおっ、貫けぇ！」
PRINTFORMW （近寄らなくていいのは助かるな…❤）	!#!PRINTFORMW （近寄らなくていいのは助かるな…❤）
PRINTFORMW 「はぁ❤はぁっ❤…当たるか…？」	!#!PRINTFORMW 「はぁ❤はぁっ❤…当たるか…？」
PRINTFORMW 「くのぉ…❤　撃ち抜いてやるぞぉ…❤」	!#!PRINTFORMW 「くのぉ…❤　撃ち抜いてやるぞぉ…❤」
PRINTFORMW 「ヤバい時こそ冷静に…！」	!#!PRINTFORMW 「ヤバい時こそ冷静に…！」
PRINTFORMW 「はぁ、はぁ…当たるか…？」	!#!PRINTFORMW 「はぁ、はぁ…当たるか…？」
PRINTFORMW （くっそぅ…）	!#!PRINTFORMW （くっそぅ…）
PRINTFORMW 「ズババーンッと！」	!#!PRINTFORMW 「ズババーンッと！」
PRINTFORMW 「月の兎どもに出来る事が、あたいに出来ないはずが無い！」	!#!PRINTFORMW 「月の兎どもに出来る事が、あたいに出来ないはずが無い！」
PRINTFORMW 「ま、テキトーにやれば当たるって」	!#!PRINTFORMW 「ま、テキトーにやれば当たるって」
PRINTFORMW （こんな時に弾が切れたらマズイな…！）	!#!PRINTFORMW （こんな時に弾が切れたらマズイな…！）
PRINTFORMW 「外しても良いように撃つぅっ❤」	!#!PRINTFORMW 「外しても良いように撃つぅっ❤」
PRINTFORMW 「ケチるべきか一気に行くべきか…ええい、こっちだ！」	!#!PRINTFORMW 「ケチるべきか一気に行くべきか…ええい、こっちだ！」
PRINTFORMW 「残弾が尽きないように…えっと、こうだったかな？」	!#!PRINTFORMW 「残弾が尽きないように…えっと、こうだったかな？」
PRINTFORMW 「ちょっとくらいケチっても良いよね？」	!#!PRINTFORMW 「ちょっとくらいケチっても良いよね？」
PRINTFORMW 「やめっ…来るなあぁっ！❤」	!#!PRINTFORMW 「やめっ…来るなあぁっ！❤」
PRINTFORMW 「うっとおしい奴らめ…まとめて撃つ！」	!#!PRINTFORMW 「うっとおしい奴らめ…まとめて撃つ！」
PRINTFORMW 「弾幕の代わりだ！」	!#!PRINTFORMW 「弾幕の代わりだ！」
PRINTFORMW 「おらららあぁっ！」	!#!PRINTFORMW 「おらららあぁっ！」
PRINTFORMW （ぐぬぅ…銃口がぶれるっ…❤）	!#!PRINTFORMW （ぐぬぅ…銃口がぶれるっ…❤）
PRINTFORMW 「ヤラシイ事される前にぶちぬくっ…！」	!#!PRINTFORMW 「ヤラシイ事される前にぶちぬくっ…！」
PRINTFORMW （倒れる前に…倒すっ！）	!#!PRINTFORMW （倒れる前に…倒すっ！）
PRINTFORMW 「そぉこだぁっ！」	!#!PRINTFORMW 「そぉこだぁっ！」
PRINTFORMW 「アット・ピンホール…ズドン！」	!#!PRINTFORMW 「アット・ピンホール…ズドン！」
PRINTFORMW （当てることに集中しよう…）	!#!PRINTFORMW （当てることに集中しよう…）
PRINTFORMW 「それ！」（…よし、このくらいなら平気だ）	!#!PRINTFORMW 「それ！」（…よし、このくらいなら平気だ）
PRINTFORML 「おりゃっ…！」		PRINTFORML 「おりゃっ…！」
PRINTFORMW （しまった、思ったより軽かった…！）	!#!PRINTFORMW （しまった、思ったより軽かった…！）
PRINTFORMW 「ぽこんっ！」	!#!PRINTFORMW 「ぽこんっ！」
PRINTFORMW 「ジャブ！」	!#!PRINTFORMW 「ジャブ！」
PRINTFORMW （ふっ❤…まあ、まだ大丈夫か…）	!#!PRINTFORMW （ふっ❤…まあ、まだ大丈夫か…）
PRINTFORMW 「ふぅん…っ！」（ウッ、ちょっと危なかった…❤）	!#!PRINTFORMW 「ふぅん…っ！」（ウッ、ちょっと危なかった…❤）
PRINTFORMW （ちょっと軽かったか…？）	!#!PRINTFORMW （ちょっと軽かったか…？）
PRINTFORMW 「ふぅん…っ！」（っとと、ちょっと危なかった…）	!#!PRINTFORMW 「ふぅん…っ！」（っとと、ちょっと危なかった…）
PRINTFORMW 「てえっ！」	!#!PRINTFORMW 「てえっ！」
PRINTFORMW 「ワン・ツー！」	!#!PRINTFORMW 「ワン・ツー！」
PRINTFORML 「くらえぇっ…！」（ﾌﾞﾝｯ!）		PRINTFORML 「くらえぇっ…！」（ﾌﾞﾝｯ!）
PRINTFORMW （ひぅ❤ちょっと負担大きかったかな…❤）	!#!PRINTFORMW （ひぅ❤ちょっと負担大きかったかな…❤）
PRINTFORMW 「どりゃー！……あッ❤」（り、力みすぎたぁ…❤）	!#!PRINTFORMW 「どりゃー！……あッ❤」（り、力みすぎたぁ…❤）
PRINTFORML 「くらえぇっ…！」		PRINTFORML 「くらえぇっ…！」
PRINTFORMW （しまった、大きく振りすぎたか…？）	!#!PRINTFORMW （しまった、大きく振りすぎたか…？）
PRINTFORMW 「どりゃー！…わ！」（危な、ちょっとよろけちゃったよ）	!#!PRINTFORMW 「どりゃー！…わ！」（危な、ちょっとよろけちゃったよ）
PRINTFORMW 「オアー！！」	!#!PRINTFORMW 「オアー！！」
PRINTFORMW 「Bust you up！（ぶっ飛ばしてやる！）」	!#!PRINTFORMW 「Bust you up！（ぶっ飛ばしてやる！）」
PRINTFORMW （牽制しとかないと危ないな…❤）「…せやっ！」	!#!PRINTFORMW （牽制しとかないと危ないな…❤）「…せやっ！」
PRINTFORMW （次の布石に…！）「…せやっ！」	!#!PRINTFORMW （次の布石に…！）「…せやっ！」
PRINTFORMW 「↓大K！」	!#!PRINTFORMW 「↓大K！」
PRINTFORMW 「足を痛めつけるのは基本よ！」	!#!PRINTFORMW 「足を痛めつけるのは基本よ！」
PRINTFORMW 「どこが痛いのかな～❤…ここだ！」	!#!PRINTFORMW 「どこが痛いのかな～❤…ここだ！」
PRINTFORMW 「叩き潰しちゃお❤」	!#!PRINTFORMW 「叩き潰しちゃお❤」
PRINTFORMW 「止まれ…！」	!#!PRINTFORMW 「止まれ…！」
PRINTFORMW （しぶといなコイツ…！）	!#!PRINTFORMW （しぶといなコイツ…！）
PRINTFORMW 「ブローッ！」	!#!PRINTFORMW 「ブローッ！」
PRINTFORMW 「セービング！」	!#!PRINTFORMW 「セービング！」
PRINTFORMW （ふひぁ❤…これはらめらぁ…❤）	!#!PRINTFORMW （ふひぁ❤…これはらめらぁ…❤）
PRINTFORMW 「あ、あひ…ちからがっ…❤」	!#!PRINTFORMW 「あ、あひ…ちからがっ…❤」
PRINTFORMW 「出せー…うあ、粘液がぁ❤」	!#!PRINTFORMW 「出せー…うあ、粘液がぁ❤」
PRINTFORMW 「ネチョネチョするうぅー！❤」	!#!PRINTFORMW 「ネチョネチョするうぅー！❤」
PRINTFORMW 「やだーっ！溶かされるのはゴメンだよ！」	!#!PRINTFORMW 「やだーっ！溶かされるのはゴメンだよ！」
PRINTFORMW （早く出ないと！喰われる！！）	!#!PRINTFORMW （早く出ないと！喰われる！！）
PRINTFORMW 「わわ、粘液が…早く出せぇ！」	!#!PRINTFORMW 「わわ、粘液が…早く出せぇ！」
PRINTFORMW 「妖精が栄養になるわけないだろ…！」	!#!PRINTFORMW 「妖精が栄養になるわけないだろ…！」
PRINTFORMW 「密着…しないでくれぇ…❤」	!#!PRINTFORMW 「密着…しないでくれぇ…❤」
PRINTFORMW 「引っ付くな…うひぃ❤」	!#!PRINTFORMW 「引っ付くな…うひぃ❤」
PRINTFORMW （こ、これ以上はまずいっ！）	!#!PRINTFORMW （こ、これ以上はまずいっ！）
PRINTFORMW 「放せ！放せったら…！」	!#!PRINTFORMW 「放せ！放せったら…！」
PRINTFORMW 「いつまで掴んでんだよっ…！」	!#!PRINTFORMW 「いつまで掴んでんだよっ…！」
PRINTFORMW 「退け！退けってこの！」	!#!PRINTFORMW 「退け！退けってこの！」
PRINTFORML 「あ、あー…❤」		PRINTFORML 「あ、あー…❤」
PRINTFORMDW %CALLNAME:TARGET%は気の抜けた顔をしている…	!#!PRINTFORMDW %CALLNAME:TARGET%は気の抜けた顔をしている…
PRINTFORMW （くしょぉ…❤　力が溜められにゃいぃ…❤）	!#!PRINTFORMW （くしょぉ…❤　力が溜められにゃいぃ…❤）
PRINTFORMW 「はぁ❤…っくううぅっ…！」	!#!PRINTFORMW 「はぁ❤…っくううぅっ…！」
PRINTFORMW （なんとか、出ないとぉ…❤）	!#!PRINTFORMW （なんとか、出ないとぉ…❤）
PRINTFORMW （次が最後のチャンスかも…！）	!#!PRINTFORMW （次が最後のチャンスかも…！）
PRINTFORMW 「絶…対っ…許さんっ…！」	!#!PRINTFORMW 「絶…対っ…許さんっ…！」
PRINTFORMW （ここは一気に出るために待とう…！）	!#!PRINTFORMW （ここは一気に出るために待とう…！）
PRINTFORMW 「くぬうぅううぅ～っ…！」	!#!PRINTFORMW 「くぬうぅううぅ～っ…！」
PRINTFORML 「け…穢して…下さい…あたい、もう我慢できましぇん…❤」		PRINTFORML 「け…穢して…下さい…あたい、もう我慢できましぇん…❤」
PRINTFORMDW %CALLNAME:TARGET%は脱出を諦め、相手におねだりを始めた…	!#!PRINTFORMDW %CALLNAME:TARGET%は脱出を諦め、相手におねだりを始めた…
PRINTFORMW （お股…変…❤）	!#!PRINTFORMW （お股…変…❤）
PRINTFORMW 「一回だけ…一回やったら満足するからぁ…❤」	!#!PRINTFORMW 「一回だけ…一回やったら満足するからぁ…❤」
PRINTFORMW 「あ…あ…❤　ダメなのに、気持ち良いぃ❤」	!#!PRINTFORMW 「あ…あ…❤　ダメなのに、気持ち良いぃ❤」
PRINTFORMW 「尻なんか弄っちゃダメだからぁ❤」	!#!PRINTFORMW 「尻なんか弄っちゃダメだからぁ❤」
PRINTFORMW 「ケツなんか触るなバカ！」	!#!PRINTFORMW 「ケツなんか触るなバカ！」
PRINTFORMW （あ…あいつ、胸見てる気がする…❤）	!#!PRINTFORMW （あ…あいつ、胸見てる気がする…❤）
PRINTFORMW 「あたいの胸にに触るな…！」	!#!PRINTFORMW 「あたいの胸にに触るな…！」
PRINTFORMW 「ヤダ…戻れなくなるっ…❤」	!#!PRINTFORMW 「ヤダ…戻れなくなるっ…❤」
PRINTFORMW 「ダメぇ…敏感だからぁ…///」	!#!PRINTFORMW 「ダメぇ…敏感だからぁ…///」
PRINTFORMW （ちんこなんかどう守ればいいんだよ…！？）	!#!PRINTFORMW （ちんこなんかどう守ればいいんだよ…！？）
PRINTFORMW 「戻んなくなったらどうすんだっ…！」	!#!PRINTFORMW 「戻んなくなったらどうすんだっ…！」
PRINTFORMW （今はマズイ今はマズイ今はマズイっ…❤）	!#!PRINTFORMW （今はマズイ今はマズイ今はマズイっ…❤）
PRINTFORMW 「く、来るなよっ…！？」	!#!PRINTFORMW 「く、来るなよっ…！？」
PRINTFORMW 「尻なら良いから…来てぇ❤」	!#!PRINTFORMW 「尻なら良いから…来てぇ❤」
PRINTFORML （尻ならまぁ、我慢できるか…）		PRINTFORML （尻ならまぁ、我慢できるか…）
PRINTFORMW 「…ほら、こっち来いっ…！❤」	!#!PRINTFORMW 「…ほら、こっち来いっ…！❤」
PRINTFORMW 「おっぱい美味しいよ…？ほらぁ…❤」（ﾑﾆｭﾆｭ❤）	!#!PRINTFORMW 「おっぱい美味しいよ…？ほらぁ…❤」（ﾑﾆｭﾆｭ❤）
PRINTFORML （胸ならまぁ、そんなに影響無い…かな…）		PRINTFORML （胸ならまぁ、そんなに影響無い…かな…）
PRINTFORMW 「…ほ～れ、揉みたいんだろ～？❤」	!#!PRINTFORMW 「…ほ～れ、揉みたいんだろ～？❤」
PRINTFORMW 「ちんぽっ❤弄ってっ❤射精したいのぉ❤❤」	!#!PRINTFORMW 「ちんぽっ❤弄ってっ❤射精したいのぉ❤❤」
PRINTFORMW 「クリっ❤クリなら弄っていいからっ❤」	!#!PRINTFORMW 「クリっ❤クリなら弄っていいからっ❤」
PRINTFORML （元から無いところなら影響も薄い…はず）		PRINTFORML （元から無いところなら影響も薄い…はず）
PRINTFORMW 「…ホレホレ、弄りたいだろ…？❤」（ﾕﾗﾕﾗ）	!#!PRINTFORMW 「…ホレホレ、弄りたいだろ…？❤」（ﾕﾗﾕﾗ）
PRINTFORML （一番小さいところだし、何とかできるかな…）		PRINTFORML （一番小さいところだし、何とかできるかな…）
PRINTFORMW 「…そぉら、触りたいならこっち来い…！❤」	!#!PRINTFORMW 「…そぉら、触りたいならこっち来い…！❤」
PRINTFORMW 「妊娠なんてどうでもいいの❤ぶっといのが欲しいの❤」（ｸﾊﾟｧ…❤）	!#!PRINTFORMW 「妊娠なんてどうでもいいの❤ぶっといのが欲しいの❤」（ｸﾊﾟｧ…❤）
PRINTFORMW 「責任なんてどうでもいいから❤早くっ♪」（ｸﾊﾟｧ…❤）	!#!PRINTFORMW 「責任なんてどうでもいいから❤早くっ♪」（ｸﾊﾟｧ…❤）
PRINTFORML （孕んでるならもう孕むことは無い…！）		PRINTFORML （孕んでるならもう孕むことは無い…！）
PRINTFORMW 「…く、来るなら来い…❤」（ｸﾊﾟｧ…）	!#!PRINTFORMW 「…く、来るなら来い…❤」（ｸﾊﾟｧ…）
PRINTFORML （本当は嫌だけどな～、一番効果高そうだしな～…）		PRINTFORML （本当は嫌だけどな～、一番効果高そうだしな～…）
PRINTFORML 「んぬぁーーっっ！」		PRINTFORML 「んぬぁーーっっ！」
PRINTFORMDW %CALLNAME:TARGET%はどうにか体を動かそうとした。	!#!PRINTFORMDW %CALLNAME:TARGET%はどうにか体を動かそうとした。
PRINTFORMW （おあずけ…寂しい…イジワル…）	!#!PRINTFORMW （おあずけ…寂しい…イジワル…）
PRINTFORML 「はい。今からボーっとします。…ボーーーー…」		PRINTFORML 「はい。今からボーっとします。…ボーーーー…」
PRINTFORMDW %CALLNAME:TARGET%は言いつけ通りに虚空を見ている。	!#!PRINTFORMDW %CALLNAME:TARGET%は言いつけ通りに虚空を見ている。
PRINTFORMW 「あっ、ん❤指が勝手にっ、くうぅぁ❤」	!#!PRINTFORMW 「あっ、ん❤指が勝手にっ、くうぅぁ❤」
PRINTFORMW 「もー、自分でするのじゃ足りないのに…」（ｸﾞﾁｭ､ｸﾞﾁｭ❤）	!#!PRINTFORMW 「もー、自分でするのじゃ足りないのに…」（ｸﾞﾁｭ､ｸﾞﾁｭ❤）
PRINTFORML 「了解です。オナニーします。…んっ❤」		PRINTFORML 「了解です。オナニーします。…んっ❤」
PRINTFORMDW %CALLNAME:TARGET%は機械的に指を動かしている。	!#!PRINTFORMDW %CALLNAME:TARGET%は機械的に指を動かしている。
PRINTFORMW 「わあぁ！体が引っ張られ…！？」	!#!PRINTFORMW 「わあぁ！体が引っ張られ…！？」
PRINTFORMW 「イチャイチャが見たいの？…じゃあ準備する！」	!#!PRINTFORMW 「イチャイチャが見たいの？…じゃあ準備する！」
PRINTFORMW 「わかりました。捕らえます…！」	!#!PRINTFORMW 「わかりました。捕らえます…！」
PRINTFORMDW %CALLNAME:TARGET%は命令通り仲間に襲い掛かった！	!#!PRINTFORMDW %CALLNAME:TARGET%は命令通り仲間に襲い掛かった！
PRINTFORMW （ﾋﾞﾘﾘ…）「ああぁ、服が脱げてくぅ…！」	!#!PRINTFORMW （ﾋﾞﾘﾘ…）「ああぁ、服が脱げてくぅ…！」
PRINTFORMW 「ンフフフ❤ストリップタイムよ❤」	!#!PRINTFORMW 「ンフフフ❤ストリップタイムよ❤」
PRINTFORMW 「『脱げ』？分かりました、ストリップを始めます…」（ｺﾞｿｺﾞｿ…）	!#!PRINTFORMW 「『脱げ』？分かりました、ストリップを始めます…」（ｺﾞｿｺﾞｿ…）
PRINTFORMW 「あたいは逃げ…うあぁ足が変な方向に～！？」	!#!PRINTFORMW 「あたいは逃げ…うあぁ足が変な方向に～！？」
PRINTFORMW 「本当は逃げたいんだけどなー。足が勝手に近付いちゃうなー…❤」	!#!PRINTFORMW 「本当は逃げたいんだけどなー。足が勝手に近付いちゃうなー…❤」
PRINTFORML 「NAME:クラウンピースに逃げるコマンド実行の権限は与えられていません…」		PRINTFORML 「NAME:クラウンピースに逃げるコマンド実行の権限は与えられていません…」
PRINTFORMDW うわ言のように呟きながら敵に近づいていく…	!#!PRINTFORMDW うわ言のように呟きながら敵に近づいていく…
PRINTFORMW 「ね…眠く、なんか…なぁ…うぐ、ぐぅ～…」	!#!PRINTFORMW 「ね…眠く、なんか…なぁ…うぐ、ぐぅ～…」
PRINTFORMW 「やだぁ、もっとエッチなことしたいぃ……んくぅ～…」	!#!PRINTFORMW 「やだぁ、もっとエッチなことしたいぃ……んくぅ～…」
PRINTFORMW 「了解。休息・睡眠に移行します………ｸﾞｩ」	!#!PRINTFORMW 「了解。休息・睡眠に移行します………ｸﾞｩ」
PRINTFORMW 「狂わせるのはあたいの領分だ…なめるなよっ…！」	!#!PRINTFORMW 「狂わせるのはあたいの領分だ…なめるなよっ…！」
PRINTFORMW 「狂っちゃダメぇ…ご主人様に嫌われるぅ…！」	!#!PRINTFORMW 「狂っちゃダメぇ…ご主人様に嫌われるぅ…！」
PRINTFORML 「私は…違うっ、あたい…は……うぐぁあっ…」		PRINTFORML 「私は…違うっ、あたい…は……うぐぁあっ…」
PRINTFORMDW %CALLNAME:TARGET%は頭を抱え唸っている…	!#!PRINTFORMDW %CALLNAME:TARGET%は頭を抱え唸っている…
PRINTFORMW 「わざわざ踏ませるなんて気前がいいなっ…オラッ！」（ｺﾞｼｬｧ！）	!#!PRINTFORMW 「わざわざ踏ませるなんて気前がいいなっ…オラッ！」（ｺﾞｼｬｧ！）
PRINTFORMW 「ふーん、ハードな足コキが好みなのね～❤」（ｸﾞｼｸﾞｼ）	!#!PRINTFORMW 「ふーん、ハードな足コキが好みなのね～❤」（ｸﾞｼｸﾞｼ）
PRINTFORMW 「命令了解、遂行します。…『潰れてしまいなさい！この腐れちんこ！』」（ｸﾞｼｨｯ！）	!#!PRINTFORMW 「命令了解、遂行します。…『潰れてしまいなさい！この腐れちんこ！』」（ｸﾞｼｨｯ！）
PRINTFORMW 「このまま張っ倒してやる！」（ﾍﾞｯﾁﾍﾞｯﾁ！）	!#!PRINTFORMW 「このまま張っ倒してやる！」（ﾍﾞｯﾁﾍﾞｯﾁ！）
PRINTFORMW 「うふふ、はたくたびに揺れて楽しい❤」（ﾋﾞﾀﾝﾋﾞﾀﾝ！）	!#!PRINTFORMW 「うふふ、はたくたびに揺れて楽しい❤」（ﾋﾞﾀﾝﾋﾞﾀﾝ！）
PRINTFORMW 「かしこまりました。…『畜生風情が…精々良い声で鳴きなさい！』」（ﾊﾞﾁｨﾝｯ！）	!#!PRINTFORMW 「かしこまりました。…『畜生風情が…精々良い声で鳴きなさい！』」（ﾊﾞﾁｨﾝｯ！）
PRINTFORMW 「後悔するなよ…千切れ飛べっ！」（ﾍﾞｷｮﾘ！）	!#!PRINTFORMW 「後悔するなよ…千切れ飛べっ！」（ﾍﾞｷｮﾘ！）
PRINTFORMW 「このちんぽは私だけのもの…誰にも渡さない…！」（ｺﾞﾍﾞｷ！）	!#!PRINTFORMW 「このちんぽは私だけのもの…誰にも渡さない…！」（ｺﾞﾍﾞｷ！）
PRINTFORMW 「はい、命令通り。…『貴方のこの粗末な物は屠殺処分よ、マゾ豚！』」（ﾎﾞｸﾝｯ！）	!#!PRINTFORMW 「はい、命令通り。…『貴方のこの粗末な物は屠殺処分よ、マゾ豚！』」（ﾎﾞｸﾝｯ！）
PRINTFORMW 「ち、近づくなっ…ンムッ～～！？」	!#!PRINTFORMW 「ち、近づくなっ…ンムッ～～！？」
PRINTFORML 「ンジュ、チュウチゥ…」		PRINTFORML 「ンジュ、チュウチゥ…」
PRINTFORMW （ディープキス…心地良いよぉ～…❤）	!#!PRINTFORMW （ディープキス…心地良いよぉ～…❤）
PRINTFORMW 「では『ベロチュー』を行います。…んちゅむ、ジュルジュル…」	!#!PRINTFORMW 「では『ベロチュー』を行います。…んちゅむ、ジュルジュル…」
PRINTFORMDL 何を思ったか%CALLNAME:TARGET%は自分から相手に口づけした…	!#!PRINTFORMDL 何を思ったか%CALLNAME:TARGET%は自分から相手に口づけした…
PRINTFORMW 「…ん…むぅ……チュプ…」	!#!PRINTFORMW 「…ん…むぅ……チュプ…」
PRINTFORMW 「うーえ、ネトついて気持ち悪っ…！」	!#!PRINTFORMW 「うーえ、ネトついて気持ち悪っ…！」
PRINTFORMW 「すぐイッちゃダメだからね？ちゃんと耐えなさいよ～❤」	!#!PRINTFORMW 「すぐイッちゃダメだからね？ちゃんと耐えなさいよ～❤」
PRINTFORMW 「命令：『手コキ』を実行します…」（ｼｺｼｺ…）	!#!PRINTFORMW 「命令：『手コキ』を実行します…」（ｼｺｼｺ…）
PRINTFORMDL 何を思ったか%CALLNAME:TARGET%は自分から手で奉仕し出した…	!#!PRINTFORMDL 何を思ったか%CALLNAME:TARGET%は自分から手で奉仕し出した…
PRINTFORMW （あ…硬い…❤）	!#!PRINTFORMW （あ…硬い…❤）
PRINTFORMW 「ひぐ！く、臭いっ…うぐぅううぅう～～！！」	!#!PRINTFORMW 「ひぐ！く、臭いっ…うぐぅううぅう～～！！」
PRINTFORMW 「あむっ❤…ジュプッジュプッ…ヂュルル…❤」	!#!PRINTFORMW 「あむっ❤…ジュプッジュプッ…ヂュルル…❤」
PRINTFORML 　『フェラチオ』　　　　　実行中		PRINTFORML 　『フェラチオ』　　　　　実行中
PRINTFORMW 「『ふぇあふぃお』…ふぃっこうふぃう…ずぶ…じゅぷ…」	!#!PRINTFORMW 「『ふぇあふぃお』…ふぃっこうふぃう…ずぶ…じゅぷ…」
PRINTFORMDL 何を思ったか%CALLNAME:TARGET%は自分から口で奉仕し出した…	!#!PRINTFORMDL 何を思ったか%CALLNAME:TARGET%は自分から口で奉仕し出した…
PRINTFORMW 「フム…ムグ……ぢゅる、じゅぷぅ…❤」	!#!PRINTFORMW 「フム…ムグ……ぢゅる、じゅぷぅ…❤」
PRINTFORMW 「うひぃ、胸がネチョ付くっ…」	!#!PRINTFORMW 「うひぃ、胸がネチョ付くっ…」
PRINTFORMW 「こんなに固くして…しょうがないな～❤」（ﾑﾆｭﾑﾆｭ…❤）	!#!PRINTFORMW 「こんなに固くして…しょうがないな～❤」（ﾑﾆｭﾑﾆｭ…❤）
PRINTFORMW 「胸での奉仕を行います…」（ﾆｭﾌﾟﾆｭﾌﾟ…）	!#!PRINTFORMW 「胸での奉仕を行います…」（ﾆｭﾌﾟﾆｭﾌﾟ…）
PRINTFORMDL 何を思ったか%CALLNAME:TARGET%は自分から胸で奉仕し出した…	!#!PRINTFORMDL 何を思ったか%CALLNAME:TARGET%は自分から胸で奉仕し出した…
PRINTFORMW 「はぁ…はぁ……んっ❤」	!#!PRINTFORMW 「はぁ…はぁ……んっ❤」
PRINTFORMW （これからが良いところなのに…❤）	!#!PRINTFORMW （これからが良いところなのに…❤）
PRINTFORMW 「拘束解除を確認…通常形態に直ります」	!#!PRINTFORMW 「拘束解除を確認…通常形態に直ります」
PRINTFORMW （ちょっと残念…いやいや流されたらいけない…！）	!#!PRINTFORMW （ちょっと残念…いやいや流されたらいけない…！）
PRINTFORMW （早く体勢を立て直さないと…！）	!#!PRINTFORMW （早く体勢を立て直さないと…！）
PRINTFORMW 「あたい、もっと他の事がしたいからぁっ…❤」	!#!PRINTFORMW 「あたい、もっと他の事がしたいからぁっ…❤」
PRINTFORMW 「任務遂行の邪魔と判断…退避します」	!#!PRINTFORMW 「任務遂行の邪魔と判断…退避します」
PRINTFORMW 「そ、そういうのは今はちょっと…！❤」	!#!PRINTFORMW 「そ、そういうのは今はちょっと…！❤」
PRINTFORMW 「フヌッ！…ふ～、やっと離れたぁ…」	!#!PRINTFORMW 「フヌッ！…ふ～、やっと離れたぁ…」
PRINTFORMW （もうちょっと…もうちょっとだけこうしてよう…❤）	!#!PRINTFORMW （もうちょっと…もうちょっとだけこうしてよう…❤）
PRINTFORMW 「命令主の感情高揚を感知、レズプレイを続行します…んあっ❤」	!#!PRINTFORMW 「命令主の感情高揚を感知、レズプレイを続行します…んあっ❤」
PRINTFORMW 「今はこういう事してる場合じゃ…はん❤」	!#!PRINTFORMW 「今はこういう事してる場合じゃ…はん❤」
PRINTFORMW 「こんな時に…ダメだって…あひ❤」	!#!PRINTFORMW 「こんな時に…ダメだって…あひ❤」
PRINTFORMW 「わっわっごめんなさい友人様っ！！」	!#!PRINTFORMW 「わっわっごめんなさい友人様っ！！」
PRINTFORMW 「うわわっごめんなさいご主人様っ！！」	!#!PRINTFORMW 「うわわっごめんなさいご主人様っ！！」
PRINTFORMW 「わわ、体がっ！」（なにさせる気だ…！？）	!#!PRINTFORMW 「わわ、体がっ！」（なにさせる気だ…！？）
PRINTFORML 「違うんです…あっ❤　体が勝手にぃっ…」		PRINTFORML 「違うんです…あっ❤　体が勝手にぃっ…」
PRINTFORMW （耐えなきゃっ…友人様に中出しなんて…！！）	!#!PRINTFORMW （耐えなきゃっ…友人様に中出しなんて…！！）
PRINTFORMW （耐えなきゃっ…ご主人様に中出しなんて後で何されるか…！）	!#!PRINTFORMW （耐えなきゃっ…ご主人様に中出しなんて後で何されるか…！）
PRINTFORML 「あっく…んあっ…❤」		PRINTFORML 「あっく…んあっ…❤」
PRINTFORMW （耐えなきゃっ…中出ししないように…！）	!#!PRINTFORMW （耐えなきゃっ…中出ししないように…！）
PRINTFORMW （友人様とこんなことさせるなんて…くそっ！）	!#!PRINTFORMW （友人様とこんなことさせるなんて…くそっ！）
PRINTFORMW （ご主人様にこんな恥をかかせるなんて…っ！！）	!#!PRINTFORMW （ご主人様にこんな恥をかかせるなんて…っ！！）
PRINTFORML 「ふあっ…あううぅ…❤」		PRINTFORML 「ふあっ…あううぅ…❤」
PRINTFORMW （レズプレイさせて悠々と見てる腹づもりか…悪趣味な奴…！）	!#!PRINTFORMW （レズプレイさせて悠々と見てる腹づもりか…悪趣味な奴…！）
PRINTFORMW 「友人様ぁ…友人様なら、この火照り癒してくれますよね…？❤」	!#!PRINTFORMW 「友人様ぁ…友人様なら、この火照り癒してくれますよね…？❤」
PRINTFORMW 「ご主人様ぁ…あたいもう耐えられないですぅ❤」	!#!PRINTFORMW 「ご主人様ぁ…あたいもう耐えられないですぅ❤」
PRINTFORMW 「はぁっ、はぁっ❤…あたい、もうっ…！❤」	!#!PRINTFORMW 「はぁっ、はぁっ❤…あたい、もうっ…！❤」
PRINTFORMW （ﾊﾟﾝｯﾊﾟﾝｯ…❤）「友人様の膣内…最高ですぅ…❤」	!#!PRINTFORMW （ﾊﾟﾝｯﾊﾟﾝｯ…❤）「友人様の膣内…最高ですぅ…❤」
PRINTFORMW （ﾊﾟﾝｯﾊﾟﾝｯ❤）「ご主人様ぁ…かわいい顔してますよぉ…❤❤」	!#!PRINTFORMW （ﾊﾟﾝｯﾊﾟﾝｯ❤）「ご主人様ぁ…かわいい顔してますよぉ…❤❤」
PRINTFORMW （ｼﾞｭﾌﾟｼﾞｭﾌﾟ❤）「あっあっああっ❤良いっ❤腰止まんないっ❤」	!#!PRINTFORMW （ｼﾞｭﾌﾟｼﾞｭﾌﾟ❤）「あっあっああっ❤良いっ❤腰止まんないっ❤」
PRINTFORMW 「抱かれてる友人様…可愛いっ…❤❤」	!#!PRINTFORMW 「抱かれてる友人様…可愛いっ…❤❤」
PRINTFORMW 「あたい知ってますよ❤ご主人様はここが弱いんですよね❤」	!#!PRINTFORMW 「あたい知ってますよ❤ご主人様はここが弱いんですよね❤」
PRINTFORMW 「仲間同士だからね❤念入りにスキンシップしないとだよね❤」	!#!PRINTFORMW 「仲間同士だからね❤念入りにスキンシップしないとだよね❤」
PRINTFORMW 「友人様を捕獲…指示を待ちます…」	!#!PRINTFORMW 「友人様を捕獲…指示を待ちます…」
PRINTFORMW 「“元”ご主人、ヘカーティア様を捕獲…指示を待ちます…」	!#!PRINTFORMW 「“元”ご主人、ヘカーティア様を捕獲…指示を待ちます…」
PRINTFORMW 「対象を捕獲…指示を待ちます…」	!#!PRINTFORMW 「対象を捕獲…指示を待ちます…」
PRINTFORMW 「了解。友人様、お覚悟を…」（ｽﾞﾌﾟｩ！）	!#!PRINTFORMW 「了解。友人様、お覚悟を…」（ｽﾞﾌﾟｩ！）
PRINTFORMW 「了解。ヘカーティア様、お覚悟を…」（ｽﾞﾌﾟｩ！）	!#!PRINTFORMW 「了解。ヘカーティア様、お覚悟を…」（ｽﾞﾌﾟｩ！）
PRINTFORMW 「了解。それでは、お覚悟を…」（ｽﾞﾌﾟｩ！）	!#!PRINTFORMW 「了解。それでは、お覚悟を…」（ｽﾞﾌﾟｩ！）
PRINTFORMW 「了解。では友人様、お体に触りますよ…」	!#!PRINTFORMW 「了解。では友人様、お体に触りますよ…」
PRINTFORMW 「了解。ではヘカーティア様、お体に触りますよ…」	!#!PRINTFORMW 「了解。ではヘカーティア様、お体に触りますよ…」
PRINTFORMW 「了解。では、お体に触りますよ…」	!#!PRINTFORMW 「了解。では、お体に触りますよ…」
PRINTFORMW 「ゆ、友人様っ…！！」	!#!PRINTFORMW 「ゆ、友人様っ…！！」
PRINTFORMW 「ご、ご主人様ぁ…！！」	!#!PRINTFORMW 「ご、ご主人様ぁ…！！」
PRINTFORMW 「ご、ごめんっ…！」	!#!PRINTFORMW 「ご、ごめんっ…！」
PRINTFORMW 「友人様っ❤許してくださいっ❤我慢できなかったんですぅっ❤」	!#!PRINTFORMW 「友人様っ❤許してくださいっ❤我慢できなかったんですぅっ❤」
PRINTFORMW 「後でどんな罰でも受けますから…今だけ、ヤラせて下さいっ…❤」	!#!PRINTFORMW 「後でどんな罰でも受けますから…今だけ、ヤラせて下さいっ…❤」
PRINTFORMW 「後で説教でも折檻でもして良いからっ…今だけ…❤」	!#!PRINTFORMW 「後で説教でも折檻でもして良いからっ…今だけ…❤」
PRINTFORMW 「友人様、綺麗ですね…あたい、もう…我慢できないんですぅ❤」	!#!PRINTFORMW 「友人様、綺麗ですね…あたい、もう…我慢できないんですぅ❤」
PRINTFORMW 「ご主人様ぁ❤こっち見て下さいよぉ❤寂しいじゃないですかぁ…❤」	!#!PRINTFORMW 「ご主人様ぁ❤こっち見て下さいよぉ❤寂しいじゃないですかぁ…❤」
PRINTFORMW 「きゃはは♪…じゃ、いただきま～す❤」	!#!PRINTFORMW 「きゃはは♪…じゃ、いただきま～す❤」
PRINTFORMW 「あぁんっ❤激しいぃっ！❤」	!#!PRINTFORMW 「あぁんっ❤激しいぃっ！❤」
PRINTFORML 「あは…痛いよぉ…❤」		PRINTFORML 「あは…痛いよぉ…❤」
PRINTFORMDW 狂わされた%CALLNAME:TARGET%の頭は痛みをも快楽に変えている…	!#!PRINTFORMDW 狂わされた%CALLNAME:TARGET%の頭は痛みをも快楽に変えている…
PRINTFORMW 「んああぁあぁっ❤」	!#!PRINTFORMW 「んああぁあぁっ❤」
PRINTFORMW 「ヒ…ガイ……チ…メ…イ……ッ！」	!#!PRINTFORMW 「ヒ…ガイ……チ…メ…イ……ッ！」
PRINTFORMW 「グ…ダ、ダメージ大…危険…！」	!#!PRINTFORMW 「グ…ダ、ダメージ大…危険…！」
PRINTFORMW 「中程度のダメージを確認…」	!#!PRINTFORMW 「中程度のダメージを確認…」
PRINTFORMW 「ダメージ軽微。続行します」	!#!PRINTFORMW 「ダメージ軽微。続行します」
PRINTFORML 「ぐ…あ…」		PRINTFORML 「ぐ…あ…」
PRINTFORMW （意識が…朦朧と…）	!#!PRINTFORMW （意識が…朦朧と…）
PRINTFORMW 「や、やめてくれ…」	!#!PRINTFORMW 「や、やめてくれ…」
PRINTFORMW 「げふっ…ぐえ…」	!#!PRINTFORMW 「げふっ…ぐえ…」
PRINTFORMW 「はひぃ！？…い、痛ったぁ…❤」	!#!PRINTFORMW 「はひぃ！？…い、痛ったぁ…❤」
PRINTFORMW 「ゴホッ…もっと優しくしてよ…❤」	!#!PRINTFORMW 「ゴホッ…もっと優しくしてよ…❤」
PRINTFORMW 「ひぎぃ…んっ❤」	!#!PRINTFORMW 「ひぎぃ…んっ❤」
PRINTFORMW 「ウゲ…ぐうぅ…」	!#!PRINTFORMW 「ウゲ…ぐうぅ…」
PRINTFORML 「がは…！」		PRINTFORML 「がは…！」
PRINTFORMW （ふ、防ぎきれないっ…！）	!#!PRINTFORMW （ふ、防ぎきれないっ…！）
PRINTFORML 「あぎっ…！」		PRINTFORML 「あぎっ…！」
PRINTFORMW （うぅ…まともに食らった…）	!#!PRINTFORMW （うぅ…まともに食らった…）
PRINTFORMW 「あ痛ったぁっ…！！」	!#!PRINTFORMW 「あ痛ったぁっ…！！」
PRINTFORMW 「グ…あだだだ…」	!#!PRINTFORMW 「グ…あだだだ…」
PRINTFORML 「うっぐぅっ！」		PRINTFORML 「うっぐぅっ！」
PRINTFORMW （き、強烈なのが…！）	!#!PRINTFORMW （き、強烈なのが…！）
PRINTFORMW 「へっ、痛くも痒くも…やっぱ痛いわ…」	!#!PRINTFORMW 「へっ、痛くも痒くも…やっぱ痛いわ…」
PRINTFORMW 「うぎゅうっ！」	!#!PRINTFORMW 「うぎゅうっ！」
PRINTFORMW 「痛い痛い！やめろよぉっ…」	!#!PRINTFORMW 「痛い痛い！やめろよぉっ…」
PRINTFORMW 「このくらいじゃ効かんぞ…！」	!#!PRINTFORMW 「このくらいじゃ効かんぞ…！」
PRINTFORMW 「痛でっ！」	!#!PRINTFORMW 「痛でっ！」
PRINTFORMW 「へっ、この程度痛くも痒くも無いね」	!#!PRINTFORMW 「へっ、この程度痛くも痒くも無いね」
PRINTFORMW 「んお…お˝ほぉ～❤」	!#!PRINTFORMW 「んお…お˝ほぉ～❤」
PRINTFORMW 「おひり、らめぇ…❤」	!#!PRINTFORMW 「おひり、らめぇ…❤」
PRINTFORMW 「おごほおぉおぉおおぉ！！❤❤」	!#!PRINTFORMW 「おごほおぉおぉおおぉ！！❤❤」
PRINTFORMW 「んいいぃぃいいぃんっ❤」	!#!PRINTFORMW 「んいいぃぃいいぃんっ❤」
PRINTFORMW 「おうっ❤おほうっ❤」	!#!PRINTFORMW 「おうっ❤おほうっ❤」
PRINTFORMW 「やめおっ❤おおぉおっ❤」	!#!PRINTFORMW 「やめおっ❤おおぉおっ❤」
PRINTFORMW 「ひぎっ❤」	!#!PRINTFORMW 「ひぎっ❤」
PRINTFORMW 「ふぎぃ❤」	!#!PRINTFORMW 「ふぎぃ❤」
PRINTFORMW 「うっぎゅううぅうぅっ！」	!#!PRINTFORMW 「うっぎゅううぅうぅっ！」
PRINTFORMW 「尻がぁっ、裂けりゅううぅぐぐ…！！」	!#!PRINTFORMW 「尻がぁっ、裂けりゅううぅぐぐ…！！」
PRINTFORMW 「おぐうぅうっ！」	!#!PRINTFORMW 「おぐうぅうっ！」
PRINTFORMW 「んぐおおぉ…！！」	!#!PRINTFORMW 「んぐおおぉ…！！」
PRINTFORMW 「んにぃ…！」	!#!PRINTFORMW 「んにぃ…！」
PRINTFORMW 「んぎっ！」	!#!PRINTFORMW 「んぎっ！」
PRINTFORMW 「もまらいれぇ…❤」	!#!PRINTFORMW 「もまらいれぇ…❤」
PRINTFORMW 「おっぱい吸っちゃ…やぁあぁ♪」	!#!PRINTFORMW 「おっぱい吸っちゃ…やぁあぁ♪」
PRINTFORMW 「頭っ❤ビリビリするぅうぅ❤」	!#!PRINTFORMW 「頭っ❤ビリビリするぅうぅ❤」
PRINTFORMW 「ふあぁあぁもっと優しくしへえぇっ❤」	!#!PRINTFORMW 「ふあぁあぁもっと優しくしへえぇっ❤」
PRINTFORMW 「ふひいぃいぃ❤」	!#!PRINTFORMW 「ふひいぃいぃ❤」
PRINTFORMW 「胸っ、弄んないでぇ❤」	!#!PRINTFORMW 「胸っ、弄んないでぇ❤」
PRINTFORMW 「はうぅっ///」	!#!PRINTFORMW 「はうぅっ///」
PRINTFORMW 「ひんっ❤」	!#!PRINTFORMW 「ひんっ❤」
PRINTFORMW 「ぎゅううぅうぅ！！」	!#!PRINTFORMW 「ぎゅううぅうぅ！！」
PRINTFORMW 「ひぎいぃあ˝ぁあ˝あぁっ！！」	!#!PRINTFORMW 「ひぎいぃあ˝ぁあ˝あぁっ！！」
PRINTFORMW 「あうぐうぅう…！」	!#!PRINTFORMW 「あうぐうぅう…！」
PRINTFORMW 「ふひいぃいいぃ…」	!#!PRINTFORMW 「ふひいぃいいぃ…」
PRINTFORMW 「あんっ…」	!#!PRINTFORMW 「あんっ…」
PRINTFORMW 「ひぃっ…！」	!#!PRINTFORMW 「ひぃっ…！」
PRINTFORMW 「おっ、おおっ♪おっおっ❤」	!#!PRINTFORMW 「おっ、おおっ♪おっおっ❤」
PRINTFORMW 「やだぁ…せーえき出ちゃうよおぉ…❤」	!#!PRINTFORMW 「やだぁ…せーえき出ちゃうよおぉ…❤」
PRINTFORMW （へぁあぁ…腰が勝手に動くうぅ…❤）	!#!PRINTFORMW （へぁあぁ…腰が勝手に動くうぅ…❤）
PRINTFORMW 「いひぎいぃいぃいいいぃ❤❤」	!#!PRINTFORMW 「いひぎいぃいぃいいいぃ❤❤」
PRINTFORMW 「あ˝ああぁ出るっちんぽ汁出ちゃううぅう❤」	!#!PRINTFORMW 「あ˝ああぁ出るっちんぽ汁出ちゃううぅう❤」
PRINTFORMW 「あうぁあぁクリイキさせられりゅううぅう❤」	!#!PRINTFORMW 「あうぁあぁクリイキさせられりゅううぅう❤」
PRINTFORMW 「あひっ❤あひぃいぃ❤」	!#!PRINTFORMW 「あひっ❤あひぃいぃ❤」
PRINTFORMW 「やめへぇ❤扱いちゃ嫌ああぁあぁ❤」	!#!PRINTFORMW 「やめへぇ❤扱いちゃ嫌ああぁあぁ❤」
PRINTFORMW 「ひいいぃんっ！❤」	!#!PRINTFORMW 「ひいいぃんっ！❤」
PRINTFORMW 「触…るなぁ…❤」	!#!PRINTFORMW 「触…るなぁ…❤」
PRINTFORMW 「そこらめぇ❤」	!#!PRINTFORMW 「そこらめぇ❤」
PRINTFORMW 「ひきゅぅう˝ぅうぅっ！！」	!#!PRINTFORMW 「ひきゅぅう˝ぅうぅっ！！」
PRINTFORMW 「いひぎぃいいちんぽでイかしゃれるううぅう！！」	!#!PRINTFORMW 「いひぎぃいいちんぽでイかしゃれるううぅう！！」
PRINTFORMW 「そ、そこは…いあぁあぁぁ～～～！！」	!#!PRINTFORMW 「そ、そこは…いあぁあぁぁ～～～！！」
PRINTFORMW 「ぐぅううぅっ～～…！！」	!#!PRINTFORMW 「ぐぅううぅっ～～…！！」
PRINTFORMW 「あひいぃいぃっ…///」	!#!PRINTFORMW 「あひいぃいぃっ…///」
PRINTFORMW 「きひいぃいぃ…！」	!#!PRINTFORMW 「きひいぃいぃ…！」
PRINTFORMW 「あぅんっ…！」	!#!PRINTFORMW 「あぅんっ…！」
PRINTFORMW 「ひいぃ…」	!#!PRINTFORMW 「ひいぃ…」
PRINTFORMW 「んっ❤んっ❤んおっ❤お˝っ❤」	!#!PRINTFORMW 「んっ❤んっ❤んおっ❤お˝っ❤」
PRINTFORMW （あ˝あぁ～❤おまんこ弄られるのきもぢいーのぉおおぉ❤）	!#!PRINTFORMW （あ˝あぁ～❤おまんこ弄られるのきもぢいーのぉおおぉ❤）
PRINTFORMW 「んの˝おぉおおぉ❤お膣っゴリゴリしないれぇえぇ！！❤❤」	!#!PRINTFORMW 「んの˝おぉおおぉ❤お膣っゴリゴリしないれぇえぇ！！❤❤」
PRINTFORMW 「深いっ❤深˝いいぃいいぃ❤❤」	!#!PRINTFORMW 「深いっ❤深˝いいぃいいぃ❤❤」
PRINTFORMW 「おほおぉんっ❤」	!#!PRINTFORMW 「おほおぉんっ❤」
PRINTFORMW 「ふぎいぃ❤」	!#!PRINTFORMW 「ふぎいぃ❤」
PRINTFORMW 「あん…///」	!#!PRINTFORMW 「あん…///」
PRINTFORMW 「あっ❤」	!#!PRINTFORMW 「あっ❤」
PRINTFORMW 「ひぎいいぃぃいぃうぅう！！」	!#!PRINTFORMW 「ひぎいいぃぃいぃうぅう！！」
PRINTFORMW 「やめっ…いやあぁあぁぁあ！！」	!#!PRINTFORMW 「やめっ…いやあぁあぁぁあ！！」
PRINTFORMW 「あぎぎぎ…！」	!#!PRINTFORMW 「あぎぎぎ…！」
PRINTFORMW 「うぎ、うぐぃいいぃ…」	!#!PRINTFORMW 「うぎ、うぐぃいいぃ…」
PRINTFORMW 「ぎゅ、う…」	!#!PRINTFORMW 「ぎゅ、う…」
PRINTFORMW 「ヤダっ…！」	!#!PRINTFORMW 「ヤダっ…！」
PRINTFORMW 「ふああぁあぁあぁ…❤」	!#!PRINTFORMW 「ふああぁあぁあぁ…❤」
PRINTFORMW （気持ちいい気持ちいいきもちいいいぃい～～❤）	!#!PRINTFORMW （気持ちいい気持ちいいきもちいいいぃい～～❤）
PRINTFORML 「うひ、ひいいぃいんっ❤」		PRINTFORML 「うひ、ひいいぃいんっ❤」
PRINTFORMW （あたいをおもちゃにしないれえぇえぇ…❤）	!#!PRINTFORMW （あたいをおもちゃにしないれえぇえぇ…❤）
PRINTFORMW 「ふにゅうぅううぅうっ❤」	!#!PRINTFORMW 「ふにゅうぅううぅうっ❤」
PRINTFORMW 「やああぁん❤」	!#!PRINTFORMW 「やああぁん❤」
PRINTFORMW 「うあうぅうんっ❤」	!#!PRINTFORMW 「うあうぅうんっ❤」
PRINTFORMW 「はぁあ…❤」	!#!PRINTFORMW 「はぁあ…❤」
PRINTFORMW 「んんっ❤」	!#!PRINTFORMW 「んんっ❤」
PRINTFORMW 「ひにぁあぁああぁ！！」	!#!PRINTFORMW 「ひにぁあぁああぁ！！」
PRINTFORMW 「うう˝ぅうぅうぅっ…！」	!#!PRINTFORMW 「うう˝ぅうぅうぅっ…！」
PRINTFORMW 「…うぅっ……っ！…」	!#!PRINTFORMW 「…うぅっ……っ！…」
PRINTFORMW 「んにぃいぃ…！」	!#!PRINTFORMW 「んにぃいぃ…！」
PRINTFORMW 「きぅっ…」	!#!PRINTFORMW 「きぅっ…」
PRINTFORMW 「ふひぃ…」	!#!PRINTFORMW 「ふひぃ…」
PRINTFORMW 「や、やだぁ…っ❤」	!#!PRINTFORMW 「や、やだぁ…っ❤」
PRINTFORMW 「あ…やぁ…」	!#!PRINTFORMW 「あ…やぁ…」
PRINTFORMW 「は、放してぇ…///」	!#!PRINTFORMW 「は、放してぇ…///」
PRINTFORMW 「あ、しまっ…❤」	!#!PRINTFORMW 「あ、しまっ…❤」
PRINTFORMW 「ぐぇ！」	!#!PRINTFORMW 「ぐぇ！」
PRINTFORMW 「おいバカッ…放せっ！」	!#!PRINTFORMW 「おいバカッ…放せっ！」
PRINTFORMW 「うぐ…しまった…！」	!#!PRINTFORMW 「うぐ…しまった…！」
PRINTFORMW 「やらぁ…もう穢さないれぇ…❤」	!#!PRINTFORMW 「やらぁ…もう穢さないれぇ…❤」
PRINTFORMW 「おへえぇ❤うぇへええぇ～～…❤」	!#!PRINTFORMW 「おへえぇ❤うぇへええぇ～～…❤」
PRINTFORML 「あ、あ˝ーっ❤なんか熱いのきでるうぅううぅ❤❤		PRINTFORML 「あ、あ˝ーっ❤なんか熱いのきでるうぅううぅ❤❤
PRINTFORMW 　赤ちゃんザーメン漬けになっちゃうううぅうぅ❤❤」	!#!PRINTFORMW 　赤ちゃんザーメン漬けになっちゃうううぅうぅ❤❤」
PRINTFORMW 　赤ちゃんできぢゃうよおおぉおぉ❤❤」	!#!PRINTFORMW 　赤ちゃんできぢゃうよおおぉおぉ❤❤」
PRINTFORMW 「んおおおぉ！！中出しっ❤らめえぇえええぇッ❤❤」	!#!PRINTFORMW 「んおおおぉ！！中出しっ❤らめえぇえええぇッ❤❤」
PRINTFORMW 「う˝ああぁあ˝ぁあぁ！！膣内（ナカ）は嫌だあぁああぁ！！」	!#!PRINTFORMW 「う˝ああぁあ˝ぁあぁ！！膣内（ナカ）は嫌だあぁああぁ！！」
PRINTFORML 「ま、まさか…ひぅあぁああぁあぁっ…！」		PRINTFORML 「ま、まさか…ひぅあぁああぁあぁっ…！」
PRINTFORMW （妊婦にもお構いなしかよ…！？）	!#!PRINTFORMW （妊婦にもお構いなしかよ…！？）
PRINTFORMW （は、孕まされるぅ！？いやあぁあぁ！！）	!#!PRINTFORMW （は、孕まされるぅ！？いやあぁあぁ！！）
PRINTFORMW 「え˝っほ…ごほっ…」	!#!PRINTFORMW 「え˝っほ…ごほっ…」
PRINTFORMW 「ぐ、この…香り…はぁ……」（ｶﾞｸﾝｯ）	!#!PRINTFORMW 「ぐ、この…香り…はぁ……」（ｶﾞｸﾝｯ）
PRINTFORMW 「ひぁ❤この香りはぁっ❤」	!#!PRINTFORMW 「ひぁ❤この香りはぁっ❤」
PRINTFORMW 「ひにゃあぁああぁ❤」	!#!PRINTFORMW 「ひにゃあぁああぁ❤」
PRINTFORMW 「うああぁっ…！？」	!#!PRINTFORMW 「うああぁっ…！？」
PRINTFORMW 「まだ、何かさせるの…？///」	!#!PRINTFORMW 「まだ、何かさせるの…？///」
PRINTFORML 「ぐぅ…あ…！」		PRINTFORML 「ぐぅ…あ…！」
PRINTFORMW （ダメだ…まともに動けないっ…！！）	!#!PRINTFORMW （ダメだ…まともに動けないっ…！！）
PRINTFORMW 「ひ、何っ…！？」	!#!PRINTFORMW 「ひ、何っ…！？」
PRINTFORMW 「ぐうっ…なんだ、体がっ！？」	!#!PRINTFORMW 「ぐうっ…なんだ、体がっ！？」
PRINTFORMW 「も、やめてぇ❤戻れなくなっちゃう❤一生変態になっちゃうぅ❤❤」	!#!PRINTFORMW 「も、やめてぇ❤戻れなくなっちゃう❤一生変態になっちゃうぅ❤❤」
PRINTFORMW 「あ、あ～❤これ、狂わされるやつだぁ❤あたい狂わされちゃったぁ❤❤」	!#!PRINTFORMW 「あ、あ～❤これ、狂わされるやつだぁ❤あたい狂わされちゃったぁ❤❤」
PRINTFORMW 「……『人形ガ忠誠ヲ誓ウノハ当然』…はい、心得ております……」	!#!PRINTFORMW 「……『人形ガ忠誠ヲ誓ウノハ当然』…はい、心得ております……」
PRINTFORMW 「うあ！？…頭に何か…書き換え…っああぁあぁあぁ…！」	!#!PRINTFORMW 「うあ！？…頭に何か…書き換え…っああぁあぁあぁ…！」
PRINTFORMW 「…………私…は…ご主人様の人形です…ご命令を、どうぞ…」	!#!PRINTFORMW 「…………私…は…ご主人様の人形です…ご命令を、どうぞ…」
PRINTFORMW 「ああぁ、ドロドロがぁっ…❤」	!#!PRINTFORMW 「ああぁ、ドロドロがぁっ…❤」
PRINTFORMW 「えぅ…臭っさぁいっ…///」	!#!PRINTFORMW 「えぅ…臭っさぁいっ…///」
PRINTFORMW 「ぶえ！…うえぇ…」（すっごい臭い…❤）	!#!PRINTFORMW 「ぶえ！…うえぇ…」（すっごい臭い…❤）
PRINTFORMW 「ああもう、ドロッドロ…❤」	!#!PRINTFORMW 「ああもう、ドロッドロ…❤」
PRINTFORMW 「ふげ！クッサ！」	!#!PRINTFORMW 「ふげ！クッサ！」
PRINTFORMW 「うわぁ、汚っ…！」	!#!PRINTFORMW 「うわぁ、汚っ…！」
PRINTFORMW 「ぶぶぅ！……んっ❤」（ｺｸﾝ❤）	!#!PRINTFORMW 「ぶぶぅ！……んっ❤」（ｺｸﾝ❤）
PRINTFORMW 「ぶぇ…うぇ、凄く濃い…❤」	!#!PRINTFORMW 「ぶぇ…うぇ、凄く濃い…❤」
PRINTFORMW 「んぶっ！？んぶぅ…！！」	!#!PRINTFORMW 「んぶっ！？んぶぅ…！！」
PRINTFORMW 「んぷぇ！…オエ～ッ！！」	!#!PRINTFORMW 「んぷぇ！…オエ～ッ！！」
PRINTFORMW 「ダメ…！❤」	!#!PRINTFORMW 「ダメ…！❤」
PRINTFORMW （欲望に負けちゃダメ…！）	!#!PRINTFORMW （欲望に負けちゃダメ…！）
PRINTFORMW 「ふうっ…！」（これ以上はぁッ❤）	!#!PRINTFORMW 「ふうっ…！」（これ以上はぁッ❤）
PRINTFORMW 「ひええぇ！？」	!#!PRINTFORMW 「ひええぇ！？」
PRINTFORMW 「か、『かすりの獄意』ってやつよ…」	!#!PRINTFORMW 「か、『かすりの獄意』ってやつよ…」
PRINTFORMW 「ひっ…！」	!#!PRINTFORMW 「ひっ…！」
PRINTFORMW 「もっとスピードあげなよ？」	!#!PRINTFORMW 「もっとスピードあげなよ？」
PRINTFORMW 「きゃはは！当たらないよ～！」	!#!PRINTFORMW 「きゃはは！当たらないよ～！」
PRINTFORMW 「かすりもしないねぇ」	!#!PRINTFORMW 「かすりもしないねぇ」
PRINTFORMW 「地獄基準じゃ、全然だね」	!#!PRINTFORMW 「地獄基準じゃ、全然だね」
PRINTFORMW 「ふへぇ…」（くたびれた…）	!#!PRINTFORMW 「ふへぇ…」（くたびれた…）
PRINTFORMW 「よ、よ～し！」	!#!PRINTFORMW 「よ、よ～し！」
PRINTFORMW 「あんたらが泣く側なんだからね…！」	!#!PRINTFORMW 「あんたらが泣く側なんだからね…！」
PRINTFORMW 「きゃはは！」	!#!PRINTFORMW 「きゃはは！」
PRINTFORMW 「撃墜～♪」	!#!PRINTFORMW 「撃墜～♪」
PRINTFORMW 「地獄に堕ちるがいい！」	!#!PRINTFORMW 「地獄に堕ちるがいい！」
PRINTFORMW 「good！なかなか良い出来！」	!#!PRINTFORMW 「good！なかなか良い出来！」
PRINTFORMW 「潰れちゃった？」	!#!PRINTFORMW 「潰れちゃった？」
PRINTFORMW （う…ぐ、食らいすぎたか…！）	!#!PRINTFORMW （う…ぐ、食らいすぎたか…！）
PRINTFORML 「被害…甚…大……うぐぐが…あたいはっ…一体……あ˝あぁうあ…！」		PRINTFORML 「被害…甚…大……うぐぐが…あたいはっ…一体……あ˝あぁうあ…！」
PRINTFORMW %CALLNAME:TARGET%は混乱とともに崩れ落ちた…	!#!PRINTFORMW %CALLNAME:TARGET%は混乱とともに崩れ落ちた…
PRINTFORMW 「あ…はひぃ…❤　あたい、たっくさん穢されちゃったぁ❤…もうらめぇ❤」	!#!PRINTFORMW 「あ…はひぃ…❤　あたい、たっくさん穢されちゃったぁ❤…もうらめぇ❤」
PRINTFORMW 「うぁ…あ…穢れが溜まって…動けないぃ…❤」	!#!PRINTFORMW 「うぁ…あ…穢れが溜まって…動けないぃ…❤」
PRINTFORMW 「あぁ、やめてぇ～…」	!#!PRINTFORMW 「あぁ、やめてぇ～…」
PRINTFORMW （あたい、こんなところですっぽんぽんにされちゃったぁ…❤）	!#!PRINTFORMW （あたい、こんなところですっぽんぽんにされちゃったぁ…❤）
PRINTFORMW 「ひ、ひぃい…❤」（お、犯されるぅ…っ❤）	!#!PRINTFORMW 「ひ、ひぃい…❤」（お、犯されるぅ…っ❤）
PRINTFORMW 「あぁ、視線が刺さるぅ…❤」	!#!PRINTFORMW 「あぁ、視線が刺さるぅ…❤」
PRINTFORMW 「ぐぅ…どんどん服がビリビリに…❤」	!#!PRINTFORMW 「ぐぅ…どんどん服がビリビリに…❤」
PRINTFORMW 「もうやめてっ…///」	!#!PRINTFORMW 「もうやめてっ…///」
PRINTFORMW 「わあっ…！」	!#!PRINTFORMW 「わあっ…！」
PRINTFORMW 「うぅ…やめてよっ…❤」	!#!PRINTFORMW 「うぅ…やめてよっ…❤」
PRINTFORMW 「いくらあたいが魅力的だからって！」	!#!PRINTFORMW 「いくらあたいが魅力的だからって！」
PRINTFORMW 「あ～なんてことをっ！ヒドイ！」	!#!PRINTFORMW 「あ～なんてことをっ！ヒドイ！」
PRINTFORMW （ヤバいマズイ犯される…！！）	!#!PRINTFORMW （ヤバいマズイ犯される…！！）
PRINTFORMW （う…かなり破れて来たな…！）	!#!PRINTFORMW （う…かなり破れて来たな…！）
PRINTFORMW 「くっそっ…！」	!#!PRINTFORMW 「くっそっ…！」
PRINTFORMW 「このくらい平気だ…！」	!#!PRINTFORMW 「このくらい平気だ…！」
PRINTFORMW 「げ、服が！」	!#!PRINTFORMW 「げ、服が！」
PRINTFORMW （あぁ…あたい、また穢されちゃうよ…///）	!#!PRINTFORMW （あぁ…あたい、また穢されちゃうよ…///）
PRINTFORMW 「こ、こんな時にぃ…っ❤」	!#!PRINTFORMW 「こ、こんな時にぃ…っ❤」
PRINTFORMW 「さ、最悪のタイミングかも…」	!#!PRINTFORMW 「さ、最悪のタイミングかも…」
PRINTFORMW 「…こいつが元凶？じゃあさっさと倒さないとな！」	!#!PRINTFORMW 「…こいつが元凶？じゃあさっさと倒さないとな！」
PRINTFORMW 「う、後ろからなんてっ…❤」	!#!PRINTFORMW 「う、後ろからなんてっ…❤」
PRINTFORMW 「ひ、ひいいぃ！？❤」	!#!PRINTFORMW 「ひ、ひいいぃ！？❤」
PRINTFORMW 「あ…あぁ…？！」	!#!PRINTFORMW 「あ…あぁ…？！」
PRINTFORMW 「ヤ、ヤバいっ…！」	!#!PRINTFORMW 「ヤ、ヤバいっ…！」
PRINTFORMW 「ワッザファック！？」	!#!PRINTFORMW 「ワッザファック！？」
PRINTFORMW 「げぇ～っ、バックアタック！？」	!#!PRINTFORMW 「げぇ～っ、バックアタック！？」
PRINTFORMW 「ああっと？！」	!#!PRINTFORMW 「ああっと？！」
PRINTFORMW 「イッツ、ルナティック…んうふぅ❤」	!#!PRINTFORMW 「イッツ、ルナティック…んうふぅ❤」
PRINTFORMW （早く、早く倒さなきゃ…❤）	!#!PRINTFORMW （早く、早く倒さなきゃ…❤）
PRINTFORMW 「イッツ、ルナティック…言ってる場合じゃないか…」	!#!PRINTFORMW 「イッツ、ルナティック…言ってる場合じゃないか…」
PRINTFORMW （よし、何とかアドバンテージは取れた…！）	!#!PRINTFORMW （よし、何とかアドバンテージは取れた…！）
PRINTFORMW 「イッツ、ルナティックターイム！」	!#!PRINTFORMW 「イッツ、ルナティックターイム！」
PRINTFORMW 「油断するほうが悪いんだぜ？」	!#!PRINTFORMW 「油断するほうが悪いんだぜ？」
PRINTFORMW 「Let's partyyyyyyyy!!」	!#!PRINTFORMW 「Let's partyyyyyyyy!!」
PRINTFORMW 「サプラ～イズ！」	!#!PRINTFORMW 「サプラ～イズ！」
PRINTFORMW （…こういう時に限って敵が来るんだよな～…）	!#!PRINTFORMW （…こういう時に限って敵が来るんだよな～…）
PRINTFORMW 「…こいつらもしかして、匂いを嗅ぎ付けたのか…？」	!#!PRINTFORMW 「…こいつらもしかして、匂いを嗅ぎ付けたのか…？」
PRINTFORML 「ちょ、丁度良いハンデだな！」		PRINTFORML 「ちょ、丁度良いハンデだな！」
PRINTFORMW （ヤバいな～…どうしようかなぁ…）	!#!PRINTFORMW （ヤバいな～…どうしようかなぁ…）
PRINTFORMW 「乗り切れるかな…？」	!#!PRINTFORMW 「乗り切れるかな…？」
PRINTFORMW 「さっさと黙らせてやろっと」	!#!PRINTFORMW 「さっさと黙らせてやろっと」
PRINTFORMW 「うっし、始めるか！」	!#!PRINTFORMW 「うっし、始めるか！」
PRINTFORMW 「ﾔｯﾀﾙｿﾞｰ！」	!#!PRINTFORMW 「ﾔｯﾀﾙｿﾞｰ！」
PRINTFORML 「あうっ❤んあんっ…❤　も、もっとゆっくり運んでぇ…」		PRINTFORML 「あうっ❤んあんっ…❤　も、もっとゆっくり運んでぇ…」
PRINTFORMDW %CALLNAME:TARGET%は仲間に担がれていった…	!#!PRINTFORMDW %CALLNAME:TARGET%は仲間に担がれていった…
PRINTFORML 「ｸﾞｩ…ｽｩ……ふげっ」		PRINTFORML 「ｸﾞｩ…ｽｩ……ふげっ」
PRINTFORMW 「こ、これ以上穢されたくないもん…❤」	!#!PRINTFORMW 「こ、これ以上穢されたくないもん…❤」
PRINTFORMW 「ヒィ、ヒィ❤…あうぅ、休憩したい…❤」	!#!PRINTFORMW 「ヒィ、ヒィ❤…あうぅ、休憩したい…❤」
PRINTFORMW 「いくら死なないからって、死ぬほど痛いのは御免だよ…！」	!#!PRINTFORMW 「いくら死なないからって、死ぬほど痛いのは御免だよ…！」
PRINTFORMW 「破れかぶれに挑んでも、無残に負けるのがオチだからね～」	!#!PRINTFORMW 「破れかぶれに挑んでも、無残に負けるのがオチだからね～」
PRINTFORMW 「へっへ～、まともに戦うと思ったかバカめ！」	!#!PRINTFORMW 「へっへ～、まともに戦うと思ったかバカめ！」
PRINTFORMW 「ふーい、ここまで逃げりゃいいかね～っと」	!#!PRINTFORMW 「ふーい、ここまで逃げりゃいいかね～っと」
PRINTFORMW 「いちいちかまってられるかっての！」	!#!PRINTFORMW 「いちいちかまってられるかっての！」
PRINTFORMW 「うっ❤！？…ふぅ、何とか耐えられた…」	!#!PRINTFORMW 「うっ❤！？…ふぅ、何とか耐えられた…」
PRINTFORMW 「悪いね…こっちもご主人様の為、欲望に負ける訳にはいけないんだ…っ❤」	!#!PRINTFORMW 「悪いね…こっちもご主人様の為、欲望に負ける訳にはいけないんだ…っ❤」
PRINTFORMW 「あたいが欲しいんだったら、もっと強いの呼んできなよ…❤」	!#!PRINTFORMW 「あたいが欲しいんだったら、もっと強いの呼んできなよ…❤」
PRINTFORMW 「きゃはははは！…は、はあはあ…疲れちゃった」	!#!PRINTFORMW 「きゃはははは！…は、はあはあ…疲れちゃった」
PRINTFORMW 「生命の象徴が簡単にやられてたまるかっての…！」	!#!PRINTFORMW 「生命の象徴が簡単にやられてたまるかっての…！」
PRINTFORMW 「あ、危うく捕まって穢されるとこだった…」	!#!PRINTFORMW 「あ、危うく捕まって穢されるとこだった…」
PRINTFORMW 「S・H・I・T!　ここまで消耗するとは…！」	!#!PRINTFORMW 「S・H・I・T!　ここまで消耗するとは…！」
PRINTFORMW 「ひゃっはー！サイコーに地獄だぜぇ！」	!#!PRINTFORMW 「ひゃっはー！サイコーに地獄だぜぇ！」
PRINTFORMW 「地獄妖精をなめるな！この触手野郎！！」	!#!PRINTFORMW 「地獄妖精をなめるな！この触手野郎！！」
PRINTFORMW 「穢れて地獄に…こいつらはもう穢れてるか」	!#!PRINTFORMW 「穢れて地獄に…こいつらはもう穢れてるか」
PRINTFORMW 「wonderfuuuuuul!　きゃっほー♪」	!#!PRINTFORMW 「wonderfuuuuuul!　きゃっほー♪」
PRINTFORMW 「ＯＫ！」	!#!PRINTFORMW 「ＯＫ！」
PRINTFORMW 「純化しなくたってこんなもんよ～！」	!#!PRINTFORMW 「純化しなくたってこんなもんよ～！」
PRINTFORMW 「あ…ま、まずった！」	!#!PRINTFORMW 「あ…ま、まずった！」
PRINTFORML 「…ぁ…まってぇ……！」		PRINTFORML 「…ぁ…まってぇ……！」
PRINTFORMDW %CALLNAME:TARGET%は仲間に置いて行かれた…	!#!PRINTFORMDW %CALLNAME:TARGET%は仲間に置いて行かれた…
PRINTFORMW 「ちょ、ウソっ！？」	!#!PRINTFORMW 「ちょ、ウソっ！？」
PRINTFORMW 「ちんぽユニット確認、精液充填完了。射精します…っ！」（ﾋﾞｭｸｸｸｯ❤）	!#!PRINTFORMW 「ちんぽユニット確認、精液充填完了。射精します…っ！」（ﾋﾞｭｸｸｸｯ❤）
PRINTFORMW 「絶頂耐久…不能っ…潮吹きを行います…～～っ！」（ﾌﾟｼｧｱｧｯ❤）	!#!PRINTFORMW 「絶頂耐久…不能っ…潮吹きを行います…～～っ！」（ﾌﾟｼｧｱｧｯ❤）
PRINTFORMW 「快楽限界点到達、絶頂します…っ❤❤」	!#!PRINTFORMW 「快楽限界点到達、絶頂します…っ❤❤」
PRINTFORMW 「ひぎいいぃいぃ❤気持ちよしゅぎてのーみそ壊れるぅうぅう❤❤❤」	!#!PRINTFORMW 「ひぎいいぃいぃ❤気持ちよしゅぎてのーみそ壊れるぅうぅう❤❤❤」
PRINTFORMW 「出りゅうう！あたい精液噴水になっちゃうのほぉおおぉ❤❤」（ﾄﾞｯﾌﾟﾌﾟｳﾝ❤）	!#!PRINTFORMW 「出りゅうう！あたい精液噴水になっちゃうのほぉおおぉ❤❤」（ﾄﾞｯﾌﾟﾌﾟｳﾝ❤）
PRINTFORMW 「あたいイクよぉ///　あたいのっ❤お潮吹き見てええぇっ！❤❤」（ﾌﾟｼｬｼｬｧｯ❤）	!#!PRINTFORMW 「あたいイクよぉ///　あたいのっ❤お潮吹き見てええぇっ！❤❤」（ﾌﾟｼｬｼｬｧｯ❤）
PRINTFORMW 「いやあぁあぁ❤ミルクがっ❤ミルクが出ちゃううぅう！❤」	!#!PRINTFORMW 「いやあぁあぁ❤ミルクがっ❤ミルクが出ちゃううぅう！❤」
PRINTFORMW 「しゅごいの来るぅっ❤…はひぃいぃいぃいぃん///」	!#!PRINTFORMW 「しゅごいの来るぅっ❤…はひぃいぃいぃいぃん///」
PRINTFORMW 「んおっ、ほおおぉおぉ！！❤❤」	!#!PRINTFORMW 「んおっ、ほおおぉおぉ！！❤❤」
PRINTFORMW 「あっひいいぃい～～っ！❤❤」	!#!PRINTFORMW 「あっひいいぃい～～っ！❤❤」
PRINTFORMW 「おほぉっ❤ちんぽが限界なのおおぉっ❤❤」（ﾄﾞﾌﾟﾌﾟﾋﾟｭ❤）	!#!PRINTFORMW 「おほぉっ❤ちんぽが限界なのおおぉっ❤❤」（ﾄﾞﾌﾟﾌﾟﾋﾟｭ❤）
PRINTFORMW 「も…無理ぃ…っんおひいぃいいぃいぃぃいっ❤❤」	!#!PRINTFORMW 「も…無理ぃ…っんおひいぃいいぃいぃぃいっ❤❤」
PRINTFORMW 「ひあぁあ…ミルクっ、出るううぅうぅっ！」	!#!PRINTFORMW 「ひあぁあ…ミルクっ、出るううぅうぅっ！」
PRINTFORMW 「ダメ、耐えられ…っああぁぁあぁああぁ！❤❤」	!#!PRINTFORMW 「ダメ、耐えられ…っああぁぁあぁああぁ！❤❤」
PRINTFORMW 「ふ、ふえぇえぇえぇえぇぇっ❤❤」	!#!PRINTFORMW 「ふ、ふえぇえぇえぇえぇぇっ❤❤」
PRINTFORML 「い…イックうぅうぅぅううぅっ～！❤❤」		PRINTFORML 「い…イックうぅうぅぅううぅっ～！❤❤」
PRINTFORMDW %CALLNAME:TARGET%は愛液をまき散らし絶頂した！	!#!PRINTFORMDW %CALLNAME:TARGET%は愛液をまき散らし絶頂した！
PRINTFORMW 「ふあ❤うあ˝あぁあ˝ぁああぁあぁ……❤❤❤」	!#!PRINTFORMW 「ふあ❤うあ˝あぁあ˝ぁああぁあぁ……❤❤❤」
PRINTFORMW 「あー❤あーっ❤いっぐうぅううぅ～～❤❤」	!#!PRINTFORMW 「あー❤あーっ❤いっぐうぅううぅ～～❤❤」
PRINTFORMW 「またイかされちゃう❤もうイクの嫌らのにぃ❤あひぁああぁっっ❤❤❤」	!#!PRINTFORMW 「またイかされちゃう❤もうイクの嫌らのにぃ❤あひぁああぁっっ❤❤❤」
PRINTFORMW 「もうやらぁ❤だれか、たしゅけてぇ❤…ん、んほおおぉおおぉ❤❤❤」	!#!PRINTFORMW 「もうやらぁ❤だれか、たしゅけてぇ❤…ん、んほおおぉおおぉ❤❤❤」
PRINTFORMW （あ…あ…生命エネルギーが、あたいの全部が…穢されてく…）	!#!PRINTFORMW （あ…あ…生命エネルギーが、あたいの全部が…穢されてく…）
PRINTFORMW （あたい…これから…どうなるの…？　助け…てぇ……友人様…ご主人…様…ぁ…………）	!#!PRINTFORMW （あたい…これから…どうなるの…？　助け…てぇ……友人様…ご主人…様…ぁ…………）
PRINTFORML 「さぁて…中に入ったのはいいけど、どこから調べるかな」		PRINTFORML 「さぁて…中に入ったのはいいけど、どこから調べるかな」
PRINTFORML 「らめぇ……スルメを鼻にくっ付けないでぇ……」		PRINTFORML 「らめぇ……スルメを鼻にくっ付けないでぇ……」
PRINTFORML 「ご主人様ぁっ……ウッ…❤」		PRINTFORML 「ご主人様ぁっ……ウッ…❤」
PRINTFORMDL %CALLNAME:TARGET%は良からぬ夢を見ているようだ…	!#!PRINTFORMDL %CALLNAME:TARGET%は良からぬ夢を見ているようだ…
PRINTFORML 「ご主人様ぁ……ｸｩｸｩ……」		PRINTFORML 「ご主人様ぁ……ｸｩｸｩ……」
PRINTFORMDL %CALLNAME:TARGET%はヘカーティアの夢を見ているようだ	!#!PRINTFORMDL %CALLNAME:TARGET%はヘカーティアの夢を見ているようだ
PRINTFORML （ｸﾞｩｰｯ…）「…みみずのみぎみみ…」（…ｽﾔｧ）		PRINTFORML （ｸﾞｩｰｯ…）「…みみずのみぎみみ…」（…ｽﾔｧ）
PRINTFORML 「……二等？……二等なんて無いよ…帰れよ……」		PRINTFORML 「……二等？……二等なんて無いよ…帰れよ……」
PRINTFORML 「ｸﾞｩｸﾞｩ……キャッハハ……ｽﾔｽﾔ」		PRINTFORML 「ｸﾞｩｸﾞｩ……キャッハハ……ｽﾔｽﾔ」
PRINTFORML （あ～…頭がぼーっとするぅ…❤）		PRINTFORML （あ～…頭がぼーっとするぅ…❤）
PRINTFORML （ﾁﾗｯ）「…ちょっとくらい撫でてもいいか…❤」		PRINTFORML （ﾁﾗｯ）「…ちょっとくらい撫でてもいいか…❤」
PRINTFORML 「ふわっふわして、調子出ない…」		PRINTFORML 「ふわっふわして、調子出ない…」
PRINTFORML （調子出ないのはこれのせいかも…ね❤）		PRINTFORML （調子出ないのはこれのせいかも…ね❤）
PRINTFORMDL %CALLNAME:TARGET%は大きく膨れた自分の腹を見た…	!#!PRINTFORMDL %CALLNAME:TARGET%は大きく膨れた自分の腹を見た…
PRINTFORML 「ちんぽがこんなに近くにあるのに…恨めしい…」		PRINTFORML 「ちんぽがこんなに近くにあるのに…恨めしい…」
PRINTFORML （ﾊｯ）「いけないいけない、流されたらダメだっ❤」		PRINTFORML （ﾊｯ）「いけないいけない、流されたらダメだっ❤」
PRINTFORML 「こんなに股を濡らして何やってるんだろ、あたい…		PRINTFORML 「こんなに股を濡らして何やってるんだろ、あたい…
PRINTFORML 　考えたらなんだか急に情けなくなってきたよ…❤」		PRINTFORML 　考えたらなんだか急に情けなくなってきたよ…❤」
PRINTFORML （あぁ…非常事態とはいえ、あたい今裸で出歩いてるんだ…❤）		PRINTFORML （あぁ…非常事態とはいえ、あたい今裸で出歩いてるんだ…❤）
PRINTFORML 「服が有るのはせめてもの救い…かな」		PRINTFORML 「服が有るのはせめてもの救い…かな」
PRINTFORML （ｷｭｩﾝｯ❤）「おうぅっ…❤　きゅ、急に疼くなよぉ❤」		PRINTFORML （ｷｭｩﾝｯ❤）「おうぅっ…❤　きゅ、急に疼くなよぉ❤」
PRINTFORML 「定着したのが分かるのも考え物だよなぁ…」		PRINTFORML 「定着したのが分かるのも考え物だよなぁ…」
PRINTFORML 「まだ馴染んではいないかな？早く処置しないと…」		PRINTFORML 「まだ馴染んではいないかな？早く処置しないと…」
PRINTFORML （…ﾂﾝｯ）「ひぃ❤…うぅ、止めときゃよかった…」		PRINTFORML （…ﾂﾝｯ）「ひぃ❤…うぅ、止めときゃよかった…」
PRINTFORML 「裸でちんこ付き…変態だぁ…ご主人様に申し訳立たないよ…」		PRINTFORML 「裸でちんこ付き…変態だぁ…ご主人様に申し訳立たないよ…」
PRINTFORML 「う～ん、ちんこを隠せてるのかこれは…」		PRINTFORML 「う～ん、ちんこを隠せてるのかこれは…」
PRINTFORML （ﾌﾘﾌﾘ）「でもちょっと面白いかも…いややっぱ邪魔か…」		PRINTFORML （ﾌﾘﾌﾘ）「でもちょっと面白いかも…いややっぱ邪魔か…」
PRINTFORML 「服の上からは…大丈夫かな？」		PRINTFORML 「服の上からは…大丈夫かな？」
PRINTFORML 「完全に根付いてるなぁ…どうしてこんな事になったかな…」		PRINTFORML 「完全に根付いてるなぁ…どうしてこんな事になったかな…」
PRINTFORML 「ん～、まだ何とかなる…か？」		PRINTFORML 「ん～、まだ何とかなる…か？」
PRINTFORML 「疲れちゃった…眠いよう…」		PRINTFORML 「疲れちゃった…眠いよう…」
PRINTFORML 　　　　　　　　　　　　　　　　　　　　　　　　　　　　性欲を持て余す……		PRINTFORML 　　　　　　　　　　　　　　　　　　　　　　　　　　　　性欲を持て余す……
PRINTFORML 「あうぅ、眠くて幻聴が聞こえるよー…」		PRINTFORML 「あうぅ、眠くて幻聴が聞こえるよー…」
PRINTFORML （……………………）		PRINTFORML （……………………）
PRINTFORML %CALLNAME:TARGET%は眠気で思考が止まっている…		PRINTFORML %CALLNAME:TARGET%は眠気で思考が止まっている…
PRINTFORML 「もう、とっとと寝たいよう…」		PRINTFORML 「もう、とっとと寝たいよう…」
PRINTFORML 「…あ、裸なの忘れてた…ちゃんと安全確保してからだね」		PRINTFORML 「…あ、裸なの忘れてた…ちゃんと安全確保してからだね」
PRINTFORML 「ぬうぅ…お腹が重たぁいっ…」		PRINTFORML 「ぬうぅ…お腹が重たぁいっ…」
PRINTFORML 「…あたい妖精なのに、なんで妊娠するの？おかしくない？」		PRINTFORML 「…あたい妖精なのに、なんで妊娠するの？おかしくない？」
PRINTFORML （胸も…お股も…おっきなお腹も丸見え…恥ずかしいよ…）		PRINTFORML （胸も…お股も…おっきなお腹も丸見え…恥ずかしいよ…）
PRINTFORML 「お腹…隠しきれてないよね～…」		PRINTFORML 「お腹…隠しきれてないよね～…」
PRINTFORML 「裸でも寒くないのはいいけどね～…」		PRINTFORML 「裸でも寒くないのはいいけどね～…」
PRINTFORML 「…あ、そうだ裸なんだった。しょっちゅう裸にされるから忘れてたよ」		PRINTFORML 「…あ、そうだ裸なんだった。しょっちゅう裸にされるから忘れてたよ」
PRINTFORML （どっかから覗き見られてる気がする…）		PRINTFORML （どっかから覗き見られてる気がする…）
PRINTFORML 「どうせ服着ても破かれるしさ～…いっそこのままで良いんじゃない？」		PRINTFORML 「どうせ服着ても破かれるしさ～…いっそこのままで良いんじゃない？」
PRINTFORML 「どうせ新しい服着ても破かれるんだろうな…		PRINTFORML 「どうせ新しい服着ても破かれるんだろうな…
PRINTFORML 　だからと言って着ないままってのもどうかと……う～ん」		PRINTFORML 　だからと言って着ないままってのもどうかと……う～ん」
PRINTFORML 「あんまり裸で出歩いてたら妖精全体の品位に関わりそうな…」		PRINTFORML 「あんまり裸で出歩いてたら妖精全体の品位に関わりそうな…」
PRINTFORML 「いくら穢れが好みといっても、限度ってもんが…ﾌﾞﾂﾌﾞﾂ…」		PRINTFORML 「いくら穢れが好みといっても、限度ってもんが…ﾌﾞﾂﾌﾞﾂ…」
PRINTFORML 「うわ、天井からなんか垂れてきた…気持悪っ」		PRINTFORML 「うわ、天井からなんか垂れてきた…気持悪っ」
PRINTFORML 「ん～と、異常あり！ていうかどこもかしこも異常！調査終了！…はダメか」		PRINTFORML 「ん～と、異常あり！ていうかどこもかしこも異常！調査終了！…はダメか」
PRINTFORML 「月とは正反対な穢れっぷりだね、ここは。穢す必要も無いね」		PRINTFORML 「月とは正反対な穢れっぷりだね、ここは。穢す必要も無いね」
PRINTFORML 「ぶっちゃけ、ここ地獄より居心地悪い…」		PRINTFORML 「ぶっちゃけ、ここ地獄より居心地悪い…」
PRINTFORMDL 月での騒動が終息した後、クラウンピースは博麗神社の地下に居を構えていた。	!#!PRINTFORMDL 月での騒動が終息した後、クラウンピースは博麗神社の地下に居を構えていた。
PRINTFORMDW その住処に訪れたヘカーティアは、クラウンピースが出迎えるなり指令を告げた。	!#!PRINTFORMDW その住処に訪れたヘカーティアは、クラウンピースが出迎えるなり指令を告げた。
PRINTFORMDL 「幻想郷内に、新たな異界が現れたわ。怪しい洞穴を見つけて、中を調査しなさい。」	!#!PRINTFORMDL 「幻想郷内に、新たな異界が現れたわ。怪しい洞穴を見つけて、中を調査しなさい。」
PRINTFORMDW それはクラウンピースが幻想郷に移住してから、初めての指令だった。	!#!PRINTFORMDW それはクラウンピースが幻想郷に移住してから、初めての指令だった。
PRINTFORML 「いきなり来たかと思えば、かなり唐突ですね…ご主人様」		PRINTFORML 「いきなり来たかと思えば、かなり唐突ですね…ご主人様」
PRINTFORMDL 「それだけ緊急性があるということよ。それに、あなたが調査に最適なの」	!#!PRINTFORMDL 「それだけ緊急性があるということよ。それに、あなたが調査に最適なの」
PRINTFORM 「と言いますと？」	!#!PRINTFORM 「と言いますと？」
PRINTFORMDW 「異界から『穢れ』の匂いがするのよ。しかも相当濃いわね」	!#!PRINTFORMDW 「異界から『穢れ』の匂いがするのよ。しかも相当濃いわね」
PRINTFORML 「なるほど、確かにあたいが適任でしょうね。じゃあまぁ、ちゃっちゃと行ってきますよ」		PRINTFORML 「なるほど、確かにあたいが適任でしょうね。じゃあまぁ、ちゃっちゃと行ってきますよ」
PRINTFORMDW	!#!PRINTFORMDW
PRINTFORMDW 早速任務に就こうとするクラウンピースだったが、ヘカーティアに止められた。	!#!PRINTFORMDW 早速任務に就こうとするクラウンピースだったが、ヘカーティアに止められた。
PRINTFORMDL 「お待ちなさい。その松明は置いていったほうが良いわ」	!#!PRINTFORMDL 「お待ちなさい。その松明は置いていったほうが良いわ」
PRINTFORMW 「えー、何でですか？相手を狂わせられて便利なのに～…」	!#!PRINTFORMW 「えー、何でですか？相手を狂わせられて便利なのに～…」
PRINTFORMDL 「直感だけど、おそらく今回の敵には通じない。むしろ逆利用されてもおかしくないわ。	!#!PRINTFORMDL 「直感だけど、おそらく今回の敵には通じない。むしろ逆利用されてもおかしくないわ。
PRINTFORMDW 　今度の異界は、見たことも無い変な奴らが跋扈しているイレギュラーな世界のはずよ」	!#!PRINTFORMDW 　今度の異界は、見たことも無い変な奴らが跋扈しているイレギュラーな世界のはずよ」
PRINTFORML 「うへ～っ、ご主人様がそんなに言うなんて。もう嫌な予感しかしないんですけど…		PRINTFORML 「うへ～っ、ご主人様がそんなに言うなんて。もう嫌な予感しかしないんですけど…
PRINTFORMW 　まあご主人様直々の指令だし、あたいは頑張りますよ。それでは改めて…行ってきま～す」	!#!PRINTFORMW 　まあご主人様直々の指令だし、あたいは頑張りますよ。それでは改めて…行ってきま～す」
PRINTFORMDW ヘカーティアは、指示された洞穴へと急ぐクラウンピースの背中を見届けた。	!#!PRINTFORMDW ヘカーティアは、指示された洞穴へと急ぐクラウンピースの背中を見届けた。
PRINTFORMDL 「期待しているわ、クラウンピース…」	!#!PRINTFORMDL 「期待しているわ、クラウンピース…」
PRINTFORMDW その言葉とは裏腹に、ヘカーティアの姿はどこか不安そうだった。	!#!PRINTFORMDW その言葉とは裏腹に、ヘカーティアの姿はどこか不安そうだった。
