//口上:

PRINTFORMDL そう判断した%CALLNAME:1%は苦渋の決断でヘカーティアをおいていくことにした……	PRINTFORMDL そう判断した%CALLNAME:1%は苦渋の決断でヘカーティアをおいていくことにした……
PRINTFORML 「ここでの経験は地獄づくりには反映させないほうがいいわね。私の品位風格にかかわるわ……」	PRINTFORML 「ここでの経験は地獄づくりには反映させないほうがいいわね。私の品位風格にかかわるわ……」
PRINTFORML 「幻想郷を愛する者達の熱き思いが宿ったこの手刀。ただの一撃で済むとは思わないことね！」	PRINTFORML 「幻想郷を愛する者達の熱き思いが宿ったこの手刀。ただの一撃で済むとは思わないことね！」
PRINTFORML 「……コア本体がどうなるかは知らないけど、少なくとも『私』はここで終わりかもね……」	PRINTFORML 「……コア本体がどうなるかは知らないけど、少なくとも『私』はここで終わりかもね……」
PRINTFORML 「……あなたにはもう何も我慢しない。全ての旋律を全力でたたき込む。今、そう決めた」	PRINTFORML 「……あなたにはもう何も我慢しない。全ての旋律を全力でたたき込む。今、そう決めた」
PRINTFORML 「聖水も無効。こんな連中と私の間で、戦闘そのものが発生する時点で異常なことよ……」	PRINTFORML 「聖水も無効。こんな連中と私の間で、戦闘そのものが発生する時点で異常なことよ……」
PRINTFORMDL 触手生物の繁殖に使われてしまいそうなヘカーティアをこのまま放置することはできない	PRINTFORMDL 触手生物の繁殖に使われてしまいそうなヘカーティアをこのまま放置することはできない
PRINTFORML 「こんな長時間能力封印されたんじゃ、元に戻った時も反動でヒドイことになりそう……」	PRINTFORML 「こんな長時間能力封印されたんじゃ、元に戻った時も反動でヒドイことになりそう……」
PRINTFORML 「星をも殺すスターバスターがあれば……。メガスマッシュだって悪い武装ではないし」	PRINTFORML 「星をも殺すスターバスターがあれば……。メガスマッシュだって悪い武装ではないし」
PRINTFORML 「くうっ、エリアごと吹き飛ばそうとしたのにこの程度にしかならないなんて！」	PRINTFORML 「くうっ、エリアごと吹き飛ばそうとしたのにこの程度にしかならないなんて！」
PRINTFORML 「私は負けられないのよ。私が最強だって信じてくれている子のためにもねっ！」	PRINTFORML 「私は負けられないのよ。私が最強だって信じてくれている子のためにもねっ！」
PRINTFORML 「『想像した地獄は現実よりもマシだった！』……いいキャッチコピーね。はぁ」	PRINTFORML 「『想像した地獄は現実よりもマシだった！』……いいキャッチコピーね。はぁ」
PRINTFORML 「あらゆる世界を駆け巡る女神の機動力。簡単に捉えられると思わないことね」	PRINTFORML 「あらゆる世界を駆け巡る女神の機動力。簡単に捉えられると思わないことね」
PRINTFORML 「あなたの落とした弾薬はこの金の弾薬？それともこちらの銀の方かしら？」	PRINTFORML 「あなたの落とした弾薬はこの金の弾薬？それともこちらの銀の方かしら？」
PRINTFORML 「……期待を裏切るようで悪いけど、女神としての力は封印されてるわよ？」	PRINTFORML 「……期待を裏切るようで悪いけど、女神としての力は封印されてるわよ？」
PRINTFORMDL 完全に燃え尽きて力尽きたヘカーティアを守りながら探索は出来そうにない	PRINTFORMDL 完全に燃え尽きて力尽きたヘカーティアを守りながら探索は出来そうにない
PRINTFORML 「こんなに触手が活性化した異界は私も初めてよ。ちょっとヤバいわね……」	PRINTFORML 「こんなに触手が活性化した異界は私も初めてよ。ちょっとヤバいわね……」
PRINTFORML 原作通りのままでは強すぎるため、異常なほどの弱体化を受けている設定。	PRINTFORML 原作通りのままでは強すぎるため、異常なほどの弱体化を受けている設定。
PRINTFORML 「右からはサイクロプスボール、左からはギガンテスボールでいくわよ！」	PRINTFORML 「右からはサイクロプスボール、左からはギガンテスボールでいくわよ！」
PRINTFORML 「羞恥責め？……平和を守る女神の戦いにそんなものが関係あるとでも？」	PRINTFORML 「羞恥責め？……平和を守る女神の戦いにそんなものが関係あるとでも？」
PRINTFORML 「女神の力だけでなく衣装まで奪われたら……私に何が残るというのよー」	PRINTFORML 「女神の力だけでなく衣装まで奪われたら……私に何が残るというのよー」
PRINTFORML 「こうなったら、蹴るしかないでしょ。ヘルダイバーシュートォォォ！」	PRINTFORML 「こうなったら、蹴るしかないでしょ。ヘルダイバーシュートォォォ！」
PRINTFORML 「絶対に絶対に絶対に絶対に絶対に絶対に絶対にぜーったいに許さない」	PRINTFORML 「絶対に絶対に絶対に絶対に絶対に絶対に絶対にぜーったいに許さない」
PRINTFORML 「今の私ひとりだとちょっとキツイと思っていたところだったのよー！」	PRINTFORML 「今の私ひとりだとちょっとキツイと思っていたところだったのよー！」
PRINTFORML 「ここは……？んー、淫魔界とか色魔界とかに近い感覚がするわね……」	PRINTFORML 「ここは……？んー、淫魔界とか色魔界とかに近い感覚がするわね……」
PRINTFORML (このままじゃ戦闘も罠への対応もできないけど……♥ どうしよう♥)	PRINTFORML (このままじゃ戦闘も罠への対応もできないけど……♥ どうしよう♥)
PRINTFORML 「Ich bin Hecatia！　Welcome♥Hell！」	PRINTFORML 「Ich bin Hecatia！　Welcome♥Hell！」
PRINTFORML 「ふぅ……あっ！入浴中にシャツが盗まれてたらどうしましょう！？」	PRINTFORML 「ふぅ……あっ！入浴中にシャツが盗まれてたらどうしましょう！？」
PRINTFORML 「青ダヌキの法則ってやつかしら。あの失礼な緑の子が言ってた気が」	PRINTFORML 「青ダヌキの法則ってやつかしら。あの失礼な緑の子が言ってた気が」
PRINTFORML 「見切っているのに、体の反応がまるでついてこないなんて……！」	PRINTFORML 「見切っているのに、体の反応がまるでついてこないなんて……！」
PRINTFORMDL ヘカーティアは言葉にならない声をあげ全身を痙攣させている……	PRINTFORMDL ヘカーティアは言葉にならない声をあげ全身を痙攣させている……
PRINTFORML 「……ごめんなさい。私が一人で引き受るべき標的が見つかったの」	PRINTFORML 「……ごめんなさい。私が一人で引き受るべき標的が見つかったの」
PRINTFORML 「この球体も、理力の杖の原理でつくっておけばよかったわ……」	PRINTFORML 「この球体も、理力の杖の原理でつくっておけばよかったわ……」
PRINTFORML 「レーザーさえ出せれば貫けるけど……威力には期待できないわ」	PRINTFORML 「レーザーさえ出せれば貫けるけど……威力には期待できないわ」
PRINTFORML 「たとえいかなる暴力だとて……払って見せましょ、この愛で！」	PRINTFORML 「たとえいかなる暴力だとて……払って見せましょ、この愛で！」
PRINTFORMDL ヘカーティアはだらしなく顔をゆるませ甘えるような声をあげた	PRINTFORMDL ヘカーティアはだらしなく顔をゆるませ甘えるような声をあげた
PRINTFORML (兎の違いだろうが、罠だろうが、女神アイで見抜いてみせる…)	PRINTFORML (兎の違いだろうが、罠だろうが、女神アイで見抜いてみせる…)
PRINTFORML 「おもしろいことなら歓迎するけど、これは明らかに違うわ……」	PRINTFORML 「おもしろいことなら歓迎するけど、これは明らかに違うわ……」
PRINTFORML 「地球『地獄に降る雨』使用不能。私の天気も涙雨かも。くすん」	PRINTFORML 「地球『地獄に降る雨』使用不能。私の天気も涙雨かも。くすん」
PRINTFORML 「カエルだのヘビだの……あの緑を思い出して闘志が沸くわー」	PRINTFORML 「カエルだのヘビだの……あの緑を思い出して闘志が沸くわー」
PRINTFORML 「！？多分、寄生されたわね……上手く消せるといいけど……」	PRINTFORML 「！？多分、寄生されたわね……上手く消せるといいけど……」
PRINTFORML 「！！寄生させたんでしょ？見逃すわけにはいかないわね……」	PRINTFORML 「！！寄生させたんでしょ？見逃すわけにはいかないわね……」
PRINTFORML 「女神には、生きとし生けるもの全ての生命を守る義務がある」	PRINTFORML 「女神には、生きとし生けるもの全ての生命を守る義務がある」
PRINTFORML 「ごめんごめん、お待たせしたわね。さっきの質問に答えるわ」	PRINTFORML 「ごめんごめん、お待たせしたわね。さっきの質問に答えるわ」
PRINTFORMDL %CALLNAME:1%はヘカーティアの綺麗な手を取った	PRINTFORMDL %CALLNAME:1%はヘカーティアの綺麗な手を取った
PRINTFORML 「女神アイは周辺にある秘宝の数がわかるのよん。……０！？」	PRINTFORML 「女神アイは周辺にある秘宝の数がわかるのよん。……０！？」
PRINTFORML 「あっ……お返しちゃんとするから、動かないで待っててね」	PRINTFORML 「あっ……お返しちゃんとするから、動かないで待っててね」
PRINTFORML 「説明はしなくてもいいわよん。やるべきことはわかるから」	PRINTFORML 「説明はしなくてもいいわよん。やるべきことはわかるから」
PRINTFORML 「過ぎてく時間は怖くないけれど……輝きを失う事が嫌なの」	PRINTFORML 「過ぎてく時間は怖くないけれど……輝きを失う事が嫌なの」
PRINTFORML 「物理法則までは変えられないでしょう？　……レーザー」	PRINTFORML 「物理法則までは変えられないでしょう？　……レーザー」
PRINTFORML 「外から見えない弱点も、中に切り込めば見えてくるもの」	PRINTFORML 「外から見えない弱点も、中に切り込めば見えてくるもの」
PRINTFORML 「おもしろくないものに、いちいちつきあってられないわ」	PRINTFORML 「おもしろくないものに、いちいちつきあってられないわ」
PRINTFORML 「Ｔシャツをこのサイズにしておいて正解だったでしょ？」	PRINTFORML 「Ｔシャツをこのサイズにしておいて正解だったでしょ？」
PRINTFORMDL ヘカーティアは幸せそうにお風呂の想い出をうたっている	PRINTFORMDL ヘカーティアは幸せそうにお風呂の想い出をうたっている
PRINTFORML 「穢れだらけじゃないの。月の民が卒倒しそうな環境ね。」	PRINTFORML 「穢れだらけじゃないの。月の民が卒倒しそうな環境ね。」
PRINTFORML （３つの体全部発情させられてるでしょ、これぇ……♥）	PRINTFORML （３つの体全部発情させられてるでしょ、これぇ……♥）
PRINTFORML 「弾幕を封じたつもりだろうけど、蹴球殺法ならどう？」	PRINTFORML 「弾幕を封じたつもりだろうけど、蹴球殺法ならどう？」
PRINTFORML 「溜めてもほとんど威力があがらないみたいけど……！」	PRINTFORML 「溜めてもほとんど威力があがらないみたいけど……！」
PRINTFORML 「女神たるもの、魔力だけではなく体術もマックスよー」	PRINTFORML 「女神たるもの、魔力だけではなく体術もマックスよー」
PRINTFORML 「舞台づくりに楽器運び、足腰だって鍛えてる。大丈夫」	PRINTFORML 「舞台づくりに楽器運び、足腰だって鍛えてる。大丈夫」
PRINTFORML 「きちゃうっ♥ きもちいいのがっ♥♥ あひぃ♥♥♥」	PRINTFORML 「きちゃうっ♥ きもちいいのがっ♥♥ あひぃ♥♥♥」
PRINTFORML 「むりっ♥ これ無理ぃ♥♥ もう無理だからぁ♥♥♥」	PRINTFORML 「むりっ♥ これ無理ぃ♥♥ もう無理だからぁ♥♥♥」
PRINTFORML 「この怒りはあの緑の巫女に暴言を吐かれたときの分よ」	PRINTFORML 「この怒りはあの緑の巫女に暴言を吐かれたときの分よ」
PRINTFORML 「無駄な時間を。女神と言えど、時間は平等ってところ」	PRINTFORML 「無駄な時間を。女神と言えど、時間は平等ってところ」
PRINTFORML 「勿体ないって同感、どうかーん。気が合うわね、私達」	PRINTFORML 「勿体ないって同感、どうかーん。気が合うわね、私達」
PRINTFORML 「一番左の通路を　上に向かって真っすぐ進むわよー！」	PRINTFORML 「一番左の通路を　上に向かって真っすぐ進むわよー！」
PRINTFORMDL ヘカーティアはふらつく足取りで必死に逃げ出した……	PRINTFORMDL ヘカーティアはふらつく足取りで必死に逃げ出した……
PRINTFORML 「免疫力まで落ちてるみたいね。……げほっげほっ…」	PRINTFORML 「免疫力まで落ちてるみたいね。……げほっげほっ…」
PRINTFORML 「いっちゃう♥ イっちゃう♥♥ イッちゃう♥♥♥」	PRINTFORML 「いっちゃう♥ イっちゃう♥♥ イッちゃう♥♥♥」
PRINTFORML 「かんじてるっ♥ かんじちゃう♥♥ あーッ♥♥♥」	PRINTFORML 「かんじてるっ♥ かんじちゃう♥♥ あーッ♥♥♥」
PRINTFORML 「私は地上の女神でもある。愛と自由と平和のために」	PRINTFORML 「私は地上の女神でもある。愛と自由と平和のために」
PRINTFORML 「女神と言えども万能ではない……か。ごめんなさい」	PRINTFORML 「女神と言えども万能ではない……か。ごめんなさい」
PRINTFORML 「気に入ってる子たちを助けるのに理由はいらないわ」	PRINTFORML 「気に入ってる子たちを助けるのに理由はいらないわ」
PRINTFORMDL ヘカーティアは濁った瞳でふらふらと立ち上がった…	PRINTFORMDL ヘカーティアは濁った瞳でふらふらと立ち上がった…
PRINTFORML 「○すべて→×すべて　……強制的に上書きのようね」	PRINTFORML 「○すべて→×すべて　……強制的に上書きのようね」
﻿PRINTFORML リターン０で汎用口上と共存できる仕様を確認する。	PRINTFORML リターン０で汎用口上と共存できる仕様を確認する。
PRINTFORMDL だが、ヘカーティアの通常弾幕は封印されている！	PRINTFORMDL だが、ヘカーティアの通常弾幕は封印されている！
PRINTFORML 「伊達にジャラジャラ身に着けてるわけじゃないわ」	PRINTFORML 「伊達にジャラジャラ身に着けてるわけじゃないわ」
PRINTFORML 「この技はやたらと時間がかかるのが欠点よね……」	PRINTFORML 「この技はやたらと時間がかかるのが欠点よね……」
PRINTFORML 「女神の手刀から逃れる術はないわ！受けなさい！」	PRINTFORML 「女神の手刀から逃れる術はないわ！受けなさい！」
PRINTFORML 「……ゴテゴテ系のほうが耐久性があったかしら？」	PRINTFORML 「……ゴテゴテ系のほうが耐久性があったかしら？」
PRINTFORML 「む、無駄。そんなことをしても私は折れない……」	PRINTFORML 「む、無駄。そんなことをしても私は折れない……」
PRINTFORML 「いくらなんでも私の能力封印されすぎでしょ……」	PRINTFORML 「いくらなんでも私の能力封印されすぎでしょ……」
PRINTFORML 「私の力って悪用されたらまずい系統だと思うわ…」	PRINTFORML 「私の力って悪用されたらまずい系統だと思うわ…」
PRINTFORML 「どの力なら使えるのか、確かめながら進まないと」	PRINTFORML 「どの力なら使えるのか、確かめながら進まないと」
PRINTFORML 「ぶんぶん振り回していいのね。腕が鳴るわー！」	PRINTFORML 「ぶんぶん振り回していいのね。腕が鳴るわー！」
PRINTFORML 「弾幕には頼れない以上、体術で貫かないと……」	PRINTFORML 「弾幕には頼れない以上、体術で貫かないと……」
PRINTFORML 「こういう状況の練習なんてしたことないけど！」	PRINTFORML 「こういう状況の練習なんてしたことないけど！」
PRINTFORML 「ダメっ♥ これダメっ♥♥ ダメなのぉ♥♥♥」	PRINTFORML 「ダメっ♥ これダメっ♥♥ ダメなのぉ♥♥♥」
PRINTFORML 「ズルイっ♥ これズルイっ♥♥ あーっ♥♥♥」	PRINTFORML 「ズルイっ♥ これズルイっ♥♥ あーっ♥♥♥」
PRINTFORML 「まっ♥ まってぇ♥♥ これダメなのぉ♥♥♥」	PRINTFORML 「まっ♥ まってぇ♥♥ これダメなのぉ♥♥♥」
PRINTFORML 「やめっ♥ やめてぇ♥♥ イっちゃうぅ♥♥♥」	PRINTFORML 「やめっ♥ やめてぇ♥♥ イっちゃうぅ♥♥♥」
PRINTFORML 「一匹駆除するのにここまで手こずるとはね……」	PRINTFORML 「一匹駆除するのにここまで手こずるとはね……」
PRINTFORML 「カラーチェンジすら許されないというの……？」	PRINTFORML 「カラーチェンジすら許されないというの……？」
PRINTFORML 「そんなにこの衣装が気に入らないというの！？」	PRINTFORML 「そんなにこの衣装が気に入らないというの！？」
PRINTFORML 「愛の力はなにものにも負けることはないわよん」	PRINTFORML 「愛の力はなにものにも負けることはないわよん」
PRINTFORML 「私は、本体が無事ならどうにでもなるから……」	PRINTFORML 「私は、本体が無事ならどうにでもなるから……」
PRINTFORML 「女神の力を封印されて困っているところなのよ」	PRINTFORML 「女神の力を封印されて困っているところなのよ」
PRINTFORML 「危険だけど、一度別れるしかないみたいね……」	PRINTFORML 「危険だけど、一度別れるしかないみたいね……」
PRINTFORML 「……大人しく入浴してもらえたことがないわ！」	PRINTFORML 「……大人しく入浴してもらえたことがないわ！」
PRINTFORML 「女神だって服装をなじられれば傷つくわよ……」	PRINTFORML 「女神だって服装をなじられれば傷つくわよ……」
PRINTFORML 「異界『地獄のノンイデアル弾幕』使用不能……」	PRINTFORML 「異界『地獄のノンイデアル弾幕』使用不能……」
PRINTFORML 「どんな技も武器も使いこなしてみせるわよん」	PRINTFORML 「どんな技も武器も使いこなしてみせるわよん」
PRINTFORML 「女神たるもの、力も速度もマックスなのよー」	PRINTFORML 「女神たるもの、力も速度もマックスなのよー」
PRINTFORML 「女神の名において、こやつを島流しにするわ」	PRINTFORML 「女神の名において、こやつを島流しにするわ」
PRINTFORML 「この場所に響く旋律、私は好きじゃないから」	PRINTFORML 「この場所に響く旋律、私は好きじゃないから」
PRINTFORML 「くるっ♥ なにかくるっ♥♥ あーッ♥♥♥」	PRINTFORML 「くるっ♥ なにかくるっ♥♥ あーッ♥♥♥」
PRINTFORML 「こんなっ♥ こんなのぉ♥♥ むりぃ♥♥♥」	PRINTFORML 「こんなっ♥ こんなのぉ♥♥ むりぃ♥♥♥」
PRINTFORML 「こんなっ♥ されたらぁ♥♥ むりぃ♥♥♥」	PRINTFORML 「こんなっ♥ されたらぁ♥♥ むりぃ♥♥♥」
PRINTFORML 「おーけー、おーけー。とりあえずは合格よね」	PRINTFORML 「おーけー、おーけー。とりあえずは合格よね」
PRINTFORML 「この異界は私がつくったわけじゃないわよん」	PRINTFORML 「この異界は私がつくったわけじゃないわよん」
PRINTFORML 「このあたりは随分揺れるわね。急ぎましょう」	PRINTFORML 「このあたりは随分揺れるわね。急ぎましょう」
PRINTFORML 「荒ぶる鎖よ、良い子だから鎮まりなさい……」	PRINTFORML 「荒ぶる鎖よ、良い子だから鎮まりなさい……」
PRINTFORMDL ヘカーティアは幸せそうに湯船に浸かっている	PRINTFORMDL ヘカーティアは幸せそうに湯船に浸かっている
PRINTFORML 「月『ルナティックインパクト』使用不能……」	PRINTFORML 「月『ルナティックインパクト』使用不能……」
PRINTFORML 「『トリニタリアンラプソディ』使用不能……」	PRINTFORML 「『トリニタリアンラプソディ』使用不能……」
PRINTFORML 「もぅ……クラピーったら……いたずら……」	PRINTFORML 「もぅ……クラピーったら……いたずら……」
PRINTFORML 「女神の力を奪われた私は石の狸同然ね……」	PRINTFORML 「女神の力を奪われた私は石の狸同然ね……」
PRINTFORML 「これっ♥ これダメっ♥♥ ダメぇ♥♥♥」	PRINTFORML 「これっ♥ これダメっ♥♥ ダメぇ♥♥♥」
PRINTFORML 「！？もしかして今のって……悪い冗談だわ」	PRINTFORML 「！？もしかして今のって……悪い冗談だわ」
PRINTFORML 「私の友人に楯突いた連中は断罪するわよー」	PRINTFORML 「私の友人に楯突いた連中は断罪するわよー」
PRINTFORML 「はぁぁ…地獄と温泉の相性はいいのよねー」	PRINTFORML 「はぁぁ…地獄と温泉の相性はいいのよねー」
PRINTFORML 「クラピーとおふろ～に、はい～ったら～♪」	PRINTFORML 「クラピーとおふろ～に、はい～ったら～♪」
PRINTFORML 「女神の心臓は……まだ動いているのよ……」	PRINTFORML 「女神の心臓は……まだ動いているのよ……」
PRINTFORML 「鎖の音がうるさいからしかたないわね……」	PRINTFORML 「鎖の音がうるさいからしかたないわね……」
PRINTFORML 「……ちょっと、Ｔシャツがほつれたみたい」	PRINTFORML 「……ちょっと、Ｔシャツがほつれたみたい」
PRINTFORML 「……すぅ～……すりぷる……すぅ～……」	PRINTFORML 「……すぅ～……すりぷる……すぅ～……」
PRINTFORML （女神だって……♥女なんだからぁ……♥）	PRINTFORML （女神だって……♥女なんだからぁ……♥）
PRINTFORML 「こんっのぉぉぉぉ！どうして重いのよ！」	PRINTFORML 「こんっのぉぉぉぉ！どうして重いのよ！」
PRINTFORML 「全てを貫く女神の手刀。通称マサムネ！」	PRINTFORML 「全てを貫く女神の手刀。通称マサムネ！」
PRINTFORML 「目的のためなら手段は選ばない方なのよ」	PRINTFORML 「目的のためなら手段は選ばない方なのよ」
PRINTFORML 「ごめんなさい、もう…ここからだして…」	PRINTFORML 「ごめんなさい、もう…ここからだして…」
PRINTFORML 「こんな音、聞きたくない。私が止めるわ」	PRINTFORML 「こんな音、聞きたくない。私が止めるわ」
PRINTFORML 「道は常に自分の力で切り開いていくもの」	PRINTFORML 「道は常に自分の力で切り開いていくもの」
PRINTFORML 「駄目ぇ！純狐とだってこんなこと……！」	PRINTFORML 「駄目ぇ！純狐とだってこんなこと……！」
PRINTFORML 「女神だからって、服は普通なのよー！？」	PRINTFORML 「女神だからって、服は普通なのよー！？」
PRINTFORML 「おっ♥ 犯されてぇ♥♥ やめぇ♥♥♥」	PRINTFORML 「おっ♥ 犯されてぇ♥♥ やめぇ♥♥♥」
PRINTFORML 「っ…こういうのは嫌いなの。わかった？」	PRINTFORML 「っ…こういうのは嫌いなの。わかった？」
PRINTFORML 「あぁっ！？でも、まだ終わるわけには！」	PRINTFORML 「あぁっ！？でも、まだ終わるわけには！」
PRINTFORML 「こんなやつらと真剣勝負だなんてね……」	PRINTFORML 「こんなやつらと真剣勝負だなんてね……」
PRINTFORMDL 誰かの弱々しい息遣いが聞えた気がした。	PRINTFORMDL 誰かの弱々しい息遣いが聞えた気がした。
PRINTFORML  (少しでも力を温存して進むわよん……)	PRINTFORML  (少しでも力を温存して進むわよん……)
PRINTFORML 「妖精へのお土産になりそうなものは……」	PRINTFORML 「妖精へのお土産になりそうなものは……」
PRINTFORML 「……またまたＴシャツがほつれたみたい」	PRINTFORML 「……またまたＴシャツがほつれたみたい」
PRINTFORML 「地獄よりキツイってのはどうかと思うわ」	PRINTFORML 「地獄よりキツイってのはどうかと思うわ」
PRINTFORML （しゅうちゅうして……平常心を……♥）	PRINTFORML （しゅうちゅうして……平常心を……♥）
PRINTFORML 「鉄球ファイトでいくしかないわね……」	PRINTFORML 「鉄球ファイトでいくしかないわね……」
PRINTFORML 「今の私の弾幕よりは当てになるはずよ」	PRINTFORML 「今の私の弾幕よりは当てになるはずよ」
PRINTFORML 「今の私って妖精以下の戦力なのかしら」	PRINTFORML 「今の私って妖精以下の戦力なのかしら」
PRINTFORML 「これ重いんだからじっとしててね……」	PRINTFORML 「これ重いんだからじっとしててね……」
PRINTFORML 「手加減なしでの戦いは不慣れなのよね」	PRINTFORML 「手加減なしでの戦いは不慣れなのよね」
PRINTFORML 「違和感あるでしょ？この旋律を聴くと」	PRINTFORML 「違和感あるでしょ？この旋律を聴くと」
PRINTFORML 「それなら、こんな音色はどうかしら？」	PRINTFORML 「それなら、こんな音色はどうかしら？」
PRINTFORML 「身体能力強化の音色に身を委ねて……」	PRINTFORML 「身体能力強化の音色に身を委ねて……」
PRINTFORML 「く、苦し……免疫力まで落とされて…」	PRINTFORML 「く、苦し……免疫力まで落とされて…」
PRINTFORML 「あーっ♥ あーっ♥♥ あーっ♥♥♥」	PRINTFORML 「あーっ♥ あーっ♥♥ あーっ♥♥♥」
PRINTFORML 「威力はあってもかわすことはたやすい」	PRINTFORML 「威力はあってもかわすことはたやすい」
PRINTFORML 「地獄すら生ぬるいわ。魂まで消滅して」	PRINTFORML 「地獄すら生ぬるいわ。魂まで消滅して」
PRINTFORML 「えっ♥ まって♥ まだおっぱいが♥」	PRINTFORML 「えっ♥ まって♥ まだおっぱいが♥」
PRINTFORML 「特にウェルカムはしていないけど……」	PRINTFORML 「特にウェルカムはしていないけど……」
PRINTFORML 「勝利の女神がいるのだから、当然よー」	PRINTFORML 「勝利の女神がいるのだから、当然よー」
PRINTFORML 「あと１、２発、撃ち込んでおきましょ」	PRINTFORML 「あと１、２発、撃ち込んでおきましょ」
PRINTFORML (少しでも力を温存して進むわよん……)	PRINTFORML (少しでも力を温存して進むわよん……)
PRINTFORML 「純狐とおふろ～に、はい～ったら～♪」	PRINTFORML 「純狐とおふろ～に、はい～ったら～♪」
PRINTFORML 「まぁ……純狐ぉ……けいかくぅ……」	PRINTFORML 「まぁ……純狐ぉ……けいかくぅ……」
PRINTFORMDL ヘカーティアの呼吸が乱れている……	PRINTFORMDL ヘカーティアの呼吸が乱れている……
PRINTFORMDL ヘカーティアの鎖球による体術弾幕！	PRINTFORMDL ヘカーティアの鎖球による体術弾幕！
PRINTFORML 「こんな機会じゃないと使わなそうね」	PRINTFORML 「こんな機会じゃないと使わなそうね」
PRINTFORML 「こいつらには選択肢なんて与えない」	PRINTFORML 「こいつらには選択肢なんて与えない」
PRINTFORML （心が…すごくドキドキしてる……！）	PRINTFORML （心が…すごくドキドキしてる……！）
PRINTFORML 「……触っていいって言ってないのに」	PRINTFORML 「……触っていいって言ってないのに」
PRINTFORML 「あ、アソコに鎖がすれて……もぅ♥」	PRINTFORML 「あ、アソコに鎖がすれて……もぅ♥」
PRINTFORML 「土地づくりは得意よ？はい、浄化。」	PRINTFORML 「土地づくりは得意よ？はい、浄化。」
PRINTFORML 「誰も来なかったらどうしようかしら」	PRINTFORML 「誰も来なかったらどうしようかしら」
PRINTFORML 「お願いだから、それだけは許して！」	PRINTFORML 「お願いだから、それだけは許して！」
PRINTFORML 「私の力が期待外れだったせいね……」	PRINTFORML 「私の力が期待外れだったせいね……」
PRINTFORML 「……女神の力にも限界があるのよね」	PRINTFORML 「……女神の力にも限界があるのよね」
PRINTFORML 「力が吸われているのがわかるわ……」	PRINTFORML 「力が吸われているのがわかるわ……」
PRINTFORML 「……またＴシャツがほつれたみたい」	PRINTFORML 「……またＴシャツがほつれたみたい」
PRINTFORML 「女神さまが世界の修復に来たわよん」	PRINTFORML 「女神さまが世界の修復に来たわよん」
PRINTFORML 「こんな状況で戦えるわけが……♥」	PRINTFORML 「こんな状況で戦えるわけが……♥」
PRINTFORML 「現状で出せる速度の確認が必要ね」	PRINTFORML 「現状で出せる速度の確認が必要ね」
PRINTFORML 「正々堂々キックオフってやつね！」	PRINTFORML 「正々堂々キックオフってやつね！」
PRINTFORML 「綺麗な花火大会になるといいわね」	PRINTFORML 「綺麗な花火大会になるといいわね」
PRINTFORML 「ご主人様とおよび！……なーんて」	PRINTFORML 「ご主人様とおよび！……なーんて」
PRINTFORML 「純狐……クラ…ピー……ごめんね」	PRINTFORML 「純狐……クラ…ピー……ごめんね」
PRINTFORML 「あ、危ない……平常心、平常心…」	PRINTFORML 「あ、危ない……平常心、平常心…」
PRINTFORML 「はやく私たちを解放しなさい……」	PRINTFORML 「はやく私たちを解放しなさい……」
PRINTFORML 「勝ってくるから、ここで待ってて」	PRINTFORML 「勝ってくるから、ここで待ってて」
PRINTFORML 「地獄行きツアー、しゅっぱーつ♪」	PRINTFORML 「地獄行きツアー、しゅっぱーつ♪」
PRINTFORML 「浄化するわよん。ハイ！終わり！」	PRINTFORML 「浄化するわよん。ハイ！終わり！」
PRINTFORML 「綺麗な地獄に変えてあげるわよん」	PRINTFORML 「綺麗な地獄に変えてあげるわよん」
PRINTFORMW 「純狐……クラ…ピー……ごめんね」	PRINTFORMW 「純狐……クラ…ピー……ごめんね」
PRINTFORML 「地獄の女神は……幸運を招く……」	PRINTFORML 「地獄の女神は……幸運を招く……」
PRINTFORML 「好きな衣装の方向性の違いね……」	PRINTFORML 「好きな衣装の方向性の違いね……」
PRINTFORML 「甘い物、もっと落ちてないかしら」	PRINTFORML 「甘い物、もっと落ちてないかしら」
PRINTFORML 「地獄の壁を突破できるとでも？」	PRINTFORML 「地獄の壁を突破できるとでも？」
PRINTFORML 「この盾で属性攻撃は防げるはず」	PRINTFORML 「この盾で属性攻撃は防げるはず」
PRINTFORML 「地獄式ワールドシェイキング！」	PRINTFORML 「地獄式ワールドシェイキング！」
PRINTFORML 「たっぷりとご馳走してあげるわ」	PRINTFORML 「たっぷりとご馳走してあげるわ」
PRINTFORML 「くすんっ……あぁ、いやぁ……」	PRINTFORML 「くすんっ……あぁ、いやぁ……」
PRINTFORML 「成功するまで……繰り返すだけ」	PRINTFORML 「成功するまで……繰り返すだけ」
PRINTFORML 「体力の消耗も早いみたいね……」	PRINTFORML 「体力の消耗も早いみたいね……」
PRINTFORML 「もう……やり方がいやらしいよ」	PRINTFORML 「もう……やり方がいやらしいよ」
PRINTFORML 「遅かれ早かれこうなるのは……」	PRINTFORML 「遅かれ早かれこうなるのは……」
PRINTFORML 「最低の結末は避けたいけど……」	PRINTFORML 「最低の結末は避けたいけど……」
PRINTFORML 「これはただの憂さ晴らしの分よ」	PRINTFORML 「これはただの憂さ晴らしの分よ」
PRINTFORML 「……鎖と球体で隠せるとはいえ」	PRINTFORML 「……鎖と球体で隠せるとはいえ」
PRINTFORML 「んもう。待ちくたびれたわよん」	PRINTFORML 「んもう。待ちくたびれたわよん」
PRINTFORML 「痛ッ、こんなのいやぁぁぁっ！」	PRINTFORML 「痛ッ、こんなのいやぁぁぁっ！」
PRINTFORML 「う、うぅぅ……あ、ありがとう」	PRINTFORML 「う、うぅぅ……あ、ありがとう」
PRINTFORML (あっ♥ あっ♥ 歩くだけで♥)	PRINTFORML (あっ♥ あっ♥ 歩くだけで♥)
PRINTFORML 「異界『逢魔ガ刻』使用不能……」	PRINTFORML 「異界『逢魔ガ刻』使用不能……」
PRINTFORML 「地球『邪穢在身』使用不能……」	PRINTFORML 「地球『邪穢在身』使用不能……」
PRINTFORML 「鎖が絡まっちゃったわよん……」	PRINTFORML 「鎖が絡まっちゃったわよん……」
PRINTFORML 「……ばかに……するなぁ……」	PRINTFORML 「……ばかに……するなぁ……」
PRINTFORML （これじゃ集中できない……♥）	PRINTFORML （これじゃ集中できない……♥）
PRINTFORML 「命中の低下はまだ補えそうね」	PRINTFORML 「命中の低下はまだ補えそうね」
PRINTFORML 「魔力が奪われすぎている……」	PRINTFORML 「魔力が奪われすぎている……」
PRINTFORML 「自由の女神砲……ファイア！」	PRINTFORML 「自由の女神砲……ファイア！」
PRINTFORML 「動きにくいけど……やるしか」	PRINTFORML 「動きにくいけど……やるしか」
PRINTFORML 「嫌な鼓動ばかり聞こえる……」	PRINTFORML 「嫌な鼓動ばかり聞こえる……」
PRINTFORML 「勇気の調べよ、私に力を……」	PRINTFORML 「勇気の調べよ、私に力を……」
PRINTFORML 「練習は無駄にならない……！」	PRINTFORML 「練習は無駄にならない……！」
PRINTFORML 「さて、どんな曲を奏でようか」	PRINTFORML 「さて、どんな曲を奏でようか」
PRINTFORML 「そう。お説教が必要みたいね」	PRINTFORML 「そう。お説教が必要みたいね」
PRINTFORML 「あぁっ！？見切れなかった！」	PRINTFORML 「あぁっ！？見切れなかった！」
PRINTFORML 「ど、どうってことないわ……」	PRINTFORML 「ど、どうってことないわ……」
PRINTFORML 「ナカにだされたみたいね……」	PRINTFORML 「ナカにだされたみたいね……」
PRINTFORML 「力、抜けてく…ごめん、ね…」	PRINTFORML 「力、抜けてく…ごめん、ね…」
PRINTFORML 「ええええ？それほどまで……」	PRINTFORML 「ええええ？それほどまで……」
PRINTFORML 「ここからじゃ、無理だわ…！」	PRINTFORML 「ここからじゃ、無理だわ…！」
PRINTFORML 「やっぱりなにかと不便ね……」	PRINTFORML 「やっぱりなにかと不便ね……」
PRINTFORML 「お肉～を♪たべましょう～♪」	PRINTFORML 「お肉～を♪たべましょう～♪」
PRINTFORML 「睡眠のとれそうな場所は……」	PRINTFORML 「睡眠のとれそうな場所は……」
PRINTFORML 「も、もしかしてこのお腹……」	PRINTFORML 「も、もしかしてこのお腹……」
PRINTFORML 「おおきいって……すぅ……」	PRINTFORML 「おおきいって……すぅ……」
PRINTFORML 「こ、こんな状態じゃ……♥」	PRINTFORML 「こ、こんな状態じゃ……♥」
PRINTFORML （カラダ、火照ってる……♥）	PRINTFORML （カラダ、火照ってる……♥）
PRINTFORML 「何かあったはずだけど……」	PRINTFORML 「何かあったはずだけど……」
PRINTFORML 「避けきれなかったみたいね」	PRINTFORML 「避けきれなかったみたいね」
PRINTFORML 「奏者の体に触るのはご法度」	PRINTFORML 「奏者の体に触るのはご法度」
PRINTFORML 「ま、間に合わなかった……」	PRINTFORML 「ま、間に合わなかった……」
PRINTFORML （これ以上触られたら……♥）	PRINTFORML （これ以上触られたら……♥）
PRINTFORML 「そういう態度は身を滅ぼす」	PRINTFORML 「そういう態度は身を滅ぼす」
PRINTFORML 「変な格好になっちゃう……」	PRINTFORML 「変な格好になっちゃう……」
PRINTFORML 「女神の力が罪を断つわよん」	PRINTFORML 「女神の力が罪を断つわよん」
PRINTFORML 「何かおもしろいものは……」	PRINTFORML 「何かおもしろいものは……」
PRINTFORML 「良い素材を見つけたいわー」	PRINTFORML 「良い素材を見つけたいわー」
PRINTFORML 「ちょっと…こんなのって…」	PRINTFORML 「ちょっと…こんなのって…」
PRINTFORML 「い、今はだめよぉ……♥」	PRINTFORML 「い、今はだめよぉ……♥」
PRINTFORML （た、耐えないとぉ……！）	PRINTFORML （た、耐えないとぉ……！）
PRINTFORML （あ、喘ぐわけには……！）	PRINTFORML （あ、喘ぐわけには……！）
PRINTFORML 「きゃぁ！やってくれる！」	PRINTFORML 「きゃぁ！やってくれる！」
PRINTFORML 「うそっ！？捕まった！？」	PRINTFORML 「うそっ！？捕まった！？」
PRINTFORML 「こ、こんなやつらに……」	PRINTFORML 「こ、こんなやつらに……」
PRINTFORML 「絶対に許さないから……」	PRINTFORML 「絶対に許さないから……」
PRINTFORML 「女神の前では児戯も同然」	PRINTFORML 「女神の前では児戯も同然」
PRINTFORML 「ギリギリだったけど……」	PRINTFORML 「ギリギリだったけど……」
PRINTFORML 「ぁぁ……最後の力も……」	PRINTFORML 「ぁぁ……最後の力も……」
PRINTFORML 「勝負は私の負けね……。」	PRINTFORML 「勝負は私の負けね……。」
PRINTFORML では、よい触手ライフを…	PRINTFORML では、よい触手ライフを…
PRINTFORML 「ひ、ひきょうものッ♥」	PRINTFORML 「ひ、ひきょうものッ♥」
PRINTFORML （おちつかないと……♥）	PRINTFORML （おちつかないと……♥）
PRINTFORML （む、胸が擦れて……♥）	PRINTFORML （む、胸が擦れて……♥）
PRINTFORML （いま、ジワって……♥）	PRINTFORML （いま、ジワって……♥）
PRINTFORML 「うるさいのは嫌い……」	PRINTFORML 「うるさいのは嫌い……」
PRINTFORML 「やってみるしか……♥」	PRINTFORML 「やってみるしか……♥」
PRINTFORML 「流れは切らさない……」	PRINTFORML 「流れは切らさない……」
PRINTFORML 「うっ、何をしたの……」	PRINTFORML 「うっ、何をしたの……」
PRINTFORML 「ええぃ！面倒なのに！」	PRINTFORML 「ええぃ！面倒なのに！」
PRINTFORML 「これじゃ動けない！？」	PRINTFORML 「これじゃ動けない！？」
PRINTFORML 「だ、だされた……！？」	PRINTFORML 「だ、だされた……！？」
PRINTFORML 「くっ、いい加減に……」	PRINTFORML 「くっ、いい加減に……」
PRINTFORML 「好き勝手なことを……」	PRINTFORML 「好き勝手なことを……」
PRINTFORML 「あぁっ……時が……。」	PRINTFORML 「あぁっ……時が……。」
PRINTFORML 「純狐……クラ…ピー…」	PRINTFORML 「純狐……クラ…ピー…」
PRINTFORML 「文字が読みにくく……」	PRINTFORML 「文字が読みにくく……」
PRINTFORML 「さて、帰りましょうか」	PRINTFORML 「さて、帰りましょうか」
PRINTFORML 「……まだねむぃ……」	PRINTFORML 「……まだねむぃ……」
PRINTFORML （ア、アソコが……♥）	PRINTFORML （ア、アソコが……♥）
PRINTFORML 「アポロ反射鏡を展開」	PRINTFORML 「アポロ反射鏡を展開」
PRINTFORML 「相手にしたくないわ」	PRINTFORML 「相手にしたくないわ」
PRINTFORML 「惑星直列ハンマー！」	PRINTFORML 「惑星直列ハンマー！」
PRINTFORML 「囚人Ｈ登場だわよん」	PRINTFORML 「囚人Ｈ登場だわよん」
PRINTFORML 「まずい･･･かもね」	PRINTFORML 「まずい･･･かもね」
PRINTFORML 「ッはぁ！…はぁっ…」	PRINTFORML 「ッはぁ！…はぁっ…」
PRINTFORML 「旋律を重ねよう……」	PRINTFORML 「旋律を重ねよう……」
PRINTFORML 「絶対に駄目よ……！」	PRINTFORML 「絶対に駄目よ……！」
PRINTFORML 「防ぎ…きれない！？」	PRINTFORML 「防ぎ…きれない！？」
PRINTFORML 「くぅぅぅ……んッ！」	PRINTFORML 「くぅぅぅ……んッ！」
PRINTFORML 「命…捨てたいんだね」	PRINTFORML 「命…捨てたいんだね」
PRINTFORML 「かすらせもしないわ」	PRINTFORML 「かすらせもしないわ」
PRINTFORML 「……たすかったの？」	PRINTFORML 「……たすかったの？」
PRINTFORML 「負け……ました……」	PRINTFORML 「負け……ました……」
PRINTFORML 「……このくらいなら」	PRINTFORML 「……このくらいなら」
PRINTFORML 「女神の登場だわよん」	PRINTFORML 「女神の登場だわよん」
PRINTFORML 「お待たせしたわよん」	PRINTFORML 「お待たせしたわよん」
PRINTFORML 「……あ、ありがとう」	PRINTFORML 「……あ、ありがとう」
PRINTFORML 「どこかで睡眠を……」	PRINTFORML 「どこかで睡眠を……」
PRINTFORML 「……育つのがはやい」	PRINTFORML 「……育つのがはやい」
PRINTFORML 「順調に育ってる……」	PRINTFORML 「順調に育ってる……」
PRINTFORML 「もうすぐなのね……」	PRINTFORML 「もうすぐなのね……」
PRINTFORML (はぁ…♥ はぁ…♥)	PRINTFORML (はぁ…♥ はぁ…♥)
PRINTFORML 「すぅ……すぅ……」	PRINTFORML 「すぅ……すぅ……」
PRINTFORML （もう濡れて……♥）	PRINTFORML （もう濡れて……♥）
PRINTFORML （どうしよう……♥）	PRINTFORML （どうしよう……♥）
PRINTFORML （ク、クリが……♥）	PRINTFORML （ク、クリが……♥）
PRINTFORML （敏感にされたッ♥）	PRINTFORML （敏感にされたッ♥）
PRINTFORML 「今回の作戦は……」	PRINTFORML 「今回の作戦は……」
PRINTFORML 「詠唱時間など不要」	PRINTFORML 「詠唱時間など不要」
PRINTFORML 「はぁ……はぁ……」	PRINTFORML 「はぁ……はぁ……」
PRINTFORML 「次につなげる……」	PRINTFORML 「次につなげる……」
PRINTFORML 「げほっげほっ……」	PRINTFORML 「げほっげほっ……」
PRINTFORML 「ああああああっ！」	PRINTFORML 「ああああああっ！」
PRINTFORML 「やっ、やめぇぇ！」	PRINTFORML 「やっ、やめぇぇ！」
PRINTFORML 「……痛いんだけど」	PRINTFORML 「……痛いんだけど」
PRINTFORML 「きゃっ…離れろ！」	PRINTFORML 「きゃっ…離れろ！」
PRINTFORML 「きゃぁ！よくも！」	PRINTFORML 「きゃぁ！よくも！」
PRINTFORML 「反応が遅れた！？」	PRINTFORML 「反応が遅れた！？」
PRINTFORML 「誘い込まれた！？」	PRINTFORML 「誘い込まれた！？」
PRINTFORML 「い、今のって……」	PRINTFORML 「い、今のって……」
PRINTFORML 「よ、汚された……」	PRINTFORML 「よ、汚された……」
PRINTFORML 「火遊びのつもり？」	PRINTFORML 「火遊びのつもり？」
PRINTFORML 「これで一安心よん」	PRINTFORML 「これで一安心よん」
PRINTFORML 「……鎖球が重いわ」	PRINTFORML 「……鎖球が重いわ」
PRINTFORML （疼いてる……♥）	PRINTFORML （疼いてる……♥）
PRINTFORML 「退くときは退く」	PRINTFORML 「退くときは退く」
PRINTFORML 「（クンッ）！！」	PRINTFORML 「（クンッ）！！」
PRINTFORML 「たす…けて……」	PRINTFORML 「たす…けて……」
PRINTFORML 「挽回する、必ず」	PRINTFORML 「挽回する、必ず」
PRINTFORML 「絶対に嫌……！」	PRINTFORML 「絶対に嫌……！」
PRINTFORML 「何をしてぇ……」	PRINTFORML 「何をしてぇ……」
PRINTFORML 「や、やめっ……」	PRINTFORML 「や、やめっ……」
PRINTFORML 「げほっげほっ…」	PRINTFORML 「げほっげほっ…」
PRINTFORML 「く、苦しい……」	PRINTFORML 「く、苦しい……」
PRINTFORML 「やっ、やめっ！」	PRINTFORML 「やっ、やめっ！」
PRINTFORML 「あわわわわわ！」	PRINTFORML 「あわわわわわ！」
PRINTFORML 「気持ちいい……」	PRINTFORML 「気持ちいい……」
PRINTFORML 「んんんッ……！」	PRINTFORML 「んんんッ……！」
PRINTFORML 「最低の感触……」	PRINTFORML 「最低の感触……」
PRINTFORML 「……これは重罪」	PRINTFORML 「……これは重罪」
PRINTFORML （休憩したい……）	PRINTFORML （休憩したい……）
PRINTFORML 「すぅ…zzz」	PRINTFORML 「すぅ…zzz」
PRINTFORML 「ぷちフレア！」	PRINTFORML 「ぷちフレア！」
PRINTFORML 「きゃぁぁぁ！」	PRINTFORML 「きゃぁぁぁ！」
PRINTFORML 「あああぁ……」	PRINTFORML 「あああぁ……」
PRINTFORML 「それだめぇ…」	PRINTFORML 「それだめぇ…」
PRINTFORML 「呑まれる！？」	PRINTFORML 「呑まれる！？」
PRINTFORML 「許さない……」	PRINTFORML 「許さない……」
PRINTFORML 「ぅ…ぁぁ……」	PRINTFORML 「ぅ…ぁぁ……」
PRINTFORML 「や、やめて！」	PRINTFORML 「や、やめて！」
PRINTFORML （徹夜地獄……）	PRINTFORML （徹夜地獄……）
PRINTFORML 「げほっ……」	PRINTFORML 「げほっ……」
PRINTFORML 「うぇぇ……」	PRINTFORML 「うぇぇ……」
PRINTFORML 「かはっ……」	PRINTFORML 「かはっ……」
PRINTFORML 「やめぇ……」	PRINTFORML 「やめぇ……」
PRINTFORML 「おのれー！」	PRINTFORML 「おのれー！」
PRINTFORML 「やめてぇ…」	PRINTFORML 「やめてぇ…」
PRINTFORML 「しまった！」	PRINTFORML 「しまった！」
PRINTFORML 「速いっ！？」	PRINTFORML 「速いっ！？」
PRINTFORML 「そんな！？」	PRINTFORML 「そんな！？」
PRINTFORML 「守れ鎖よ！」	PRINTFORML 「守れ鎖よ！」
PRINTFORML 「ゃぁ……」	PRINTFORML 「ゃぁ……」
PRINTFORML 「ぉぇ……」	PRINTFORML 「ぉぇ……」
PRINTFORML 「……ぅぅ」	PRINTFORML 「……ぅぅ」
PRINTFORML 「力がっ…」	PRINTFORML 「力がっ…」
PRINTFORML 「瘴気！？」	PRINTFORML 「瘴気！？」
PRINTFORML 「すごぃ…」	PRINTFORML 「すごぃ…」
PRINTFORML 「あひぃ…」	PRINTFORML 「あひぃ…」
PRINTFORML 「うぅ……」	PRINTFORML 「うぅ……」
PRINTFORML 「爆ぜろ」	PRINTFORML 「爆ぜろ」
PRINTFORML 「堕ちよ」	PRINTFORML 「堕ちよ」
PRINTFORML 「痛っ…」	PRINTFORML 「痛っ…」
PRINTFORML 「散れ」	PRINTFORML 「散れ」
PRINTFORML 「滅」	PRINTFORML 「滅」
PRINTFORMDL …？	PRINTFORMDL …？
PRINTFORML 	PRINTFORML 
PRINTL 	PRINTL 
