﻿PRINTFORML 	!#!PRINTFORML 
PRINTFORML 詳しい性格付けなどはリードミーにて。	!#!PRINTFORML 詳しい性格付けなどはリードミーにて。
PRINTFORMW 「……ン、グゥ……」	!#!PRINTFORMW 「……ン、グゥ……」
PRINTFORMW 「ぎゅ…んんぅ…」	!#!PRINTFORMW 「ぎゅ…んんぅ…」
PRINTFORMW 「…ふ……んが……」	!#!PRINTFORMW 「…ふ……んが……」
PRINTFORMW 「ひぃ…っ❤」	!#!PRINTFORMW 「ひぃ…っ❤」
PRINTFORMW （矢鱈に動いても効果無さそうだべ…）	!#!PRINTFORMW （矢鱈に動いても効果無さそうだべ…）
PRINTFORMW （今迂闊に切り込むと不味いべ…！）	!#!PRINTFORMW （今迂闊に切り込むと不味いべ…！）
PRINTFORMW 「く、来るなら来い…！」	!#!PRINTFORMW 「く、来るなら来い…！」
PRINTFORMW （一旦様子見するか…）	!#!PRINTFORMW （一旦様子見するか…）
PRINTFORMW （守りを固めて様子を見るべ…）	!#!PRINTFORMW （守りを固めて様子を見るべ…）
PRINTFORMW （…っ今のは弱かったか？！）	!#!PRINTFORMW （…っ今のは弱かったか？！）
PRINTFORMW 「く…力が入らん…」	!#!PRINTFORMW 「く…力が入らん…」
PRINTFORMW 「はッ！」	!#!PRINTFORMW 「はッ！」
PRINTFORMW 「そら！」	!#!PRINTFORMW 「そら！」
PRINTFORMW 「倒す…！」	!#!PRINTFORMW 「倒す…！」
PRINTFORMW 「っ、喰らえ…！」	!#!PRINTFORMW 「っ、喰らえ…！」
PRINTFORMW 「喰らえ！」	!#!PRINTFORMW 「喰らえ！」
PRINTFORMW 「おらっ！」	!#!PRINTFORMW 「おらっ！」
PRINTFORMW 「ふ…っ！」	!#!PRINTFORMW 「ふ…っ！」
PRINTFORMW （ピンチの時こそ、全力をっ…！）	!#!PRINTFORMW （ピンチの時こそ、全力をっ…！）
PRINTFORMW 「ダぁっ！！」	!#!PRINTFORMW 「ダぁっ！！」
PRINTFORMW 「ぶち抜く！」	!#!PRINTFORMW 「ぶち抜く！」
PRINTFORML 「ふぅー……っ！」	!#!PRINTFORML 「ふぅー……っ！」
PRINTFORMW （上手いこと集中できないべ…❤）	!#!PRINTFORMW （上手いこと集中できないべ…❤）
PRINTFORMW 「余計なこと、考えたらダメだ…！」	!#!PRINTFORMW 「余計なこと、考えたらダメだ…！」
PRINTFORMW 「うちの怒り、思い知れ…！」	!#!PRINTFORMW 「うちの怒り、思い知れ…！」
PRINTFORMW （撃てるか分からんが、試す価値はある筈だべ…）	!#!PRINTFORMW （撃てるか分からんが、試す価値はある筈だべ…）
PRINTFORMW 「なわばり荒らして、タダじゃ帰さねえべ！」	!#!PRINTFORMW 「なわばり荒らして、タダじゃ帰さねえべ！」
PRINTFORMW 「山姥のやり方で倒すべ…！」	!#!PRINTFORMW 「山姥のやり方で倒すべ…！」
PRINTFORMW 「刃符『山姥の鬼包丁研ぎ』いいっ❤！」	!#!PRINTFORMW 「刃符『山姥の鬼包丁研ぎ』いいっ❤！」
PRINTFORMW 「尽符『ブラッディマウンテンマーだああぁ❤」（ち、力が抜けて…❤）	!#!PRINTFORMW 「尽符『ブラッディマウンテンマーだああぁ❤」（ち、力が抜けて…❤）
PRINTFORMW （頼むっ…）「刃符『山姥の鬼包丁研ぎ』！」	!#!PRINTFORMW （頼むっ…）「刃符『山姥の鬼包丁研ぎ』！」
PRINTFORMW 「尽符っ、『ブラッディマウンテンマーダー』…ッ！」	!#!PRINTFORMW 「尽符っ、『ブラッディマウンテンマーダー』…ッ！」
PRINTFORMW 「引き裂け！刃符『山姥の鬼包丁研ぎ』！」	!#!PRINTFORMW 「引き裂け！刃符『山姥の鬼包丁研ぎ』！」
PRINTFORMW 「吹き飛びな！尽符『ブラッディマウンテンマーダー』！」	!#!PRINTFORMW 「吹き飛びな！尽符『ブラッディマウンテンマーダー』！」
PRINTFORMW （ばら撒いときゃこっちに来ないはずだ…！）	!#!PRINTFORMW （ばら撒いときゃこっちに来ないはずだ…！）
PRINTFORMW （ばら撒いて動きを止める…！）	!#!PRINTFORMW （ばら撒いて動きを止める…！）
PRINTFORMW 「布石を打つべ…！」	!#!PRINTFORMW 「布石を打つべ…！」
PRINTFORMW 「ううっ///…鬱陶しいわ！」	!#!PRINTFORMW 「ううっ///…鬱陶しいわ！」
PRINTFORML （はっ❤早く倒さんと…///）	!#!PRINTFORML （はっ❤早く倒さんと…///）
PRINTFORMW 「雨符『囚われの秋雨』…！」	!#!PRINTFORMW 「雨符『囚われの秋雨』…！」
PRINTFORMW 「鬱陶しい…っ！」	!#!PRINTFORMW 「鬱陶しい…っ！」
PRINTFORML （迷ってる暇はない…！）	!#!PRINTFORML （迷ってる暇はない…！）
PRINTFORMW 「雨符『囚われの秋雨』！！」	!#!PRINTFORMW 「雨符『囚われの秋雨』！！」
PRINTFORMW 「撃ち抜け！雨符『囚われの秋雨』！」	!#!PRINTFORMW 「撃ち抜け！雨符『囚われの秋雨』！」
PRINTFORMW 「纏めて相手するべ！」	!#!PRINTFORMW 「纏めて相手するべ！」
PRINTFORMW 「今は近づかんで良いのが有り難いべ…」	!#!PRINTFORMW 「今は近づかんで良いのが有り難いべ…」
PRINTFORMW （遠くから撃てば反撃は受けない！当然だな）	!#!PRINTFORMW （遠くから撃てば反撃は受けない！当然だな）
PRINTFORMW （悔しいが、今はこれに頼らざるをを得んな…）	!#!PRINTFORMW （悔しいが、今はこれに頼らざるをを得んな…）
PRINTFORMW 「性に合わねえが、こんな時だし仕方ないべな」	!#!PRINTFORMW 「性に合わねえが、こんな時だし仕方ないべな」
PRINTFORMW 「うちだってこれくらい使えるわ！」	!#!PRINTFORMW 「うちだってこれくらい使えるわ！」
PRINTFORMW 「おらっ！コイツの弾をくらえ！」	!#!PRINTFORMW 「おらっ！コイツの弾をくらえ！」
PRINTFORMW （次に備えとかねえと…！）	!#!PRINTFORMW （次に備えとかねえと…！）
PRINTFORMW 「外したら不味いし、保険を掛けておくか…」	!#!PRINTFORMW 「外したら不味いし、保険を掛けておくか…」
PRINTFORMW 「物資が有限とはいえ、ケチりすぎたか…？」	!#!PRINTFORMW 「物資が有限とはいえ、ケチりすぎたか…？」
PRINTFORMW （チッ、日和っちまった…！）	!#!PRINTFORMW （チッ、日和っちまった…！）
PRINTFORMW 「無駄遣いは好かないべ」	!#!PRINTFORMW 「無駄遣いは好かないべ」
PRINTFORMW 「お前にはこれで十分だ」	!#!PRINTFORMW 「お前にはこれで十分だ」
PRINTFORMW 「こんな状態じゃ狙えねえべ…だから乱れ撃つ！」	!#!PRINTFORMW 「こんな状態じゃ狙えねえべ…だから乱れ撃つ！」
PRINTFORMW 「相手のどこかに当たってくれーっ！」	!#!PRINTFORMW 「相手のどこかに当たってくれーっ！」
PRINTFORMW 「狙うのは面倒だ、撃ってりゃ当たるだろ！」	!#!PRINTFORMW 「狙うのは面倒だ、撃ってりゃ当たるだろ！」
PRINTFORMW 「ハチの巣にしてやるわ！」	!#!PRINTFORMW 「ハチの巣にしてやるわ！」
PRINTFORMW （……集中できん！）	!#!PRINTFORMW （……集中できん！）
PRINTFORMW 「あ、あ、手がぶれるべ…❤」	!#!PRINTFORMW 「あ、あ、手がぶれるべ…❤」
PRINTFORMW （当たってくれ…！）	!#!PRINTFORMW （当たってくれ…！）
PRINTFORMW 「……今だ！」	!#!PRINTFORMW 「……今だ！」
PRINTFORMW （こうして狙ってるとマタギの気分だべ…！）	!#!PRINTFORMW （こうして狙ってるとマタギの気分だべ…！）
PRINTFORMW 「逃さん！」	!#!PRINTFORMW 「逃さん！」
PRINTFORMW （思わず手加減しちまった…！）	!#!PRINTFORMW （思わず手加減しちまった…！）
PRINTFORMW 「くうっ…❤」（力が入らなかったっ…！）	!#!PRINTFORMW 「くうっ…❤」（力が入らなかったっ…！）
PRINTFORMW 「喰らえ…っ！」（まずい、力が乗らないっ）	!#!PRINTFORMW 「喰らえ…っ！」（まずい、力が乗らないっ）
PRINTFORMW 「くうっ…！」（軽かったか…っ？！）	!#!PRINTFORMW 「くうっ…！」（軽かったか…っ？！）
PRINTFORMW 「ふんっ！」	!#!PRINTFORMW 「ふんっ！」
PRINTFORMW 「シャッ！」	!#!PRINTFORMW 「シャッ！」
PRINTFORMW （こんくらいが丁度良いべ…！）	!#!PRINTFORMW （こんくらいが丁度良いべ…！）
PRINTFORMW 「くっ❤…おおっ！」	!#!PRINTFORMW 「くっ❤…おおっ！」
PRINTFORMW 「うっとおしい…！」	!#!PRINTFORMW 「うっとおしい…！」
PRINTFORMW 「おらぁっ！」	!#!PRINTFORMW 「おらぁっ！」
PRINTFORMW 「三枚に卸してやる！」	!#!PRINTFORMW 「三枚に卸してやる！」
PRINTFORMW 「叩っ切るべ！」	!#!PRINTFORMW 「叩っ切るべ！」
PRINTFORMW 「ふっ❤ふっ❤…ふううんっ！」	!#!PRINTFORMW 「ふっ❤ふっ❤…ふううんっ！」
PRINTFORMW 「ぬおおおおっ…うっ❤」	!#!PRINTFORMW 「ぬおおおおっ…うっ❤」
PRINTFORMW （時間をかけるとまずい…）「っ…るああぁ！」	!#!PRINTFORMW （時間をかけるとまずい…）「っ…るああぁ！」
PRINTFORMW 「こいつを掻っ捌くぐらいの力は有るべ…！」	!#!PRINTFORMW 「こいつを掻っ捌くぐらいの力は有るべ…！」
PRINTFORMW 「バッサリ掻っ捌く！」	!#!PRINTFORMW 「バッサリ掻っ捌く！」
PRINTFORMW 「…ブッた斬る！」	!#!PRINTFORMW 「…ブッた斬る！」
PRINTFORMW 「てえぇやっ！」	!#!PRINTFORMW 「てえぇやっ！」
PRINTFORMW 「動けねえようにしちまえば…！」	!#!PRINTFORMW 「動けねえようにしちまえば…！」
PRINTFORMW 「足から削ぎ切ってやるわ！」	!#!PRINTFORMW 「足から削ぎ切ってやるわ！」
PRINTFORMW 「要らんとこを斬り落とす！」	!#!PRINTFORMW 「要らんとこを斬り落とす！」
PRINTFORMW 「そんなに欲しけりゃくれてやるわ…！❤」	!#!PRINTFORMW 「そんなに欲しけりゃくれてやるわ…！❤」
PRINTFORMW 「うぅ…なんだか狙いにくいべ…///」	!#!PRINTFORMW 「うぅ…なんだか狙いにくいべ…///」
PRINTFORMW 「こいつの弱点…ここかぁ！」	!#!PRINTFORMW 「こいつの弱点…ここかぁ！」
PRINTFORMW （上手いこと当たれば有利になるはずだ…！）	!#!PRINTFORMW （上手いこと当たれば有利になるはずだ…！）
PRINTFORMW 「ちょん切ってやる！」	!#!PRINTFORMW 「ちょん切ってやる！」
PRINTFORMW 「真っ二つにしてやろうかぁ！」	!#!PRINTFORMW 「真っ二つにしてやろうかぁ！」
PRINTFORMW （ひぃ、ひぃ❤…次こそはぁ…っ❤）	!#!PRINTFORMW （ひぃ、ひぃ❤…次こそはぁ…っ❤）
PRINTFORMW 「あ、だめだっ、力がぁ…❤」	!#!PRINTFORMW 「あ、だめだっ、力がぁ…❤」
PRINTFORMW 「うちを喰おうったってそうはいかねえぞ…！！」	!#!PRINTFORMW 「うちを喰おうったってそうはいかねえぞ…！！」
PRINTFORMW （マズイ…早くしねえと喰われる…！）	!#!PRINTFORMW （マズイ…早くしねえと喰われる…！）
PRINTFORMW 「うえぇ、ネチョネチョする…」	!#!PRINTFORMW 「うえぇ、ネチョネチョする…」
PRINTFORMW 「おえっ…生臭ぇし生温けぇ……」	!#!PRINTFORMW 「おえっ…生臭ぇし生温けぇ……」
PRINTFORMW 「やめろっ…放せ…❤」	!#!PRINTFORMW 「やめろっ…放せ…❤」
PRINTFORMW 「ひ、引っ付かないでくんろっ…///」	!#!PRINTFORMW 「ひ、引っ付かないでくんろっ…///」
PRINTFORMW （逃げねえと何されるか分かんねえ…！！）	!#!PRINTFORMW （逃げねえと何されるか分かんねえ…！！）
PRINTFORMW 「くおぉ～っ！！」	!#!PRINTFORMW 「くおぉ～っ！！」
PRINTFORMW 「邪魔だ退け！」	!#!PRINTFORMW 「邪魔だ退け！」
PRINTFORMW 「こいつっ…しつこいべ！！」	!#!PRINTFORMW 「こいつっ…しつこいべ！！」
PRINTFORML 「ぐひぃ…ぃ❤」	!#!PRINTFORML 「ぐひぃ…ぃ❤」
PRINTFORMDW %CALLNAME:TARGET%は気の抜けた顔をしている…	!#!PRINTFORMDW %CALLNAME:TARGET%は気の抜けた顔をしている…
PRINTFORMW （こんなんじゃ、力、入んねぇっ…❤）	!#!PRINTFORMW （こんなんじゃ、力、入んねぇっ…❤）
PRINTFORMW 「ふ、ふうぅんぬぅ…！」	!#!PRINTFORMW 「ふ、ふうぅんぬぅ…！」
PRINTFORMW （落ち着けっ、今はチャンスを窺ってっ…！）	!#!PRINTFORMW （落ち着けっ、今はチャンスを窺ってっ…！）
PRINTFORMW （ピンチだからこそ冷静にっ…！）	!#!PRINTFORMW （ピンチだからこそ冷静にっ…！）
PRINTFORMW 「焦っても何にもならんべ…！！」	!#!PRINTFORMW 「焦っても何にもならんべ…！！」
PRINTFORMW （一気に脱出するべきだな…）	!#!PRINTFORMW （一気に脱出するべきだな…）
PRINTFORMW 「ふんぬぬぬ…！」	!#!PRINTFORMW 「ふんぬぬぬ…！」
PRINTFORML 「お、お慈悲をっ❤お慈悲をくんろぉっ……❤」	!#!PRINTFORML 「お、お慈悲をっ❤お慈悲をくんろぉっ……❤」
PRINTFORMDW %CALLNAME:TARGET%は脱出を諦め、相手におねだりを始めた…	!#!PRINTFORMDW %CALLNAME:TARGET%は脱出を諦め、相手におねだりを始めた…
PRINTFORMW （戦いの興奮でっ❤、股座が濡れ濡れだべ❤……ああっ♪）	!#!PRINTFORMW （戦いの興奮でっ❤、股座が濡れ濡れだべ❤……ああっ♪）
PRINTFORMW （ダメだ…手がっ、勝手にまたぐらにぃ…❤）	!#!PRINTFORMW （ダメだ…手がっ、勝手にまたぐらにぃ…❤）
PRINTFORMW 「い、今だけ…一回だけ、させてくんろ…❤」	!#!PRINTFORMW 「い、今だけ…一回だけ、させてくんろ…❤」
PRINTFORML （コイツら容赦なく入ってくるからな…///）	!#!PRINTFORML （コイツら容赦なく入ってくるからな…///）
PRINTFORML 「は、入るなっ！こっちは出す穴だべ！」	!#!PRINTFORML 「は、入るなっ！こっちは出す穴だべ！」
PRINTFORMDW %CALLNAME:TARGET%は尻を引っ込めた。	!#!PRINTFORMDW %CALLNAME:TARGET%は尻を引っ込めた。
PRINTFORML （吸ったり揉んだりされてたまるかっ…❤）	!#!PRINTFORML （吸ったり揉んだりされてたまるかっ…❤）
PRINTFORML 「どうしてコイツらは胸に寄って来るかね…！」	!#!PRINTFORML 「どうしてコイツらは胸に寄って来るかね…！」
PRINTFORMDW %CALLNAME:TARGET%は胸を隠した。	!#!PRINTFORMDW %CALLNAME:TARGET%は胸を隠した。
PRINTFORML （今弄られたら…容易く射精しちまうべ…❤）	!#!PRINTFORML （今弄られたら…容易く射精しちまうべ…❤）
PRINTFORML （今弄られたら…イキ狂ってしまうべ…❤）	!#!PRINTFORML （今弄られたら…イキ狂ってしまうべ…❤）
PRINTFORML 「余計なもんを付けやがってっ…！」	!#!PRINTFORML 「余計なもんを付けやがってっ…！」
PRINTFORML 「やめろっ、そこは敏感な場所だべ！」	!#!PRINTFORML 「やめろっ、そこは敏感な場所だべ！」
PRINTFORMDW %CALLNAME:TARGET%は内股になり股間を隠した。	!#!PRINTFORMDW %CALLNAME:TARGET%は内股になり股間を隠した。
PRINTFORML （な、膣内は絶対ダメだっ…❤）	!#!PRINTFORML （な、膣内は絶対ダメだっ…❤）
PRINTFORML 「くっ、露骨に狙ってきよるっ…！」	!#!PRINTFORML 「くっ、露骨に狙ってきよるっ…！」
PRINTFORMDW %CALLNAME:TARGET%は腰を引き股間を守った。	!#!PRINTFORMDW %CALLNAME:TARGET%は腰を引き股間を守った。
PRINTFORMW 「今はケツマンコが温くてお勧めだべ❤」	!#!PRINTFORMW 「今はケツマンコが温くてお勧めだべ❤」
PRINTFORMW 「頼む…尻で許してくんろぉ…」	!#!PRINTFORMW 「頼む…尻で許してくんろぉ…」
PRINTFORMW 「…やるなら、せめて尻にしてくんろ…❤」	!#!PRINTFORMW 「…やるなら、せめて尻にしてくんろ…❤」
PRINTFORMW 「早よ来い❤乳で挟んで絞り出してやる♪」	!#!PRINTFORMW 「早よ来い❤乳で挟んで絞り出してやる♪」
PRINTFORMW 「胸…胸が良いんだ、頼む…」	!#!PRINTFORMW 「胸…胸が良いんだ、頼む…」
PRINTFORMW 「胸がっ、疼くんだべ…❤」	!#!PRINTFORMW 「胸がっ、疼くんだべ…❤」
PRINTFORMW 「うちのちんぽが『射精したい』って言ってるべ…手伝ってくれぇっ❤」	!#!PRINTFORMW 「うちのちんぽが『射精したい』って言ってるべ…手伝ってくれぇっ❤」
PRINTFORMW 「うちのお豆を鎮めてくんろっ…❤」	!#!PRINTFORMW 「うちのお豆を鎮めてくんろっ…❤」
PRINTFORMW 「おちんぽっ、しごいてくれぇ…」	!#!PRINTFORMW 「おちんぽっ、しごいてくれぇ…」
PRINTFORMW 「中は嫌だぁ…ここで勘弁してくんろ…」	!#!PRINTFORMW 「中は嫌だぁ…ここで勘弁してくんろ…」
PRINTFORMW 「はーっはーっ❤…射精したいっ、射精させてくんろっ…！」	!#!PRINTFORMW 「はーっはーっ❤…射精したいっ、射精させてくんろっ…！」
PRINTFORMW 「豆がっ…ヒクつくんだぁ…///」	!#!PRINTFORMW 「豆がっ…ヒクつくんだぁ…///」
PRINTFORMW 「ボテ腹妊婦まんこに挿入れたいんだべ？❤」	!#!PRINTFORMW 「ボテ腹妊婦まんこに挿入れたいんだべ？❤」
PRINTFORMW 「今ならパパになれるかもしれないぞ？ほら、早く…❤」	!#!PRINTFORMW 「今ならパパになれるかもしれないぞ？ほら、早く…❤」
PRINTFORMW 「どうせ孕まされてんだ、好きにしてくれ…」	!#!PRINTFORMW 「どうせ孕まされてんだ、好きにしてくれ…」
PRINTFORMW （もうどうとでもしてくんろ…）	!#!PRINTFORMW （もうどうとでもしてくんろ…）
PRINTFORML （逆に考えろ、今は孕むことがない…油断を誘えるはずだべ）	!#!PRINTFORML （逆に考えろ、今は孕むことがない…油断を誘えるはずだべ）
PRINTFORMW 「おら、来てみろ…❤」	!#!PRINTFORMW 「おら、来てみろ…❤」
PRINTFORML 「ほれ、こっちにこい…❤」	!#!PRINTFORML 「ほれ、こっちにこい…❤」
PRINTFORMW （そんで油断したところを掻っ捌いてやるべ）	!#!PRINTFORMW （そんで油断したところを掻っ捌いてやるべ）
PRINTFORML 「ぬおおぉーーっ……！」（う、動かん…）	!#!PRINTFORML 「ぬおおぉーーっ……！」（う、動かん…）
PRINTFORMDW %CALLNAME:TARGET%はどうにか体を動かそうとした。…が、無理だった。	!#!PRINTFORMDW %CALLNAME:TARGET%はどうにか体を動かそうとした。…が、無理だった。
PRINTFORMW （うちを待たせるなんていい度胸だべ…❤）	!#!PRINTFORMW （うちを待たせるなんていい度胸だべ…❤）
PRINTFORMDW %CALLNAME:TARGET%は平常にしている。とても平常だ。平常すぎるくらいだ！	!#!PRINTFORMDW %CALLNAME:TARGET%は平常にしている。とても平常だ。平常すぎるくらいだ！
PRINTFORMW 「あ、ひ❤　指ぃっ、と、止まってくんろぉ///」	!#!PRINTFORMW 「あ、ひ❤　指ぃっ、と、止まってくんろぉ///」
PRINTFORMW （ｸﾞﾁｭ､ｸﾞﾁｭ❤）「イヤラシイ音だべ？抱きたくなってきたろ？❤」	!#!PRINTFORMW （ｸﾞﾁｭ､ｸﾞﾁｭ❤）「イヤラシイ音だべ？抱きたくなってきたろ？❤」
PRINTFORML 「わかった…準備しておくべ」（ｸﾞﾁｭ､ｸﾞﾁｭ❤）	!#!PRINTFORML 「わかった…準備しておくべ」（ｸﾞﾁｭ､ｸﾞﾁｭ❤）
PRINTFORMDW %CALLNAME:TARGET%は	!#!PRINTFORMDW %CALLNAME:TARGET%は
PRINTFORMW （！？　同士討ちさせる気か！）	!#!PRINTFORMW （！？　同士討ちさせる気か！）
PRINTFORMW 「本能が抑えらんねえんだ…悪いが犠牲になってくんろ❤」	!#!PRINTFORMW 「本能が抑えらんねえんだ…悪いが犠牲になってくんろ❤」
PRINTFORMW 「旦那がレズプレイを見たいそうだべ…悪いが、お前を抱くぞ」	!#!PRINTFORMW 「旦那がレズプレイを見たいそうだべ…悪いが、お前を抱くぞ」
PRINTFORMDL %CALLNAME:TARGET%は自らの服を破いていく…	!#!PRINTFORMDL %CALLNAME:TARGET%は自らの服を破いていく…
PRINTFORMW （ﾋﾞﾘﾋﾞﾘ…）（ぐうぅ…自分の怪力が憎らしいべ…！）	!#!PRINTFORMW （ﾋﾞﾘﾋﾞﾘ…）（ぐうぅ…自分の怪力が憎らしいべ…！）
PRINTFORMW 「まぐわいにこんなもん要らないべ❤」	!#!PRINTFORMW 「まぐわいにこんなもん要らないべ❤」
PRINTFORMW 「まったく…うちの旦那はお盛んで困るべ…❤」	!#!PRINTFORMW 「まったく…うちの旦那はお盛んで困るべ…❤」
PRINTFORMW 「そ、そっちは逆だべ！？」	!#!PRINTFORMW 「そ、そっちは逆だべ！？」
PRINTFORMW 「逃げるのはそっちのほうじゃないか？❤」	!#!PRINTFORMW 「逃げるのはそっちのほうじゃないか？❤」
PRINTFORMW 「あぇ…？家はあっちだったか…？」	!#!PRINTFORMW 「あぇ…？家はあっちだったか…？」
PRINTFORMW 「く…眠らせる、暗示…だ……えぁ…」	!#!PRINTFORMW 「く…眠らせる、暗示…だ……えぁ…」
PRINTFORMW 「コラ、うちはまだ満足してねえ…ンガァ…」	!#!PRINTFORMW 「コラ、うちはまだ満足してねえ…ンガァ…」
PRINTFORMW 「なんだ？もう夜だべかぁ…？　…ｸﾞｩ～…」	!#!PRINTFORMW 「なんだ？もう夜だべかぁ…？　…ｸﾞｩ～…」
PRINTFORMW 「山姥…ナメん…なあ…っ！」	!#!PRINTFORMW 「山姥…ナメん…なあ…っ！」
PRINTFORML 「はあーっ…はあぁーっ…❤」	!#!PRINTFORML 「はあーっ…はあぁーっ…❤」
PRINTFORMW （なんだか落ち着いたほうがいいように感じたべ…？）	!#!PRINTFORMW （なんだか落ち着いたほうがいいように感じたべ…？）
PRINTFORML 「あれ…うちは…いつ嫁いだんだったか…？？」	!#!PRINTFORML 「あれ…うちは…いつ嫁いだんだったか…？？」
PRINTFORMDW %CALLNAME:TARGET%は頭を抱え唸っている…	!#!PRINTFORMDW %CALLNAME:TARGET%は頭を抱え唸っている…
PRINTFORMW 「わざわざ踏ませる意味が分からんが…手加減しねえべ！」	!#!PRINTFORMW 「わざわざ踏ませる意味が分からんが…手加減しねえべ！」
PRINTFORMW 「足コキじゃ済まねえべ？…じゃ遠慮なく♪」（ｸﾞﾁｬｸﾞﾁｬ）	!#!PRINTFORMW 「足コキじゃ済まねえべ？…じゃ遠慮なく♪」（ｸﾞﾁｬｸﾞﾁｬ）
PRINTFORMW 「旦那が真性のマゾヒストなんて笑えないべ…」（ｸﾞﾘｸﾞﾘ…）	!#!PRINTFORMW 「旦那が真性のマゾヒストなんて笑えないべ…」（ｸﾞﾘｸﾞﾘ…）
PRINTFORMW （捥ぐ勢いではたいてやるわ…！）「うおおおらっ！」	!#!PRINTFORMW （捥ぐ勢いではたいてやるわ…！）「うおおおらっ！」
PRINTFORMW 「ちんぽに元気注入だべ❤ほれ、がんばれ❤がんばれ❤」（ﾍﾞﾁﾍﾞﾁ）	!#!PRINTFORMW 「ちんぽに元気注入だべ❤ほれ、がんばれ❤がんばれ❤」（ﾍﾞﾁﾍﾞﾁ）
PRINTFORMW 「ん～、このあたりがいいんか？…じゃ、いくぞ」（ﾊﾞﾁｺｰﾝ！）	!#!PRINTFORMW 「ん～、このあたりがいいんか？…じゃ、いくぞ」（ﾊﾞﾁｺｰﾝ！）
PRINTFORMW 「うぇっ気持ち悪い…とっとと折ろう」（ｺｷｭｯ）	!#!PRINTFORMW 「うぇっ気持ち悪い…とっとと折ろう」（ｺｷｭｯ）
PRINTFORMW （ｻﾜｻﾜ❤）「気持ち良くなってきたか？…ハイ、ここまで❤」（ﾍﾞｷｮ！）	!#!PRINTFORMW （ｻﾜｻﾜ❤）「気持ち良くなってきたか？…ハイ、ここまで❤」（ﾍﾞｷｮ！）
PRINTFORMW 「どっちに折ればいいんだ？…どっちでもいい？ほれっ」（ﾊﾟｷｮｯ）	!#!PRINTFORMW 「どっちに折ればいいんだ？…どっちでもいい？ほれっ」（ﾊﾟｷｮｯ）
PRINTFORMW 「んぶぅ…！」（むせ返るような臭いがするっ…！！）	!#!PRINTFORMW 「んぶぅ…！」（むせ返るような臭いがするっ…！！）
PRINTFORML 「んうっ…レロ……ちぅ……❤」	!#!PRINTFORML 「んうっ…レロ……ちぅ……❤」
PRINTFORMW （隅から隅まで味わうのが礼儀ってもんだべ…❤）	!#!PRINTFORMW （隅から隅まで味わうのが礼儀ってもんだべ…❤）
PRINTFORMW 「ンチュッ…ふぅ、濃厚な接吻だったべ❤」	!#!PRINTFORMW 「ンチュッ…ふぅ、濃厚な接吻だったべ❤」
PRINTFORMDL 何を思ったか%CALLNAME:TARGET%は自分から相手に口づけした…	!#!PRINTFORMDL 何を思ったか%CALLNAME:TARGET%は自分から相手に口づけした…
PRINTFORMW 「今回だけだからな…んむっ…❤」	!#!PRINTFORMW 「今回だけだからな…んむっ…❤」
PRINTFORMW （う…脈打ってて気持ち悪りぃ…）	!#!PRINTFORMW （う…脈打ってて気持ち悪りぃ…）
PRINTFORMW 「シュッシュッシュ❤…ふひひ❤ちんぽこヒクついてるべ❤」	!#!PRINTFORMW 「シュッシュッシュ❤…ふひひ❤ちんぽこヒクついてるべ❤」
PRINTFORMW 「手でして欲しいのか、わがままだな❤」	!#!PRINTFORMW 「手でして欲しいのか、わがままだな❤」
PRINTFORMDL 何を思ったか%CALLNAME:TARGET%は自分から手で奉仕し出した…	!#!PRINTFORMDL 何を思ったか%CALLNAME:TARGET%は自分から手で奉仕し出した…
PRINTFORMW （…うわぁ、熱くて脈打ってるべ…❤）	!#!PRINTFORMW （…うわぁ、熱くて脈打ってるべ…❤）
PRINTFORMW 「んぶぅ…うえぅ…」（臭ぇ…死ぬ…臭いで死ぬぅ……）	!#!PRINTFORMW 「んぶぅ…うえぅ…」（臭ぇ…死ぬ…臭いで死ぬぅ……）
PRINTFORMW （ﾁﾞｭﾎﾟｯﾁﾞｭﾎﾟｯ❤）「んんっ❤ちんぽしゃぶり病みつきだべ❤❤」	!#!PRINTFORMW （ﾁﾞｭﾎﾟｯﾁﾞｭﾎﾟｯ❤）「んんっ❤ちんぽしゃぶり病みつきだべ❤❤」
PRINTFORMW 「じゃあ咥えるべ…（ﾁﾞｭﾌﾟｯ）あむ、んむ、んぶぅっ…❤」	!#!PRINTFORMW 「じゃあ咥えるべ…（ﾁﾞｭﾌﾟｯ）あむ、んむ、んぶぅっ…❤」
PRINTFORMDL 何を思ったか%CALLNAME:TARGET%は自分から口で奉仕し出した…	!#!PRINTFORMDL 何を思ったか%CALLNAME:TARGET%は自分から口で奉仕し出した…
PRINTFORMW （ｸﾞﾎﾟｯｼﾞｭﾙｯ❤）「んぅっ❤…んぶぅ❤…」	!#!PRINTFORMW （ｸﾞﾎﾟｯｼﾞｭﾙｯ❤）「んぅっ❤…んぶぅ❤…」
PRINTFORMW 「わざわざ胸でこすらせる意味が分からんべ…」	!#!PRINTFORMW 「わざわざ胸でこすらせる意味が分からんべ…」
PRINTFORMW 「ほおれ…どうだ？すぐイッちまいそうだべ？❤」	!#!PRINTFORMW 「ほおれ…どうだ？すぐイッちまいそうだべ？❤」
PRINTFORMW （ｷﾞｭｯｷﾞｭｯ）「んっ、意外と胸でしごくの難しいな…❤」	!#!PRINTFORMW （ｷﾞｭｯｷﾞｭｯ）「んっ、意外と胸でしごくの難しいな…❤」
PRINTFORMDL 何を思ったか%CALLNAME:TARGET%は自分から胸で奉仕し出した…	!#!PRINTFORMDL 何を思ったか%CALLNAME:TARGET%は自分から胸で奉仕し出した…
PRINTFORMW 「…ほら、早く出せ。こっちも暇じゃねえんだ…//」	!#!PRINTFORMW 「…ほら、早く出せ。こっちも暇じゃねえんだ…//」
PRINTFORMW 「もう終わりか…だらしねえな」	!#!PRINTFORMW 「もう終わりか…だらしねえな」
PRINTFORMW 「まったく、あんまりやると旦那が寂しがるべ」	!#!PRINTFORMW 「まったく、あんまりやると旦那が寂しがるべ」
PRINTFORMW ﾎﾟｲｯ「ふげっ、うぅ…」（ヤリ捨てされた…）	!#!PRINTFORMW ﾎﾟｲｯ「ふげっ、うぅ…」（ヤリ捨てされた…）
PRINTFORML 「そうだ、ゆっくり離れてくんろ…」	!#!PRINTFORML 「そうだ、ゆっくり離れてくんろ…」
PRINTFORMW （これ以上は危なかったべ…//）	!#!PRINTFORMW （これ以上は危なかったべ…//）
PRINTFORMW 「…やっと退いたか」	!#!PRINTFORMW 「…やっと退いたか」
PRINTFORMW 「こっちが攻める側だ！分かったか？」	!#!PRINTFORMW 「こっちが攻める側だ！分かったか？」
PRINTFORMW 「独り占めはずるいぞ、うちの旦那が待ってるからな」	!#!PRINTFORMW 「独り占めはずるいぞ、うちの旦那が待ってるからな」
PRINTFORMW 「も…もう十分やったべ…」	!#!PRINTFORMW 「も…もう十分やったべ…」
PRINTFORML 「バカ！離れろ！まったく…！」	!#!PRINTFORML 「バカ！離れろ！まったく…！」
PRINTFORMW （危うく流されるところだったべ…//）	!#!PRINTFORMW （危うく流されるところだったべ…//）
PRINTFORMW 「邪魔だってのに、ほれっ！」	!#!PRINTFORMW 「邪魔だってのに、ほれっ！」
PRINTFORMW 「もっとっ❤もっとうちを愛してくれっ❤❤」	!#!PRINTFORMW 「もっとっ❤もっとうちを愛してくれっ❤❤」
PRINTFORML 「あんっ♪ふあんっ♪あんた、なかなかヤるなっ❤」	!#!PRINTFORML 「あんっ♪ふあんっ♪あんた、なかなかヤるなっ❤」
PRINTFORMW （ああっ、旦那が見てるっ❤寝取らせた旦那がうちを見てるっ❤❤）	!#!PRINTFORMW （ああっ、旦那が見てるっ❤寝取らせた旦那がうちを見てるっ❤❤）
PRINTFORMW 「もういい、好きに使ってくれ…」	!#!PRINTFORMW 「もういい、好きに使ってくれ…」
PRINTFORMW （ダメなのにっ❤ダメなのにすっげえ気持ちいいっ❤❤）	!#!PRINTFORMW （ダメなのにっ❤ダメなのにすっげえ気持ちいいっ❤❤）
PRINTFORMW 「やめろぉっ…仲間内でこんな…！」	!#!PRINTFORMW 「やめろぉっ…仲間内でこんな…！」
PRINTFORMW （コイツ、うちと仲間のセックスを見ようと…趣味の悪いっ！）	!#!PRINTFORMW （コイツ、うちと仲間のセックスを見ようと…趣味の悪いっ！）
PRINTFORML 「こんなもんが付いてるばっかりにっ…ううっ」	!#!PRINTFORML 「こんなもんが付いてるばっかりにっ…ううっ」
PRINTFORMW （気持ちいいっ…！　でも耐えねえとっ…！）	!#!PRINTFORMW （気持ちいいっ…！　でも耐えねえとっ…！）
PRINTFORMW 「スマンっ、耐えてくれっ…うあっ、あっ❤」	!#!PRINTFORMW 「スマンっ、耐えてくれっ…うあっ、あっ❤」
PRINTFORMW 「へへへ…さぁ、どうしてやるか❤」	!#!PRINTFORMW 「へへへ…さぁ、どうしてやるか❤」
PRINTFORMW 「あんたにゃ悪いが、うちのオナホになってもらうべ❤」	!#!PRINTFORMW 「あんたにゃ悪いが、うちのオナホになってもらうべ❤」
PRINTFORMW 「安心しろ、女同士でも気持ちよくなれるぞ❤」（ﾇﾁｯﾇﾁｯ）	!#!PRINTFORMW 「安心しろ、女同士でも気持ちよくなれるぞ❤」（ﾇﾁｯﾇﾁｯ）
PRINTFORMW 「おとなしくしろ。そうすりゃ気持ちいいだけで終わるべ」	!#!PRINTFORMW 「おとなしくしろ。そうすりゃ気持ちいいだけで終わるべ」
PRINTFORMW 「おらっ、もっと喘げ。うちの旦那にも聞こえるようにな」	!#!PRINTFORMW 「おらっ、もっと喘げ。うちの旦那にも聞こえるようにな」
PRINTFORMW 「どうだ、気持ちいいだろ。遠慮なくイッていいぞ」	!#!PRINTFORMW 「どうだ、気持ちいいだろ。遠慮なくイッていいぞ」
PRINTFORMW 「すまん、ちょっと我慢してくんろ…❤」	!#!PRINTFORMW 「すまん、ちょっと我慢してくんろ…❤」
PRINTFORMW 「一回だけ…鎮めるためだから…！❤」	!#!PRINTFORMW 「一回だけ…鎮めるためだから…！❤」
PRINTFORMW 「一回だけ…一回やったら満足するから…❤」	!#!PRINTFORMW 「一回だけ…一回やったら満足するから…❤」
PRINTFORMW 「いいぞぉ…♪もっと打ってこいっ！❤」	!#!PRINTFORMW 「いいぞぉ…♪もっと打ってこいっ！❤」
PRINTFORML 「ひいっ❤痛え…けど、癖になりそうだぁ…❤」	!#!PRINTFORML 「ひいっ❤痛え…けど、癖になりそうだぁ…❤」
PRINTFORMDW 狂わされた%CALLNAME:TARGET%の頭は痛みをも快楽に変えている…	!#!PRINTFORMDW 狂わされた%CALLNAME:TARGET%の頭は痛みをも快楽に変えている…
PRINTFORMW （ああっ❤うちマゾ調教されてるうっ❤❤）	!#!PRINTFORMW （ああっ❤うちマゾ調教されてるうっ❤❤）
PRINTFORMW 「う……ぎぃ…」	!#!PRINTFORMW 「う……ぎぃ…」
PRINTFORMW 「っ！！…う、うぅ……」	!#!PRINTFORMW 「っ！！…う、うぅ……」
PRINTFORMW 「い…痛…ぐ……！」	!#!PRINTFORMW 「い…痛…ぐ……！」
PRINTFORMW 「ぐあぁっ！…うぅっ」	!#!PRINTFORMW 「ぐあぁっ！…うぅっ」
PRINTFORML 「あ……ぐぅ…！」	!#!PRINTFORML 「あ……ぐぅ…！」
PRINTFORMW （もろに食らった…！）	!#!PRINTFORMW （もろに食らった…！）
PRINTFORML 「う、が……！！」	!#!PRINTFORML 「う、が……！！」
PRINTFORMW （防ぎ…切れない…！）	!#!PRINTFORMW （防ぎ…切れない…！）
PRINTFORMW 「がああ！があああ！！」	!#!PRINTFORMW 「がああ！があああ！！」
PRINTFORML 「おグゥ！！　…ゴホッ…」	!#!PRINTFORML 「おグゥ！！　…ゴホッ…」
PRINTFORMW （う…意識が飛びかけた…）	!#!PRINTFORMW （う…意識が飛びかけた…）
PRINTFORML 「うげぇ…っ！」	!#!PRINTFORML 「うげぇ…っ！」
PRINTFORMW （こいつら…一体、どっからこんな…！）	!#!PRINTFORMW （こいつら…一体、どっからこんな…！）
PRINTFORMW 「やりやがったな…！」	!#!PRINTFORMW 「やりやがったな…！」
PRINTFORMW 「ぐはっ…！」（今のは割と効いたぞ…）	!#!PRINTFORMW 「ぐはっ…！」（今のは割と効いたぞ…）
PRINTFORMW （思ったより喰らったか…！）	!#!PRINTFORMW （思ったより喰らったか…！）
PRINTFORMW 「うぐっ！」	!#!PRINTFORMW 「うぐっ！」
PRINTFORMW 「ぐわ！」	!#!PRINTFORMW 「ぐわ！」
PRINTFORMW 「痛ェ…」	!#!PRINTFORMW 「痛ェ…」
PRINTFORMW 「この野郎ッ…！」	!#!PRINTFORMW 「この野郎ッ…！」
PRINTFORMW 「くぅっ❤良いっ❤もっと良くしてくんろっ♪」	!#!PRINTFORMW 「くぅっ❤良いっ❤もっと良くしてくんろっ♪」
PRINTFORMW 「おっ♪ほっ♪お˝っ♪トぶっ❤トんぢゃうっ❤」	!#!PRINTFORMW 「おっ♪ほっ♪お˝っ♪トぶっ❤トんぢゃうっ❤」
PRINTFORMW 「あっああっ❤しょこっ♪そこきもちいいっ❤❤」	!#!PRINTFORMW 「あっああっ❤しょこっ♪そこきもちいいっ❤❤」
PRINTFORMW 「ふぇ……へええぇ……」	!#!PRINTFORMW 「ふぇ……へええぇ……」
PRINTFORMW 「ん…ひぃ……❤」	!#!PRINTFORMW 「ん…ひぃ……❤」
PRINTFORMW 「やめへ…広げないでっ❤くんろぉ…おぎゅぎゅぎゅ…❤」	!#!PRINTFORMW 「やめへ…広げないでっ❤くんろぉ…おぎゅぎゅぎゅ…❤」
PRINTFORMW 「おっ❤おっ❤おほっ❤おっ❤…もうおひり嫌ぁ…❤❤」	!#!PRINTFORMW 「おっ❤おっ❤おほっ❤おっ❤…もうおひり嫌ぁ…❤❤」
PRINTFORMW 「うごおおぉ！❤しゅごいいいぃいっ❤❤」	!#!PRINTFORMW 「うごおおぉ！❤しゅごいいいぃいっ❤❤」
PRINTFORMW 「やめ、ひ❤ひぎああぁっ❤❤」	!#!PRINTFORMW 「やめ、ひ❤ひぎああぁっ❤❤」
PRINTFORMW 「お˝ーっ❤おほお˝ぉーっ！！❤❤」	!#!PRINTFORMW 「お˝ーっ❤おほお˝ぉーっ！！❤❤」
PRINTFORMW 「おごっ、おごごご…❤」	!#!PRINTFORMW 「おごっ、おごごご…❤」
PRINTFORMW 「うっ❤うあぁああっ…❤」	!#!PRINTFORMW 「うっ❤うあぁああっ…❤」
PRINTFORMW 「やめっ…戻らなくなるう˝っ！❤」	!#!PRINTFORMW 「やめっ…戻らなくなるう˝っ！❤」
PRINTFORMW 「どこ触っ…ひっ❤」	!#!PRINTFORMW 「どこ触っ…ひっ❤」
PRINTFORMW 「んうっ…❤」	!#!PRINTFORMW 「んうっ…❤」
PRINTFORMW 「そっちはっ、出る穴…ひあ！❤」	!#!PRINTFORMW 「そっちはっ、出る穴…ひあ！❤」
PRINTFORMW 「あひっ、ひあああぁああぁっ！！」	!#!PRINTFORMW 「あひっ、ひあああぁああぁっ！！」
PRINTFORMW 「ふぎいいいっ！あうあああぁ！」	!#!PRINTFORMW 「ふぎいいいっ！あうあああぁ！」
PRINTFORMW 「ふんぎっ！うぎいっ！！尻がっ壊れりゅぅう！」	!#!PRINTFORMW 「ふんぎっ！うぎいっ！！尻がっ壊れりゅぅう！」
PRINTFORMW 「くっ…うぁうぅ…！！」	!#!PRINTFORMW 「くっ…うぁうぅ…！！」
PRINTFORMW 「ん、ふああぁっ…！」	!#!PRINTFORMW 「ん、ふああぁっ…！」
PRINTFORMW 「やめろおぉっ広げるなあ˝ぁ！」	!#!PRINTFORMW 「やめろおぉっ広げるなあ˝ぁ！」
PRINTFORMW 「ひぎ！」	!#!PRINTFORMW 「ひぎ！」
PRINTFORMW 「触んっ、な…！」	!#!PRINTFORMW 「触んっ、な…！」
PRINTFORMW 「どこにっ…ひぅ！」	!#!PRINTFORMW 「どこにっ…ひぅ！」
PRINTFORMW 「おっ…ひ……❤」	!#!PRINTFORMW 「おっ…ひ……❤」
PRINTFORMW （乳首っ❤…イクっ❤…イヤあっ❤…）	!#!PRINTFORMW （乳首っ❤…イクっ❤…イヤあっ❤…）
PRINTFORMW 「あうううっ…おっぱい玩具にしないでくんろぉ…」	!#!PRINTFORMW 「あうううっ…おっぱい玩具にしないでくんろぉ…」
PRINTFORMW 「んあっ❤はああっ❤乳でっイかされるう˝うぅっ！❤❤」	!#!PRINTFORMW 「んあっ❤はああっ❤乳でっイかされるう˝うぅっ！❤❤」
PRINTFORMW 「乳にっ…ひっ❤乳首弾くなっあっ❤」	!#!PRINTFORMW 「乳にっ…ひっ❤乳首弾くなっあっ❤」
PRINTFORMW 「揉むんじゃ、っん❤ないっ…！」	!#!PRINTFORMW 「揉むんじゃ、っん❤ないっ…！」
PRINTFORMW 「んおっお˝おぉっ乳が壊れるぅ！！」	!#!PRINTFORMW 「んおっお˝おぉっ乳が壊れるぅ！！」
PRINTFORMW 「うっぎゅうぅ！触んなっ…搾るなあっ…！！」	!#!PRINTFORMW 「うっぎゅうぅ！触んなっ…搾るなあっ…！！」
PRINTFORMW 「ふっぐぅっ…！」	!#!PRINTFORMW 「ふっぐぅっ…！」
PRINTFORMW （そんなとこっ…触ったら…ああっ❤あっあぁ❤……）	!#!PRINTFORMW （そんなとこっ…触ったら…ああっ❤あっあぁ❤……）
PRINTFORMW 「シコシコしちゃっ…ん❤ダメえぇ…」	!#!PRINTFORMW 「シコシコしちゃっ…ん❤ダメえぇ…」
PRINTFORMW 「クリクリしちゃっ…ん❤イヤあぁ…」	!#!PRINTFORMW 「クリクリしちゃっ…ん❤イヤあぁ…」
PRINTFORMW 「おひいぃっ❤チンポコきもっちいいぃいぃ❤❤」	!#!PRINTFORMW 「おひいぃっ❤チンポコきもっちいいぃいぃ❤❤」
PRINTFORMW 「おひいぃっ❤クリはダメなにょおおぉおぉ❤❤」	!#!PRINTFORMW 「おひいぃっ❤クリはダメなにょおおぉおぉ❤❤」
PRINTFORMW 「あっ❤そこっ、らめっ❤出ちゃうっ❤」	!#!PRINTFORMW 「あっ❤そこっ、らめっ❤出ちゃうっ❤」
PRINTFORMW 「あっ❤そこっ、はっ❤弱いのぉっ///」	!#!PRINTFORMW 「あっ❤そこっ、はっ❤弱いのぉっ///」
PRINTFORMW 「んひっ！❤」	!#!PRINTFORMW 「んひっ！❤」
PRINTFORMW 「ひんっ！❤」	!#!PRINTFORMW 「ひんっ！❤」
PRINTFORMW 「ふぎいいいぎっ！あうあああぁ！」	!#!PRINTFORMW 「ふぎいいいぎっ！あうあああぁ！」
PRINTFORMW 「ひぎいうぅっ！っ射精るっ！やべでぐれぇっ！！」	!#!PRINTFORMW 「ひぎいうぅっ！っ射精るっ！やべでぐれぇっ！！」
PRINTFORMW 「うあぁあーっ！ああぁっあ˝ぁ～！！」	!#!PRINTFORMW 「うあぁあーっ！ああぁっあ˝ぁ～！！」
PRINTFORMW 「ひっあっ…う˝ぅっ…」（出す訳にはっ…！）	!#!PRINTFORMW 「ひっあっ…う˝ぅっ…」（出す訳にはっ…！）
PRINTFORMW 「ひっあっ…うぐくっ～…///」	!#!PRINTFORMW 「ひっあっ…うぐくっ～…///」
PRINTFORMW 「あぉっ…」（目立つせいで逆に守りにくいっ…！）	!#!PRINTFORMW 「あぉっ…」（目立つせいで逆に守りにくいっ…！）
PRINTFORMW 「ひんっ！」（くそっ、的確に狙ってくるっ…！）	!#!PRINTFORMW 「ひんっ！」（くそっ、的確に狙ってくるっ…！）
PRINTFORMW 「ズポズポ、しないでぇ…あっ❤あっへえぇっ❤❤」	!#!PRINTFORMW 「ズポズポ、しないでぇ…あっ❤あっへえぇっ❤❤」
PRINTFORMW （使い易いようにっ❤調教っ❤されてるううぅ❤）	!#!PRINTFORMW （使い易いようにっ❤調教っ❤されてるううぅ❤）
PRINTFORMW 「子宮っ❤押し上げっ❤…んいっ❤❤」	!#!PRINTFORMW 「子宮っ❤押し上げっ❤…んいっ❤❤」
PRINTFORMW 「おっほっ…んひいぃ❤」	!#!PRINTFORMW 「おっほっ…んひいぃ❤」
PRINTFORMW 「やめっ…今敏感んんっ❤」	!#!PRINTFORMW 「やめっ…今敏感んんっ❤」
PRINTFORMW 「ぎゆううぅっ！腹が潰れるうぅう！！」	!#!PRINTFORMW 「ぎゆううぅっ！腹が潰れるうぅう！！」
PRINTFORMW 「ひ！開くな弄るなっ、あぁっあ！」	!#!PRINTFORMW 「ひ！開くな弄るなっ、あぁっあ！」
PRINTFORMW 「んっ、のやろっ…！」	!#!PRINTFORMW 「んっ、のやろっ…！」
PRINTFORMW 「あー、あ˝ーっ❤頭っおがじぐっなるううぅ～～…❤」	!#!PRINTFORMW 「あー、あ˝ーっ❤頭っおがじぐっなるううぅ～～…❤」
PRINTFORMW （も、イヤ…んあぁ❤…助けてくれぇ……）	!#!PRINTFORMW （も、イヤ…んあぁ❤…助けてくれぇ……）
PRINTFORMW 「あひいいっ❤ひあああんっ❤❤」	!#!PRINTFORMW 「あひいいっ❤ひあああんっ❤❤」
PRINTFORMW 「おっ❤ほっ❤やめりょっ…❤❤」	!#!PRINTFORMW 「おっ❤ほっ❤やめりょっ…❤❤」
PRINTFORMW 「や、やめろっ…///」	!#!PRINTFORMW 「や、やめろっ…///」
PRINTFORMW 「ふぎいいっ！あうあああぁ！」	!#!PRINTFORMW 「ふぎいいっ！あうあああぁ！」
PRINTFORMW 「いぎっ！イかざれるうう˝ぅっ」	!#!PRINTFORMW 「いぎっ！イかざれるうう˝ぅっ」
PRINTFORMW 「んうぅっ…！」	!#!PRINTFORMW 「んうぅっ…！」
PRINTFORMW 「やめろ気色悪いっ…！」	!#!PRINTFORMW 「やめろ気色悪いっ…！」
PRINTFORMW 「あ…うあっ…！」（く、喰われるぅ…）	!#!PRINTFORMW 「あ…うあっ…！」（く、喰われるぅ…）
PRINTFORMW 「やめっ…誰かっ…助けてくんろ～…」	!#!PRINTFORMW 「やめっ…誰かっ…助けてくんろ～…」
PRINTFORMW （に、逃げないと…だめだぁ、身体が動かねぇ…）	!#!PRINTFORMW （に、逃げないと…だめだぁ、身体が動かねぇ…）
PRINTFORMW 「うわっ…何をする気だべ…！」	!#!PRINTFORMW 「うわっ…何をする気だべ…！」
PRINTFORMW 「ひ…！」（不味いべ、今は…っ❤）	!#!PRINTFORMW 「ひ…！」（不味いべ、今は…っ❤）
PRINTFORMW 「ちょ、ま、やめてくんろ…」	!#!PRINTFORMW 「ちょ、ま、やめてくんろ…」
PRINTFORMW 「う、しまっ……放せぇ！」	!#!PRINTFORMW 「う、しまっ……放せぇ！」
PRINTFORMW 「ぐえっ！」	!#!PRINTFORMW 「ぐえっ！」
PRINTFORMW 「くそっ…さっさと開放しろっ！」	!#!PRINTFORMW 「くそっ…さっさと開放しろっ！」
PRINTFORMW 「ぅあ…ああぁ……！！」	!#!PRINTFORMW 「ぅあ…ああぁ……！！」
PRINTFORMW （あぁ…出されてるっ……子宮に、ドクドクっ…❤）	!#!PRINTFORMW （あぁ…出されてるっ……子宮に、ドクドクっ…❤）
PRINTFORMW 「やめ……あへえぇ…熱いいぃ……」	!#!PRINTFORMW 「やめ……あへえぇ…熱いいぃ……」
PRINTFORMW 「やめろ、膣内はっ…あ˝あぁあ～！！❤❤」	!#!PRINTFORMW 「やめろ、膣内はっ…あ˝あぁあ～！！❤❤」
PRINTFORMW 「あっあ˝ーっ❤お、奥っ❤深いぃっ❤」	!#!PRINTFORMW 「あっあ˝ーっ❤お、奥っ❤深いぃっ❤」
PRINTFORMW 「ひいいぃ！熱いのがぁっ…！！❤」	!#!PRINTFORMW 「ひいいぃ！熱いのがぁっ…！！❤」
PRINTFORMW 「…うぎああぁっ…！！」（早くっ、掻き出さないと…！！）	!#!PRINTFORMW 「…うぎああぁっ…！！」（早くっ、掻き出さないと…！！）
PRINTFORMW 「ぐううぅっ！！」（射精された…膣内にぃ…っ！）	!#!PRINTFORMW 「ぐううぅっ！！」（射精された…膣内にぃ…っ！）
PRINTFORMW 「な、何を…うああぁっ！熱いいぃっ！？」	!#!PRINTFORMW 「な、何を…うああぁっ！熱いいぃっ！？」
PRINTFORMW 「うえっ、ゴッホホ…」	!#!PRINTFORMW 「うえっ、ゴッホホ…」
PRINTFORMW 「うっ、これは…あれ…目がぁ…」（ｶｸﾝ）	!#!PRINTFORMW 「うっ、これは…あれ…目がぁ…」（ｶｸﾝ）
PRINTFORMW 「うっ、これは……熱いっ、身体が熱っちいっ❤」	!#!PRINTFORMW 「うっ、これは……熱いっ、身体が熱っちいっ❤」
PRINTFORMW 「あ、あ…吸い付くなぁ……」	!#!PRINTFORMW 「あ、あ…吸い付くなぁ……」
PRINTFORMW 「うああっ…力がっ、吸われる…！！」	!#!PRINTFORMW 「うああっ…力がっ、吸われる…！！」
PRINTFORMW 「こ、これ以上何をさせる気だぁ…」	!#!PRINTFORMW 「こ、これ以上何をさせる気だぁ…」
PRINTFORMW 「うぎぎっ…」（こいつ、縛りを強めたな…！）	!#!PRINTFORMW 「うぎぎっ…」（こいつ、縛りを強めたな…！）
PRINTFORMW 「ひ！？…なっ、身体がっ…！？」	!#!PRINTFORMW 「ひ！？…なっ、身体がっ…！？」
PRINTFORMW 「うぐっ…！？」（しまっ…身体が…！）	!#!PRINTFORMW 「うぐっ…！？」（しまっ…身体が…！）
PRINTFORMW 「そうだ…もっとだ、うちはもっと助平になるんだぁ…❤」	!#!PRINTFORMW 「そうだ…もっとだ、うちはもっと助平になるんだぁ…❤」
PRINTFORMW 「あ、はあぁっ❤なんだかすっげえムラムラしてきたべ…❤」	!#!PRINTFORMW 「あ、はあぁっ❤なんだかすっげえムラムラしてきたべ…❤」
PRINTFORMW 「……はいはい。わかっとるよ、旦那様…」	!#!PRINTFORMW 「……はいはい。わかっとるよ、旦那様…」
PRINTFORMW 「……うん…？うちらはけっこんしたんだったっけかぁ…？」	!#!PRINTFORMW 「……うん…？うちらはけっこんしたんだったっけかぁ…？」
PRINTFORMW 「おうおう、タップリ出したな❤」	!#!PRINTFORMW 「おうおう、タップリ出したな❤」
PRINTFORMW 「んふ、臭っせぇ♪この臭さがムラムラ来るべ❤」	!#!PRINTFORMW 「んふ、臭っせぇ♪この臭さがムラムラ来るべ❤」
PRINTFORMW 「うえぇ、臭えよぉ……」	!#!PRINTFORMW 「うえぇ、臭えよぉ……」
PRINTFORMW 「あうぅ…汚え…おえっ……」	!#!PRINTFORMW 「あうぅ…汚え…おえっ……」
PRINTFORMW 「うえっぷ…臭っさ！！」	!#!PRINTFORMW 「うえっぷ…臭っさ！！」
PRINTFORMW 「ぐえー、生臭い…」	!#!PRINTFORMW 「ぐえー、生臭い…」
PRINTFORML 「んっんっんっ❤…おご❤」	!#!PRINTFORML 「んっんっんっ❤…おご❤」
PRINTFORMW （喉の奥までザーメン流し込みやがって…❤）	!#!PRINTFORMW （喉の奥までザーメン流し込みやがって…❤）
PRINTFORML 「んぐっんぐっ…ぷはっ❤」	!#!PRINTFORML 「んぐっんぐっ…ぷはっ❤」
PRINTFORMW （すっげー濃い…胃まで犯された気分だべ❤）	!#!PRINTFORMW （すっげー濃い…胃まで犯された気分だべ❤）
PRINTFORMW 「んぶ！ゴボボボ！」（溺れっるぅ…！）	!#!PRINTFORMW 「んぶ！ゴボボボ！」（溺れっるぅ…！）
PRINTFORMW 「うぐ…んぶえ……」	!#!PRINTFORMW 「うぐ…んぶえ……」
PRINTFORMW 「んんんっ！？ングゥ！」	!#!PRINTFORMW 「んんんっ！？ングゥ！」
PRINTFORMW 「おぶっ！？ぐむむ～！！」	!#!PRINTFORMW 「おぶっ！？ぐむむ～！！」
PRINTFORMW 「くっ、ふ…❤」	!#!PRINTFORMW 「くっ、ふ…❤」
PRINTFORMW 「ひー…❤」（色んな意味で危ないべ…っ❤）	!#!PRINTFORMW 「ひー…❤」（色んな意味で危ないべ…っ❤）
PRINTFORMW 「っぶねぇ…！」（くぅ…上手いこと避けられん…❤）	!#!PRINTFORMW 「っぶねぇ…！」（くぅ…上手いこと避けられん…❤）
PRINTFORMW 「やらせるか…！」	!#!PRINTFORMW 「やらせるか…！」
PRINTFORMW 「危ねぇな、っ…！」（今油断すると致命傷になり兼ねん…！）	!#!PRINTFORMW 「危ねぇな、っ…！」（今油断すると致命傷になり兼ねん…！）
PRINTFORMW 「！！」（か、掠ったべ…）	!#!PRINTFORMW 「！！」（か、掠ったべ…）
PRINTFORMW 「舐めんな！」（ひいぃー危なかったべ！）	!#!PRINTFORMW 「舐めんな！」（ひいぃー危なかったべ！）
PRINTFORMW 「ハズレだべ！」	!#!PRINTFORMW 「ハズレだべ！」
PRINTFORMW 「温い、浅い、甘すぎる！」	!#!PRINTFORMW 「温い、浅い、甘すぎる！」
PRINTFORMW 「どこに目ン玉くっ付けてんだぁ？」	!#!PRINTFORMW 「どこに目ン玉くっ付けてんだぁ？」
PRINTFORMW 「あくびが出るねぇ」	!#!PRINTFORMW 「あくびが出るねぇ」
PRINTFORMW 「当たってねえぞポンコツ」	!#!PRINTFORMW 「当たってねえぞポンコツ」
PRINTFORMW （よし、頭数は減らせた…！）	!#!PRINTFORMW （よし、頭数は減らせた…！）
PRINTFORMW 「どうだ、うちはまだやれる！」	!#!PRINTFORMW 「どうだ、うちはまだやれる！」
PRINTFORMW 「へっ、手負いでもこのくらい倒せるわ」	!#!PRINTFORMW 「へっ、手負いでもこのくらい倒せるわ」
PRINTFORMW 「さてはザコだなオメー」	!#!PRINTFORMW 「さてはザコだなオメー」
PRINTFORMW 「はいぃ次ィィ！」	!#!PRINTFORMW 「はいぃ次ィィ！」
PRINTFORMW 「この程度か、だらしねぇな」	!#!PRINTFORMW 「この程度か、だらしねぇな」
PRINTFORMW 「一丁上がり！」	!#!PRINTFORMW 「一丁上がり！」
PRINTFORMW 「次はどいつだ！？」	!#!PRINTFORMW 「次はどいつだ！？」
PRINTFORMW 「うちは、まだ…まだ、立てるべ…！」	!#!PRINTFORMW 「うちは、まだ…まだ、立てるべ…！」
PRINTFORML 「うちは、何を…うぐぅ…」	!#!PRINTFORML 「うちは、何を…うぐぅ…」
PRINTFORMW %CALLNAME:TARGET%は混乱とともに崩れ落ちた…	!#!PRINTFORMW %CALLNAME:TARGET%は混乱とともに崩れ落ちた…
PRINTFORML 催眠が%CALLNAME:TARGET%の脳の限界を超えた！	!#!PRINTFORML 催眠が%CALLNAME:TARGET%の脳の限界を超えた！
PRINTFORMW 「あへえぇっ❤ちんぽちんぽっ、おちんぽぉ❤❤」	!#!PRINTFORMW 「あへえぇっ❤ちんぽちんぽっ、おちんぽぉ❤❤」
PRINTFORMW 「も、もう限界だべ…許してくんろぉ……」	!#!PRINTFORMW 「も、もう限界だべ…許してくんろぉ……」
PRINTFORMW 「あーれーお戯れを～❤」	!#!PRINTFORMW 「あーれーお戯れを～❤」
PRINTFORMW 「ま～た破かれちまったな…」	!#!PRINTFORMW 「ま～た破かれちまったな…」
PRINTFORMW 「ひ、ひん剥かれちまったぁ…」	!#!PRINTFORMW 「ひ、ひん剥かれちまったぁ…」
PRINTFORMW 「あーあー、これじゃボロ布にもなりゃしねえ…」	!#!PRINTFORMW 「あーあー、これじゃボロ布にもなりゃしねえ…」
PRINTFORMW 「今更こんなんで恥ずかしがると思うなよ！」	!#!PRINTFORMW 「今更こんなんで恥ずかしがると思うなよ！」
PRINTFORMW （ははは恥ずかしいべー！？）	!#!PRINTFORMW （ははは恥ずかしいべー！？）
PRINTFORMW （このくらいじゃ隠さんでも良いか）	!#!PRINTFORMW （このくらいじゃ隠さんでも良いか）
PRINTFORMW （まずいっ、大事なところ隠さんと！！）	!#!PRINTFORMW （まずいっ、大事なところ隠さんと！！）
PRINTFORMW 「やめろ馬鹿っ、服が勿体ねえべ！」	!#!PRINTFORMW 「やめろ馬鹿っ、服が勿体ねえべ！」
PRINTFORMW 「やめろ馬鹿っ、見えちまうべ！？」	!#!PRINTFORMW 「やめろ馬鹿っ、見えちまうべ！？」
PRINTFORMW 「あっこら、止めんか！」	!#!PRINTFORMW 「あっこら、止めんか！」
PRINTFORMW 「げっ、服が！？」	!#!PRINTFORMW 「げっ、服が！？」
PRINTFORMDW しかし%CALLNAME:TARGET%は眠っている！	!#!PRINTFORMDW しかし%CALLNAME:TARGET%は眠っている！
PRINTFORMW 「い、今はダメだべ…！」	!#!PRINTFORMW 「い、今はダメだべ…！」
PRINTFORMW 「い、今は不味いべ！」	!#!PRINTFORMW 「い、今は不味いべ！」
PRINTFORMW 「親玉だか支配者だか知らねえけども、出て行ってくんろ！」	!#!PRINTFORMW 「親玉だか支配者だか知らねえけども、出て行ってくんろ！」
PRINTFORML 「うぅ…❤」	!#!PRINTFORML 「うぅ…❤」
PRINTFORMW （集中出来ないタイミングを狙ってたか…！！）	!#!PRINTFORMW （集中出来ないタイミングを狙ってたか…！！）
PRINTFORMW 「あ…マズッ…」	!#!PRINTFORMW 「あ…マズッ…」
PRINTFORMW 「弱り目に祟り目か…」	!#!PRINTFORMW 「弱り目に祟り目か…」
PRINTFORML 「……ッ！？」	!#!PRINTFORML 「……ッ！？」
PRINTFORMW （しまった、反応が遅れたっ…！）	!#!PRINTFORMW （しまった、反応が遅れたっ…！）
PRINTFORMW （気が逸れてたか…！？）	!#!PRINTFORMW （気が逸れてたか…！？）
PRINTFORMW 「なんだ？！敵ぃ！？」	!#!PRINTFORMW 「なんだ？！敵ぃ！？」
PRINTFORMW 「小賢しい真似を…！」	!#!PRINTFORMW 「小賢しい真似を…！」
PRINTFORMW 「悶々とムシャクシャするから一発殴らせろッ！」	!#!PRINTFORMW 「悶々とムシャクシャするから一発殴らせろッ！」
PRINTFORMW （先手で伸せば色々されることもないはず…だ）	!#!PRINTFORMW （先手で伸せば色々されることもないはず…だ）
PRINTFORMW 「潰される前に潰す！」	!#!PRINTFORMW 「潰される前に潰す！」
PRINTFORMW （よし、先手なら…！）	!#!PRINTFORMW （よし、先手なら…！）
PRINTFORMW 「お、絶好のチャンス！」	!#!PRINTFORMW 「お、絶好のチャンス！」
PRINTFORMW 「後ろがガラ空きだぞ？」	!#!PRINTFORMW 「後ろがガラ空きだぞ？」
PRINTFORMW 「こっちの先制攻撃だべ！」	!#!PRINTFORMW 「こっちの先制攻撃だべ！」
PRINTFORMW 「やんなきゃ、ヤられるべ…❤」	!#!PRINTFORMW 「やんなきゃ、ヤられるべ…❤」
PRINTFORML 「はっ…はっ…❤」	!#!PRINTFORML 「はっ…はっ…❤」
PRINTFORMW （イカン、気を散らしては…！）	!#!PRINTFORMW （イカン、気を散らしては…！）
PRINTFORMW （こんな状態じゃ当然狙ってくるか…）	!#!PRINTFORMW （こんな状態じゃ当然狙ってくるか…）
PRINTFORMW （不味い時に出会ったな…）	!#!PRINTFORMW （不味い時に出会ったな…）
PRINTFORMW 「……へっ、いいハンデだろうよ…！！」	!#!PRINTFORMW 「……へっ、いいハンデだろうよ…！！」
PRINTFORMW 「弱ってるところに漬け込みよって…！」	!#!PRINTFORMW 「弱ってるところに漬け込みよって…！」
PRINTFORMW 「さ～て、いっちょ豪快に捌くべ！」	!#!PRINTFORMW 「さ～て、いっちょ豪快に捌くべ！」
PRINTFORMDW %CALLNAME:TARGET%は素振りをしている。	!#!PRINTFORMDW %CALLNAME:TARGET%は素振りをしている。
PRINTFORMW 「うっし、やるか！」	!#!PRINTFORMW 「うっし、やるか！」
PRINTFORMW 「軽く伸してやるべ」	!#!PRINTFORMW 「軽く伸してやるべ」
PRINTFORMDW %CALLNAME:TARGET%は仲間に担がれていった…	!#!PRINTFORMDW %CALLNAME:TARGET%は仲間に担がれていった…
PRINTFORML 「……Zzz…ふげっ……」	!#!PRINTFORML 「……Zzz…ふげっ……」
PRINTFORMW 「ひぃ、ひぃ…❤　うぅっ、辛いべ…」	!#!PRINTFORMW 「ひぃ、ひぃ…❤　うぅっ、辛いべ…」
PRINTFORMW 「に、逃げられて良かったべ…❤」	!#!PRINTFORMW 「に、逃げられて良かったべ…❤」
PRINTFORMW 「あのまま戦ってたらヤバかったかもな…」	!#!PRINTFORMW 「あのまま戦ってたらヤバかったかもな…」
PRINTFORMW 「立て直さないと不味いべ…」	!#!PRINTFORMW 「立て直さないと不味いべ…」
PRINTFORMW 「端から倒してたらキリ無いべ」	!#!PRINTFORMW 「端から倒してたらキリ無いべ」
PRINTFORMW 「悔しいが、矢鱈に突っ込んでも犬死するだけだべ…」	!#!PRINTFORMW 「悔しいが、矢鱈に突っ込んでも犬死するだけだべ…」
PRINTFORMW 「『戦略的撤退』ってやつだ、うん」	!#!PRINTFORMW 「『戦略的撤退』ってやつだ、うん」
PRINTFORMW 「ふーっ❤ふーっ❤…何とかなったべ…」	!#!PRINTFORMW 「ふーっ❤ふーっ❤…何とかなったべ…」
PRINTFORMW 「強いやつは嫌いではない。もっとも、限度ってもんがあるけどな」	!#!PRINTFORMW 「強いやつは嫌いではない。もっとも、限度ってもんがあるけどな」
PRINTFORMW 「苗床は御免被るべ…」	!#!PRINTFORMW 「苗床は御免被るべ…」
PRINTFORMW 「こいつら案外強いな…一体何者なんだか」	!#!PRINTFORMW 「こいつら案外強いな…一体何者なんだか」
PRINTFORMW 「次はちょっといかんかもな…」	!#!PRINTFORMW 「次はちょっといかんかもな…」
PRINTFORMW 「うーん、結構疲れたべ…」	!#!PRINTFORMW 「うーん、結構疲れたべ…」
PRINTFORMDW %CALLNAME:TARGET%の顔からは疲労の色が見える。	!#!PRINTFORMDW %CALLNAME:TARGET%の顔からは疲労の色が見える。
PRINTFORMW 「まだ、何とかなるべ…！」	!#!PRINTFORMW 「まだ、何とかなるべ…！」
PRINTFORMW （開いて天日に干したら喰えるべか…？）	!#!PRINTFORMW （開いて天日に干したら喰えるべか…？）
PRINTFORMW 「威勢の良さだけは買ってやるよ」	!#!PRINTFORMW 「威勢の良さだけは買ってやるよ」
PRINTFORMW 「山姥の怖さを知らねえのか？それとも向こう見ずなんか？」	!#!PRINTFORMW 「山姥の怖さを知らねえのか？それとも向こう見ずなんか？」
PRINTFORMW 「どいつもこいつも、発情期だべかコノヤロー」	!#!PRINTFORMW 「どいつもこいつも、発情期だべかコノヤロー」
PRINTFORMW 「…いややっぱ持って帰るのは止しとくか」	!#!PRINTFORMW 「…いややっぱ持って帰るのは止しとくか」
PRINTFORMW 「しまった……うっかり置いてきたべ」	!#!PRINTFORMW 「しまった……うっかり置いてきたべ」
PRINTFORML 「見捨てないでくんろぉ…」	!#!PRINTFORML 「見捨てないでくんろぉ…」
PRINTFORMDW %CALLNAME:TARGET%は仲間に置いて行かれた…	!#!PRINTFORMDW %CALLNAME:TARGET%は仲間に置いて行かれた…
PRINTFORML 「ちょ、助けてくんろぉ～！」	!#!PRINTFORML 「ちょ、助けてくんろぉ～！」
PRINTFORMW 「来るっ♪気持ち良いの来るっ♪ひあ゛ああぁぁ～っ！❤❤」	!#!PRINTFORMW 「来るっ♪気持ち良いの来るっ♪ひあ゛ああぁぁ～っ！❤❤」
PRINTFORMW 「ぶひいぃっ❤ふぎいいぃいいぃいいぃ！！❤❤」	!#!PRINTFORMW 「ぶひいぃっ❤ふぎいいぃいいぃいいぃ！！❤❤」
PRINTFORMW 「そこっ❤そこしゅきぃ❤んおおぉ♪❤お゛ぉぉおおぉ❤❤」	!#!PRINTFORMW 「そこっ❤そこしゅきぃ❤んおおぉ♪❤お゛ぉぉおおぉ❤❤」
PRINTFORMW 「いか…されぅっ…あ˝あぁあぁああぁ！！❤❤」	!#!PRINTFORMW 「いか…されぅっ…あ˝あぁあぁああぁ！！❤❤」
PRINTFORMW 「はひっ❤はひいぃぃいぃっ❤❤」	!#!PRINTFORMW 「はひっ❤はひいぃぃいぃっ❤❤」
PRINTFORMW 「ふ、ひ❤…あひいぃーーっ！❤❤」	!#!PRINTFORMW 「ふ、ひ❤…あひいぃーーっ！❤❤」
PRINTFORMW 「ダメッ❤…イッ、イっクぅううううぅうぅ！！❤❤」	!#!PRINTFORMW 「ダメッ❤…イッ、イっクぅううううぅうぅ！！❤❤」
PRINTFORMW 「や…だ…んあ˝っ❤あああぁ～～～～っ❤❤❤」	!#!PRINTFORMW 「や…だ…んあ˝っ❤あああぁ～～～～っ❤❤❤」
PRINTFORMW 「も、ムリぃ…んのお˝おぉおぉおっ❤❤❤」	!#!PRINTFORMW 「も、ムリぃ…んのお˝おぉおぉおっ❤❤❤」
PRINTFORMW 「も❤やめでっ❤くんろ˝おおぉ～～っ❤❤」	!#!PRINTFORMW 「も❤やめでっ❤くんろ˝おおぉ～～っ❤❤」
PRINTFORMW 「❤っ❤❤っ❤～～ッ❤❤❤」（ｶﾞｸｶﾞｸｶﾞｸ）	!#!PRINTFORMW 「❤っ❤❤っ❤～～ッ❤❤❤」（ｶﾞｸｶﾞｸｶﾞｸ）
PRINTFORMW 「ひ…❤❤　あ…❤　ふいぃんっ…❤❤❤」	!#!PRINTFORMW 「ひ…❤❤　あ…❤　ふいぃんっ…❤❤❤」
PRINTFORMW 「お❤❤あへっ❤❤ん˝ほおおぉ…❤❤❤」	!#!PRINTFORMW 「お❤❤あへっ❤❤ん˝ほおおぉ…❤❤❤」
PRINTFORML （うちは…狩られる獲物側だったか…）	!#!PRINTFORML （うちは…狩られる獲物側だったか…）
PRINTFORMW （狩られて、喰われて……呆気ない…もんだ…な……）	!#!PRINTFORMW （狩られて、喰われて……呆気ない…もんだ…な……）
PRINTFORML 「さってと、どうするべか？」	!#!PRINTFORML 「さってと、どうするべか？」
PRINTFORML 「………ﾝｶﾞｧｯ！………ぐぅ～………」	!#!PRINTFORML 「………ﾝｶﾞｧｯ！………ぐぅ～………」
PRINTFORML 「んむぅ…❤　……んんっ❤」	!#!PRINTFORML 「んむぅ…❤　……んんっ❤」
PRINTFORMDL %CALLNAME:TARGET%は良からぬ夢を見ているようだ…	!#!PRINTFORMDL %CALLNAME:TARGET%は良からぬ夢を見ているようだ…
PRINTFORML 「んぁががぁ………すぴゅうぅ～～………」	!#!PRINTFORML 「んぁががぁ………すぴゅうぅ～～………」
PRINTFORML （ｸﾞｶﾞｧ…）「……梅ジャムと……味噌少々…」（ｽﾋﾟｨ…）	!#!PRINTFORML （ｸﾞｶﾞｧ…）「……梅ジャムと……味噌少々…」（ｽﾋﾟｨ…）
PRINTFORML 「……特等？そりゃめでてぇ…………そんだけだ、帰ぇれ……」	!#!PRINTFORML 「……特等？そりゃめでてぇ…………そんだけだ、帰ぇれ……」
PRINTFORML 「はっ、はっ❤どうにか収まらねぇべか…❤」	!#!PRINTFORML 「はっ、はっ❤どうにか収まらねぇべか…❤」
PRINTFORML （ﾁﾗｯ）「うぅ～…流されちゃイカン…！」	!#!PRINTFORML （ﾁﾗｯ）「うぅ～…流されちゃイカン…！」
PRINTFORML （ああ、体が火照る…落ち着かねぇ…）	!#!PRINTFORML （ああ、体が火照る…落ち着かねぇ…）
PRINTFORML （ちんぽ起ちっぱなしって結構辛いべ……）	!#!PRINTFORML （ちんぽ起ちっぱなしって結構辛いべ……）
PRINTFORML （またぐらが濡れっぱなしで気持ち悪いべ……）	!#!PRINTFORML （またぐらが濡れっぱなしで気持ち悪いべ……）
PRINTFORML （…イカン、癖になりそうな気分だ…❤）	!#!PRINTFORML （…イカン、癖になりそうな気分だ…❤）
PRINTFORML （こんな時に裸で徘徊なんて、変な癖がついちまう……///）	!#!PRINTFORML （こんな時に裸で徘徊なんて、変な癖がついちまう……///）
PRINTFORML 「服があるだけマシ、だな」	!#!PRINTFORML 「服があるだけマシ、だな」
PRINTFORML （そうでも考えないとやって行けねえ…）	!#!PRINTFORML （そうでも考えないとやって行けねえ…）
PRINTFORML 「フーッ❤フーッ❤…熱いっ…体が熱っちぃ…❤」	!#!PRINTFORML 「フーッ❤フーッ❤…熱いっ…体が熱っちぃ…❤」
PRINTFORML 「ずっとこのままになってるけど…どうすんべ…？」	!#!PRINTFORML 「ずっとこのままになってるけど…どうすんべ…？」
PRINTFORML 「早く元に戻ってほしいべ…」	!#!PRINTFORML 「早く元に戻ってほしいべ…」
PRINTFORML （…ﾂﾝｯ）「う…しっかり感触がある…」	!#!PRINTFORML （…ﾂﾝｯ）「う…しっかり感触がある…」
PRINTFORML （まるっと見えちまってる…！）	!#!PRINTFORML （まるっと見えちまってる…！）
PRINTFORML 「まぁ隠せてるだけマシかねぇ…」	!#!PRINTFORML 「まぁ隠せてるだけマシかねぇ…」
PRINTFORML 「どういう原理だか、さっぱりわからんな…」	!#!PRINTFORML 「どういう原理だか、さっぱりわからんな…」
PRINTFORML 「……何でも慣れるもんだな」	!#!PRINTFORML 「……何でも慣れるもんだな」
PRINTFORML 「思ったより歩くのに邪魔だな…」	!#!PRINTFORML 「思ったより歩くのに邪魔だな…」
PRINTFORML 「眠い！うちはもう…寝るぞぉ…！」	!#!PRINTFORML 「眠い！うちはもう…寝るぞぉ…！」
PRINTFORMDL ネムノは大口を開けてあくびをしている…	!#!PRINTFORMDL ネムノは大口を開けてあくびをしている…
PRINTFORML （あ˝ー…………）	!#!PRINTFORML （あ˝ー…………）
PRINTFORML %CALLNAME:TARGET%は眠気で思考が止まっている…	!#!PRINTFORML %CALLNAME:TARGET%は眠気で思考が止まっている…
PRINTFORML 「寝てねぇから、疲れたべ……」	!#!PRINTFORML 「寝てねぇから、疲れたべ……」
PRINTFORML 「あ、服…いやもう寝るのが先だべ…」	!#!PRINTFORML 「あ、服…いやもう寝るのが先だべ…」
PRINTFORML 「うぇっ…うぅ、具合悪ぃ…」	!#!PRINTFORML 「うぇっ…うぅ、具合悪ぃ…」
PRINTFORML 「つわりなんて経験したくなかったべ…」	!#!PRINTFORML 「つわりなんて経験したくなかったべ…」
PRINTFORML 「体が重い…腹に体力持ってかれてるみてえだぁ…」	!#!PRINTFORML 「体が重い…腹に体力持ってかれてるみてえだぁ…」
PRINTFORML 「どうせ服着ても、すぐ引っぺがされるべ…」	!#!PRINTFORML 「どうせ服着ても、すぐ引っぺがされるべ…」
PRINTFORML 「そこらに布きれの一つでも落ちてねぇべか…？」	!#!PRINTFORML 「そこらに布きれの一つでも落ちてねぇべか…？」
PRINTFORML 「割り切りゃ恰好なんてどうってことないな」	!#!PRINTFORML 「割り切りゃ恰好なんてどうってことないな」
PRINTFORML （こんな格好で出歩くの恥ずかしいべ…///）	!#!PRINTFORML （こんな格好で出歩くの恥ずかしいべ…///）
PRINTFORML 「なんか見られてる気がするべ。ま、気にしてもしゃあないな」	!#!PRINTFORML 「なんか見られてる気がするべ。ま、気にしてもしゃあないな」
PRINTFORML 「なんか見られてる気がするべ…嫌だわぁ…」	!#!PRINTFORML 「なんか見られてる気がするべ…嫌だわぁ…」
PRINTFORML 「もう裸にも慣れたべ。…それでいいのか疑問だけども」	!#!PRINTFORML 「もう裸にも慣れたべ。…それでいいのか疑問だけども」
PRINTFORML 「素っ裸で出歩くなんて…嫁に行けねぇべ…」	!#!PRINTFORML 「素っ裸で出歩くなんて…嫁に行けねぇべ…」
PRINTFORML 「包丁、砥ぎてぇなぁ…」	!#!PRINTFORML 「包丁、砥ぎてぇなぁ…」
PRINTFORML 「なんかその辺にキノコ生えてそうだべ。喰う気はしねぇけど」	!#!PRINTFORML 「なんかその辺にキノコ生えてそうだべ。喰う気はしねぇけど」
PRINTFORML 「肉喰いてぇなぁ…家に干しといた肉はどうなってるんだべか」	!#!PRINTFORML 「肉喰いてぇなぁ…家に干しといた肉はどうなってるんだべか」
PRINTFORML 「んー、ここはどの辺りなんじゃろうかねー」	!#!PRINTFORML 「んー、ここはどの辺りなんじゃろうかねー」
PRINTFORML 「ここは空気が良くないし、殺風景だな。なわばりにはしたく無ぇな」	!#!PRINTFORML 「ここは空気が良くないし、殺風景だな。なわばりにはしたく無ぇな」
PRINTFORML 「……腹ァ減ったな～……」	!#!PRINTFORML 「……腹ァ減ったな～……」
PRINTFORMW 「ん、なんだべこりゃ？」	!#!PRINTFORMW 「ん、なんだべこりゃ？」
PRINTFORMDL 自分の住み家の近くに、いつの間にやら洞穴が開いている。	!#!PRINTFORMDL 自分の住み家の近くに、いつの間にやら洞穴が開いている。
PRINTFORMDW 全く見覚えのないソレに、山姥…坂田ネムノは怪訝な顔をした。	!#!PRINTFORMDW 全く見覚えのないソレに、山姥…坂田ネムノは怪訝な顔をした。
PRINTFORML 「餓鬼の悪戯じゃこんなデカい穴は無理だな。天狗が開けてったのか？	!#!PRINTFORML 「餓鬼の悪戯じゃこんなデカい穴は無理だな。天狗が開けてったのか？
PRINTFORMW 　…誰だか知らんがうちの縄張りに勝手なことをしよって、許さん！」	!#!PRINTFORMW 　…誰だか知らんがうちの縄張りに勝手なことをしよって、許さん！」
PRINTFORML 「居るんならとっとと出てこーい！でないと食っちまうぞ～！」	!#!PRINTFORML 「居るんならとっとと出てこーい！でないと食っちまうぞ～！」
PRINTFORMDW ネムノは洞窟の中へズカズカと入っていった。	!#!PRINTFORMDW ネムノは洞窟の中へズカズカと入っていった。
PRINTFORMW 「お？中は案外広いな…松明でも持って来りゃよかったか」	!#!PRINTFORMW 「お？中は案外広いな…松明でも持って来りゃよかったか」
PRINTFORMDW 暗さで足元が見えなかったネムノは、急勾配に気づかずつんのめった！	!#!PRINTFORMDW 暗さで足元が見えなかったネムノは、急勾配に気づかずつんのめった！
PRINTFORMW 「うぇっ！？…ひえぇえぇっ！！」	!#!PRINTFORMW 「うぇっ！？…ひえぇえぇっ！！」
PRINTFORMDW 洞窟は途中から急な坂になっており、その先には大きな穴が口を開けていた。	!#!PRINTFORMDW 洞窟は途中から急な坂になっており、その先には大きな穴が口を開けていた。
PRINTFORML 「おわああああぁぁぁ～～………」	!#!PRINTFORML 「おわああああぁぁぁ～～………」
PRINTFORMDW 成す術もなく、ネムノは転げ落ちていった…	!#!PRINTFORMDW 成す術もなく、ネムノは転げ落ちていった…
PRINTFORMW 	!#!PRINTFORMW 
PRINTFORMW 広い空間の壁から出てきたネムノは、クルクル回りながら床に落ちた。	!#!PRINTFORMW 広い空間の壁から出てきたネムノは、クルクル回りながら床に落ちた。
PRINTFORMW （ﾄﾞｽﾝ）「うげぇ！！い、痛…くない？んん？」	!#!PRINTFORMW （ﾄﾞｽﾝ）「うげぇ！！い、痛…くない？んん？」
PRINTFORMDL よく見ると足元は土や石ではなく、柔らかい何かだった。	!#!PRINTFORMDL よく見ると足元は土や石ではなく、柔らかい何かだった。
PRINTFORMDW 足元だけでなく、周囲も、出てきた壁も、天井も同じような物質で出来ていた。	!#!PRINTFORMDW 足元だけでなく、周囲も、出てきた壁も、天井も同じような物質で出来ていた。
PRINTFORMW 「うぇー、なんだか変なとこに迷い込んだな…げ、包丁も無い…」	!#!PRINTFORMW 「うぇー、なんだか変なとこに迷い込んだな…げ、包丁も無い…」
PRINTFORML 「…まぁ、失くしたもんはしょうがねぇ。	!#!PRINTFORML 「…まぁ、失くしたもんはしょうがねぇ。
PRINTFORMW 　何があったのかは知らねえけど、代わりのを適当に拾ってさっさと出るべ！」	!#!PRINTFORMW 　何があったのかは知らねえけど、代わりのを適当に拾ってさっさと出るべ！」
PRINTFORMDW ネムノは脱出に向け、動き出した。	!#!PRINTFORMDW ネムノは脱出に向け、動き出した。
