//口上:

PRINTFORML 寄生＆妊娠系も搭載　こちらもそれぞれランダム分岐を用意。何回もアリスを孕ませたい紳士な方に	PRINTFORML 寄生＆妊娠系も搭載　こちらもそれぞれランダム分岐を用意。何回もアリスを孕ませたい紳士な方に
PRINTFORMDW 一途に乳をもとめようとする異形に対して、アリスはなぜか抵抗をする気がおきない……	PRINTFORMDW 一途に乳をもとめようとする異形に対して、アリスはなぜか抵抗をする気がおきない……
PRINTFORMDW 胎内で育つモノのことを考えないように、アリスは別のことに思考を巡らせている……	PRINTFORMDW 胎内で育つモノのことを考えないように、アリスは別のことに思考を巡らせている……
PRINTFORMDW アリスの子宮を借り宿にしていた異形はようやく外に出られた喜びに打ち震えている！	PRINTFORMDW アリスの子宮を借り宿にしていた異形はようやく外に出られた喜びに打ち震えている！
PRINTFORMDW アリスの必死の抵抗も虚しく、激しい絶頂を迎えた直後の身体は言うことを聞かない…	PRINTFORMDW アリスの必死の抵抗も虚しく、激しい絶頂を迎えた直後の身体は言うことを聞かない…
PRINTFORMDW 我が子が産道をこする度、限界まで拡張したアリスの膣洞に激しい快感が走り抜ける！	PRINTFORMDW 我が子が産道をこする度、限界まで拡張したアリスの膣洞に激しい快感が走り抜ける！
PRINTFORMDW 望まれなかった生命は、産んでくれた母親に感謝するように全身を愛撫しつづける……	PRINTFORMDW 望まれなかった生命は、産んでくれた母親に感謝するように全身を愛撫しつづける……
PRINTFORMDW アリスのクレヴァスからは愛液が泉のごとく溢れ、くぱくぱと痙攣し続けている！	PRINTFORMDW アリスのクレヴァスからは愛液が泉のごとく溢れ、くぱくぱと痙攣し続けている！
PRINTFORMDW そのまま触手の幼体は身をくねらせアリスの乳房に巻きつき母乳をしぼりあげる！	PRINTFORMDW そのまま触手の幼体は身をくねらせアリスの乳房に巻きつき母乳をしぼりあげる！
PRINTFORMDW どうやらアリスの肉体はこの迷宮で条理の外側から造り替えられてしまったようだ	PRINTFORMDW どうやらアリスの肉体はこの迷宮で条理の外側から造り替えられてしまったようだ
PRINTFORMDW 触手の手からは逃れられないことを悟ると、アリスの手がだらりと下がった……	PRINTFORMDW 触手の手からは逃れられないことを悟ると、アリスの手がだらりと下がった……
PRINTFORMDW 　背中から回りこむ触手の気配を感じ、アリスはお尻をふって狙いを逸らした！	PRINTFORMDW 　背中から回りこむ触手の気配を感じ、アリスはお尻をふって狙いを逸らした！
PRINTFORMDW 腸内に侵入したおぞましい感覚をアリスはお尻をふって振り払おうをしている！	PRINTFORMDW 腸内に侵入したおぞましい感覚をアリスはお尻をふって振り払おうをしている！
PRINTFORMDW 得体のしれない生命との行為で子を孕んだ事実に、アリスは呆然としている……	PRINTFORMDW 得体のしれない生命との行為で子を孕んだ事実に、アリスは呆然としている……
PRINTFORMDW 内側から腹をける我が子の感触に、アリスはなんとも言えない気分になった……	PRINTFORMDW 内側から腹をける我が子の感触に、アリスはなんとも言えない気分になった……
PRINTFORMDW 本人の思惑とは別に、母親となる準備を終えた乳房の先端から母乳が滴っている	PRINTFORMDW 本人の思惑とは別に、母親となる準備を終えた乳房の先端から母乳が滴っている
PRINTFORMDW 胎内から犯されきったアリスはしばらくそのままピクリとも動けなかった……	PRINTFORMDW 胎内から犯されきったアリスはしばらくそのままピクリとも動けなかった……
PRINTFORML なるべく自然な口上　触手宮の雰囲気に合わせ、かつアリスっぽいものを想定	PRINTFORML なるべく自然な口上　触手宮の雰囲気に合わせ、かつアリスっぽいものを想定
PRINTFORMDW お人形のように動けないアリスを、産まれたばかり獣が犯し続けている……	PRINTFORMDW お人形のように動けないアリスを、産まれたばかり獣が犯し続けている……
PRINTFORMDW 　敏感な部分をくすぐられたアリスは身をくねらせて、触手から離れた！	PRINTFORMDW 　敏感な部分をくすぐられたアリスは身をくねらせて、触手から離れた！
PRINTFORMDW 触手は冒涜的な儀式を経てアリスに自らの児を孕ませようとしている……	PRINTFORMDW 触手は冒涜的な儀式を経てアリスに自らの児を孕ませようとしている……
PRINTFORMDW 身に覚えがあるアリスは、異形の子種で妊娠した現実に驚愕している……	PRINTFORMDW 身に覚えがあるアリスは、異形の子種で妊娠した現実に驚愕している……
PRINTFORMDW アリスの乳首から吹き出した母乳が噴水のように細く弧を描いている……	PRINTFORMDW アリスの乳首から吹き出した母乳が噴水のように細く弧を描いている……
PRINTFORMDW 　体からくる刺激と恐怖にアリスの精神はこれ以上耐えれそうにない！	PRINTFORMDW 　体からくる刺激と恐怖にアリスの精神はこれ以上耐えれそうにない！
PRINTFORML   なんでかって？　作る手間が省けるじゃない。……いや、人形をよ」	PRINTFORML   なんでかって？　作る手間が省けるじゃない。……いや、人形をよ」
PRINTFORML 「外の世界で私と同じ名前の魔女がいるらしいわ。会ってみたいわね」	PRINTFORML 「外の世界で私と同じ名前の魔女がいるらしいわ。会ってみたいわね」
PRINTFORMDW アリスは涙をこらえて、懸命にふくらみきった腹を押さえている……	PRINTFORMDW アリスは涙をこらえて、懸命にふくらみきった腹を押さえている……
PRINTFORMDW 敵の子を産み落としてしまったことに、アリスは歯噛みしている……	PRINTFORMDW 敵の子を産み落としてしまったことに、アリスは歯噛みしている……
PRINTFORMDW 寄生出産を終えてなお、火照り続ける体をアリスは自分で慰めた……	PRINTFORMDW 寄生出産を終えてなお、火照り続ける体をアリスは自分で慰めた……
PRINTFORMDW 思わず涙を流したアリスの足の間に、破瓜の証が滴り落ちている……	PRINTFORMDW 思わず涙を流したアリスの足の間に、破瓜の証が滴り落ちている……
PRINTFORMDW 　とてつもなく敏感になった部位からアリスは意識を背けている！	PRINTFORMDW 　とてつもなく敏感になった部位からアリスは意識を背けている！
PRINTFORMDW 　触手に体を弄ばれながらも、アリスはまだ闘志を失っていない！	PRINTFORMDW 　触手に体を弄ばれながらも、アリスはまだ闘志を失っていない！
PRINTFORMDW 　アリスは欲情に集中を乱され、ありったけの人形を投げつけた！	PRINTFORMDW 　アリスは欲情に集中を乱され、ありったけの人形を投げつけた！
PRINTFORMDW 　急に体中がうずいたアリスは武器の弾を縦横無尽にばらまいた！	PRINTFORMDW 　急に体中がうずいたアリスは武器の弾を縦横無尽にばらまいた！
PRINTFORML アリスはボロきれと化した服を、未練がましそうに見つめている……	PRINTFORML アリスはボロきれと化した服を、未練がましそうに見つめている……
PRINTFORMDW  アリスは迷宮の物陰に屈みこんだあと、息をついて出てきた……	PRINTFORMDW  アリスは迷宮の物陰に屈みこんだあと、息をついて出てきた……
PRINTFORMDW M字に開脚したアリスの股から異形との落とし子が産声をあげる！	PRINTFORMDW M字に開脚したアリスの股から異形との落とし子が産声をあげる！
PRINTFORMDW その瞬間、強烈な快楽の痺れにアリスの頭の中が真っ白に染まる！	PRINTFORMDW その瞬間、強烈な快楽の痺れにアリスの頭の中が真っ白に染まる！
PRINTFORMDW 膣内に侵入したおぞましい感覚にアリスは身を震わせている……	PRINTFORMDW 膣内に侵入したおぞましい感覚にアリスは身を震わせている……
PRINTFORML 「……か、感じ、　ないわ……　！？　──ふぅうぁあああ!!」	PRINTFORML 「……か、感じ、　ないわ……　！？　──ふぅうぁあああ!!」
PRINTFORMDW 　アリスは発情しきった体を理性と同時に守ろうとしている！	PRINTFORMDW 　アリスは発情しきった体を理性と同時に守ろうとしている！
PRINTFORMDW 　顔を染めたアリスは自分の胸と大事な箇所を押さえている！	PRINTFORMDW 　顔を染めたアリスは自分の胸と大事な箇所を押さえている！
PRINTFORML 「材料があれば、貴方をモデルに人形作ってあげてもいいわよ」	PRINTFORML 「材料があれば、貴方をモデルに人形作ってあげてもいいわよ」
PRINTFORML 「外の世界から流れてくる人形って角張ってるのが多いわねぇ」	PRINTFORML 「外の世界から流れてくる人形って角張ってるのが多いわねぇ」
PRINTFORML 「何体まで同時に操れるかって？　さぁ……試したことないわ」	PRINTFORML 「何体まで同時に操れるかって？　さぁ……試したことないわ」
PRINTFORMDW 触手に弄ばれたアリスの身体はさらなる悦楽を欲している……	PRINTFORMDW 触手に弄ばれたアリスの身体はさらなる悦楽を欲している……
PRINTFORMDW どこか遠くの出来事のように、アリスはそれを眺めていた……	PRINTFORMDW どこか遠くの出来事のように、アリスはそれを眺めていた……
PRINTFORMDW アリスは秘貝開帳するような体勢で這い出た幼体を出迎えた！	PRINTFORMDW アリスは秘貝開帳するような体勢で這い出た幼体を出迎えた！
﻿PRINTFORML ランダム分岐を多め　繰り返しが飽きにくいものを目指して。	PRINTFORML ランダム分岐を多め　繰り返しが飽きにくいものを目指して。
PRINTFORMDW 　アリスは頬を染めながら、必死に歯を食いしばっている！	PRINTFORMDW 　アリスは頬を染めながら、必死に歯を食いしばっている！
PRINTFORML 人形のようにアリスは　虚ろな瞳で何かを考え込んでいる……	PRINTFORML 人形のようにアリスは　虚ろな瞳で何かを考え込んでいる……
PRINTFORML   え？　この前歩いていたのを見たって？　そんなまさか」	PRINTFORML   え？　この前歩いていたのを見たって？　そんなまさか」
PRINTFORMDW アリスの体は絶頂の余韻でビクビクと痙攣し続けている……	PRINTFORMDW アリスの体は絶頂の余韻でビクビクと痙攣し続けている……
PRINTFORML 「いたっ……あわてないで。　まだ、いっぱいあるから……」	PRINTFORML 「いたっ……あわてないで。　まだ、いっぱいあるから……」
PRINTFORML 一度に展開した人形達が敵全体に向けて一斉射撃を始めた！	PRINTFORML 一度に展開した人形達が敵全体に向けて一斉射撃を始めた！
PRINTFORMDW 不浄の穴に触れられる感覚にアリスは戸惑いを隠せない！	PRINTFORMDW 不浄の穴に触れられる感覚にアリスは戸惑いを隠せない！
PRINTFORMDW 　会話の途中でアリスは言葉を止め、お腹をさすった……	PRINTFORMDW 　会話の途中でアリスは言葉を止め、お腹をさすった……
PRINTFORML 「人形とお風呂に入りたかったから防水加工を施したのよ」	PRINTFORML 「人形とお風呂に入りたかったから防水加工を施したのよ」
PRINTFORML 「この前ドールハウスというのを見たわ。あれは職人芸ね。	PRINTFORML 「この前ドールハウスというのを見たわ。あれは職人芸ね。
PRINTFORMDW 痙攣するたびに母乳が吹き出て、体を白く染めていく……	PRINTFORMDW 痙攣するたびに母乳が吹き出て、体を白く染めていく……
PRINTFORMDW アリスの子供は母親の敏感な胸をしゃぶり続けている……	PRINTFORMDW アリスの子供は母親の敏感な胸をしゃぶり続けている……
PRINTFORML 「ふわぁ……！　いやぁ……！　近寄らないで……！！」	PRINTFORML 「ふわぁ……！　いやぁ……！　近寄らないで……！！」
PRINTFORMDW 　ボロボロのアリスの代わりに大江戸人形が特攻した！	PRINTFORMDW 　ボロボロのアリスの代わりに大江戸人形が特攻した！
PRINTFORMDW 　アリスは自らの体を抱くようにして胸を守っている！	PRINTFORMDW 　アリスは自らの体を抱くようにして胸を守っている！
PRINTFORMDW アリスの桃色のつぼみに触手の群れが殺到している……	PRINTFORMDW アリスの桃色のつぼみに触手の群れが殺到している……
PRINTFORML ねぶるような視線を感じて思わずアリスは目を逸らした！	PRINTFORML ねぶるような視線を感じて思わずアリスは目を逸らした！
PRINTFORMDW 人形達が看板をもってアリスの裸を隠そうとしている！	PRINTFORMDW 人形達が看板をもってアリスの裸を隠そうとしている！
PRINTFORML   外の人間はあんな穴だらけの板で満足するのかしら」	PRINTFORML   外の人間はあんな穴だらけの板で満足するのかしら」
PRINTFORML 「ここに入ってからなんだか人形達の様子がおかしいわ。	PRINTFORML 「ここに入ってからなんだか人形達の様子がおかしいわ。
PRINTFORMDW アリスは痛めた腹をさすりながら、それを見送った……	PRINTFORMDW アリスは痛めた腹をさすりながら、それを見送った……
PRINTFORMDW 　アリスは発情しきった体を抑えながら走りだした！	PRINTFORMDW 　アリスは発情しきった体を抑えながら走りだした！
PRINTFORMDW 追い詰められながらも、アリスは冷静さを失わない！	PRINTFORMDW 追い詰められながらも、アリスは冷静さを失わない！
PRINTFORMW 挿入を本能的に恐れたアリスは手で入口を覆い隠した！	PRINTFORMW 挿入を本能的に恐れたアリスは手で入口を覆い隠した！
PRINTFORMDW  　時折思い出したかのように腹の奥が脈動する……	PRINTFORMDW  　時折思い出したかのように腹の奥が脈動する……
PRINTFORMDW アリスは身重になった自分の体を見下ろしている……	PRINTFORMDW アリスは身重になった自分の体を見下ろしている……
PRINTFORMW アリスは足を閉じて必死に触手を押さえ込んでいる！	PRINTFORMW アリスは足を閉じて必死に触手を押さえ込んでいる！
PRINTFORML 「髪をきりたいの？　じゃあ少し分けて。使うから」	PRINTFORML 「髪をきりたいの？　じゃあ少し分けて。使うから」
PRINTFORML 「……なんだか今は脱出できない気がするのよねぇ」	PRINTFORML 「……なんだか今は脱出できない気がするのよねぇ」
PRINTFORMDW アリスの秘裂から断続的に愛液が吹きでている……	PRINTFORMDW アリスの秘裂から断続的に愛液が吹きでている……
PRINTFORMDW アリスは時々お腹を押さえて考え事をしている……	PRINTFORMDW アリスは時々お腹を押さえて考え事をしている……
PRINTFORML 「こ、こんなに……ひ、ひぅうぁぁあああｯ!!!」	PRINTFORML 「こ、こんなに……ひ、ひぅうぁぁあああｯ!!!」
PRINTFORML 「あ…あ……おっぱい出るたび、か、感じるの……」	PRINTFORML 「あ…あ……おっぱい出るたび、か、感じるの……」
PRINTFORMDW 　アリスはため息をついて、一歩前に進み出た！	PRINTFORMDW 　アリスはため息をついて、一歩前に進み出た！
PRINTFORML スペクトルミステリーの波動が敵に向かっていく！	PRINTFORML スペクトルミステリーの波動が敵に向かっていく！
PRINTFORML アリスは武器を持たせた人形を急所に投げつけた！	PRINTFORML アリスは武器を持たせた人形を急所に投げつけた！
PRINTFORML 「人形の巨大化もまだまだ問題点が多いわね……」	PRINTFORML 「人形の巨大化もまだまだ問題点が多いわね……」
PRINTFORML 「だめ！　らめぇ！　ふぁあああぁぁあｯん!!」	PRINTFORML 「だめ！　らめぇ！　ふぁあああぁぁあｯん!!」
PRINTFORML （この迷宮では時間の流れが違うのかしら……？）	PRINTFORML （この迷宮では時間の流れが違うのかしら……？）
PRINTFORML アリスは人形を使って部屋中の汚物を一掃させた！	PRINTFORML アリスは人形を使って部屋中の汚物を一掃させた！
PRINTFORMDW 　アリスは魔法の糸で牽制しながら後退した！	PRINTFORMDW 　アリスは魔法の糸で牽制しながら後退した！
PRINTFORML 「ふぅ、ん　……！　い、今は戦いに集中よ！」	PRINTFORML 「ふぅ、ん　……！　い、今は戦いに集中よ！」
PRINTFORMW 「う、く……私が追い詰められるなんて……っ」	PRINTFORMW 「う、く……私が追い詰められるなんて……っ」
PRINTFORML 拡散した弾幕が敵の動きを封じようとしている！	PRINTFORML 拡散した弾幕が敵の動きを封じようとしている！
PRINTFORML アリスはもう立つこともままならないようだ……	PRINTFORML アリスはもう立つこともままならないようだ……
PRINTFORML 「おめでたい巫女まで捕まっているなんて……」	PRINTFORML 「おめでたい巫女まで捕まっているなんて……」
PRINTFORML 「ドッペルゲンガーが姿を間違えたのかしら？」	PRINTFORML 「ドッペルゲンガーが姿を間違えたのかしら？」
PRINTFORML 「人形のメンテにも手間が掛かるわ。散髪とか」	PRINTFORML 「人形のメンテにも手間が掛かるわ。散髪とか」
PRINTFORML 「博打は嫌いじゃないわ。イカサマ有りなら」	PRINTFORML 「博打は嫌いじゃないわ。イカサマ有りなら」
PRINTFORMW 「こんな状態じゃ……思うように動けないわ」	PRINTFORMW 「こんな状態じゃ……思うように動けないわ」
PRINTFORML ついでにアリスは藁人形に武器を叩きつけた！	PRINTFORML ついでにアリスは藁人形に武器を叩きつけた！
PRINTFORML 「上海じゃない。　こんなところにいたのね」	PRINTFORML 「上海じゃない。　こんなところにいたのね」
PRINTFORML （細かいことを考えたら負けな気がする……）	PRINTFORML （細かいことを考えたら負けな気がする……）
PRINTFORML 「やだ、やぁら！　はぁあああぁぁあｯ!!」	PRINTFORML 「やだ、やぁら！　はぁあああぁぁあｯ!!」
PRINTFORMDW (嘘……、まさか、できちゃったの……？)	PRINTFORMDW (嘘……、まさか、できちゃったの……？)
PRINTFORML (これってやっぱり……つわり、なの……？)	PRINTFORML (これってやっぱり……つわり、なの……？)
PRINTFORML 「化物に責任……とってくれるわけないわね」	PRINTFORML 「化物に責任……とってくれるわけないわね」
PRINTFORML 「相手が慎重に動いてれば先制がとれるわね」	PRINTFORML 「相手が慎重に動いてれば先制がとれるわね」
PRINTFORMDW 　追い詰められたアリスは逃走を試みた！	PRINTFORMDW 　追い詰められたアリスは逃走を試みた！
PRINTFORML 「ふあっ……っん！　もう、怒ったわよ！」	PRINTFORML 「ふあっ……っん！　もう、怒ったわよ！」
PRINTFORML アリスが操る人形が敵を次々と貫いていく！	PRINTFORML アリスが操る人形が敵を次々と貫いていく！
PRINTFORML 「ターゲットをレンジに入れてシュート！」	PRINTFORML 「ターゲットをレンジに入れてシュート！」
PRINTFORML アリスは人形に武器を持たせて突撃させた！	PRINTFORML アリスは人形に武器を持たせて突撃させた！
PRINTFORML アリスは武器に糸をつけて宙で操っている！	PRINTFORML アリスは武器に糸をつけて宙で操っている！
PRINTFORML アリスは武器に糸をつけて敵に叩きつけた！	PRINTFORML アリスは武器に糸をつけて敵に叩きつけた！
PRINTFORMW 「動きを鈍らせれば戦いやすくなりそうね」	PRINTFORMW 「動きを鈍らせれば戦いやすくなりそうね」
PRINTFORML 「気分が悪そう？　平気よ……これぐらい」	PRINTFORML 「気分が悪そう？　平気よ……これぐらい」
PRINTFORML   天気がいい日はちゃんと干しているわ」	PRINTFORML   天気がいい日はちゃんと干しているわ」
PRINTFORML   まるで本当に生きている気がするのよ」	PRINTFORML   まるで本当に生きている気がするのよ」
PRINTFORML 「どこかで落ち着いてお裁縫がしたいわね」	PRINTFORML 「どこかで落ち着いてお裁縫がしたいわね」
PRINTFORML 「ｶｸｶｸｼｶｼﾞｶって便利な呪文よね」	PRINTFORML 「ｶｸｶｸｼｶｼﾞｶって便利な呪文よね」
PRINTFORML 「な、なに……これ……やっ、そこっ……」	PRINTFORML 「な、なに……これ……やっ、そこっ……」
PRINTFORML 「で、でてくる……いやぁあぁぁっ!!!」	PRINTFORML 「で、でてくる……いやぁあぁぁっ!!!」
PRINTFORML 「これじゃ、まるでやぶれかぶれね……」	PRINTFORML 「これじゃ、まるでやぶれかぶれね……」
PRINTFORML 弾幕にまぎれて魔法の糸が敵を絡めとる！	PRINTFORML 弾幕にまぎれて魔法の糸が敵を絡めとる！
PRINTFORML 極太のレーザーが敵を貫通して薙ぎ払う！	PRINTFORML 極太のレーザーが敵を貫通して薙ぎ払う！
PRINTFORMW 「こういう贅沢もたまには悪くないわね」	PRINTFORMW 「こういう贅沢もたまには悪くないわね」
PRINTFORML アリスは人形に武器もたせて突撃させた！	PRINTFORML アリスは人形に武器もたせて突撃させた！
PRINTFORMDW 触手の粘液とアリスの愛液が交じり合い	PRINTFORMDW 触手の粘液とアリスの愛液が交じり合い
PRINTFORMDW 異物の挿入に淫らな音を添えている……	PRINTFORMDW 異物の挿入に淫らな音を添えている……
PRINTFORML アリスは眉をしかめて汚れを落としている	PRINTFORML アリスは眉をしかめて汚れを落としている
PRINTFORML 「そこの白黒いのは魔理沙ね。大丈夫？」	PRINTFORML 「そこの白黒いのは魔理沙ね。大丈夫？」
PRINTFORML 「子供を生める人形を試作しているのよ。	PRINTFORML 「子供を生める人形を試作しているのよ。
PRINTFORMDW 迷宮の片隅でアリスは激しく嘔吐した…	PRINTFORMDW 迷宮の片隅でアリスは激しく嘔吐した…
PRINTFORMW 「う、うそ……急におっぱいが……！？」	PRINTFORMW 「う、うそ……急におっぱいが……！？」
PRINTFORML 「痛みがない…！？　こんなのって……」	PRINTFORML 「痛みがない…！？　こんなのって……」
PRINTFORML アリスは炎の弾幕で辺りを焼き尽くした！	PRINTFORML アリスは炎の弾幕で辺りを焼き尽くした！
PRINTFORML 「いやっ！　お願い、いれないで……！」	PRINTFORML 「いやっ！　お願い、いれないで……！」
PRINTFORMDW アリスの精神力はもうぎりぎりだ……	PRINTFORMDW アリスの精神力はもうぎりぎりだ……
PRINTFORML アリスは次々と人形を取り出している！	PRINTFORML アリスは次々と人形を取り出している！
PRINTFORML アリスは人形に魔力を充填している……	PRINTFORML アリスは人形に魔力を充填している……
PRINTFORML 試験中の巨大化した人形が暴れている！	PRINTFORML 試験中の巨大化した人形が暴れている！
PRINTFORML 小さな人形が敵の注意を逸らしている！	PRINTFORML 小さな人形が敵の注意を逸らしている！
PRINTFORML 「いいわ。まとめて相手をしてあげる」	PRINTFORML 「いいわ。まとめて相手をしてあげる」
PRINTFORML （ここから出ることは……不可能だわ）	PRINTFORML （ここから出ることは……不可能だわ）
PRINTFORMDW 晒された素肌が微かに震えている……	PRINTFORMDW 晒された素肌が微かに震えている……
PRINTFORML 「あら蓬莱。こっちにいらっしゃいな」	PRINTFORML 「あら蓬莱。こっちにいらっしゃいな」
PRINTFORML 「え。もしかしてここって魔界なの？」	PRINTFORML 「え。もしかしてここって魔界なの？」
PRINTFORML 「うっ……はやく、なんとかしないと」	PRINTFORML 「うっ……はやく、なんとかしないと」
PRINTFORML 「あ……あ、あぁあアアァあｯ!!!」	PRINTFORML 「あ……あ、あぁあアアァあｯ!!!」
PRINTFORMDW 異形の出産には激しい快感が伴うのか	PRINTFORMDW 異形の出産には激しい快感が伴うのか
PRINTFORML 「だ、めぇ……、むね、弱いのに……」	PRINTFORML 「だ、めぇ……、むね、弱いのに……」
PRINTFORML 「おかあさん、私の……おにんぎょう」	PRINTFORML 「おかあさん、私の……おにんぎょう」
PRINTFORML 「こんな……はぁ……、ぁ……っ」」	PRINTFORML 「こんな……はぁ……、ぁ……っ」」
PRINTFORML 「まだよ……！　今は確実に……！」	PRINTFORML 「まだよ……！　今は確実に……！」
PRINTFORMDW アリスの目から涙が滲んでいる……	PRINTFORMDW アリスの目から涙が滲んでいる……
PRINTFORML 「ここに人形をおいて、ターン終了」	PRINTFORML 「ここに人形をおいて、ターン終了」
PRINTFORML 投げつけた人形が大爆発を起こした！	PRINTFORML 投げつけた人形が大爆発を起こした！
PRINTFORML アリスは巧みに道具を使用している！	PRINTFORML アリスは巧みに道具を使用している！
PRINTFORMW 「ふぁっ！？　もう、なんなのよ！」	PRINTFORMW 「ふぁっ！？　もう、なんなのよ！」
PRINTFORMW 「……あ、敵を、先にたおさなきゃ」	PRINTFORMW 「……あ、敵を、先にたおさなきゃ」
PRINTFORML 「……相手の行動より先に動ければ」	PRINTFORML 「……相手の行動より先に動ければ」
PRINTFORMW 「これが最後のチャンスかしら……」	PRINTFORMW 「これが最後のチャンスかしら……」
PRINTFORMW 「力をためれば……抜け出せるはず」	PRINTFORMW 「力をためれば……抜け出せるはず」
PRINTFORML 「こんなの、気持よくなんか……！」	PRINTFORML 「こんなの、気持よくなんか……！」
PRINTFORML （自立制御の実験でもしてたっけ？）	PRINTFORML （自立制御の実験でもしてたっけ？）
PRINTFORML 「アっん…ぁん…あぁ……ぁんっ!」	PRINTFORML 「アっん…ぁん…あぁ……ぁんっ!」
PRINTFORML 「もう、こんなに大きくなって……」	PRINTFORML 「もう、こんなに大きくなって……」
PRINTFORML 「人形たちが落ち着かないわね……」	PRINTFORML 「人形たちが落ち着かないわね……」
PRINTFORML 「待ち伏せ程度なら気づけるはずね」	PRINTFORML 「待ち伏せ程度なら気づけるはずね」
PRINTFORMW 「……こちらは防御に専念するわ」	PRINTFORMW 「……こちらは防御に専念するわ」
PRINTFORMW 「これぐらい……なんでもないわ」	PRINTFORMW 「これぐらい……なんでもないわ」
PRINTFORML 虹色の弾幕が辺りを染めている……	PRINTFORML 虹色の弾幕が辺りを染めている……
PRINTFORML 続いて一際大きい人形が突撃した！	PRINTFORML 続いて一際大きい人形が突撃した！
PRINTFORML アリスは次々と大玉を放っている！	PRINTFORML アリスは次々と大玉を放っている！
PRINTFORML 「もったいないから当たってね！」	PRINTFORML 「もったいないから当たってね！」
PRINTFORML 「これで当たりやすくなるかしら」	PRINTFORML 「これで当たりやすくなるかしら」
PRINTFORMW 「んんっ……私……なにをやって」	PRINTFORMW 「んんっ……私……なにをやって」
PRINTFORML 「ふ……あぁああああああっ！？」	PRINTFORML 「ふ……あぁああああああっ！？」
PRINTFORML 「これくらいなら直せるけど……」	PRINTFORML 「これくらいなら直せるけど……」
PRINTFORML   多少小さすぎる気がするけど」	PRINTFORML   多少小さすぎる気がするけど」
PRINTFORML 「やっぱり気のせいだったみたい」	PRINTFORML 「やっぱり気のせいだったみたい」
PRINTFORML 「……もう取り返しがつかないわ」	PRINTFORML 「……もう取り返しがつかないわ」
PRINTFORML 「ふっ…っ…　あ……うぅ……」	PRINTFORML 「ふっ…っ…　あ……うぅ……」
PRINTFORML 「この私を盾にするなんて……」	PRINTFORML 「この私を盾にするなんて……」
PRINTFORML 「これじゃ集中……できないわ」	PRINTFORML 「これじゃ集中……できないわ」
PRINTFORML 「塵も積もれは……ただのゴミ」	PRINTFORML 「塵も積もれは……ただのゴミ」
PRINTFORML ついでにアリスは人形を投げた！	PRINTFORML ついでにアリスは人形を投げた！
PRINTFORML アリスはスペルカードを掲げた！	PRINTFORML アリスはスペルカードを掲げた！
PRINTFORML 無数の人形達が敵に襲いかかる！	PRINTFORML 無数の人形達が敵に襲いかかる！
PRINTFORML 「残り弾数に気をつけないとね」	PRINTFORML 「残り弾数に気をつけないとね」
PRINTFORML 「これでトドメ刺せるかしら？」	PRINTFORML 「これでトドメ刺せるかしら？」
PRINTFORMW 「……！　そこだけはやめて！」	PRINTFORMW 「……！　そこだけはやめて！」
PRINTFORML 「ナカ……こすらない、で…！」	PRINTFORML 「ナカ……こすらない、で…！」
PRINTFORML 「心配してる？　余計なお世話」	PRINTFORML 「心配してる？　余計なお世話」
PRINTFORML 「昼も夜もよくわからないわね」	PRINTFORML 「昼も夜もよくわからないわね」
PRINTFORML 「糸でひっぱり出せないかしら」	PRINTFORML 「糸でひっぱり出せないかしら」
PRINTFORML 「う、ぐ……魔力を吸われてる」	PRINTFORML 「う、ぐ……魔力を吸われてる」
PRINTFORML 「うっ……まさか、大丈夫よね」	PRINTFORML 「うっ……まさか、大丈夫よね」
PRINTFORML 「妙にあれが早かったけど……」	PRINTFORML 「妙にあれが早かったけど……」
PRINTFORML 「人形たちに先行させましょう」	PRINTFORML 「人形たちに先行させましょう」
PRINTFORML 「こっち、見ないでよ……！」	PRINTFORML 「こっち、見ないでよ……！」
PRINTFORMW 「今度はあなたが前に出る？」	PRINTFORMW 「今度はあなたが前に出る？」
PRINTFORML 「今逃げなきゃ……やられる」	PRINTFORML 「今逃げなきゃ……やられる」
PRINTFORML アリスは魔力を節約している！	PRINTFORML アリスは魔力を節約している！
PRINTFORML 「はぁ……はぁ……いくわよ」	PRINTFORML 「はぁ……はぁ……いくわよ」
PRINTFORML 「きっとこれが布石になるわ」	PRINTFORML 「きっとこれが布石になるわ」
PRINTFORMW 「はぁ……ふっぅ……くっ！」	PRINTFORMW 「はぁ……ふっぅ……くっ！」
PRINTFORML 「どうもしっくりこないわね」	PRINTFORML 「どうもしっくりこないわね」
PRINTFORML 「や……そこはやめなさい！」	PRINTFORML 「や……そこはやめなさい！」
PRINTFORML 「そこから離れなさい……！」	PRINTFORML 「そこから離れなさい……！」
PRINTFORML 「隠しきれないじゃない……」	PRINTFORML 「隠しきれないじゃない……」
PRINTFORML 「何を入れられたの……！？」	PRINTFORML 「何を入れられたの……！？」
PRINTFORML 「何も隠せないだなんて……」	PRINTFORML 「何も隠せないだなんて……」
PRINTFORML 「無防備もいいところね……」	PRINTFORML 「無防備もいいところね……」
PRINTFORML 「人形と服を直さないと……」	PRINTFORML 「人形と服を直さないと……」
PRINTFORML アリスはそっと息を吐いた……	PRINTFORML アリスはそっと息を吐いた……
PRINTFORML 「人形遣いをなめないことね」	PRINTFORML 「人形遣いをなめないことね」
PRINTFORML 「貴方も閉じ込められたのね」	PRINTFORML 「貴方も閉じ込められたのね」
PRINTFORML 「プラモデルって知ってる？　	PRINTFORML 「プラモデルって知ってる？　
PRINTFORML 「人形は湿気がたまると大変。	PRINTFORML 「人形は湿気がたまると大変。
PRINTFORML 「無理は良くないわ。何事も」	PRINTFORML 「無理は良くないわ。何事も」
PRINTFORML 「まだテスト中？　なにそれ」	PRINTFORML 「まだテスト中？　なにそれ」
PRINTFORML 「色々な物が落ちているわね」	PRINTFORML 「色々な物が落ちているわね」
PRINTFORML 「？　どうしたのかしら……」	PRINTFORML 「？　どうしたのかしら……」
PRINTFORML 「ふ……っ、いたぁっ……！」	PRINTFORML 「ふ……っ、いたぁっ……！」
PRINTFORML 「ここは一気に抜けましょう」	PRINTFORML 「ここは一気に抜けましょう」
PRINTFORML 「ここは慎重にいきましょう」	PRINTFORML 「ここは慎重にいきましょう」
PRINTFORML 「なにがでてくるかしら……」	PRINTFORML 「なにがでてくるかしら……」
PRINTFORML 「く……まだ！　まだよ！」	PRINTFORML 「く……まだ！　まだよ！」
PRINTFORML 「これでも喰らいなさい！」	PRINTFORML 「これでも喰らいなさい！」
PRINTFORMW 「……これでいけるかしら」	PRINTFORMW 「……これでいけるかしら」
PRINTFORMW 「ついケチってしまうわね」	PRINTFORMW 「ついケチってしまうわね」
PRINTFORML 「私が武器に頼るなんてね」	PRINTFORML 「私が武器に頼るなんてね」
PRINTFORML 「これじゃもう……無理ね」	PRINTFORML 「これじゃもう……無理ね」
PRINTFORML 「後ろ……？　まさか！？」	PRINTFORML 「後ろ……？　まさか！？」
PRINTFORML 「攻撃を受けすぎたわ……」	PRINTFORML 「攻撃を受けすぎたわ……」
PRINTFORML （もう……何もかも無駄よ）	PRINTFORML （もう……何もかも無駄よ）
PRINTFORML 「よくも　私の服を……！」	PRINTFORML 「よくも　私の服を……！」
PRINTFORML 「まだ、直せるかしら……」	PRINTFORML 「まだ、直せるかしら……」
PRINTFORML 「まさか……こいつの！？」	PRINTFORML 「まさか……こいつの！？」
PRINTFORML 「敵の情報はありがたいわ」	PRINTFORML 「敵の情報はありがたいわ」
PRINTFORML 「ここは協力しあうべきね」	PRINTFORML 「ここは協力しあうべきね」
PRINTFORML 「見張りは部屋の中央でね」	PRINTFORML 「見張りは部屋の中央でね」
PRINTFORML 「不躾なお願いだけど……」	PRINTFORML 「不躾なお願いだけど……」
PRINTFORML 「んっくぅうううぅ!!」」	PRINTFORML 「んっくぅうううぅ!!」」
PRINTFORML 「あっ……イっ、ちゃ──」	PRINTFORML 「あっ……イっ、ちゃ──」
PRINTFORML 「いやぁ！　吸わないで！」	PRINTFORML 「いやぁ！　吸わないで！」
PRINTFORML 「ふっ……ぐぅ、う……！」	PRINTFORML 「ふっ……ぐぅ、う……！」
PRINTFORML （どこにいくのかしら……）	PRINTFORML （どこにいくのかしら……）
PRINTFORMW 「今、これを使うべきね」	PRINTFORMW 「今、これを使うべきね」
PRINTFORML 「豆鉄砲をくらいなさい」	PRINTFORML 「豆鉄砲をくらいなさい」
PRINTFORML アリスは人形を設置した！	PRINTFORML アリスは人形を設置した！
PRINTFORMW 「体が……　ふぁぅ！？」	PRINTFORMW 「体が……　ふぁぅ！？」
PRINTFORMW 「う……今は確実に……」	PRINTFORMW 「う……今は確実に……」
PRINTFORML 「この際なんでも使うわ」	PRINTFORML 「この際なんでも使うわ」
PRINTFORMW 「もう逃げたほうが……」	PRINTFORMW 「もう逃げたほうが……」
PRINTFORMW 「大分……しぶといわね」	PRINTFORMW 「大分……しぶといわね」
PRINTFORMW 「やだ……体が熱い……」	PRINTFORMW 「やだ……体が熱い……」
PRINTFORML 「スタンを狙ってみるわ」	PRINTFORML 「スタンを狙ってみるわ」
PRINTFORMW 「……いちか……ばちか」	PRINTFORMW 「……いちか……ばちか」
PRINTFORML 「どこを触ってるのよ！」	PRINTFORML 「どこを触ってるのよ！」
PRINTFORML （きもち　わるい……！）	PRINTFORML （きもち　わるい……！）
PRINTFORML 「そっちは……ちが……」	PRINTFORML 「そっちは……ちが……」
PRINTFORML 「この、けだもの……！」	PRINTFORML 「この、けだもの……！」
PRINTFORML 「……絶対、許さないわ」	PRINTFORML 「……絶対、許さないわ」
PRINTFORML 「丸呑みだなんて……！」	PRINTFORML 「丸呑みだなんて……！」
PRINTFORML 「う、うごけない……！」	PRINTFORML 「う、うごけない……！」
PRINTFORML 「相手にしてられないわ」	PRINTFORML 「相手にしてられないわ」
PRINTFORML 「あら、なにかあったわ」	PRINTFORML 「あら、なにかあったわ」
PRINTFORML 「これなら大分休めるわ」	PRINTFORML 「これなら大分休めるわ」
PRINTFORML 「うぇっ……ふぐっ……」	PRINTFORML 「うぇっ……ふぐっ……」
PRINTFORML 「おっぱい……でてるわ」	PRINTFORML 「おっぱい……でてるわ」
PRINTFORML 「もっと調べないと……」	PRINTFORML 「もっと調べないと……」
PRINTFORML 「下がらせてもらうわ」	PRINTFORML 「下がらせてもらうわ」
PRINTFORML 「確実に当てていくわ」	PRINTFORML 「確実に当てていくわ」
PRINTFORML 「とどめはこれで十分」	PRINTFORML 「とどめはこれで十分」
PRINTFORML 「弾幕はブレインよ！」	PRINTFORML 「弾幕はブレインよ！」
PRINTFORML 「当たれば儲けものね」	PRINTFORML 「当たれば儲けものね」
PRINTFORML 「大味だったかしら？」	PRINTFORML 「大味だったかしら？」
PRINTFORML 「弾幕はばらまくもの」	PRINTFORML 「弾幕はばらまくもの」
PRINTFORMW 「う……ここは一気に」	PRINTFORMW 「う……ここは一気に」
PRINTFORMW 「う、……お腹が熱い」	PRINTFORMW 「う、……お腹が熱い」
PRINTFORMW 「……やるしかないわ」	PRINTFORMW 「……やるしかないわ」
PRINTFORMW 「ふぁ、あ……あ……」	PRINTFORMW 「ふぁ、あ……あ……」
PRINTFORMW 「きっと、無理……ね」	PRINTFORMW 「きっと、無理……ね」
PRINTFORMW 「なにするつもり！？」	PRINTFORMW 「なにするつもり！？」
PRINTFORML 「これ以上させないわ」	PRINTFORML 「これ以上させないわ」
PRINTFORML 「……ひどい事するわ」	PRINTFORML 「……ひどい事するわ」
PRINTFORML 「！？　うそ、今……」	PRINTFORML 「！？　うそ、今……」
PRINTFORML 「これじゃ、もう……」	PRINTFORML 「これじゃ、もう……」
PRINTFORML 「人形にも魂があるわ。	PRINTFORML 「人形にも魂があるわ。
PRINTFORML 「これの使い方は……」	PRINTFORML 「これの使い方は……」
PRINTFORML 「交代で休みましょう」	PRINTFORML 「交代で休みましょう」
PRINTFORML 「私が……こんな……」	PRINTFORML 「私が……こんな……」
PRINTFORML 「……抑え切れないわ」	PRINTFORML 「……抑え切れないわ」
PRINTFORML 「気のせいかしら……」	PRINTFORML 「気のせいかしら……」
PRINTFORMDW 「今、中で動いたわ」	PRINTFORMDW 「今、中で動いたわ」
PRINTFORML (これが……私の……)	PRINTFORML (これが……私の……)
PRINTFORML 「残しておくと厄介ね」	PRINTFORML 「残しておくと厄介ね」
PRINTFORML 「ゆっくり移動するわ」	PRINTFORML 「ゆっくり移動するわ」
PRINTFORML 「なにがあるかしら？」	PRINTFORML 「なにがあるかしら？」
PRINTFORML 「ナマモノのくせに！」	PRINTFORML 「ナマモノのくせに！」
PRINTFORML 「少しひやっとしたわ」	PRINTFORML 「少しひやっとしたわ」
PRINTFORML 「たべ……られちゃう」	PRINTFORML 「たべ……られちゃう」
PRINTFORML 「これが一番確実ね」	PRINTFORML 「これが一番確実ね」
PRINTFORML 「これはどうかしら」	PRINTFORML 「これはどうかしら」
PRINTFORML スペルカードが発動！	PRINTFORML スペルカードが発動！
PRINTFORML 「吹き飛びなさい！」	PRINTFORML 「吹き飛びなさい！」
PRINTFORMW 「……もう終わって」	PRINTFORMW 「……もう終わって」
PRINTFORMW 「……少しはこれで」	PRINTFORMW 「……少しはこれで」
PRINTFORML 「感じ……ないわ！」	PRINTFORML 「感じ……ないわ！」
PRINTFORML 「力が入らない……」	PRINTFORML 「力が入らない……」
PRINTFORML 「……こんな辱めを」	PRINTFORML 「……こんな辱めを」
PRINTFORML 「きりがないわ……」	PRINTFORML 「きりがないわ……」
PRINTFORML 「あら可愛いお人形」	PRINTFORML 「あら可愛いお人形」
PRINTFORML 「なにやってるの？」	PRINTFORML 「なにやってるの？」
PRINTFORMW 「すぅ……すぅ……」	PRINTFORMW 「すぅ……すぅ……」
PRINTFORML 「はぁ……はぁ……」	PRINTFORML 「はぁ……はぁ……」
PRINTFORML 「やられたわね……」	PRINTFORML 「やられたわね……」
PRINTFORML 「……迂闊だったわ」	PRINTFORML 「……迂闊だったわ」
PRINTFORML 「も、もう……限界」	PRINTFORML 「も、もう……限界」
PRINTFORML 「調子が出ないわね」	PRINTFORML 「調子が出ないわね」
PRINTFORML 「ぁ……あぅ……ん」	PRINTFORML 「ぁ……あぅ……ん」
PRINTFORML 「きれいさっぱりよ」	PRINTFORML 「きれいさっぱりよ」
PRINTFORML 「はやく移動するわ」	PRINTFORML 「はやく移動するわ」
PRINTFORML 「危なかったわ……」	PRINTFORML 「危なかったわ……」
PRINTFORML 「やれそう、かも」	PRINTFORML 「やれそう、かも」
PRINTFORML 「少し激しくね！」	PRINTFORML 「少し激しくね！」
PRINTFORML 「切り札を使うわ」	PRINTFORML 「切り札を使うわ」
PRINTFORML 「当たりなさい！」	PRINTFORML 「当たりなさい！」
PRINTFORMW 「……きついわね」	PRINTFORMW 「……きついわね」
PRINTFORML 「大盤振る舞いよ」	PRINTFORML 「大盤振る舞いよ」
PRINTFORMW 「……まずいわね」	PRINTFORMW 「……まずいわね」
PRINTFORMW 「はぁ……もう！」	PRINTFORMW 「はぁ……もう！」
PRINTFORML 「そこが弱点ね！」	PRINTFORML 「そこが弱点ね！」
PRINTFORML 「当たらないわ！」	PRINTFORML 「当たらないわ！」
PRINTFORML 「許さないわ……」	PRINTFORML 「許さないわ……」
PRINTFORML 「かすっただけね」	PRINTFORML 「かすっただけね」
PRINTFORML 「……なんて格好」	PRINTFORML 「……なんて格好」
PRINTFORML 「ええ……そうね」	PRINTFORML 「ええ……そうね」
PRINTFORML 「これなら安心ね」	PRINTFORML 「これなら安心ね」
PRINTFORML 「お腹の奥ね……」	PRINTFORML 「お腹の奥ね……」
PRINTFORML 「あ……うまれた」	PRINTFORML 「あ……うまれた」
PRINTFORML 「まあまあかしら」	PRINTFORML 「まあまあかしら」
PRINTFORML 「手が滑ったわ」	PRINTFORML 「手が滑ったわ」
PRINTFORML 「ファンネル！」	PRINTFORML 「ファンネル！」
PRINTFORML 「狙い撃つわ！」	PRINTFORML 「狙い撃つわ！」
PRINTFORML 「やってみるわ」	PRINTFORML 「やってみるわ」
PRINTFORML 「……いやぁ！」	PRINTFORML 「……いやぁ！」
PRINTFORML 「お尻……！？」	PRINTFORML 「お尻……！？」
PRINTFORML 「まったく……」	PRINTFORML 「まったく……」
PRINTFORML 「しまった！？」	PRINTFORML 「しまった！？」
PRINTFORML 「一時撤退よ！」	PRINTFORML 「一時撤退よ！」
PRINTFORML 「ごきげんよう」	PRINTFORML 「ごきげんよう」
PRINTFORML 「次は私の番？」	PRINTFORML 「次は私の番？」
PRINTFORML 「変な感じ……」	PRINTFORML 「変な感じ……」
PRINTFORML 「あ……あ……」	PRINTFORML 「あ……あ……」
PRINTFORML 「探索は基本ね」	PRINTFORML 「探索は基本ね」
PRINTFORML 「もうっ……！」	PRINTFORML 「もうっ……！」
PRINTFORML 「やめなさい！」	PRINTFORML 「やめなさい！」
PRINTFORML 「得意分野ね」	PRINTFORML 「得意分野ね」
PRINTFORML 「ひぁ!!?」	PRINTFORML 「ひぁ!!?」
PRINTFORML 「んっ……！」	PRINTFORML 「んっ……！」
PRINTFORML 「計算通りね」	PRINTFORML 「計算通りね」
PRINTFORML 「こんにちは」	PRINTFORML 「こんにちは」
PRINTFORML 「よろしくね」	PRINTFORML 「よろしくね」
PRINTFORML 「見つけた！」	PRINTFORML 「見つけた！」
PRINTFORML 「熱い……！」	PRINTFORML 「熱い……！」
PRINTFORMW 「うぅ……」	PRINTFORMW 「うぅ……」
PRINTFORML 「いたっ！」	PRINTFORML 「いたっ！」
PRINTFORML 「きゃっ！」	PRINTFORML 「きゃっ！」
PRINTFORML 「さよなら」	PRINTFORML 「さよなら」
PRINTFORML 「ふふ……」	PRINTFORML 「ふふ……」
PRINTFORML 「……あら」	PRINTFORML 「……あら」
PRINTFORML 「…………」	PRINTFORML 「…………」
PRINTFORML 「助かるわ」	PRINTFORML 「助かるわ」
PRINTFORML 「お疲れ様」	PRINTFORML 「お疲れ様」
PRINTFORML 「頼むわね」	PRINTFORML 「頼むわね」
PRINTFORML 「ふぅ……」	PRINTFORML 「ふぅ……」
PRINTFORML 「はぁ……」	PRINTFORML 「はぁ……」
PRINTFORMW 「…………」	PRINTFORMW 「…………」
PRINTFORML 「うぅ……」	PRINTFORML 「うぅ……」
PRINTFORML 「ぁ……！」	PRINTFORML 「ぁ……！」
PRINTFORML 「やっ！」	PRINTFORML 「やっ！」
PRINTFORML 「う……」	PRINTFORML 「う……」
PRINTFORML 「当然ね」	PRINTFORML 「当然ね」
PRINTFORML 「ん……」	PRINTFORML 「ん……」
PRINTFORMW 「……」	PRINTFORMW 「……」
PRINTFORML 「……」	PRINTFORML 「……」
PRINTFORML  	PRINTFORML  
PRINTFORML 	PRINTFORML 
PRINTFORMW 	PRINTFORMW 
PRINTFORML	PRINTFORML
PRINTFORM 	PRINTFORM 
PRINTFORM	PRINTFORM
