//口上:

﻿PRINTFORML -----------------------------------------------------------------------------------------------------	PRINTFORML -----------------------------------------------------------------------------------------------------
PRINTFORMDW リリーホワイトの奥深くまで挿入された触手が突如激しく脈動すると、彼女の胎内に溢れるほどの白濁液を注ぎ込んでゆく	PRINTFORMDW リリーホワイトの奥深くまで挿入された触手が突如激しく脈動すると、彼女の胎内に溢れるほどの白濁液を注ぎ込んでゆく
PRINTFORMDW リリーホワイトの秘所を掻き分けクリトリスに絡みついてくるぬるりとした感触に、彼女の虚ろな表情が引きつっている	PRINTFORMDW リリーホワイトの秘所を掻き分けクリトリスに絡みついてくるぬるりとした感触に、彼女の虚ろな表情が引きつっている
PRINTFORMDW 力を失った彼女の半身が見る見るうちに粘液にまみれた肉壁の奥に沈んでいき、彼女は餌としての運命を辿るのみだ……	PRINTFORMDW 力を失った彼女の半身が見る見るうちに粘液にまみれた肉壁の奥に沈んでいき、彼女は餌としての運命を辿るのみだ……
PRINTFORMDW 完全に呑み込まれたリリーホワイトは蠢く肉壁に人形のように弄ばれ、熱い粘液にココロとカラダを蕩かされている……	PRINTFORMDW 完全に呑み込まれたリリーホワイトは蠢く肉壁に人形のように弄ばれ、熱い粘液にココロとカラダを蕩かされている……
PRINTFORMDW リリーホワイトの秘所を掻き分けクリトリスに絡みついてくるぬるりとした感触に、彼女の紅潮した顔が蕩けていく	PRINTFORMDW リリーホワイトの秘所を掻き分けクリトリスに絡みついてくるぬるりとした感触に、彼女の紅潮した顔が蕩けていく
PRINTFORMDW 触手はリリーホワイトの濡れそぼった秘裂を押し拡げ膣肉を掻き分け奥まで沈み込み、彼女もそれを受け入れる……	PRINTFORMDW 触手はリリーホワイトの濡れそぼった秘裂を押し拡げ膣肉を掻き分け奥まで沈み込み、彼女もそれを受け入れる……
PRINTFORMDW 彼女の中で激しくうねる触手を熱い蜜壺が飲み込んでいき、彼女は犯されることすらも自然と快感に変えていく……	PRINTFORMDW 彼女の中で激しくうねる触手を熱い蜜壺が飲み込んでいき、彼女は犯されることすらも自然と快感に変えていく……
PRINTFORMDW リリーホワイトの奥深くまで挿入された触手が突如激しく脈動すると、彼女の胎内に大量の白濁液を注ぎ込んでゆく	PRINTFORMDW リリーホワイトの奥深くまで挿入された触手が突如激しく脈動すると、彼女の胎内に大量の白濁液を注ぎ込んでゆく
PRINTFORMDW 首筋から背中、羽、足裏から太腿…そして双丘へ、秘所へと蠢きながら這い登っていき、眠っている彼女の躰を弄ぶ	PRINTFORMDW 首筋から背中、羽、足裏から太腿…そして双丘へ、秘所へと蠢きながら這い登っていき、眠っている彼女の躰を弄ぶ
PRINTFORMDW 狭い膣内を掻き分け胎内深く潜り込んでいく触手が彼女のココロとカラダに純潔を奪われる感覚を刻み込んでいく	PRINTFORMDW 狭い膣内を掻き分け胎内深く潜り込んでいく触手が彼女のココロとカラダに純潔を奪われる感覚を刻み込んでいく
PRINTFORMDW 彼女の中で激しくうねる触手が肉襞と擦れる感触が、彼女のココロとカラダに犯される感覚を刻み込んでいく……	PRINTFORMDW 彼女の中で激しくうねる触手が肉襞と擦れる感触が、彼女のココロとカラダに犯される感覚を刻み込んでいく……
PRINTFORMDW もはや抵抗する気力の無いリリーホワイトの躰を嬲り尽くそうと絡み付いた触手は無理矢理彼女の両脚を開かせ、	PRINTFORMDW もはや抵抗する気力の無いリリーホワイトの躰を嬲り尽くそうと絡み付いた触手は無理矢理彼女の両脚を開かせ、
PRINTFORMDW 糸の切れた人形のように動かないリリーホワイトの躰を嬲り尽くそうと絡み付いた触手は彼女の両脚を開かせ、	PRINTFORMDW 糸の切れた人形のように動かないリリーホワイトの躰を嬲り尽くそうと絡み付いた触手は彼女の両脚を開かせ、
PRINTFORMDW リリーホワイトの眼が一瞬開いたように見えたが、穢された己の肢体とそれに絡み付く触手が視界に入った瞬間	PRINTFORMDW リリーホワイトの眼が一瞬開いたように見えたが、穢された己の肢体とそれに絡み付く触手が視界に入った瞬間
PRINTFORMDW 少女の最も敏感な部分を吸い上げられる恥辱と快楽に思わず身体が反応し、何度も喘ぎ声を漏らしてしまう……	PRINTFORMDW 少女の最も敏感な部分を吸い上げられる恥辱と快楽に思わず身体が反応し、何度も喘ぎ声を漏らしてしまう……
PRINTFORMDW 触手は抵抗する気力のないリリーホワイトの秘裂を押し拡げ膣肉を掻き分けながら奥まで沈み込んでいった……	PRINTFORMDW 触手は抵抗する気力のないリリーホワイトの秘裂を押し拡げ膣肉を掻き分けながら奥まで沈み込んでいった……
PRINTFORMDW 凌辱が終わった後も、彼女は秘所から鮮血混じりの粘液を垂らしながら黒く濁った瞳で虚空を見つめていた……	PRINTFORMDW 凌辱が終わった後も、彼女は秘所から鮮血混じりの粘液を垂らしながら黒く濁った瞳で虚空を見つめていた……
PRINTFORMDW 少女の最も敏感な部分を吸い上げられる快楽を自ら抵抗なく受け入れ、何度も嬌声と蜜を漏らしてしまう……	PRINTFORMDW 少女の最も敏感な部分を吸い上げられる快楽を自ら抵抗なく受け入れ、何度も嬌声と蜜を漏らしてしまう……
PRINTFORMDW 動けなくなったリリーホワイトの躰を貪るように触手は体液をまき散らし、肢体を這い回り、弄んでいる……	PRINTFORMDW 動けなくなったリリーホワイトの躰を貪るように触手は体液をまき散らし、肢体を這い回り、弄んでいる……
PRINTFORMDW おぞましい魔物の子種が子宮を満たしているというのに、彼女の瞳からは希望にも似た何かが見て取れる……	PRINTFORMDW おぞましい魔物の子種が子宮を満たしているというのに、彼女の瞳からは希望にも似た何かが見て取れる……
PRINTFORMDW 身も心も犯し尽されたリリーホワイトの瞳は、彼女の心の中を映したように真っ黒に濁っていた。そして――	PRINTFORMDW 身も心も犯し尽されたリリーホワイトの瞳は、彼女の心の中を映したように真っ黒に濁っていた。そして――
PRINTFORMDW 拒絶の言葉とは裏腹にリリーホワイトの顔はほんのりと赤く染まり幼いつぼみからは愛蜜を滴らせている……	PRINTFORMDW 拒絶の言葉とは裏腹にリリーホワイトの顔はほんのりと赤く染まり幼いつぼみからは愛蜜を滴らせている……
PRINTFORML （口上サンプルの上海と半霊、阿求口上に加え各種分岐はサニーミルク口上と屠自古口上を参考にしています	PRINTFORML （口上サンプルの上海と半霊、阿求口上に加え各種分岐はサニーミルク口上と屠自古口上を参考にしています
PRINTFORMDW リリーホワイトの弱々しい拒絶の声とは裏腹に彼女のアヌスは異形の触手を抵抗なく飲み込んでいった……	PRINTFORMDW リリーホワイトの弱々しい拒絶の声とは裏腹に彼女のアヌスは異形の触手を抵抗なく飲み込んでいった……
PRINTFORMDW 膣内から触手が引き抜かれた頃には、リリーホワイトはとろりとした表情に濁った笑みを浮かべていた……	PRINTFORMDW 膣内から触手が引き抜かれた頃には、リリーホワイトはとろりとした表情に濁った笑みを浮かべていた……
PRINTFORMDW 首筋から背中、羽、足裏から太腿…そして下着の中…双丘へ秘所へと潜り込み、眠っている彼女の躰を弄ぶ	PRINTFORMDW 首筋から背中、羽、足裏から太腿…そして下着の中…双丘へ秘所へと潜り込み、眠っている彼女の躰を弄ぶ
PRINTFORMDW リリーホワイトの懇願するような嬌声と共に彼女のアヌスは異形の触手を抵抗なく飲み込んでいった……	PRINTFORMDW リリーホワイトの懇願するような嬌声と共に彼女のアヌスは異形の触手を抵抗なく飲み込んでいった……
PRINTFORMDW そのたびに彼女は悲鳴とも嬌声ともつかない喘ぎ声を漏らし胸を突き出しながら更なる責めを求める……	PRINTFORMDW そのたびに彼女は悲鳴とも嬌声ともつかない喘ぎ声を漏らし胸を突き出しながら更なる責めを求める……
PRINTFORML 　と言うより必要な構文をコピペしてエラーが出たらその都度書き直してるのが実情です、すみません）	PRINTFORML 　と言うより必要な構文をコピペしてエラーが出たらその都度書き直してるのが実情です、すみません）
PRINTFORMDW 幼い秘裂を触手に貫かれ、何者も受け容れた事のないその奥を凌辱される恐怖と苦痛に顔が歪んでゆく	PRINTFORMDW 幼い秘裂を触手に貫かれ、何者も受け容れた事のないその奥を凌辱される恐怖と苦痛に顔が歪んでゆく
PRINTFORMDW 動けない彼女の肢体が肉壁に揉まれ粘液に浸かるたびに飴玉のようにそこから力が溶け出していく……	PRINTFORMDW 動けない彼女の肢体が肉壁に揉まれ粘液に浸かるたびに飴玉のようにそこから力が溶け出していく……
PRINTFORMDW 白い素肌を床一面の触手に埋め眠りにつくリリーホワイトの無防備な裸身はどこか背徳的に見える……	PRINTFORMDW 白い素肌を床一面の触手に埋め眠りにつくリリーホワイトの無防備な裸身はどこか背徳的に見える……
PRINTFORMDW ずぶずぶと体内奥深くへと入り込み腸壁を蹂躙する感触に、彼女の虚ろな瞳に涙が浮かんでいる……	PRINTFORMDW ずぶずぶと体内奥深くへと入り込み腸壁を蹂躙する感触に、彼女の虚ろな瞳に涙が浮かんでいる……
PRINTFORMDW おぞましい魔物の子種が子宮を満たしていく感覚に、彼女の淀んだ瞳からとめどなく涙が零れる……	PRINTFORMDW おぞましい魔物の子種が子宮を満たしていく感覚に、彼女の淀んだ瞳からとめどなく涙が零れる……
PRINTFORMDW 触手が幼い秘裂を抉じ開け、蠢く先端が何者も受け容れた事のないその奥へ入り込んでいく度に、	PRINTFORMDW 触手が幼い秘裂を抉じ開け、蠢く先端が何者も受け容れた事のないその奥へ入り込んでいく度に、
PRINTFORMDW 膣内から触手が引き抜かれた頃には、リリーホワイトはとろりとした表情に濁った笑みを浮かべ、	PRINTFORMDW 膣内から触手が引き抜かれた頃には、リリーホワイトはとろりとした表情に濁った笑みを浮かべ、
PRINTFORMDW ずぶずぶと体内奥深くへと入り込み腸壁を蹂躙する感触に、彼女のココロが徐々に蕩けていく……	PRINTFORMDW ずぶずぶと体内奥深くへと入り込み腸壁を蹂躙する感触に、彼女のココロが徐々に蕩けていく……
PRINTFORMDW 抵抗する気力のないリリーホワイトは一瞬のうちに咥えこまれ、体内に引きずり込まれていく……	PRINTFORMDW 抵抗する気力のないリリーホワイトは一瞬のうちに咥えこまれ、体内に引きずり込まれていく……
PRINTFORMDW 激しくうねる触手が顔を、胸を、太腿を這う感触が、彼女の心に凌辱の絶望を刷り込んでいく……	PRINTFORMDW 激しくうねる触手が顔を、胸を、太腿を這う感触が、彼女の心に凌辱の絶望を刷り込んでいく……
PRINTFORMDW 部屋中の触手が無防備な寝姿を晒すリリーホワイトの手足を這い登り衣服の隙間に入り込む……。	PRINTFORMDW 部屋中の触手が無防備な寝姿を晒すリリーホワイトの手足を這い登り衣服の隙間に入り込む……。
PRINTFORMDW 苦痛よりも快楽がはるかに勝るのか、膣内を凌辱される度に純潔の証が混じった蜜を溢れさせる	PRINTFORMDW 苦痛よりも快楽がはるかに勝るのか、膣内を凌辱される度に純潔の証が混じった蜜を溢れさせる
PRINTFORMDW 幾つもの触手が口を、胸を、羽を、そして肛門や秘裂を犯すたびに彼女の心が壊されていく……	PRINTFORMDW 幾つもの触手が口を、胸を、羽を、そして肛門や秘裂を犯すたびに彼女の心が壊されていく……
PRINTFORMDW 己の身に起きたあまりに異様な出来事にリリーホワイトの瞳がみるみるうちに濁っていく……	PRINTFORMDW 己の身に起きたあまりに異様な出来事にリリーホワイトの瞳がみるみるうちに濁っていく……
PRINTFORMDW おぞましい魔物の子種が子宮を満たしていく感覚に、彼女の瞳からとめどなく涙が零れる……	PRINTFORMDW おぞましい魔物の子種が子宮を満たしていく感覚に、彼女の瞳からとめどなく涙が零れる……
PRINTFORMDW 無抵抗のリリーホワイトは全身を呑み込まれ、蠢く肉壁のさらに奥深くへと沈んでいく……	PRINTFORMDW 無抵抗のリリーホワイトは全身を呑み込まれ、蠢く肉壁のさらに奥深くへと沈んでいく……
PRINTFORMDW やはり春告精のリリーブラック。ホワイトとは二人で一人、一人で二人という関係である。	PRINTFORMDW やはり春告精のリリーブラック。ホワイトとは二人で一人、一人で二人という関係である。
PRINTFORMDW 粘液にまみれた触手がぐったりとしたリリーホワイトの双丘に絡みつき桜色の先端を弄ぶ	PRINTFORMDW 粘液にまみれた触手がぐったりとしたリリーホワイトの双丘に絡みつき桜色の先端を弄ぶ
PRINTFORMDW 触手は抵抗する気力のないリリーホワイトの躰を味わうように全身に絡み付き始めた……	PRINTFORMDW 触手は抵抗する気力のないリリーホワイトの躰を味わうように全身に絡み付き始めた……
PRINTFORMDW 全身に絡み付く触手が無抵抗のリリーホワイトの躰を嬲り尽くそうとさらに数を増す……	PRINTFORMDW 全身に絡み付く触手が無抵抗のリリーホワイトの躰を嬲り尽くそうとさらに数を増す……
PRINTFORMDW リリーホワイトは濁った笑みを浮かべ、流れる一筋の血も気にかけず己を慰めている……	PRINTFORMDW リリーホワイトは濁った笑みを浮かべ、流れる一筋の血も気にかけず己を慰めている……
PRINTFORMDW 白い素肌を晒して眠りにつくリリーホワイトの無防備な裸身はどこか煽情的に見える……	PRINTFORMDW 白い素肌を晒して眠りにつくリリーホワイトの無防備な裸身はどこか煽情的に見える……
PRINTFORMDW 膣内から引き抜かれた触手の粘液には純潔を奪われた事を意味する鮮血が混じっていた	PRINTFORMDW 膣内から引き抜かれた触手の粘液には純潔を奪われた事を意味する鮮血が混じっていた
PRINTFORMDW リリーホワイトは青ざめた顔で秘所に入り込もうとする触手を振り払おうとしている！	PRINTFORMDW リリーホワイトは青ざめた顔で秘所に入り込もうとする触手を振り払おうとしている！
PRINTFORML 「でももし異変だとしたら、巫女だの魔法使いだのがとっくに動き出してる筈よね……」	PRINTFORML 「でももし異変だとしたら、巫女だの魔法使いだのがとっくに動き出してる筈よね……」
PRINTFORMDW ガーディアンは残る力を悪しき視線に変え反撃するが、二人を包む眩い光に阻まれた！	PRINTFORMDW ガーディアンは残る力を悪しき視線に変え反撃するが、二人を包む眩い光に阻まれた！
PRINTFORMDW 気合一閃、前に突き出した手先から渾身の砲撃が放たれガーディアンの眼を撃ち貫く！	PRINTFORMDW 気合一閃、前に突き出した手先から渾身の砲撃が放たれガーディアンの眼を撃ち貫く！
PRINTFORMDW 迷宮の主は残る全ての触手を伸ばし反撃するが、全て二人を包む清浄な風に阻まれた！	PRINTFORMDW 迷宮の主は残る全ての触手を伸ばし反撃するが、全て二人を包む清浄な風に阻まれた！
PRINTFORML 「……はぁはぁ…痛くしないでよぅぅ…　…んはぁっ！…ああああぁぁぁぁぁぁ！！」	PRINTFORML 「……はぁはぁ…痛くしないでよぅぅ…　…んはぁっ！…ああああぁぁぁぁぁぁ！！」
PRINTFORMDW そのたびに彼女は身震いと共に悲鳴とも嬌声ともつかない喘ぎ声を漏らしている……	PRINTFORMDW そのたびに彼女は身震いと共に悲鳴とも嬌声ともつかない喘ぎ声を漏らしている……
PRINTFORMDW ナムサン！得体の知れぬ触手蠢く奇怪なラビリンスめいた洞窟に迷い込んでしまう。	PRINTFORMDW ナムサン！得体の知れぬ触手蠢く奇怪なラビリンスめいた洞窟に迷い込んでしまう。
PRINTFORML ・もし不審な挙動やエラーが発生した場合など、各自で構文を最適化してください。	PRINTFORML ・もし不審な挙動やエラーが発生した場合など、各自で構文を最適化してください。
PRINTFORMDW 幼いつぼみは愛蜜をたたえた花弁を開き、蠢く触手を抵抗なく受け容れていく……	PRINTFORMDW 幼いつぼみは愛蜜をたたえた花弁を開き、蠢く触手を抵抗なく受け容れていく……
PRINTFORML 「ひぎいぃぃっ！！　いたいいたいいたい！！　ああああぁぁぁぁぁぁっ！！！！」	PRINTFORML 「ひぎいぃぃっ！！　いたいいたいいたい！！　ああああぁぁぁぁぁぁっ！！！！」
PRINTFORMDW 粘液にまみれた触手が紅潮したリリーホワイトの双丘に絡みつき桜色の先端を弄ぶ	PRINTFORMDW 粘液にまみれた触手が紅潮したリリーホワイトの双丘に絡みつき桜色の先端を弄ぶ
PRINTFORML 「……でもぉ……くちゅくちゅしたらぁ…きもちいいからぁ、いいかなぁぁっ……」	PRINTFORML 「……でもぉ……くちゅくちゅしたらぁ…きもちいいからぁ、いいかなぁぁっ……」
PRINTFORMDW リリーホワイトは顔を紅潮させ、流れる一筋の血も気にかけず己を慰めている……	PRINTFORMDW リリーホワイトは顔を紅潮させ、流れる一筋の血も気にかけず己を慰めている……
PRINTFORMDW 全身の性感帯を愛撫され続ける彼女の寝息に、次第に喘ぎ声が混じっていく……。	PRINTFORMDW 全身の性感帯を愛撫され続ける彼女の寝息に、次第に喘ぎ声が混じっていく……。
PRINTFORMDW その時、店の中から一人の男性が姿を現した。香霖堂の店主、森近霖之助である。	PRINTFORMDW その時、店の中から一人の男性が姿を現した。香霖堂の店主、森近霖之助である。
PRINTFORMDW ――二人の渾身の弾幕が一つに重なり、輝く光の渦となって全てを浄化する！――	PRINTFORMDW ――二人の渾身の弾幕が一つに重なり、輝く光の渦となって全てを浄化する！――
PRINTFORMDW 処女膜を破られる苦痛よりも胎内を子供に刺激される快楽がはるかに勝るのか、	PRINTFORMDW 処女膜を破られる苦痛よりも胎内を子供に刺激される快楽がはるかに勝るのか、
PRINTFORMDW リリーホワイトは逃げ腰になりながらも武器を大きく振り上げ、一撃を放つ！	PRINTFORMDW リリーホワイトは逃げ腰になりながらも武器を大きく振り上げ、一撃を放つ！
PRINTFORMDW 彼女の小柄な体とは裏腹に、その声には聞く者を威圧するような気迫が漂う。	PRINTFORMDW 彼女の小柄な体とは裏腹に、その声には聞く者を威圧するような気迫が漂う。
PRINTFORMDW 満身創痍になりながらも迷宮の主はなお余裕に満ち溢れているように見える。	PRINTFORMDW 満身創痍になりながらも迷宮の主はなお余裕に満ち溢れているように見える。
PRINTFORMDW 彼女の顔はほんのりと赤く染まり幼いつぼみからは愛蜜を滴らせている……	PRINTFORMDW 彼女の顔はほんのりと赤く染まり幼いつぼみからは愛蜜を滴らせている……
PRINTFORMDW リリーホワイトは淀んだ瞳に涙を滲ませ声にならない叫びを上げている……	PRINTFORMDW リリーホワイトは淀んだ瞳に涙を滲ませ声にならない叫びを上げている……
PRINTFORMDW リリーホワイトはあまりの快楽に言葉を失いながら身を跳ねさせている……	PRINTFORMDW リリーホワイトはあまりの快楽に言葉を失いながら身を跳ねさせている……
PRINTFORMDW 部屋中の触手が無防備な裸身を晒すリリーホワイトの素肌を押し包む……。	PRINTFORMDW 部屋中の触手が無防備な裸身を晒すリリーホワイトの素肌を押し包む……。
PRINTFORMDW 春告精リリーホワイトは古道具屋、香霖堂付近で春が消失する異変を察知。	PRINTFORMDW 春告精リリーホワイトは古道具屋、香霖堂付近で春が消失する異変を察知。
PRINTFORMDW 脱出路を断たれ、バディたるリリーブラックとも分断されてしまったのだ。	PRINTFORMDW 脱出路を断たれ、バディたるリリーブラックとも分断されてしまったのだ。
PRINTFORML 「「リリースプリングウィンド・マーブル……マックスうぅぅっ！！！！」」	PRINTFORML 「「リリースプリングウィンド・マーブル……マックスうぅぅっ！！！！」」
PRINTFORMDW 産道を押し広げる自らの子供に処女膜を破られるという理不尽な痛みに、	PRINTFORMDW 産道を押し広げる自らの子供に処女膜を破られるという理不尽な痛みに、
PRINTFORMDW リリーホワイトが香霖堂の屋根裏に上がり、それに続くリリーブラック。	PRINTFORMDW リリーホワイトが香霖堂の屋根裏に上がり、それに続くリリーブラック。
PRINTFORMDW 少女たちの激しい弾幕が、確実にガーディアンの邪悪な力を削っている！	PRINTFORMDW 少女たちの激しい弾幕が、確実にガーディアンの邪悪な力を削っている！
PRINTFORMDW 全身を拘束されたリリーホワイトは動けないまま犯され続けている……	PRINTFORMDW 全身を拘束されたリリーホワイトは動けないまま犯され続けている……
PRINTFORML ぅふ、いいですよぉ…？　触手さんの赤ちゃんっ…産んであげても……。	PRINTFORML ぅふ、いいですよぉ…？　触手さんの赤ちゃんっ…産んであげても……。
PRINTFORML 「いたいいたいいたい！！　お腹やぶれちゃううぅぅぅ――っ！！！！」	PRINTFORML 「いたいいたいいたい！！　お腹やぶれちゃううぅぅぅ――っ！！！！」
PRINTFORML ――清らかなる風よ、春告精リリーホワイトの名の下にこの地の穢れを…	PRINTFORML ――清らかなる風よ、春告精リリーホワイトの名の下にこの地の穢れを…
PRINTFORMDW リリーホワイトの春告精としての活動も終わりにさしかかっていた……	PRINTFORMDW リリーホワイトの春告精としての活動も終わりにさしかかっていた……
PRINTFORMDW リリーホワイトは逃げ腰になりながらも狙い澄ました弾幕を放った！	PRINTFORMDW リリーホワイトは逃げ腰になりながらも狙い澄ました弾幕を放った！
PRINTFORMDW リリーホワイトは逃げ腰になりながらも狙い澄まして武器を撃った！	PRINTFORMDW リリーホワイトは逃げ腰になりながらも狙い澄まして武器を撃った！
PRINTFORMDW リリーホワイトは逃げ腰になりながらも力の限り武器を撃ちこんだ！	PRINTFORMDW リリーホワイトは逃げ腰になりながらも力の限り武器を撃ちこんだ！
PRINTFORMDW リリーホワイトは逃げ腰になりながらも正確に狙って武器を振った！	PRINTFORMDW リリーホワイトは逃げ腰になりながらも正確に狙って武器を振った！
PRINTFORMDW リリーホワイトは構えた武器もろとも突撃し、敵の中心を一撃した！	PRINTFORMDW リリーホワイトは構えた武器もろとも突撃し、敵の中心を一撃した！
PRINTFORMDW リリーホワイトは全身を触手に愛撫され甘い喘ぎ声をあげている……	PRINTFORMDW リリーホワイトは全身を触手に愛撫され甘い喘ぎ声をあげている……
PRINTFORML きっ…きもちよくてえぇっ、おまたがびちゃびちゃしてるよおぉぉ！！	PRINTFORML きっ…きもちよくてえぇっ、おまたがびちゃびちゃしてるよおぉぉ！！
PRINTFORML ぁぁっ…あつくなってるっ、なかきゅんきゅんしてるよぉぉぉ――！！	PRINTFORML ぁぁっ…あつくなってるっ、なかきゅんきゅんしてるよぉぉぉ――！！
PRINTFORML ……ここから…だしてぇ…　…暗いよ…狭いよ…熱い…よ…ぉぉっ……	PRINTFORML ……ここから…だしてぇ…　…暗いよ…狭いよ…熱い…よ…ぉぉっ……
PRINTFORMDW それを直視してしまったリリーホワイトの瞳が絶望に濁っていく……	PRINTFORMDW それを直視してしまったリリーホワイトの瞳が絶望に濁っていく……
PRINTFORMDW ――この時二人は、この先に何が待っているか知る由も無かった――	PRINTFORMDW ――この時二人は、この先に何が待っているか知る由も無かった――
PRINTFORMDW 少女たちの激しい弾幕が、確実に迷宮の主の邪悪な力を削っている！	PRINTFORMDW 少女たちの激しい弾幕が、確実に迷宮の主の邪悪な力を削っている！
PRINTFORMDW リリーホワイトは逃げ腰になりながらも敵に渾身の弾幕を放った！	PRINTFORMDW リリーホワイトは逃げ腰になりながらも敵に渾身の弾幕を放った！
PRINTFORML ……ぁっ…そこぉ…はずかしいのにぃ…あつくなっちゃうぅぅ……。	PRINTFORML ……ぁっ…そこぉ…はずかしいのにぃ…あつくなっちゃうぅぅ……。
PRINTFORML ……もう…やめてよぉっ…　…はなして…はな…し…て…よぉぉ……	PRINTFORML ……もう…やめてよぉっ…　…はなして…はな…し…て…よぉぉ……
PRINTFORML ……あ…んっ…　なかくちゅくちゅしたらぁ…わたしいぃ…もぉ……	PRINTFORML ……あ…んっ…　なかくちゅくちゅしたらぁ…わたしいぃ…もぉ……
PRINTFORML 「……春来るぅぅ…がまんできないぃ…　いれちゃうのぉぉっ……」	PRINTFORML 「……春来るぅぅ…がまんできないぃ…　いれちゃうのぉぉっ……」
PRINTFORML ――よかった…支えてくれてるみんなは、いつだってそばに……！！	PRINTFORML ――よかった…支えてくれてるみんなは、いつだってそばに……！！
PRINTFORMDW 二人は力を合わせ、その身に宿された全ての春度を力に変える……	PRINTFORMDW 二人は力を合わせ、その身に宿された全ての春度を力に変える……
PRINTFORML ・内容の半分は春で出来ています。残りの半分は……　ネタです。	PRINTFORML ・内容の半分は春で出来ています。残りの半分は……　ネタです。
PRINTFORML ……ひいぃぃ！！　……うぅぅっ…ああああぁぁぁぁぁぁ……！！	PRINTFORML ……ひいぃぃ！！　……うぅぅっ…ああああぁぁぁぁぁぁ……！！
PRINTFORMDW リリーホワイトは逃げ腰になりながらも勢いある弾幕を放った！	PRINTFORMDW リリーホワイトは逃げ腰になりながらも勢いある弾幕を放った！
PRINTFORMDW リリーホワイトは逃げ腰になりながらも勢いよく武器を撃った！	PRINTFORMDW リリーホワイトは逃げ腰になりながらも勢いよく武器を撃った！
PRINTFORMDW リリーホワイトは逃げ腰になりながらも勢いよく武器を振った！	PRINTFORMDW リリーホワイトは逃げ腰になりながらも勢いよく武器を振った！
PRINTFORMDW リリーホワイトは構えた武器を振り回し、敵の足元を一撃した！	PRINTFORMDW リリーホワイトは構えた武器を振り回し、敵の足元を一撃した！
PRINTFORML 「何かあるの…奇跡はないかもしれないけど、それと同じものが」	PRINTFORML 「何かあるの…奇跡はないかもしれないけど、それと同じものが」
PRINTFORML あったかいのぉ、わたしの中にいっぱい出してくださいぃぃっ……	PRINTFORML あったかいのぉ、わたしの中にいっぱい出してくださいぃぃっ……
PRINTFORMDW リリーホワイトの瞳に濁りが見える、精神的に余裕がないようだ	PRINTFORMDW リリーホワイトの瞳に濁りが見える、精神的に余裕がないようだ
PRINTFORML 「それじゃさっそく、香霖堂へ行って春伝えてくるですよー！！」	PRINTFORML 「それじゃさっそく、香霖堂へ行って春伝えてくるですよー！！」
PRINTFORMDW 香霖堂周辺には雪が深く降り積もり、未だ春の気配は全く無い。	PRINTFORMDW 香霖堂周辺には雪が深く降り積もり、未だ春の気配は全く無い。
PRINTFORMDW 「そう言えば屋根裏に住み着いてる本読み妖怪を最近見ないね」	PRINTFORMDW 「そう言えば屋根裏に住み着いてる本読み妖怪を最近見ないね」
PRINTFORML ……それでも冬はいつか終わって、また春が来るんです……！！」	PRINTFORML ……それでも冬はいつか終わって、また春が来るんです……！！」
PRINTFORMDW 目視でも分かるほど強力な魔力へと変換して渾身の砲撃を放つ！	PRINTFORMDW 目視でも分かるほど強力な魔力へと変換して渾身の砲撃を放つ！
PRINTFORMDW リリーホワイトは自らの純潔に迫る危機に気付いていない……	PRINTFORMDW リリーホワイトは自らの純潔に迫る危機に気付いていない……
PRINTFORMDW 触手と粘液にまみれたまま甘いまどろみへと沈んでいった……	PRINTFORMDW 触手と粘液にまみれたまま甘いまどろみへと沈んでいった……
PRINTFORMDW リリーホワイトは歓喜とも嬌声とも似た叫びを上げている……	PRINTFORMDW リリーホワイトは歓喜とも嬌声とも似た叫びを上げている……
PRINTFORMDW リリーホワイトは歯を食いしばり苦痛の叫びを上げている……	PRINTFORMDW リリーホワイトは歯を食いしばり苦痛の叫びを上げている……
PRINTFORML さきっぽもっとっ…もっといじってえぇぇ…んあぁぁっ……！！	PRINTFORML さきっぽもっとっ…もっといじってえぇぇ…んあぁぁっ……！！
PRINTFORML …ひゃぁあっ！…おくまでぇ、おくまではいってくるうぅぅ！！	PRINTFORML …ひゃぁあっ！…おくまでぇ、おくまではいってくるうぅぅ！！
PRINTFORML ……んんっ…　おしりきもちいぃっ…がまんできないようぅ……	PRINTFORML ……んんっ…　おしりきもちいぃっ…がまんできないようぅ……
PRINTFORML んぁああ！！　…ぁあぁっ…あっ、あっあああぁぁぁっ！！！！	PRINTFORML んぁああ！！　…ぁあぁっ…あっ、あっあああぁぁぁっ！！！！
PRINTFORMDW ガーディアンは残る力を邪視に集め、最後の反撃を試みる……	PRINTFORMDW ガーディアンは残る力を邪視に集め、最後の反撃を試みる……
PRINTFORMDW その奥で固く閉じたつぼみへとその先端を伸ばしていく……	PRINTFORMDW その奥で固く閉じたつぼみへとその先端を伸ばしていく……
PRINTFORMDW 暗く淀んだ表情の口許から微かに苦悶の喘ぎ声が漏れる……	PRINTFORMDW 暗く淀んだ表情の口許から微かに苦悶の喘ぎ声が漏れる……
PRINTFORMDW リリーホワイトは敵に向かって大量の花吹雪をばら撒いた！	PRINTFORMDW リリーホワイトは敵に向かって大量の花吹雪をばら撒いた！
PRINTFORMDW リリーホワイトは手にした武器をあたり構わず撃っている！	PRINTFORMDW リリーホワイトは手にした武器をあたり構わず撃っている！
PRINTFORMDW リリーホワイトは敵に狙いを定め手にした武器を連射した！	PRINTFORMDW リリーホワイトは敵に狙いを定め手にした武器を連射した！
PRINTFORMDW リリーホワイトは武器を大きく振り上げ、敵に叩きつけた！	PRINTFORMDW リリーホワイトは武器を大きく振り上げ、敵に叩きつけた！
PRINTFORMDW リリーホワイトは肢体を投げ出し凌辱に身を任せている……	PRINTFORMDW リリーホワイトは肢体を投げ出し凌辱に身を任せている……
PRINTFORML 「……じゃなきゃ、誰も生きてなんていけないもの……！！」	PRINTFORML 「……じゃなきゃ、誰も生きてなんていけないもの……！！」
PRINTFORML ……こんなに出されたらぁっ…赤ちゃんできちゃうよぉ……。	PRINTFORML ……こんなに出されたらぁっ…赤ちゃんできちゃうよぉ……。
PRINTFORML ……あ…ぁっ…　またっ…またはいってっ…きちゃうぅぅ……	PRINTFORML ……あ…ぁっ…　またっ…またはいってっ…きちゃうぅぅ……
PRINTFORML ……あ…ぁっ…　またっ…またすごいのっ…きちゃうぅぅ……	PRINTFORML ……あ…ぁっ…　またっ…またすごいのっ…きちゃうぅぅ……
PRINTFORML ……ううぅ…　あそこが熱いよぅっ…もう…げんかいぃぃ……	PRINTFORML ……ううぅ…　あそこが熱いよぅっ…もう…げんかいぃぃ……
PRINTFORML ぁっ…ぁあっ…ゃあっ、あっあっあっあああぁぁ――！！！！	PRINTFORML ぁっ…ぁあっ…ゃあっ、あっあっあっあああぁぁ――！！！！
PRINTFORML 「……中で動いて…外に出てくるぅ…早くでてきてぇっ……」	PRINTFORML 「……中で動いて…外に出てくるぅ…早くでてきてぇっ……」
PRINTFORML 「……こんなにおっきい…　…わたしの中から…んぁっ……」	PRINTFORML 「……こんなにおっきい…　…わたしの中から…んぁっ……」
PRINTFORML 「……なかで…中で動いてるのぅ…外にでてくるよぉぉ……」	PRINTFORML 「……なかで…中で動いてるのぅ…外にでてくるよぉぉ……」
PRINTFORMDW 「書庫から勝手に持ち出した本を返して貰いた……あれ？」	PRINTFORMDW 「書庫から勝手に持ち出した本を返して貰いた……あれ？」
PRINTFORML 「仕方ないわねぇ…消えた本読み妖怪の話も気になるし……」	PRINTFORML 「仕方ないわねぇ…消えた本読み妖怪の話も気になるし……」
PRINTFORMDW 退路無き以上、このケオスの中で脱出法を探さねばならぬ。	PRINTFORMDW 退路無き以上、このケオスの中で脱出法を探さねばならぬ。
PRINTFORMDW リリーホワイトは高く舞い上がると、迷宮の主に呼びかける	PRINTFORMDW リリーホワイトは高く舞い上がると、迷宮の主に呼びかける
PRINTFORML ・一部を除いて口上に「」がついていませんが、仕様です。	PRINTFORML ・一部を除いて口上に「」がついていませんが、仕様です。
PRINTFORML ・ライセンスなどの詳細はりーどみーを読むこと。いいね？	PRINTFORML ・ライセンスなどの詳細はりーどみーを読むこと。いいね？
PRINTFORML …ぁっあっ…ぁあん…　ぁ…んぅあぁぁ――――っ……！！	PRINTFORML …ぁっあっ…ぁあん…　ぁ…んぅあぁぁ――――っ……！！
PRINTFORML …あぁぁっ…！　…あたまとろけちゃうよぉぉ…ぁぁぁ……	PRINTFORML …あぁぁっ…！　…あたまとろけちゃうよぉぉ…ぁぁぁ……
PRINTFORML ……やめて…はいって…こないでぇ…　…いやっ…ぁっ……	PRINTFORML ……やめて…はいって…こないでぇ…　…いやっ…ぁっ……
PRINTFORML ……ぁぁ…おなかに…はいってくる…　…ぃやあぁぁっ……	PRINTFORML ……ぁぁ…おなかに…はいってくる…　…ぃやあぁぁっ……
PRINTFORML ……いっぱい溢れてる…こんなに、奥までたくさん……！？	PRINTFORML ……いっぱい溢れてる…こんなに、奥までたくさん……！？
PRINTFORML なかが、なんか熱いのっ、はいってくる…いやあああぁ……	PRINTFORML なかが、なんか熱いのっ、はいってくる…いやあああぁ……
PRINTFORML ……あ…はぁ…　胸がじんじんしてぇ…もう…あぁぁぁ……	PRINTFORML ……あ…はぁ…　胸がじんじんしてぇ…もう…あぁぁぁ……
PRINTFORML 「……よく会う気がしますけど、まさかこんな場所で……」	PRINTFORML 「……よく会う気がしますけど、まさかこんな場所で……」
PRINTFORML 「……こんな化け物が…　…わたしの中から…うぅっ……」	PRINTFORML 「……こんな化け物が…　…わたしの中から…うぅっ……」
PRINTFORML 「こういうのってあれじゃないんですか？『異変』です！」	PRINTFORML 「こういうのってあれじゃないんですか？『異変』です！」
PRINTFORML 「春が来て、夏が来て、秋になって、やがては冬になる……	PRINTFORML 「春が来て、夏が来て、秋になって、やがては冬になる……
PRINTFORMDW リリーホワイトは敵に向かって輝かしい弾幕を放った！	PRINTFORMDW リリーホワイトは敵に向かって輝かしい弾幕を放った！
PRINTFORMDW リリーホワイトは敵の隙を突き、全力の一撃を放った！	PRINTFORMDW リリーホワイトは敵の隙を突き、全力の一撃を放った！
PRINTFORML ……そこは…ぁっ！？　…ぁんっ…！　はぁ…ぁあっ……	PRINTFORML ……そこは…ぁっ！？　…ぁんっ…！　はぁ…ぁあっ……
PRINTFORML でも…すごくぅぅっ…気持ちが…あったかいよぉぉ……。	PRINTFORML でも…すごくぅぅっ…気持ちが…あったかいよぉぉ……。
PRINTFORML 「……おねがい…痛くしないで…早くでてきてぇっ……」	PRINTFORML 「……おねがい…痛くしないで…早くでてきてぇっ……」
PRINTFORML 「あぁぁぁ、……わたしぃ…こわれちゃううぅぅぅ……」	PRINTFORML 「あぁぁぁ、……わたしぃ…こわれちゃううぅぅぅ……」
PRINTFORMDW リリーホワイトの手許に大量の春度が集まってゆく……	PRINTFORMDW リリーホワイトの手許に大量の春度が集まってゆく……
PRINTFORML 「は、　る、　で、　す、　よ　お　おぉぉぉ！！！！」	PRINTFORML 「は、　る、　で、　す、　よ　お　おぉぉぉ！！！！」
PRINTFORMDW リリーホワイトは敵に向かって渾身の弾幕を放った！	PRINTFORMDW リリーホワイトは敵に向かって渾身の弾幕を放った！
PRINTFORMDW リリーホワイトは辺り一面に無数の光の矢を放った！	PRINTFORMDW リリーホワイトは辺り一面に無数の光の矢を放った！
PRINTFORMDW リリーホワイトは敵に最大火力で武器を撃ちこんだ！	PRINTFORMDW リリーホワイトは敵に最大火力で武器を撃ちこんだ！
PRINTFORML ぃやぁぁー！食べられて一回休みなんてやですーっ！！	PRINTFORML ぃやぁぁー！食べられて一回休みなんてやですーっ！！
PRINTFORML ……ぅぅっ…わたし…どうなっ…　…ぃゃ…ぁああ……	PRINTFORML ……ぅぅっ…わたし…どうなっ…　…ぃゃ…ぁああ……
PRINTFORML 抜け出さなきゃっ…でも…気持ちよくなっちゃう……。	PRINTFORML 抜け出さなきゃっ…でも…気持ちよくなっちゃう……。
PRINTFORML ……んんっ…ぬるぬるして…なんか不思議な気分……。	PRINTFORML ……んんっ…ぬるぬるして…なんか不思議な気分……。
PRINTFORML 身体中…舐められてるみたいぃ…気持ちいいょぉぉ……	PRINTFORML 身体中…舐められてるみたいぃ…気持ちいいょぉぉ……
PRINTFORML ……んぁっ…ぁあぁっ…また…きちゃうぅぅっ……！！	PRINTFORML ……んぁっ…ぁあぁっ…また…きちゃうぅぅっ……！！
PRINTFORML でもっ…何されるのか…ちょっと楽しみですうぅぅ……	PRINTFORML でもっ…何されるのか…ちょっと楽しみですうぅぅ……
PRINTFORML 気持ちいいこと…してくれる…ぁあっ…そこぉぉっ……	PRINTFORML 気持ちいいこと…してくれる…ぁあっ…そこぉぉっ……
PRINTFORML はなして…だめ…そこは…そこはやめてえぇぇ……！！	PRINTFORML はなして…だめ…そこは…そこはやめてえぇぇ……！！
PRINTFORML ……な…なかはいやぁ…！　…だめ…えっ…あぁぁ……	PRINTFORML ……な…なかはいやぁ…！　…だめ…えっ…あぁぁ……
PRINTFORML ……こころにも…からだにも…いっぱい入れられて……	PRINTFORML ……こころにも…からだにも…いっぱい入れられて……
PRINTFORML 「力を吸収して…より強くなったっていうの……！？」	PRINTFORML 「力を吸収して…より強くなったっていうの……！？」
PRINTFORMDW その元凶が屋根裏にあると踏み調査を開始したが……	PRINTFORMDW その元凶が屋根裏にあると踏み調査を開始したが……
PRINTFORMDW 守るべきもののため、走れ！リリーホワイト！走れ！	PRINTFORMDW 守るべきもののため、走れ！リリーホワイト！走れ！
PRINTFORMDW リリーホワイトは全身の春度を眼前の一点に凝縮し、	PRINTFORMDW リリーホワイトは全身の春度を眼前の一点に凝縮し、
PRINTFORML 「リリースプリングウィンド・ホワイトー！！！！」	PRINTFORML 「リリースプリングウィンド・ホワイトー！！！！」
PRINTFORMDW リリーホワイトはチャージした春度を解き放った！	PRINTFORMDW リリーホワイトはチャージした春度を解き放った！
PRINTFORMDW 解き放たれた春が光の渦となり敵を浄化してゆく！	PRINTFORMDW 解き放たれた春が光の渦となり敵を浄化してゆく！
PRINTFORMDW リリーホワイトは敵を正確に狙って武器を振った！	PRINTFORMDW リリーホワイトは敵を正確に狙って武器を振った！
PRINTFORML 「わたしの願いは、全ての触手を消し去ること！！」	PRINTFORML 「わたしの願いは、全ての触手を消し去ること！！」
PRINTFORMDW ――目覚めた心は走り出した未来を描くため…――	PRINTFORMDW ――目覚めた心は走り出した未来を描くため…――
PRINTFORML …んんっ…おしりのなかきもちいいよおぉぉぉ……。	PRINTFORML …んんっ…おしりのなかきもちいいよおぉぉぉ……。
PRINTFORML ……ぁっ…わたし…食べられて…　…ぃゃ…ぁ……。	PRINTFORML ……ぁっ…わたし…食べられて…　…ぃゃ…ぁ……。
PRINTFORML ……んあぁっ…巻き付いてくる…敏感なとこにぃ……	PRINTFORML ……んあぁっ…巻き付いてくる…敏感なとこにぃ……
PRINTFORML ……ゃっ…だ…め…ぇっ…　は…はな…し…てっ……	PRINTFORML ……ゃっ…だ…め…ぇっ…　は…はな…し…てっ……
PRINTFORML んあぁっ…とけちゃう…とけちゃうよおぉっ……！！	PRINTFORML んあぁっ…とけちゃう…とけちゃうよおぉっ……！！
PRINTFORML 中で動いてて…こわれちゃうよ……き、きゃぁぁ！？	PRINTFORML 中で動いてて…こわれちゃうよ……き、きゃぁぁ！？
PRINTFORML ……やだ、お腹に…なかになにかいれられて――！？	PRINTFORML ……やだ、お腹に…なかになにかいれられて――！？
PRINTFORML ……ん…ぁぁっ――――z＿＿＿＿＿＿＿＿！！！！	PRINTFORML ……ん…ぁぁっ――――z＿＿＿＿＿＿＿＿！！！！
PRINTFORML 「……いたいいぃ…おなか…こわれちゃうぅっ……」	PRINTFORML 「……いたいいぃ…おなか…こわれちゃうぅっ……」
PRINTFORML ……別のものに…ずっと気持ちよくなれるなにか……	PRINTFORML ……別のものに…ずっと気持ちよくなれるなにか……
PRINTFORMDW リリーホワイトは黒く濁った瞳で宙を見つめている	PRINTFORMDW リリーホワイトは黒く濁った瞳で宙を見つめている
PRINTFORMDW リリーホワイトは顔を紅潮させどこか緩んだ表情だ	PRINTFORMDW リリーホワイトは顔を紅潮させどこか緩んだ表情だ
PRINTFORML 「白百合の花言葉は『純潔』『無垢』なんですよー」	PRINTFORML 「白百合の花言葉は『純潔』『無垢』なんですよー」
PRINTFORML 「今年もこれで春を伝える仕事はおしまいですよー」	PRINTFORML 「今年もこれで春を伝える仕事はおしまいですよー」
PRINTFORMDW 「君たちは確か…春の妖精だね、用事は何かな？」	PRINTFORMDW 「君たちは確か…春の妖精だね、用事は何かな？」
PRINTFORMDW 既に二人の姿は霖之助の視界から消えていた……。	PRINTFORMDW 既に二人の姿は霖之助の視界から消えていた……。
PRINTFORML 「春を奪ったのは、あなただったんですね……！！」	PRINTFORML 「春を奪ったのは、あなただったんですね……！！」
PRINTFORMDW しかしそれが春告精の激情に最後の火をつけた……	PRINTFORMDW しかしそれが春告精の激情に最後の火をつけた……
PRINTFORMDW 彼女の意識は再び絶望の淵へと沈んでいった……	PRINTFORMDW 彼女の意識は再び絶望の淵へと沈んでいった……
PRINTFORMDW リリーホワイトは狙いを澄まして弾幕を放った！	PRINTFORMDW リリーホワイトは狙いを澄まして弾幕を放った！
PRINTFORMDW リリーホワイトは狙いを澄まして武器を撃った！	PRINTFORMDW リリーホワイトは狙いを澄まして武器を撃った！
PRINTFORMDW リリーホワイトは牽制程度に武器を撃っている！	PRINTFORMDW リリーホワイトは牽制程度に武器を撃っている！
PRINTFORML （……きもちいい…　…もう…動けないよぅ……）	PRINTFORML （……きもちいい…　…もう…動けないよぅ……）
PRINTFORML 捕まったら気持ちいいことしてくれるですかね……	PRINTFORML 捕まったら気持ちいいことしてくれるですかね……
PRINTFORML 「…わたしなら…絶対、だいじょうぶだから！！」	PRINTFORML 「…わたしなら…絶対、だいじょうぶだから！！」
PRINTFORML ……やぁぁぁ…こわれ…ちゃうよぉ…　うぅっ……	PRINTFORML ……やぁぁぁ…こわれ…ちゃうよぉ…　うぅっ……
PRINTFORML …そこぉ、そこじんじんするのおぉぉぉっ……！！	PRINTFORML …そこぉ、そこじんじんするのおぉぉぉっ……！！
PRINTFORML は、離れてよぉ…ぁあっ…揉まないでぇっ……！！	PRINTFORML は、離れてよぉ…ぁあっ…揉まないでぇっ……！！
PRINTFORML ……やだっ…だめ…ぇっ…　は…はな…し…て……	PRINTFORML ……やだっ…だめ…ぇっ…　は…はな…し…て……
PRINTFORML ……ひゃあぁ！　…そんなに舐めないでよぉぉ……	PRINTFORML ……ひゃあぁ！　…そんなに舐めないでよぉぉ……
PRINTFORML ……あっあぁぁっ…羽は…弱いの…おぉぉ……！！	PRINTFORML ……あっあぁぁっ…羽は…弱いの…おぉぉ……！！
PRINTFORML ……あぁっ…ぁぁぁ…そこは…弱いのぉぉ……！！	PRINTFORML ……あぁっ…ぁぁぁ…そこは…弱いのぉぉ……！！
PRINTFORML こんな気持ち悪いのに食べられるのはいやーっ！！	PRINTFORML こんな気持ち悪いのに食べられるのはいやーっ！！
PRINTFORML ……もう…抜け出す…なんてぇっ…んあぁぁ……。	PRINTFORML ……もう…抜け出す…なんてぇっ…んあぁぁ……。
PRINTFORML 「……あのー、一時休戦でいいですねー……？」		PRINTFORML 「……あのー、一時休戦でいいですねー……？」	
PRINTFORML 「幽香さんも閉じ込められたんですか……！？」		PRINTFORML 「幽香さんも閉じ込められたんですか……！？」	
PRINTFORML 「妖夢さんも春を探して……？　違ったですかー」	PRINTFORML 「妖夢さんも春を探して……？　違ったですかー」
PRINTFORML 「……うぅ…いやっ…　こんなのってないよ……」	PRINTFORML 「……うぅ…いやっ…　こんなのってないよ……」
PRINTFORML 「……わたし…　お母さんに…なっちゃった……」	PRINTFORML 「……わたし…　お母さんに…なっちゃった……」
PRINTFORML …あぁぁぁ…！　…あたまとろけちゃうよぉぉ……	PRINTFORML …あぁぁぁ…！　…あたまとろけちゃうよぉぉ……
PRINTFORML 「ここ気持ちいい…わたし…いれちゃうよぉ……」	PRINTFORML 「ここ気持ちいい…わたし…いれちゃうよぉ……」
PRINTFORML 「……でも……　きもちいいから、いいかな……」	PRINTFORML 「……でも……　きもちいいから、いいかな……」
PRINTFORML 「……私も感じる、この奥には確実に何かあるわ」	PRINTFORML 「……私も感じる、この奥には確実に何かあるわ」
PRINTFORMDW ――Listen to my song…――	PRINTFORMDW ――Listen to my song…――
PRINTFORML んうっ！？…ふ…ぅみゅうぅぅぅ――――っ……	PRINTFORML んうっ！？…ふ…ぅみゅうぅぅぅ――――っ……
PRINTFORML 「逃げちゃだめ逃げちゃだめ逃げちゃだめ……」	PRINTFORML 「逃げちゃだめ逃げちゃだめ逃げちゃだめ……」
PRINTFORML 「ブラック、ふたりで撃ちまくりますよー！！」	PRINTFORML 「ブラック、ふたりで撃ちまくりますよー！！」
PRINTFORMDW リリーホワイトは敵に勢いよく武器を振った！	PRINTFORMDW リリーホワイトは敵に勢いよく武器を振った！
PRINTFORML んあぁー！　…ふぁ、あっ…ぁああぁぁ……！！	PRINTFORML んあぁー！　…ふぁ、あっ…ぁああぁぁ……！！
PRINTFORML 食べても美味しくないって言ったですよー……。	PRINTFORML 食べても美味しくないって言ったですよー……。
PRINTFORML もうちょっと…もうちょっとだったのにっ……。	PRINTFORML もうちょっと…もうちょっとだったのにっ……。
PRINTFORML ……放してぇっ…もう…乱暴しないでよぅ……。	PRINTFORML ……放してぇっ…もう…乱暴しないでよぅ……。
PRINTFORML …いやぁっ…！　恥ずかしいですよおぉっ……。	PRINTFORML …いやぁっ…！　恥ずかしいですよおぉっ……。
PRINTFORML ……いや…ぁん！？　…んっ…ぁぁ…ぁあっ……	PRINTFORML ……いや…ぁん！？　…んっ…ぁぁ…ぁあっ……
PRINTFORML ゃあぁぁ…お尻でぇ、お尻のなかでえぇぇ……。	PRINTFORML ゃあぁぁ…お尻でぇ、お尻のなかでえぇぇ……。
PRINTFORML 恥ずかしいとこなのに…この感じいぃぃ……！！	PRINTFORML 恥ずかしいとこなのに…この感じいぃぃ……！！
PRINTFORML なかで…動いてるうぅ…なにこの気分っ……！？	PRINTFORML なかで…動いてるうぅ…なにこの気分っ……！？
PRINTFORML お尻の穴がぁあ…なんか広がってるよおぉ……。	PRINTFORML お尻の穴がぁあ…なんか広がってるよおぉ……。
PRINTFORML ……ひゃあぁ…中まではいってくるぅぅ……！？	PRINTFORML ……ひゃあぁ…中まではいってくるぅぅ……！？
PRINTFORML ゃ…そこ弱いのぉっ！　んあっぁっぁぁぁ……。	PRINTFORML ゃ…そこ弱いのぉっ！　んあっぁっぁぁぁ……。
PRINTFORML やだっ…はいってくる…動いてるよおぉぉ……。	PRINTFORML やだっ…はいってくる…動いてるよおぉぉ……。
PRINTFORML ふあぁん…抜けないとっ…でもこの感触っ……。	PRINTFORML ふあぁん…抜けないとっ…でもこの感触っ……。
PRINTFORML ……熱いぃぃ…ぁぁ…ふぁあっ…んぅぅっ……。	PRINTFORML ……熱いぃぃ…ぁぁ…ふぁあっ…んぅぅっ……。
PRINTFORML ……やだっ…こんなに…もうやめてよおぉぉ……	PRINTFORML ……やだっ…こんなに…もうやめてよおぉぉ……
PRINTFORML …わたし…　…これからどうなっちゃうのぉ……	PRINTFORML …わたし…　…これからどうなっちゃうのぉ……
PRINTFORML ん―――！！　あぁ――――――――っ！！！！	PRINTFORML ん―――！！　あぁ――――――――っ！！！！
PRINTFORML 「……なかで…うごいてっ…でてくるぅっ……」	PRINTFORML 「……なかで…うごいてっ…でてくるぅっ……」
PRINTFORML 「……いや…　…なかから…こんなのぉっ……」	PRINTFORML 「……いや…　…なかから…こんなのぉっ……」
PRINTFORML 「……わたしの…胸…　吸ってくれてるぅ……」	PRINTFORML 「……わたしの…胸…　吸ってくれてるぅ……」
PRINTFORML 「……わたし…そっくり…　…かわいいっ……」	PRINTFORML 「……わたし…そっくり…　…かわいいっ……」
PRINTFORMDL リリーホワイト口上オープニングを見ますか？	PRINTFORMDL リリーホワイト口上オープニングを見ますか？
PRINTFORML 「何か変わったことは起こりませんでしたか？」	PRINTFORML 「何か変わったことは起こりませんでしたか？」
PRINTFORML 「屋根裏に手がかりがあるかも知れませんよ！」	PRINTFORML 「屋根裏に手がかりがあるかも知れませんよ！」
PRINTFORML 「間違いないよ、この奥に春が消えていってる」	PRINTFORML 「間違いないよ、この奥に春が消えていってる」
PRINTFORML ……だから、まだ頑張れるっ…戦えるっ……！！	PRINTFORML ……だから、まだ頑張れるっ…戦えるっ……！！
PRINTFORML ……からだうごかない…もう少し…寝る……。	PRINTFORML ……からだうごかない…もう少し…寝る……。
PRINTFORML …んん――っ！？ぁぁ…みひゃぁぁっ……！？	PRINTFORML …んん――っ！？ぁぁ…みひゃぁぁっ……！？
PRINTFORMDW リリーホワイトは春度をチャージしている！	PRINTFORMDW リリーホワイトは春度をチャージしている！
PRINTFORML だから食べても美味しくないですよー……！！	PRINTFORML だから食べても美味しくないですよー……！！
PRINTFORML も、もう…おねがいぃ、はなして…えぇ……。	PRINTFORML も、もう…おねがいぃ、はなして…えぇ……。
PRINTFORML もっとぉ…もっとはいってきてえぇっ……！！	PRINTFORML もっとぉ…もっとはいってきてえぇっ……！！
PRINTFORML ……胸が…なんか…すごいのおぉぉっ……！！	PRINTFORML ……胸が…なんか…すごいのおぉぉっ……！！
PRINTFORML ……ふあっ…ぁ…ぁぁ…ぁあぁぁぁっ……！？	PRINTFORML ……ふあっ…ぁ…ぁぁ…ぁあぁぁぁっ……！？
PRINTFORML そ、そんなとこ…恥ずかしいですよぉ……！！	PRINTFORML そ、そんなとこ…恥ずかしいですよぉ……！！
PRINTFORML ……やだ…ぁぁ…ぁあっ、ひゃあぁぁぁん！？	PRINTFORML ……やだ…ぁぁ…ぁあっ、ひゃあぁぁぁん！？
PRINTFORML きゃあっ！　…あっ…なかまで…ううっ……。	PRINTFORML きゃあっ！　…あっ…なかまで…ううっ……。
PRINTFORML いっぱい…ぁ…撫でられてる…んうぅぅぅ……	PRINTFORML いっぱい…ぁ…撫でられてる…んうぅぅぅ……
PRINTFORML ……足とか胸に…絡み付いてるぅ…んんっ……	PRINTFORML ……足とか胸に…絡み付いてるぅ…んんっ……
PRINTFORML いやぁっ…！？　やだっ、放してよお……！！	PRINTFORML いやぁっ…！？　やだっ、放してよお……！！
PRINTFORML ……いやっ…ぬるぬるで気持ち悪いよぉ……。	PRINTFORML ……いやっ…ぬるぬるで気持ち悪いよぉ……。
PRINTFORML ……はぅぅ…どうなっちゃうのぉ…ぉぉっ……	PRINTFORML ……はぅぅ…どうなっちゃうのぉ…ぉぉっ……
PRINTFORML ……全身…ぎゅうってされて…ふあぁぁっ……	PRINTFORML ……全身…ぎゅうってされて…ふあぁぁっ……
PRINTFORML ……んううぅぅぅ…だめえぇっ…ぁあぁぁ……	PRINTFORML ……んううぅぅぅ…だめえぇっ…ぁあぁぁ……
PRINTFORML ……体が熱くてっ…とろけてくみたいぃぃ……	PRINTFORML ……体が熱くてっ…とろけてくみたいぃぃ……
PRINTFORML ……んあっ…動けない…逃げられないよ……。	PRINTFORML ……んあっ…動けない…逃げられないよ……。
PRINTFORML ……こうやってぇ…絡まってれば…きっと……	PRINTFORML ……こうやってぇ…絡まってれば…きっと……
PRINTFORML 食べられて一回休みなんて…嫌ですよぅ……。	PRINTFORML 食べられて一回休みなんて…嫌ですよぅ……。
PRINTFORMDW ――ついに、最後の一筋の光が消えた……。	PRINTFORMDW ――ついに、最後の一筋の光が消えた……。
PRINTFORML ……わたしのおなかで…大きくなってるぅ……	PRINTFORML ……わたしのおなかで…大きくなってるぅ……
PRINTFORML ……ふぁ…中からもうすぐ…でてくるぅっ……	PRINTFORML ……ふぁ…中からもうすぐ…でてくるぅっ……
PRINTFORML ……いや…わたしのお腹…こんなに大きく……	PRINTFORML ……いや…わたしのお腹…こんなに大きく……
PRINTFORML 「……わたしの…胸…　吸ってくれてる……」	PRINTFORML 「……わたしの…胸…　吸ってくれてる……」
PRINTFORML 「……わたしの…　おっぱい…吸ってる……」	PRINTFORML 「……わたしの…　おっぱい…吸ってる……」
PRINTFORML ……ほんとうの春って…ここにあったんだ……	PRINTFORML ……ほんとうの春って…ここにあったんだ……
PRINTFORML 「でもこの店を中心に春が消えてる感じ……」	PRINTFORML 「でもこの店を中心に春が消えてる感じ……」
PRINTFORMDW ――慈悲無き春に、彼女は何を見るのか――	PRINTFORMDW ――慈悲無き春に、彼女は何を見るのか――
PRINTFORMDW ――リリーホワイトの瞳に光が戻った！――	PRINTFORMDW ――リリーホワイトの瞳に光が戻った！――
PRINTFORML 「リリースプリングウィンド・ホワイトっ！」	PRINTFORML 「リリースプリングウィンド・ホワイトっ！」
PRINTFORML 「リリースプリングウィンド・ブラックっ！」	PRINTFORML 「リリースプリングウィンド・ブラックっ！」
PRINTFORMDW （今お前が纏うその力は一体何だ！！！！）	PRINTFORMDW （今お前が纏うその力は一体何だ！！！！）
PRINTFORMDW （……何故…何故だぁぁぁっ……！！！！）	PRINTFORMDW （……何故…何故だぁぁぁっ……！！！！）
PRINTFORML ……いたい……　…や…やめてぇぇぇ……。	PRINTFORML ……いたい……　…や…やめてぇぇぇ……。
PRINTFORMDW リリーホワイトは勢いよく弾幕を放った！	PRINTFORMDW リリーホワイトは勢いよく弾幕を放った！
PRINTFORMDW リリーホワイトは勢いよく武器を撃った！	PRINTFORMDW リリーホワイトは勢いよく武器を撃った！
PRINTFORML ……ぁあっ…また…閉じちゃったよぉ……。	PRINTFORML ……ぁあっ…また…閉じちゃったよぉ……。
PRINTFORML ……んあぁぁーっ…は…放してよおおっ！！	PRINTFORML ……んあぁぁーっ…は…放してよおおっ！！
PRINTFORML ……もうっ…好きにしていいよおぉぉ……。	PRINTFORML ……もうっ…好きにしていいよおぉぉ……。
PRINTFORMDW リリーホワイトは眼光鋭く身構えている！	PRINTFORMDW リリーホワイトは眼光鋭く身構えている！
PRINTFORML ……まだぁ…からだが…あついのぉぉ……。	PRINTFORML ……まだぁ…からだが…あついのぉぉ……。
PRINTFORML …ふわぁっ…んあぁぁぁぁぁっ――――！？	PRINTFORML …ふわぁっ…んあぁぁぁぁぁっ――――！？
PRINTFORML 無理、こわれちゃうぅっ…嫌あぁぁぁ……。	PRINTFORML 無理、こわれちゃうぅっ…嫌あぁぁぁ……。
PRINTFORML ……ぁっ…やめて…見えちゃうよおっ……。	PRINTFORML ……ぁっ…やめて…見えちゃうよおっ……。
PRINTFORML ……ぅあっ…熱いよぉ…ぁっ…ぁぁぁ……。	PRINTFORML ……ぅあっ…熱いよぉ…ぁっ…ぁぁぁ……。
PRINTFORML ……ふあぁぁっ…離して…よおぉぉぉっ……	PRINTFORML ……ふあぁぁっ…離して…よおぉぉぉっ……
PRINTFORML ……どうしよう…食べられちゃったぁぁ……	PRINTFORML ……どうしよう…食べられちゃったぁぁ……
PRINTFORML ……でも…なんか暖かくて…春みたい……？	PRINTFORML ……でも…なんか暖かくて…春みたい……？
PRINTFORML ……お腹の中…柔らかくて暖かいですぅ……	PRINTFORML ……お腹の中…柔らかくて暖かいですぅ……
PRINTFORML ……わたしは食べられて…お腹の中でっ……	PRINTFORML ……わたしは食べられて…お腹の中でっ……
PRINTFORML ……もう出してくださいよう…ぅぅっ……。	PRINTFORML ……もう出してくださいよう…ぅぅっ……。
PRINTFORML あっ…ぁぁ…んみゃあぁぁ――――！！？？	PRINTFORML あっ…ぁぁ…んみゃあぁぁ――――！！？？
PRINTFORML 「……幽々子さん…なんでここに……？」		PRINTFORML 「……幽々子さん…なんでここに……？」	
PRINTFORML あなたの全部を春色に染めてあげますよ……	PRINTFORML あなたの全部を春色に染めてあげますよ……
PRINTFORML ……ぁうぅぅぅっ…もう…うまれるのぉ……	PRINTFORML ……ぁうぅぅぅっ…もう…うまれるのぉ……
PRINTFORML ……あの触手の…？　なんで…こんなの……	PRINTFORML ……あの触手の…？　なんで…こんなの……
PRINTFORML ……そんな…もうすぐ…産まれるの……！？	PRINTFORML ……そんな…もうすぐ…産まれるの……！？
PRINTFORML 「……うっ…やめて…　すわないでぇ……」	PRINTFORML 「……うっ…やめて…　すわないでぇ……」
PRINTFORML 「……わたしの…おっぱい…のんでる……」	PRINTFORML 「……わたしの…おっぱい…のんでる……」
PRINTFORML 「……わ…わたしの…　…こども……！？」	PRINTFORML 「……わ…わたしの…　…こども……！？」
PRINTFORML ……散っちゃった…わたしの…初めて……。	PRINTFORML ……散っちゃった…わたしの…初めて……。
PRINTFORML 「んあぁぁ…痛っ、……やっちゃった……」	PRINTFORML 「んあぁぁ…痛っ、……やっちゃった……」
PRINTFORML ……こころも…からだも…溶けてってる……	PRINTFORML ……こころも…からだも…溶けてってる……
PRINTFORML 「…気持ち良くしてくれる触手さんは…？」	PRINTFORML 「…気持ち良くしてくれる触手さんは…？」
PRINTFORML 「私を置いていくのはやめなさいーっ！！」	PRINTFORML 「私を置いていくのはやめなさいーっ！！」
PRINTFORML 「リリーホワイト・ブレイカーっ！！！！」	PRINTFORML 「リリーホワイト・ブレイカーっ！！！！」
PRINTFORMDW （――心は確かに折り砕いた筈……！！）	PRINTFORMDW （――心は確かに折り砕いた筈……！！）
PRINTFORML ……んぅぅ？…ひゃあぁあああっ……！！	PRINTFORML ……んぅぅ？…ひゃあぁあああっ……！！
PRINTFORML ――春よ…遠き春よ…　瞼閉じれば…――	PRINTFORML ――春よ…遠き春よ…　瞼閉じれば…――
PRINTFORML 「ブラック、力を合わせるですよー！！」	PRINTFORML 「ブラック、力を合わせるですよー！！」
PRINTFORML 「ブラック、わたしが足止めするよ！！」	PRINTFORML 「ブラック、わたしが足止めするよ！！」
PRINTFORML 「ブラック、敵の急所をねらうよー！！」	PRINTFORML 「ブラック、敵の急所をねらうよー！！」
PRINTFORML ……黒百合ちゃんごめん…もう…だめ……	PRINTFORML ……黒百合ちゃんごめん…もう…だめ……
PRINTFORML 見ないで、こっち見ないでよおっ―――！	PRINTFORML 見ないで、こっち見ないでよおっ―――！
PRINTFORML …もう…がまん、できないよぉぉっ……！	PRINTFORML …もう…がまん、できないよぉぉっ……！
PRINTFORML ……あ、ぁうぅっ…ひえぇぇぇっ……！？	PRINTFORML ……あ、ぁうぅっ…ひえぇぇぇっ……！？
PRINTFORML や…やめてよぉ…や…ゃあぁぁぁっ……。	PRINTFORML や…やめてよぉ…や…ゃあぁぁぁっ……。
PRINTFORML ……ふあっ…あぁ…ぁぁっ…熱いぃ……。	PRINTFORML ……ふあっ…あぁ…ぁぁっ…熱いぃ……。
PRINTFORML ……口の中で…いっぱい舐められてる……	PRINTFORML ……口の中で…いっぱい舐められてる……
PRINTFORML ……お願い、もう放してくださいー……。	PRINTFORML ……お願い、もう放してくださいー……。
PRINTFORML 何、なにするの…もう抜いてよぉ……！！	PRINTFORML 何、なにするの…もう抜いてよぉ……！！
PRINTFORML 「アリスさんがいると心強いですー」			PRINTFORML 「アリスさんがいると心強いですー」		
PRINTFORML ……これってもしかして…そんな……！？	PRINTFORML ……これってもしかして…そんな……！？
PRINTFORML ……おなかの中で…何か動いてる……！？	PRINTFORML ……おなかの中で…何か動いてる……！？
PRINTFORML ……なにか…何かが中から…もうすぐ……	PRINTFORML ……なにか…何かが中から…もうすぐ……
PRINTFORML ……こんなとこで寝られませんよー……。	PRINTFORML ……こんなとこで寝られませんよー……。
PRINTFORML 「……この状況から最も遠い言葉ね……」	PRINTFORML 「……この状況から最も遠い言葉ね……」
PRINTFORML ・天然系ヒロイン→負けちゃったよ……	PRINTFORML ・天然系ヒロイン→負けちゃったよ……
PRINTFORML ……春はまだ？…二度寝する……zzz	PRINTFORML ……春はまだ？…二度寝する……zzz
PRINTFORML 「zzz……そこはだめぇ…んぅ……」	PRINTFORML 「zzz……そこはだめぇ…んぅ……」
PRINTFORML 「ブラック、あれを使うですよー！！」	PRINTFORML 「ブラック、あれを使うですよー！！」
PRINTFORML 「ブラック、あの戦法で行くよー！！」	PRINTFORML 「ブラック、あの戦法で行くよー！！」
PRINTFORML 「ブラック、集中砲火でいくよー！！」	PRINTFORML 「ブラック、集中砲火でいくよー！！」
PRINTFORML また…食べられ…るうぅぅぅっ……！！	PRINTFORML また…食べられ…るうぅぅぅっ……！！
PRINTFORML ちから、はいら…ない…よおぉぉ……。	PRINTFORML ちから、はいら…ない…よおぉぉ……。
PRINTFORML ……動けないのはやーですよっ……！！	PRINTFORML ……動けないのはやーですよっ……！！
PRINTFORML ……もうちょっと…もうちょっとで……	PRINTFORML ……もうちょっと…もうちょっとで……
PRINTFORML 「――全力全開ですよぉぉぉ！！！！」	PRINTFORML 「――全力全開ですよぉぉぉ！！！！」
PRINTFORML 「絶対…絶対戻ってくるから……！！」	PRINTFORML 「絶対…絶対戻ってくるから……！！」
PRINTFORML 「信じてる…すぐ助けに来るって……」	PRINTFORML 「信じてる…すぐ助けに来るって……」
PRINTFORML ……やっぱり…足手まといなの……！？	PRINTFORML ……やっぱり…足手まといなの……！？
PRINTFORML 見ないで、見ないでよお、んっ―――！	PRINTFORML 見ないで、見ないでよお、んっ―――！
PRINTFORML だめぇ、がまんっ…できないよおぉぉ…	PRINTFORML だめぇ、がまんっ…できないよおぉぉ…
PRINTFORML ……やだっ…胸が…ゃふあぁぁぁっ！？	PRINTFORML ……やだっ…胸が…ゃふあぁぁぁっ！？
PRINTFORML わたしって…そんなに美味しいの……？	PRINTFORML わたしって…そんなに美味しいの……？
PRINTFORML ……んあぁ…あっ…暖かいですぅ……。	PRINTFORML ……んあぁ…あっ…暖かいですぅ……。
PRINTFORML ……わたし…食べられちゃうの……！？	PRINTFORML ……わたし…食べられちゃうの……！？
PRINTFORML 食べられちゃう…助けてえぇぇっ……。	PRINTFORML 食べられちゃう…助けてえぇぇっ……。
PRINTFORML ……いやぁぁ…狭くて動けないぃ……。	PRINTFORML ……いやぁぁ…狭くて動けないぃ……。
PRINTFORML んあぁぁ…ゃあぁあああぁぁっ……！！	PRINTFORML んあぁぁ…ゃあぁあああぁぁっ……！！
PRINTFORML 「……やっぱり異変、なんですか？」		PRINTFORML 「……やっぱり異変、なんですか？」	
PRINTFORML ……うぅ…なかから…でてくるよぉ……	PRINTFORML ……うぅ…なかから…でてくるよぉ……
PRINTFORML ……どうも最近調子が出ないですよー。	PRINTFORML ……どうも最近調子が出ないですよー。
PRINTFORML ……こんなに…おっきく育ってるぅ……	PRINTFORML ……こんなに…おっきく育ってるぅ……
PRINTFORML ……やっと…会えるんですねぇっ……。	PRINTFORML ……やっと…会えるんですねぇっ……。
PRINTFORML 「……わたしの…こども…なの……？」	PRINTFORML 「……わたしの…こども…なの……？」
PRINTFORML ……もっと寝心地いいとこないかな……	PRINTFORML ……もっと寝心地いいとこないかな……
PRINTFORML これっ…なんか気持ちいいですよぉ……	PRINTFORML これっ…なんか気持ちいいですよぉ……
PRINTFORML ……わたしが…無くなってくみたい……	PRINTFORML ……わたしが…無くなってくみたい……
PRINTFORML 「黒百合ちゃんだいじょうぶかな……」	PRINTFORML 「黒百合ちゃんだいじょうぶかな……」
PRINTFORMDW リリーホワイトは春を振りまいている	PRINTFORMDW リリーホワイトは春を振りまいている
PRINTFORML 「……幻想少女に力を…春を……！！」	PRINTFORML 「……幻想少女に力を…春を……！！」
PRINTFORML ……うっ…ぁっ…　…いゃぁぁぁ……	PRINTFORML ……うっ…ぁっ…　…いゃぁぁぁ……
PRINTFORML 「……こんなの絶対おかしいよ……」	PRINTFORML 「……こんなの絶対おかしいよ……」
PRINTFORML 「ブラック、ばしばし行くよー！！」	PRINTFORML 「ブラック、ばしばし行くよー！！」
PRINTFORML ……ぁぁ…んあぁ…あついよおぉ……	PRINTFORML ……ぁぁ…んあぁ…あついよおぉ……
PRINTFORML ……わたしはお菓子じゃないですっ。	PRINTFORML ……わたしはお菓子じゃないですっ。
PRINTFORML あっ、今の避けなきゃよかったぁ……	PRINTFORML あっ、今の避けなきゃよかったぁ……
PRINTFORML ……ぁあぁ…ぃやっ…んあぁぁっ……	PRINTFORML ……ぁあぁ…ぃやっ…んあぁぁっ……
PRINTFORML ……もう堪忍袋の緒が切れましたー！	PRINTFORML ……もう堪忍袋の緒が切れましたー！
PRINTFORML 「春風の使者、リリーホワイト！！」	PRINTFORML 「春風の使者、リリーホワイト！！」
PRINTFORML ……わたしじゃ…助けられない……。	PRINTFORML ……わたしじゃ…助けられない……。
PRINTFORML …だめぇ…戦わなきゃあぁ…でも……	PRINTFORML …だめぇ…戦わなきゃあぁ…でも……
PRINTFORML …この服気に入ってたのにー……！！	PRINTFORML …この服気に入ってたのにー……！！
PRINTFORML ……はあぁぁぁ…ぅうぅぅんっ……。	PRINTFORML ……はあぁぁぁ…ぅうぅぅんっ……。
PRINTFORML お、お尻なんて入らないよぉぉっ！？	PRINTFORML お、お尻なんて入らないよぉぉっ！？
PRINTFORML ……ああっ…食べられちゃうよぉ……	PRINTFORML ……ああっ…食べられちゃうよぉ……
PRINTFORML 食べても美味しくないですよー……。	PRINTFORML 食べても美味しくないですよー……。
PRINTFORML ……ううう…春を伝えに行けない……	PRINTFORML ……ううう…春を伝えに行けない……
PRINTFORML 狭くてぬるぬるで気持ち悪いです……	PRINTFORML 狭くてぬるぬるで気持ち悪いです……
PRINTFORML 黒百合ちゃんはこんなことしない！！	PRINTFORML 黒百合ちゃんはこんなことしない！！
PRINTFORML ……わたしの中に…何かいるの……？	PRINTFORML ……わたしの中に…何かいるの……？
PRINTFORML ……やだぁ…こんなのってえぇぇ……	PRINTFORML ……やだぁ…こんなのってえぇぇ……
PRINTFORML ……んっ…ひゃあぁあああっ……！！	PRINTFORML ……んっ…ひゃあぁあああっ……！！
PRINTFORML ……溶けてってる…おなかの中で……	PRINTFORML ……溶けてってる…おなかの中で……
PRINTFORML うーん、どこもじめじめしてますねー	PRINTFORML うーん、どこもじめじめしてますねー
PRINTFORML 「香霖堂にまだ春が来ていないけど」	PRINTFORML 「香霖堂にまだ春が来ていないけど」
PRINTFORMDW （――まだ戦える…だと……！？）	PRINTFORMDW （――まだ戦える…だと……！？）
PRINTFORML …春を伝えたかっただけなのに……	PRINTFORML …春を伝えたかっただけなのに……
PRINTFORML …チルノちゃん、それは痛いー……	PRINTFORML …チルノちゃん、それは痛いー……
PRINTFORML …柔らかくてあったかい…春……？	PRINTFORML …柔らかくてあったかい…春……？
PRINTFORML …そこは…だめですよ…んんっ……	PRINTFORML …そこは…だめですよ…んんっ……
PRINTFORML 「zzz……だめぇっ…あぁ……」	PRINTFORML 「zzz……だめぇっ…あぁ……」
PRINTFORML 「……気持ちいい…おやすみ……」	PRINTFORML 「……気持ちいい…おやすみ……」
PRINTFORML リリーホワイト、弾幕開花宣言っ！	PRINTFORML リリーホワイト、弾幕開花宣言っ！
PRINTFORML やぁ…とろ…け…るうぅぅぅ……。	PRINTFORML やぁ…とろ…け…るうぅぅぅ……。
PRINTFORML ……出られる…もうちょっとで……	PRINTFORML ……出られる…もうちょっとで……
PRINTFORML もうちょっとで…出られたのに……	PRINTFORML もうちょっとで…出られたのに……
PRINTFORML ……ぅうん…　…ひあぁっ……！！	PRINTFORML ……ぅうん…　…ひあぁっ……！！
PRINTFORML これじゃ見られちゃいますぅ……。	PRINTFORML これじゃ見られちゃいますぅ……。
PRINTFORML ……んぁぁ…ゃぁ…ふぁあぁぁ……	PRINTFORML ……んぁぁ…ゃぁ…ふぁあぁぁ……
PRINTFORML はるっ、はあっ、はるですよおぉ…	PRINTFORML はるっ、はあっ、はるですよおぉ…
PRINTFORML ひゃあっ…羽にも…ぁっ…いい……	PRINTFORML ひゃあっ…羽にも…ぁっ…いい……
PRINTFORML ……おねがい…もう…離して……。	PRINTFORML ……おねがい…もう…離して……。
PRINTFORML ……なかで…うごいて…うぅっ……	PRINTFORML ……なかで…うごいて…うぅっ……
PRINTFORML わたしの勘違いだったみたいですー	PRINTFORML わたしの勘違いだったみたいですー
PRINTFORML ……こんな…のって…ないよ……。	PRINTFORML ……こんな…のって…ないよ……。
PRINTFORML ……んんっ…んぁ…ぁふうぅぅ……	PRINTFORML ……んんっ…んぁ…ぁふうぅぅ……
PRINTFORML ……はぁ…はあぁ…んうぅぅっ……	PRINTFORML ……はぁ…はあぁ…んうぅぅっ……
PRINTFORML ……ちからが…抜けていってる……	PRINTFORML ……ちからが…抜けていってる……
PRINTFORML 「ゼロ・トレラント・スプリング」	PRINTFORML 「ゼロ・トレラント・スプリング」
PRINTFORML ――聞こえる…みんなの声が……。	PRINTFORML ――聞こえる…みんなの声が……。
PRINTFORML 「……これも…夢…だよね……」	PRINTFORML 「……これも…夢…だよね……」
PRINTFORML ブラック、やっぱり無理っ……！	PRINTFORML ブラック、やっぱり無理っ……！
PRINTFORML リリーホワイト、春風の到来っ！	PRINTFORML リリーホワイト、春風の到来っ！
PRINTFORML リリーホワイト、春告精の光っ！	PRINTFORML リリーホワイト、春告精の光っ！
PRINTFORML ……いやぁ、あっ…ぁあぁぁ……	PRINTFORML ……いやぁ、あっ…ぁあぁぁ……
PRINTFORML ……やっと…放してくれた……。	PRINTFORML ……やっと…放してくれた……。
PRINTFORML 「……少し…頭冷やしてよ……」	PRINTFORML 「……少し…頭冷やしてよ……」
PRINTFORML 「……全力全開！いくよっ！！」	PRINTFORML 「……全力全開！いくよっ！！」
PRINTFORML 「……絶対、だいじょうぶ……」	PRINTFORML 「……絶対、だいじょうぶ……」
PRINTFORML 手が、勝手に、動いちゃう……！	PRINTFORML 手が、勝手に、動いちゃう……！
PRINTFORML あ、いやっ、見られてるのにぃ…	PRINTFORML あ、いやっ、見られてるのにぃ…
PRINTFORML ぁあっ…そこは…そこはぁっ……	PRINTFORML ぁあっ…そこは…そこはぁっ……
PRINTFORML えっ？……きゃあぁぁ――っ！？	PRINTFORML えっ？……きゃあぁぁ――っ！？
PRINTFORML だめっ、入ってこないでよぉ……	PRINTFORML だめっ、入ってこないでよぉ……
PRINTFORML ……からだが…動かないぃ……。	PRINTFORML ……からだが…動かないぃ……。
PRINTFORML ……んんっ…出ちゃいますかぁ？	PRINTFORML ……んんっ…出ちゃいますかぁ？
PRINTFORML ……もう…もうやめてえぇぇ……	PRINTFORML ……もう…もうやめてえぇぇ……
PRINTFORML ……うぅ…　もう…やめてぇ……	PRINTFORML ……うぅ…　もう…やめてぇ……
PRINTFORML ……生きてる…わたしの中で……	PRINTFORML ……生きてる…わたしの中で……
PRINTFORML 「――あっ…どこいくのっ……」	PRINTFORML 「――あっ…どこいくのっ……」
PRINTFORML ……こころ…溶けてくみたい……	PRINTFORML ……こころ…溶けてくみたい……
PRINTFORML ……感じそのものになってく……	PRINTFORML ……感じそのものになってく……
PRINTFORML ……頭が…　…まっしろ…に……	PRINTFORML ……頭が…　…まっしろ…に……
PRINTFORML …一回休み…　…ですねー……。	PRINTFORML …一回休み…　…ですねー……。
PRINTFORML 「春は……　死にますか……？」	PRINTFORML 「春は……　死にますか……？」
PRINTFORML ……わたし、助かったんだ……。	PRINTFORML ……わたし、助かったんだ……。
PRINTFORML 「あぁっ…はるですよぅぅ……」	PRINTFORML 「あぁっ…はるですよぅぅ……」
PRINTFORML （……この一撃で決める……！）	PRINTFORML （……この一撃で決める……！）
PRINTFORMDW （…貴様ら…よくも……！！）	PRINTFORMDW （…貴様ら…よくも……！！）
PRINTFORML ……きゃあぁぁ…うぅぅぅ……	PRINTFORML ……きゃあぁぁ…うぅぅぅ……
PRINTFORML 「……これは…夢…です……」	PRINTFORML 「……これは…夢…です……」
PRINTFORML ブラック、わたしが行くよっ！	PRINTFORML ブラック、わたしが行くよっ！
PRINTFORMDW 眩い輝きに敵が一瞬ひるむ！	PRINTFORMDW 眩い輝きに敵が一瞬ひるむ！
PRINTFORML 春も弾幕もあげないですよー！	PRINTFORML 春も弾幕もあげないですよー！
PRINTFORML ……もうすこしで…外にっ……	PRINTFORML ……もうすこしで…外にっ……
PRINTFORML だめえぇぇ――――っ！！！！	PRINTFORML だめえぇぇ――――っ！！！！
PRINTFORML ――くらえ、この愛っ！！！！	PRINTFORML ――くらえ、この愛っ！！！！
PRINTFORML ぅうっ…や、やめてよぉ……。	PRINTFORML ぅうっ…や、やめてよぉ……。
PRINTFORML ……手が届かない…春が……。	PRINTFORML ……手が届かない…春が……。
PRINTFORML ……あぁっ、ぃいのぉぉ……。	PRINTFORML ……あぁっ、ぃいのぉぉ……。
PRINTFORML 春をもらいに来ましたよー！！	PRINTFORML 春をもらいに来ましたよー！！
PRINTFORML ……なか…に…なにかいる……	PRINTFORML ……なか…に…なにかいる……
PRINTFORML ……もうすぐ…産まれそう……	PRINTFORML ……もうすぐ…産まれそう……
PRINTFORML 「――あっ…きもちいい……」	PRINTFORML 「――あっ…きもちいい……」
PRINTFORML ……ちからが…吸われてく……	PRINTFORML ……ちからが…吸われてく……
PRINTFORML ……そのためにここに来た……	PRINTFORML ……そのためにここに来た……
PRINTFORML ……力が…あふれてくる……。	PRINTFORML ……力が…あふれてくる……。
PRINTFORML 「分かったわ、ホワイト！！」	PRINTFORML 「分かったわ、ホワイト！！」
PRINTFORMDW （……それが如何したと？）	PRINTFORMDW （……それが如何したと？）
PRINTFORML ん……くすぐったいー……。	PRINTFORML ん……くすぐったいー……。
PRINTFORML ？…ぎゅうぅ…すーすー……	PRINTFORML ？…ぎゅうぅ…すーすー……
PRINTFORML ……おなか…あついぃ……。	PRINTFORML ……おなか…あついぃ……。
PRINTFORML ……うぅぅん……ぁっ……。	PRINTFORML ……うぅぅん……ぁっ……。
PRINTFORML 「――春よ…遠き春よ――」	PRINTFORML 「――春よ…遠き春よ――」
PRINTFORML 春！はる！はる――！！！！	PRINTFORML 春！はる！はる――！！！！
PRINTFORML ……だめ…もう動けない……	PRINTFORML ……だめ…もう動けない……
PRINTFORML 「……きゃあ…っ！！……」	PRINTFORML 「……きゃあ…っ！！……」
PRINTFORML ……中はだめですうぅっ！！	PRINTFORML ……中はだめですうぅっ！！
PRINTFORML やだっ、恥ずかしいよぉ……	PRINTFORML やだっ、恥ずかしいよぉ……
PRINTFORML 「……こんなことって……」	PRINTFORML 「……こんなことって……」
PRINTFORML ……一体、何物なの……！？	PRINTFORML ……一体、何物なの……！？
PRINTFORML もっと優しくしてよぅ……。	PRINTFORML もっと優しくしてよぅ……。
PRINTFORML きゃぁ…服に穴がっ……！？	PRINTFORML きゃぁ…服に穴がっ……！？
PRINTFORML ……ゃふぁ…んうっ……！？	PRINTFORML ……ゃふぁ…んうっ……！？
PRINTFORML ……うぅ…動けないぃ……。	PRINTFORML ……うぅ…動けないぃ……。
PRINTFORML ……いやあぁぁ…ぁぁっ……	PRINTFORML ……いやあぁぁ…ぁぁっ……
PRINTFORML ……わたし…もう…だめ……	PRINTFORML ……わたし…もう…だめ……
PRINTFORML ……おやすみなさいですー。	PRINTFORML ……おやすみなさいですー。
PRINTFORML ……気持ちいいっていう……	PRINTFORML ……気持ちいいっていう……
PRINTFORML 「……ありがとう……！！」	PRINTFORML 「……ありがとう……！！」
PRINTFORML 「お花畑お花畑お花畑……」	PRINTFORML 「お花畑お花畑お花畑……」
PRINTFORML 絶対、だいじょうぶだから！	PRINTFORML 絶対、だいじょうぶだから！
PRINTFORMDL [1] あらすじだけ見る	PRINTFORMDL [1] あらすじだけ見る
PRINTFORML 「行くよっ、ブラック！！」	PRINTFORML 「行くよっ、ブラック！！」
PRINTFORML …んんんーっ…すぅ……。	PRINTFORML …んんんーっ…すぅ……。
PRINTFORML 「うぅ…これも…夢……」	PRINTFORML 「うぅ…これも…夢……」
PRINTFORML やっぱり離れなきゃ……！	PRINTFORML やっぱり離れなきゃ……！
PRINTFORML 初めては渡しませんっ…！	PRINTFORML 初めては渡しませんっ…！
PRINTFORML な、中はやめてえぇっ…！	PRINTFORML な、中はやめてえぇっ…！
PRINTFORML ……はううぅぅーっ……。	PRINTFORML ……はううぅぅーっ……。
PRINTFORML ……今なら…いけるっ……	PRINTFORML ……今なら…いけるっ……
PRINTFORML まだまだ…戦えるよっ……	PRINTFORML まだまだ…戦えるよっ……
PRINTFORML 捕まらないですよーっ！！	PRINTFORML 捕まらないですよーっ！！
PRINTFORML あぁっ、どうしようぉ……	PRINTFORML あぁっ、どうしようぉ……
PRINTFORML なんとか…大丈夫っ……。	PRINTFORML なんとか…大丈夫っ……。
PRINTFORML わたし…勝ったのっ……？	PRINTFORML わたし…勝ったのっ……？
PRINTFORML 春が、来ちゃうよう……！	PRINTFORML 春が、来ちゃうよう……！
PRINTFORML きゃあぁっ…え、何っ…？	PRINTFORML きゃあぁっ…え、何っ…？
PRINTFORML ……やだぁああっ……！！	PRINTFORML ……やだぁああっ……！！
PRINTFORML ぬるぬるうねうね嫌ぁ……	PRINTFORML ぬるぬるうねうね嫌ぁ……
PRINTFORML ……また…会えるかな……	PRINTFORML ……また…会えるかな……
PRINTFORML ……力が…吸われてく……	PRINTFORML ……力が…吸われてく……
PRINTFORML 「春ですよー……あれ？」	PRINTFORML 「春ですよー……あれ？」
PRINTFORML 「春を伝えに来ましたー」	PRINTFORML 「春を伝えに来ましたー」
PRINTFORMDW 「これまでのあらすじ」	PRINTFORMDW 「これまでのあらすじ」
PRINTFORML 「この…一発でっ…！！」	PRINTFORML 「この…一発でっ…！！」
PRINTFORML 「これで決めるよっ！！」	PRINTFORML 「これで決めるよっ！！」
PRINTFORML 「ねぇ、春返そうよ……」	PRINTFORML 「ねぇ、春返そうよ……」
PRINTFORML ……うぅぅぅ…ゃっ……	PRINTFORML ……うぅぅぅ…ゃっ……
PRINTFORML ここは逃げるですよー！	PRINTFORML ここは逃げるですよー！
PRINTFORML はーるーでーすーよー！	PRINTFORML はーるーでーすーよー！
PRINTFORML 足元がお留守ですよー！	PRINTFORML 足元がお留守ですよー！
PRINTFORML 触らないでくださいぃ…	PRINTFORML 触らないでくださいぃ…
PRINTFORML ……離れ…ないぃぃ……	PRINTFORML ……離れ…ないぃぃ……
PRINTFORML ……おね…がい…っ……	PRINTFORML ……おね…がい…っ……
PRINTFORML やっ…ふぁあああっ……	PRINTFORML やっ…ふぁあああっ……
PRINTFORML どこ触る気ですかー！？	PRINTFORML どこ触る気ですかー！？
PRINTFORML 「……まさか……！？」	PRINTFORML 「……まさか……！？」
PRINTFORML 体が熱くて眠れないよ…	PRINTFORML 体が熱くて眠れないよ…
PRINTFORML …はあっ…あぁぁんっ…	PRINTFORML …はあっ…あぁぁんっ…
PRINTFORML 痛いのはやですー……。	PRINTFORML 痛いのはやですー……。
PRINTFORML あなたは誰なの……！？	PRINTFORML あなたは誰なの……！？
PRINTFORML ……いたいいたいっ！！	PRINTFORML ……いたいいたいっ！！
PRINTFORML ……ぃ……ゃぁっ……。	PRINTFORML ……ぃ……ゃぁっ……。
PRINTFORML ……うぅぅぅ…ぁっ……	PRINTFORML ……うぅぅぅ…ぁっ……
PRINTFORML …やらせませーんっ！！	PRINTFORML …やらせませーんっ！！
PRINTFORML ……うぅぅぅっ……！！	PRINTFORML ……うぅぅぅっ……！！
PRINTFORML ……気持ちいいですー。	PRINTFORML ……気持ちいいですー。
PRINTFORML ……もう、動けない……	PRINTFORML ……もう、動けない……
PRINTFORML ちょっとピンチです……	PRINTFORML ちょっとピンチです……
PRINTFORML ……だ、だいじょうぶ。	PRINTFORML ……だ、だいじょうぶ。
PRINTFORML ……もうやだよぉ……。	PRINTFORML ……もうやだよぉ……。
PRINTFORMDW ――20XX年、春。	PRINTFORMDW ――20XX年、春。
PRINTFORML 「ちょっと待ちなさい」	PRINTFORML 「ちょっと待ちなさい」
PRINTFORML お尻はいやですーっ…	PRINTFORML お尻はいやですーっ…
PRINTFORML 恥ずかしいですよぉ…	PRINTFORML 恥ずかしいですよぉ…
PRINTFORML ……だ、めぇぇっ……	PRINTFORML ……だ、めぇぇっ……
PRINTFORML （……うぅぅ……。）	PRINTFORML （……うぅぅ……。）
PRINTFORML 身体がっ、熱いぃ…！	PRINTFORML 身体がっ、熱いぃ…！
PRINTFORML いったぁぁーぃ……。	PRINTFORML いったぁぁーぃ……。
PRINTFORML 脱がされちゃう……。	PRINTFORML 脱がされちゃう……。
PRINTFORML ……もう…むり……。	PRINTFORML ……もう…むり……。
PRINTFORML ぁあっ…はあぁっ……	PRINTFORML ぁあっ…はあぁっ……
PRINTFORML ……ぁぁ…ぁあっ……	PRINTFORML ……ぁぁ…ぁあっ……
PRINTFORML 「黒百合ちゃん！」		PRINTFORML 「黒百合ちゃん！」	
PRINTFORML 「チルノちゃん！」		PRINTFORML 「チルノちゃん！」	
PRINTFORML ……『鏡』ですね！！	PRINTFORML ……『鏡』ですね！！
PRINTFORML …もう…終わり……？	PRINTFORML …もう…終わり……？
PRINTFORML 「…ぁっ…ぃぃ……」	PRINTFORML 「…ぁっ…ぃぃ……」
PRINTFORML 春風が恋しいです……	PRINTFORML 春風が恋しいです……
PRINTFORML ……すぅすぅ……。	PRINTFORML ……すぅすぅ……。
PRINTFORML それえぇぇーっ！！	PRINTFORML それえぇぇーっ！！
PRINTFORML ……それだけは……	PRINTFORML ……それだけは……
PRINTFORML ひやあぁぁぁっ！？	PRINTFORML ひやあぁぁぁっ！？
PRINTFORML 避けられたぁ……。	PRINTFORML 避けられたぁ……。
PRINTFORML 当たりませんよー！	PRINTFORML 当たりませんよー！
PRINTFORML 春がきましたよー！	PRINTFORML 春がきましたよー！
PRINTFORML ……いた…ぁっ……	PRINTFORML ……いた…ぁっ……
PRINTFORML ……んあ…ぁっ……	PRINTFORML ……んあ…ぁっ……
PRINTFORML ひゃあ…んっ……。	PRINTFORML ひゃあ…んっ……。
PRINTFORML 服やぶれちゃうー！	PRINTFORML 服やぶれちゃうー！
PRINTFORML 何するですかー！！	PRINTFORML 何するですかー！！
PRINTFORML 払い清めよ！！！！	PRINTFORML 払い清めよ！！！！
PRINTFORML 春がきましたよ…。	PRINTFORML 春がきましたよ…。
PRINTFORML 春はどこですか…？	PRINTFORML 春はどこですか…？
PRINTFORML …だめ…だよぉ……	PRINTFORML …だめ…だよぉ……
PRINTFORML ……はにゃーん……	PRINTFORML ……はにゃーん……
PRINTFORML 「…ぁ…ぅっ……」	PRINTFORML 「…ぁ…ぅっ……」
PRINTFORML 黒百合ちゃん……！	PRINTFORML 黒百合ちゃん……！
PRINTFORMDL [0] 全部見る	PRINTFORMDL [0] 全部見る
PRINTFORML かいたひと：無銘	PRINTFORML かいたひと：無銘
PRINTFORML ……ひゃあん……	PRINTFORML ……ひゃあん……
PRINTFORML あぶないです……	PRINTFORML あぶないです……
PRINTFORML これを使って……	PRINTFORML これを使って……
PRINTFORML 「春風よっ！！」	PRINTFORML 「春風よっ！！」
PRINTFORML だだだだだー！！	PRINTFORML だだだだだー！！
PRINTFORML あれれっ……！？	PRINTFORML あれれっ……！？
PRINTFORML んぎゅぅ……！！	PRINTFORML んぎゅぅ……！！
PRINTFORML ……ぁ…いや……	PRINTFORML ……ぁ…いや……
PRINTFORML ……やめ…て……	PRINTFORML ……やめ…て……
PRINTFORML もうやめてぇ……	PRINTFORML もうやめてぇ……
PRINTFORML 「春ですよー」		PRINTFORML 「春ですよー」	
PRINTFORML ――あなたは……	PRINTFORML ――あなたは……
PRINTFORML 春ですよーっ！！	PRINTFORML 春ですよーっ！！
PRINTFORML …や…あぁ……。	PRINTFORML …や…あぁ……。
PRINTFORML 「………………」	PRINTFORML 「………………」
PRINTFORMDL [2] 見ない	PRINTFORMDL [2] 見ない
PRINTFORMDW ……筈だった。	PRINTFORMDW ……筈だった。
PRINTFORMDW ――香霖堂――	PRINTFORMDW ――香霖堂――
PRINTFORML 春ですよーっ！	PRINTFORML 春ですよーっ！
PRINTFORML くらうですー！	PRINTFORML くらうですー！
PRINTFORML 逃げましたよー	PRINTFORML 逃げましたよー
PRINTFORML 大勝利ーっ！！	PRINTFORML 大勝利ーっ！！
PRINTFORML ……ぅうっ……	PRINTFORML ……ぅうっ……
PRINTFORML やめてよぉ……	PRINTFORML やめてよぉ……
PRINTFORML あぁっ……！！	PRINTFORML あぁっ……！！
PRINTFORML わたしの服……	PRINTFORML わたしの服……
PRINTFORML ゃふあぁっ！？	PRINTFORML ゃふあぁっ！？
PRINTFORML ……まるで……	PRINTFORML ……まるで……
PRINTFORML ……ちがう……	PRINTFORML ……ちがう……
PRINTFORML きゃぁ、敵！	PRINTFORML きゃぁ、敵！
PRINTFORML いたいですー	PRINTFORML いたいですー
PRINTFORML ぁひゃっ！？	PRINTFORML ぁひゃっ！？
PRINTFORML ……ぅ……。	PRINTFORML ……ぅ……。
PRINTFORML 春なのです…	PRINTFORML 春なのです…
PRINTFORML 春ですよー	PRINTFORML 春ですよー
PRINTFORML …………。	PRINTFORML …………。
PRINTFORML きゃっ！	PRINTFORML きゃっ！
PRINTFORML ――違う	PRINTFORML ――違う
PRINTFORMDW ﾌﾞﾁ	PRINTFORMDW ﾌﾞﾁ
PRINTFORMDW 	PRINTFORMDW 
PRINTFORML 	PRINTFORML 
