//口上:

PRINTFORML 「これだけじゃ全部は伝えられないけど、今はこれが精一杯。わかったら、二度と近寄らないで」	PRINTFORML 「これだけじゃ全部は伝えられないけど、今はこれが精一杯。わかったら、二度と近寄らないで」
PRINTFORMDL そう判断した%CALLNAME:1%は苦渋の決断でルナサをおいていくことにした……	PRINTFORMDL そう判断した%CALLNAME:1%は苦渋の決断でルナサをおいていくことにした……
PRINTFORML 「……あなたにはもう何も我慢しない。全ての旋律を全力でたたき込む。今、そう決めた」	PRINTFORML 「……あなたにはもう何も我慢しない。全ての旋律を全力でたたき込む。今、そう決めた」
PRINTFORML 「裁縫のためのスタイル測定中だけど……大丈夫？きつくなったら言ってね。」	PRINTFORML 「裁縫のためのスタイル測定中だけど……大丈夫？きつくなったら言ってね。」
PRINTFORML 「こんな場所でもちゃんと耳を澄ますとね、自然が奏でる音色が聴こえるの…」	PRINTFORML 「こんな場所でもちゃんと耳を澄ますとね、自然が奏でる音色が聴こえるの…」
PRINTFORML 「私っていう中身は変わってないはずなのに、前より、前を向けてる気がする」	PRINTFORML 「私っていう中身は変わってないはずなのに、前より、前を向けてる気がする」
PRINTFORML 「……ごめんなさい。私が決着をつけなくてはいけない敵の気配を感じたの」	PRINTFORML 「……ごめんなさい。私が決着をつけなくてはいけない敵の気配を感じたの」
PRINTFORML 「楽器の使い方が意外？奏者に必要なのは表現力と発想力だから問題ない」	PRINTFORML 「楽器の使い方が意外？奏者に必要なのは表現力と発想力だから問題ない」
PRINTFORML 「ふう。まだまだ強敵が残っているし問題も山積みになっているけど……」	PRINTFORML 「ふう。まだまだ強敵が残っているし問題も山積みになっているけど……」
PRINTFORML 「ふぅ……この時間が私は好き。お風呂が嫌いな人はいないだろうけどね」	PRINTFORML 「ふぅ……この時間が私は好き。お風呂が嫌いな人はいないだろうけどね」
PRINTFORML 「いくら撲殺用とはいえ……楽器で殴りつけるのって……緊張、するね」	PRINTFORML 「いくら撲殺用とはいえ……楽器で殴りつけるのって……緊張、するね」
PRINTFORML 「リリカがいたずらでつくった撲殺用楽器シリーズが役に立つなんてね」	PRINTFORML 「リリカがいたずらでつくった撲殺用楽器シリーズが役に立つなんてね」
PRINTFORML 「私が言えるのはひとつだけ。何が来たって、幻想郷は負けたりしない」	PRINTFORML 「私が言えるのはひとつだけ。何が来たって、幻想郷は負けたりしない」
PRINTFORML (このままじゃ戦闘も罠への対応もできないけど……♥ どうしよう♥)	PRINTFORML (このままじゃ戦闘も罠への対応もできないけど……♥ どうしよう♥)
PRINTFORML 「！？今ので寄生された？……とっておきの子守歌が仇になるなんて」	PRINTFORML 「！？今ので寄生された？……とっておきの子守歌が仇になるなんて」
PRINTFORML 「上手く弾けなかったフレーズが弾けるようになるのはうれしいもの」	PRINTFORML 「上手く弾けなかったフレーズが弾けるようになるのはうれしいもの」
PRINTFORMDL 完全に燃え尽きて力尽きたルナサを守りながら探索は出来そうにない	PRINTFORMDL 完全に燃え尽きて力尽きたルナサを守りながら探索は出来そうにない
PRINTFORML 「もしかしたら、今、立ってる場所だって危険なのかもしれないけど」	PRINTFORML 「もしかしたら、今、立ってる場所だって危険なのかもしれないけど」
PRINTFORML 「視線を浴びるのは慣れているけど、こういう格好にされると……」	PRINTFORML 「視線を浴びるのは慣れているけど、こういう格好にされると……」
PRINTFORML 「よかった……私のせいで全滅したらどうしようって思ってたから」	PRINTFORML 「よかった……私のせいで全滅したらどうしようって思ってたから」
PRINTFORML 「私もボロボロだから、あなたの視線もやっぱり気になるかな……」	PRINTFORML 「私もボロボロだから、あなたの視線もやっぱり気になるかな……」
PRINTFORML 「いつもは…こんなに…はしたなくは……しないのに……んっ……」	PRINTFORML 「いつもは…こんなに…はしたなくは……しないのに……んっ……」
PRINTFORML 「物には執着しない…なんて思ってたけど、そうは言ってられない」	PRINTFORML 「物には執着しない…なんて思ってたけど、そうは言ってられない」
PRINTFORML 「……？わたし、気を失ってたの？それで、ここは、どこなの……」	PRINTFORML 「……？わたし、気を失ってたの？それで、ここは、どこなの……」
PRINTFORML 「今までの道は険しかったし、きっと、この先も険しいと思うけど」	PRINTFORML 「今までの道は険しかったし、きっと、この先も険しいと思うけど」
PRINTFORML 「私と一緒に居て、つまらなくないかな……？話も下手だし……」	PRINTFORML 「私と一緒に居て、つまらなくないかな……？話も下手だし……」
PRINTFORML 「ちゃんと演奏するための集中力が……必要だから……んっ……」	PRINTFORML 「ちゃんと演奏するための集中力が……必要だから……んっ……」
PRINTFORML 「そんな。きっと無事だって……信じさせて……欲しかったのに」	PRINTFORML 「そんな。きっと無事だって……信じさせて……欲しかったのに」
PRINTFORML 「この演奏スタイル。んふふっ、今までより積極的になれそう」	PRINTFORML 「この演奏スタイル。んふふっ、今までより積極的になれそう」
PRINTFORML 「私は、あなたを信じて待つだけ。大丈夫、意外と楽しいから」	PRINTFORML 「私は、あなたを信じて待つだけ。大丈夫、意外と楽しいから」
PRINTFORMDL 虚ろな瞳で妹たちの名を呟くルナサを放置することはできない	PRINTFORMDL 虚ろな瞳で妹たちの名を呟くルナサを放置することはできない
PRINTFORML 「お転婆は少し、恥ずかしい……けど、ふふっ、悪くないよ」	PRINTFORML 「お転婆は少し、恥ずかしい……けど、ふふっ、悪くないよ」
PRINTFORMDL ルナサは言葉にならない声をあげ全身を痙攣させている……	PRINTFORMDL ルナサは言葉にならない声をあげ全身を痙攣させている……
PRINTFORML 「あっ……お返しちゃんとするから、動かないで待っててね」	PRINTFORML 「あっ……お返しちゃんとするから、動かないで待っててね」
PRINTFORML 「あいつらも増援呼んだみたい……これからどうすれば……」	PRINTFORML 「あいつらも増援呼んだみたい……これからどうすれば……」
PRINTFORML 「一人でするのは慣れて……あっ　わたし、なにをいって…」	PRINTFORML 「一人でするのは慣れて……あっ　わたし、なにをいって…」
PRINTFORML 「おあいにくさま。演奏用の楽器と撲殺用の楽器は別なの」	PRINTFORML 「おあいにくさま。演奏用の楽器と撲殺用の楽器は別なの」
PRINTFORMDL ルナサはだらしなく顔をゆるませ甘えるような声をあげた	PRINTFORMDL ルナサはだらしなく顔をゆるませ甘えるような声をあげた
PRINTFORML 「どうせ軽くなるなら、この気持ちも軽くしてほしい……」	PRINTFORML 「どうせ軽くなるなら、この気持ちも軽くしてほしい……」
PRINTFORML 「奪われたものは……自分の手で……取り戻さないと……」	PRINTFORML 「奪われたものは……自分の手で……取り戻さないと……」
PRINTFORML 「立ち止まる理由なんかどこにも無い。私は前に進むんだ」	PRINTFORML 「立ち止まる理由なんかどこにも無い。私は前に進むんだ」
PRINTFORML 「音を鳴らすだけが騒霊の仕事だと思ったのが運のツキ」	PRINTFORML 「音を鳴らすだけが騒霊の仕事だと思ったのが運のツキ」
PRINTFORML 「舞台づくりに楽器運び、足腰だって鍛えてる。大丈夫」	PRINTFORML 「舞台づくりに楽器運び、足腰だって鍛えてる。大丈夫」
PRINTFORML 「駄目ぇ！メルランやリリカにだってこんなこと……！」	PRINTFORML 「駄目ぇ！メルランやリリカにだってこんなこと……！」
PRINTFORML 「きちゃうっ♥ きもちいいのがっ♥♥ あひぃ♥♥♥」	PRINTFORML 「きちゃうっ♥ きもちいいのがっ♥♥ あひぃ♥♥♥」
PRINTFORML 「むりっ♥ これ無理ぃ♥♥ もう無理だからぁ♥♥♥」	PRINTFORML 「むりっ♥ これ無理ぃ♥♥ もう無理だからぁ♥♥♥」
PRINTFORML 「聞こえてくるのは、幻想郷の旋律だけでいいのに……」	PRINTFORML 「聞こえてくるのは、幻想郷の旋律だけでいいのに……」
PRINTFORMDL %CALLNAME:1%はルナサの綺麗な手を取った	PRINTFORMDL %CALLNAME:1%はルナサの綺麗な手を取った
PRINTFORML 「ここに放置された道具は付喪神にはなれなそうね……」	PRINTFORML 「ここに放置された道具は付喪神にはなれなそうね……」
PRINTFORML 「はぁぁ…うん、いい感じ。力が少し戻っていくみたい」	PRINTFORML 「はぁぁ…うん、いい感じ。力が少し戻っていくみたい」
PRINTFORML 「いっちゃう♥ イっちゃう♥♥ イッちゃう♥♥♥」	PRINTFORML 「いっちゃう♥ イっちゃう♥♥ イッちゃう♥♥♥」
PRINTFORML 「かんじてるっ♥ かんじちゃう♥♥ あーッ♥♥♥」	PRINTFORML 「かんじてるっ♥ かんじちゃう♥♥ あーッ♥♥♥」
PRINTFORML 「この瞬間を、私は忘れない。何があっても、絶対に」	PRINTFORML 「この瞬間を、私は忘れない。何があっても、絶対に」
PRINTFORML 「静かに終わらせれば……だいじょうぶ……んっ……」	PRINTFORML 「静かに終わらせれば……だいじょうぶ……んっ……」
PRINTFORML 「ただの生理現象…せいりげんしょうよ……んっ……」	PRINTFORML 「ただの生理現象…せいりげんしょうよ……んっ……」
PRINTFORML  (リリカが音探しをしてたことがあったような……)	PRINTFORML  (リリカが音探しをしてたことがあったような……)
PRINTFORML （どこかでこっそり『独奏』の練習しないと……♥）	PRINTFORML （どこかでこっそり『独奏』の練習しないと……♥）
PRINTFORML 「私じゃ上手く扱えないかも……ううん、善処する」	PRINTFORML 「私じゃ上手く扱えないかも……ううん、善処する」
PRINTFORML 「む、無駄。そんなことをしても私は折れない……」	PRINTFORML 「む、無駄。そんなことをしても私は折れない……」
PRINTFORML (リリカが音探しをしてたことがあったような……)	PRINTFORML (リリカが音探しをしてたことがあったような……)
PRINTFORMDL ルナサは幸せそうにお風呂の想い出をうたっている	PRINTFORMDL ルナサは幸せそうにお風呂の想い出をうたっている
PRINTFORML 「プリズムリバーの輝きは……私が守らないと……」	PRINTFORML 「プリズムリバーの輝きは……私が守らないと……」
PRINTFORML 「でろでろで～ん♪たいへんおきのどくですが……」	PRINTFORML 「でろでろで～ん♪たいへんおきのどくですが……」
PRINTFORML 「……すぐに心が沈む私の性格、なおさないとなぁ」	PRINTFORML 「……すぐに心が沈む私の性格、なおさないとなぁ」
PRINTFORML 「誰も耳を塞がなくていいように、私は頑張りたい」	PRINTFORML 「誰も耳を塞がなくていいように、私は頑張りたい」
PRINTFORML 「嫌な音の発生源は、どうしても止めたくなるの」	PRINTFORML 「嫌な音の発生源は、どうしても止めたくなるの」
PRINTFORML 「悪いね。今持ってる楽器は撲殺用のスペアなの」	PRINTFORML 「悪いね。今持ってる楽器は撲殺用のスペアなの」
PRINTFORML 「こういう状況の練習なんてしたことないけど！」	PRINTFORML 「こういう状況の練習なんてしたことないけど！」
PRINTFORML 「ダメっ♥ これダメっ♥♥ ダメなのぉ♥♥♥」	PRINTFORML 「ダメっ♥ これダメっ♥♥ ダメなのぉ♥♥♥」
PRINTFORML 「ズルイっ♥ これズルイっ♥♥ あーっ♥♥♥」	PRINTFORML 「ズルイっ♥ これズルイっ♥♥ あーっ♥♥♥」
PRINTFORML 「まっ♥ まってぇ♥♥ これダメなのぉ♥♥♥」	PRINTFORML 「まっ♥ まってぇ♥♥ これダメなのぉ♥♥♥」
PRINTFORML 「やめっ♥ やめてぇ♥♥ イっちゃうぅ♥♥♥」	PRINTFORML 「やめっ♥ やめてぇ♥♥ イっちゃうぅ♥♥♥」
PRINTFORML 「いつもはメルランの方が目立つのだけれど……」	PRINTFORML 「いつもはメルランの方が目立つのだけれど……」
PRINTFORML 「危険だけど、一度別れるしかないみたいね……」	PRINTFORML 「危険だけど、一度別れるしかないみたいね……」
PRINTFORML 「今は……落ちつく方が大切だから……んっ……」	PRINTFORML 「今は……落ちつく方が大切だから……んっ……」
PRINTFORMDL ルナサはふらつく足取りで必死に逃げ出した……	PRINTFORMDL ルナサはふらつく足取りで必死に逃げ出した……
PRINTFORML 「そろそろ新しい効果の曲、練習しようかしら？」	PRINTFORML 「そろそろ新しい効果の曲、練習しようかしら？」
PRINTFORML 「テンポを上げるよ。これでもついてこれる？」	PRINTFORML 「テンポを上げるよ。これでもついてこれる？」
PRINTFORML 「これで奏でて見せる！戦いのシンフォニー！」	PRINTFORML 「これで奏でて見せる！戦いのシンフォニー！」
PRINTFORML 「この場所に響く旋律、私は好きじゃないから」	PRINTFORML 「この場所に響く旋律、私は好きじゃないから」
PRINTFORML 「くるっ♥ なにかくるっ♥♥ あーッ♥♥♥」	PRINTFORML 「くるっ♥ なにかくるっ♥♥ あーッ♥♥♥」
PRINTFORML 「こんなっ♥ こんなのぉ♥♥ むりぃ♥♥♥」	PRINTFORML 「こんなっ♥ こんなのぉ♥♥ むりぃ♥♥♥」
PRINTFORML 「こんなっ♥ されたらぁ♥♥ むりぃ♥♥♥」	PRINTFORML 「こんなっ♥ されたらぁ♥♥ むりぃ♥♥♥」
PRINTFORML （これ以上触られたら緊張の弦が切れる……♥）	PRINTFORML （これ以上触られたら緊張の弦が切れる……♥）
PRINTFORML 「……こうなった以上、すぐに片付けないと！」	PRINTFORML 「……こうなった以上、すぐに片付けないと！」
PRINTFORML 「！？旋律が乱れた？……そんな、まさか……」	PRINTFORML 「！？旋律が乱れた？……そんな、まさか……」
PRINTFORML 「！？嫌な鼓動の予感が……これって…おぇっ」	PRINTFORML 「！？嫌な鼓動の予感が……これって…おぇっ」
PRINTFORML （奉仕とか…お願いされたら、どうしよう…？）	PRINTFORML （奉仕とか…お願いされたら、どうしよう…？）
PRINTFORMDL ルナサは濁った瞳でふらふらと立ち上がった…	PRINTFORMDL ルナサは濁った瞳でふらふらと立ち上がった…
PRINTFORML 「これっ♥ これダメっ♥♥ ダメぇ♥♥♥」	PRINTFORML 「これっ♥ これダメっ♥♥ ダメぇ♥♥♥」
PRINTFORML 「やっぱり…照れちゃうね。こういう格好は」	PRINTFORML 「やっぱり…照れちゃうね。こういう格好は」
PRINTFORML 「えっ♥ まって♥ まだチューニングが♥」	PRINTFORML 「えっ♥ まって♥ まだチューニングが♥」
PRINTFORML 「もう少し、うまく勝ちたかったけど……。」	PRINTFORML 「もう少し、うまく勝ちたかったけど……。」
PRINTFORML 「こ、この場所からはすぐに離れないと……」	PRINTFORML 「こ、この場所からはすぐに離れないと……」
PRINTFORML 「止まれない…止まるわけにはいかない……」	PRINTFORML 「止まれない…止まるわけにはいかない……」
PRINTFORML 「メルランとおふろ～に、はい～ったら～♪」	PRINTFORML 「メルランとおふろ～に、はい～ったら～♪」
PRINTFORML 「……ちょっと、ぼーっとしてた。何だろ…」	PRINTFORML 「……ちょっと、ぼーっとしてた。何だろ…」
PRINTFORML 「……すぅ～……すりぷる……すぅ～……」	PRINTFORML 「……すぅ～……すりぷる……すぅ～……」
PRINTFORML 「優しい旋律だけが流れ続ければいいのに」	PRINTFORML 「優しい旋律だけが流れ続ければいいのに」
PRINTFORML 「ごめんなさい、もう…ここからだして…」	PRINTFORML 「ごめんなさい、もう…ここからだして…」
PRINTFORML 「こんな音、聞きたくない。私が止めるわ」	PRINTFORML 「こんな音、聞きたくない。私が止めるわ」
PRINTFORML 「道は常に自分の力で切り開いていくもの」	PRINTFORML 「道は常に自分の力で切り開いていくもの」
PRINTFORML 「魅力はないと思うけど、絶対に嫌……！」	PRINTFORML 「魅力はないと思うけど、絶対に嫌……！」
PRINTFORML 「お、お、お、お、落ちつかないと……！」	PRINTFORML 「お、お、お、お、落ちつかないと……！」
PRINTFORML 「おっ♥ 犯されてぇ♥♥ やめぇ♥♥♥」	PRINTFORML 「おっ♥ 犯されてぇ♥♥ やめぇ♥♥♥」
PRINTFORML 「っ…こういうのは嫌いなの。わかった？」	PRINTFORML 「っ…こういうのは嫌いなの。わかった？」
PRINTFORML 「あぁっ！？でも、まだ終わるわけには！」	PRINTFORML 「あぁっ！？でも、まだ終わるわけには！」
PRINTFORMDL 誰かの弱々しい息遣いが聞えた気がした。	PRINTFORMDL 誰かの弱々しい息遣いが聞えた気がした。
PRINTFORML 「この状況では、仕方ないの……んっ……」	PRINTFORML 「この状況では、仕方ないの……んっ……」
PRINTFORML 「やってみせる。掃除は嫌いじゃないから」	PRINTFORML 「やってみせる。掃除は嫌いじゃないから」
PRINTFORML 「リリカとおふろ～に、はい～ったら～♪」	PRINTFORML 「リリカとおふろ～に、はい～ったら～♪」
PRINTFORML 「いつもよりさらに気分が沈むような……」	PRINTFORML 「いつもよりさらに気分が沈むような……」
PRINTFORML 「練習は怠らない。日々の積み重ねが大切」	PRINTFORML 「練習は怠らない。日々の積み重ねが大切」
PRINTFORML （しゅうちゅうして……平常心を……♥）	PRINTFORML （しゅうちゅうして……平常心を……♥）
PRINTFORML 「良い結末を迎えるかどうかは自分次第」	PRINTFORML 「良い結末を迎えるかどうかは自分次第」
PRINTFORML 「違和感あるでしょ？この旋律を聴くと」	PRINTFORML 「違和感あるでしょ？この旋律を聴くと」
PRINTFORML 「それなら、こんな音色はどうかしら？」	PRINTFORML 「それなら、こんな音色はどうかしら？」
PRINTFORML 「身体能力強化の音色に身を委ねて……」	PRINTFORML 「身体能力強化の音色に身を委ねて……」
PRINTFORML 「メルラン、リリカ……ごめんなさい…」	PRINTFORML 「メルラン、リリカ……ごめんなさい…」
PRINTFORML 「あーっ♥ あーっ♥♥ あーっ♥♥♥」	PRINTFORML 「あーっ♥ あーっ♥♥ あーっ♥♥♥」
PRINTFORML 「ぁぁ……私の演奏ではダメなの……？」	PRINTFORML 「ぁぁ……私の演奏ではダメなの……？」
PRINTFORML 「もう…私を怒らせるの、上手すぎるよ」	PRINTFORML 「もう…私を怒らせるの、上手すぎるよ」
PRINTFORML 「泣き言なんて、言いたくないけど…！」	PRINTFORML 「泣き言なんて、言いたくないけど…！」
PRINTFORML 「よかった……ちゃんと、勝てた……！」	PRINTFORML 「よかった……ちゃんと、勝てた……！」
PRINTFORML 「本来ならレクイエムの時間だろうけど」	PRINTFORML 「本来ならレクイエムの時間だろうけど」
PRINTFORML 「やっぱり、勝てると嬉しいものだね。」	PRINTFORML 「やっぱり、勝てると嬉しいものだね。」
PRINTFORML 「貴方の心の中に流れる旋律、私は好き」	PRINTFORML 「貴方の心の中に流れる旋律、私は好き」
PRINTFORML 「ゆび…止まらないみたい……んっ……」	PRINTFORML 「ゆび…止まらないみたい……んっ……」
PRINTFORMDL ルナサは幸せそうに湯船に浸かっている	PRINTFORMDL ルナサは幸せそうに湯船に浸かっている
PRINTFORML 「私の力って、栄養価低そうだけどね…」	PRINTFORML 「私の力って、栄養価低そうだけどね…」
﻿PRINTFORML 静葉さんの秋モードにノリを合わせる。	PRINTFORML 静葉さんの秋モードにノリを合わせる。
PRINTFORML 「……はいはい、そういうのいいから」	PRINTFORML 「……はいはい、そういうのいいから」
PRINTFORML （心が…すごくドキドキしてる……！）	PRINTFORML （心が…すごくドキドキしてる……！）
PRINTFORML 「……触っていいって言ってないのに」	PRINTFORML 「……触っていいって言ってないのに」
PRINTFORML 「私の演奏、役に立つといいけど……」	PRINTFORML 「私の演奏、役に立つといいけど……」
PRINTFORML 「課題は見えた。みんなで頑張ろうか」	PRINTFORML 「課題は見えた。みんなで頑張ろうか」
PRINTFORML 「貴方の綺麗な音色、もっと聴かせて」	PRINTFORML 「貴方の綺麗な音色、もっと聴かせて」
PRINTFORML 「ここも綺麗に掃除していかないとね」	PRINTFORML 「ここも綺麗に掃除していかないとね」
PRINTFORML 「お願いだから、それだけは許して！」	PRINTFORML 「お願いだから、それだけは許して！」
PRINTFORML 「サヨナラは別れの言葉じゃないもの」	PRINTFORML 「サヨナラは別れの言葉じゃないもの」
PRINTFORML 「希望、なんて……どこにも無いよね」	PRINTFORML 「希望、なんて……どこにも無いよね」
PRINTFORML 「心配事ばかり増えていく……悪循環」	PRINTFORML 「心配事ばかり増えていく……悪循環」
PRINTFORML 「誰も置いてかない。全員で帰る……」	PRINTFORML 「誰も置いてかない。全員で帰る……」
PRINTFORML （姉としてしっかりしないと……♥）	PRINTFORML （姉としてしっかりしないと……♥）
PRINTFORML （これじゃ、アノ音が漏れる……♥）	PRINTFORML （これじゃ、アノ音が漏れる……♥）
PRINTFORML 「こんな状況で戦えるわけが……♥」	PRINTFORML 「こんな状況で戦えるわけが……♥」
PRINTFORML 「あ、危ない……平常心、平常心…」	PRINTFORML 「あ、危ない……平常心、平常心…」
PRINTFORML 「妹たちには手を出さないでぇ……」	PRINTFORML 「妹たちには手を出さないでぇ……」
PRINTFORML 「弦の張り替え、いつにしようかな」	PRINTFORML 「弦の張り替え、いつにしようかな」
PRINTFORML 「勝ってくるから、ここで待ってて」	PRINTFORML 「勝ってくるから、ここで待ってて」
PRINTFORML 「妹のいたずらで…慣らされて……」	PRINTFORML 「妹のいたずらで…慣らされて……」
PRINTFORMW 「メルラン……リリカ……ごめんね」	PRINTFORMW 「メルラン……リリカ……ごめんね」
PRINTFORML 「私といると音が漏れるものね……」	PRINTFORML 「私といると音が漏れるものね……」
PRINTFORML 「力が吸われているのがわかる……」	PRINTFORML 「力が吸われているのがわかる……」
PRINTFORML 「なんだか嫌な旋律が聞こえる……」	PRINTFORML 「なんだか嫌な旋律が聞こえる……」
PRINTFORML 「もう少し積極的にいかないと……」	PRINTFORML 「もう少し積極的にいかないと……」
PRINTFORML 「くすんっ……あぁ、いやぁ……」	PRINTFORML 「くすんっ……あぁ、いやぁ……」
PRINTFORML 「成功するまで……繰り返すだけ」	PRINTFORML 「成功するまで……繰り返すだけ」
PRINTFORML 「もう……やり方がいやらしいよ」	PRINTFORML 「もう……やり方がいやらしいよ」
PRINTFORML 「遅かれ早かれこうなるのは……」	PRINTFORML 「遅かれ早かれこうなるのは……」
PRINTFORML 「最低の結末は避けたいけど……」	PRINTFORML 「最低の結末は避けたいけど……」
PRINTFORML 「あぁっ……儚いね、本当……。」	PRINTFORML 「あぁっ……儚いね、本当……。」
PRINTFORML 「嫌な音、やっと終わったみたい」	PRINTFORML 「嫌な音、やっと終わったみたい」
PRINTFORML 「ガンガン行くから。ついてきて」	PRINTFORML 「ガンガン行くから。ついてきて」
PRINTFORML 「今のうちにチューニングを……」	PRINTFORML 「今のうちにチューニングを……」
PRINTFORML 「痛ッ、こんなのいやぁぁぁっ！」	PRINTFORML 「痛ッ、こんなのいやぁぁぁっ！」
PRINTFORML 「う、うぅぅ……あ、ありがとう」	PRINTFORML 「う、うぅぅ……あ、ありがとう」
PRINTFORML (あっ♥ あっ♥ 歩くだけで♥)	PRINTFORML (あっ♥ あっ♥ 歩くだけで♥)
PRINTFORML （これじゃ演奏できない……♥）	PRINTFORML （これじゃ演奏できない……♥）
PRINTFORML （こんなノイズくらいで……♥）	PRINTFORML （こんなノイズくらいで……♥）
PRINTFORMDL ルナサの呼吸が乱れている……	PRINTFORMDL ルナサの呼吸が乱れている……
PRINTFORML 「この会場は空席だけでいい！」	PRINTFORML 「この会場は空席だけでいい！」
PRINTFORML 「嫌な鼓動ばかり聞こえる……」	PRINTFORML 「嫌な鼓動ばかり聞こえる……」
PRINTFORML 「勇気の調べよ、私に力を……」	PRINTFORML 「勇気の調べよ、私に力を……」
PRINTFORML 「練習は無駄にならない……！」	PRINTFORML 「練習は無駄にならない……！」
PRINTFORML 「さて、どんな曲を奏でようか」	PRINTFORML 「さて、どんな曲を奏でようか」
PRINTFORML 「そう。お説教が必要みたいね」	PRINTFORML 「そう。お説教が必要みたいね」
PRINTFORML 「あぁっ！？見切れなかった！」	PRINTFORML 「あぁっ！？見切れなかった！」
PRINTFORML 「くっ、いい加減にしてよ……」	PRINTFORML 「くっ、いい加減にしてよ……」
PRINTFORML 「やっと静かになったみたいね」	PRINTFORML 「やっと静かになったみたいね」
PRINTFORML 「力、抜けてく…ごめん、ね…」	PRINTFORML 「力、抜けてく…ごめん、ね…」
PRINTFORML 「……しょうがないなぁ…もう」	PRINTFORML 「……しょうがないなぁ…もう」
PRINTFORML 「戦闘……気が乗らないかな。」	PRINTFORML 「戦闘……気が乗らないかな。」
PRINTFORML 「私の力じゃ、この程度……。」	PRINTFORML 「私の力じゃ、この程度……。」
PRINTFORML 「大丈夫？怪我とかしてない？」	PRINTFORML 「大丈夫？怪我とかしてない？」
PRINTFORML 「体は暖まってる。問題ないよ」	PRINTFORML 「体は暖まってる。問題ないよ」
PRINTFORML 「演奏が冴えてきた。いい感じ」	PRINTFORML 「演奏が冴えてきた。いい感じ」
PRINTFORML 「狙いはあそこ。少し急ごうか」	PRINTFORML 「狙いはあそこ。少し急ごうか」
PRINTFORML 「睡眠のとれそうな場所は……」	PRINTFORML 「睡眠のとれそうな場所は……」
PRINTFORML 「も、もしかしてこのお腹……」	PRINTFORML 「も、もしかしてこのお腹……」
PRINTFORML 「柔らかいって……すぅ……」	PRINTFORML 「柔らかいって……すぅ……」
PRINTFORML 「こ、こんな状態じゃ……♥」	PRINTFORML 「こ、こんな状態じゃ……♥」
PRINTFORML （カラダ、火照ってる……♥）	PRINTFORML （カラダ、火照ってる……♥）
PRINTFORML 「何かあったはずだけど……」	PRINTFORML 「何かあったはずだけど……」
PRINTFORML 「ここからは徐々に強く……」	PRINTFORML 「ここからは徐々に強く……」
PRINTFORML 「無駄使いはできないけど！」	PRINTFORML 「無駄使いはできないけど！」
PRINTFORML 「……ちょっと怒ってるから」	PRINTFORML 「……ちょっと怒ってるから」
PRINTFORML 「さっ、捌き…切れない！？」	PRINTFORML 「さっ、捌き…切れない！？」
PRINTFORML 「奏者の体に触るのはご法度」	PRINTFORML 「奏者の体に触るのはご法度」
PRINTFORML 「ま、間に合わなかった……」	PRINTFORML 「ま、間に合わなかった……」
PRINTFORML 「ど、どうってことない……」	PRINTFORML 「ど、どうってことない……」
PRINTFORML 「私はあなたを許さない……」	PRINTFORML 「私はあなたを許さない……」
PRINTFORML 「楽器の手入れは十分みたい」	PRINTFORML 「楽器の手入れは十分みたい」
PRINTFORML 「悲しい音色が響いているわ」	PRINTFORML 「悲しい音色が響いているわ」
PRINTFORML 「前に……前に進むんだ……」	PRINTFORML 「前に……前に進むんだ……」
PRINTFORML 「何も見逃さないように……」	PRINTFORML 「何も見逃さないように……」
PRINTFORML 「ちょっと…こんなのって…」	PRINTFORML 「ちょっと…こんなのって…」
PRINTFORML 「うん。いける。私は大丈夫」	PRINTFORML 「うん。いける。私は大丈夫」
PRINTFORML 「風を切る音。音色のようね」	PRINTFORML 「風を切る音。音色のようね」
PRINTFORML 「まぁ……メルランったら」	PRINTFORML 「まぁ……メルランったら」
PRINTFORML 「……本番前に……練習ぅ」	PRINTFORML 「……本番前に……練習ぅ」
PRINTFORML （一度手入れしないとぉ♥）	PRINTFORML （一度手入れしないとぉ♥）
PRINTFORML 「柔らかな水の音のように」	PRINTFORML 「柔らかな水の音のように」
PRINTFORML 「散ってしまえばいいのに」	PRINTFORML 「散ってしまえばいいのに」
PRINTFORML 「派手めに行ってみようか」	PRINTFORML 「派手めに行ってみようか」
PRINTFORML 「まとめて綺麗にするよ！」	PRINTFORML 「まとめて綺麗にするよ！」
PRINTFORML 「このほうが手っ取り早い」	PRINTFORML 「このほうが手っ取り早い」
PRINTFORML 「期待に応えて。お願い！」	PRINTFORML 「期待に応えて。お願い！」
PRINTFORML （た、耐えないとぉ……！）	PRINTFORML （た、耐えないとぉ……！）
PRINTFORML （あ、喘ぐわけには……！）	PRINTFORML （あ、喘ぐわけには……！）
PRINTFORML 「きゃぁ！やってくれる！」	PRINTFORML 「きゃぁ！やってくれる！」
PRINTFORML 「うそっ！？捕まった！？」	PRINTFORML 「うそっ！？捕まった！？」
PRINTFORML 「こ、こんなやつらに……」	PRINTFORML 「こ、こんなやつらに……」
PRINTFORML 「最低の感触なんだね……」	PRINTFORML 「最低の感触なんだね……」
PRINTFORML 「絶対に許さないから……」	PRINTFORML 「絶対に許さないから……」
PRINTFORML 「ギリギリだったけど……」	PRINTFORML 「ギリギリだったけど……」
PRINTFORML 「メルラン……リリカ……」	PRINTFORML 「メルラン……リリカ……」
PRINTFORML 「統一感のある衣装が……」	PRINTFORML 「統一感のある衣装が……」
PRINTFORML 「お待たせ。助けに来たよ」	PRINTFORML 「お待たせ。助けに来たよ」
PRINTFORML 「次はまっすぐいこうかな」	PRINTFORML 「次はまっすぐいこうかな」
PRINTFORML では、よい触手ライフを…	PRINTFORML では、よい触手ライフを…
PRINTFORML 「もぅ……ルナサったら」	PRINTFORML 「もぅ……ルナサったら」
PRINTFORML 「ひ、ひきょうものッ♥」	PRINTFORML 「ひ、ひきょうものッ♥」
PRINTFORML （おちつかないと……♥）	PRINTFORML （おちつかないと……♥）
PRINTFORML （む、胸が擦れて……♥）	PRINTFORML （む、胸が擦れて……♥）
PRINTFORML （いま、ジワって……♥）	PRINTFORML （いま、ジワって……♥）
PRINTFORML 「ち、近寄るなぁ……♥」	PRINTFORML 「ち、近寄るなぁ……♥」
PRINTFORML 「その間合い…甘過ぎ！」	PRINTFORML 「その間合い…甘過ぎ！」
PRINTFORML 「うるさいのは嫌い……」	PRINTFORML 「うるさいのは嫌い……」
PRINTFORML 「やってみるしか……♥」	PRINTFORML 「やってみるしか……♥」
PRINTFORML 「流れは切らさない……」	PRINTFORML 「流れは切らさない……」
PRINTFORML 「うっ、何をしたの……」	PRINTFORML 「うっ、何をしたの……」
PRINTFORML 「ええぃ！面倒なのに！」	PRINTFORML 「ええぃ！面倒なのに！」
PRINTFORML 「これじゃ動けない！？」	PRINTFORML 「これじゃ動けない！？」
PRINTFORML 「だ、だされた……！？」	PRINTFORML 「だ、だされた……！？」
PRINTFORML 「ナカにだされたか……」	PRINTFORML 「ナカにだされたか……」
PRINTFORML 「好き勝手なことを……」	PRINTFORML 「好き勝手なことを……」
PRINTFORML 「あ、足腰が……もぅ♥」	PRINTFORML 「あ、足腰が……もぅ♥」
PRINTFORML (音漏れしないように…)	PRINTFORML (音漏れしないように…)
PRINTFORML （ア、アソコが……♥）	PRINTFORML （ア、アソコが……♥）
PRINTFORML 「一度距離を取ろうか」	PRINTFORML 「一度距離を取ろうか」
PRINTFORML 「大人しくしててね？」	PRINTFORML 「大人しくしててね？」
PRINTFORML 「塵ひとつ残さない！」	PRINTFORML 「塵ひとつ残さない！」
PRINTFORML 「これが音楽の力よ！」	PRINTFORML 「これが音楽の力よ！」
PRINTFORML 「これでフィナーレ！」	PRINTFORML 「これでフィナーレ！」
PRINTFORML 「貫け！雷鳴の如く！」	PRINTFORML 「貫け！雷鳴の如く！」
PRINTFORML 「まずい･･･かもね」	PRINTFORML 「まずい･･･かもね」
PRINTFORML 「ッはぁ！…はぁっ…」	PRINTFORML 「ッはぁ！…はぁっ…」
PRINTFORML 「旋律を重ねよう……」	PRINTFORML 「旋律を重ねよう……」
PRINTFORML 「絶対に駄目よ……！」	PRINTFORML 「絶対に駄目よ……！」
PRINTFORML 「くぅぅぅ……んッ！」	PRINTFORML 「くぅぅぅ……んッ！」
PRINTFORML 「命…捨てたいんだね」	PRINTFORML 「命…捨てたいんだね」
PRINTFORML 「速く…もっと速く！」	PRINTFORML 「速く…もっと速く！」
PRINTFORML 「……たすかったの？」	PRINTFORML 「……たすかったの？」
PRINTFORML 「努力は嘘をつかない」	PRINTFORML 「努力は嘘をつかない」
PRINTFORML 「アンコールはないわ」	PRINTFORML 「アンコールはないわ」
PRINTFORML 「……ごめんなさい！」	PRINTFORML 「……ごめんなさい！」
PRINTFORML 「まとめて片づける！」	PRINTFORML 「まとめて片づける！」
PRINTFORML 「今はこれでいい……」	PRINTFORML 「今はこれでいい……」
PRINTFORML 「……あ、ありがとう」	PRINTFORML 「……あ、ありがとう」
PRINTFORML 「どこかで睡眠を……」	PRINTFORML 「どこかで睡眠を……」
PRINTFORML 「……育つのがはやい」	PRINTFORML 「……育つのがはやい」
PRINTFORML 「順調に育ってる……」	PRINTFORML 「順調に育ってる……」
PRINTFORML 「もうすぐなのね……」	PRINTFORML 「もうすぐなのね……」
PRINTFORML (はぁ…♥ はぁ…♥)	PRINTFORML (はぁ…♥ はぁ…♥)
PRINTFORML 「さぁ、次に行こっか」	PRINTFORML 「さぁ、次に行こっか」
PRINTFORML 「……まだ休演中ぅ」	PRINTFORML 「……まだ休演中ぅ」
PRINTFORML 「すぅ……すぅ……」	PRINTFORML 「すぅ……すぅ……」
PRINTFORML （もう濡れて……♥）	PRINTFORML （もう濡れて……♥）
PRINTFORML （どうしよう……♥）	PRINTFORML （どうしよう……♥）
PRINTFORML （ク、クリが……♥）	PRINTFORML （ク、クリが……♥）
PRINTFORML （敏感にされたッ♥）	PRINTFORML （敏感にされたッ♥）
PRINTFORML 「ここは一旦下がる」	PRINTFORML 「ここは一旦下がる」
PRINTFORML 「しぶとい奴は嫌い」	PRINTFORML 「しぶとい奴は嫌い」
PRINTFORML 「これが私の前奏曲」	PRINTFORML 「これが私の前奏曲」
PRINTFORML 「嫌な音は私が消す」	PRINTFORML 「嫌な音は私が消す」
PRINTFORML 「永遠に静かにして」	PRINTFORML 「永遠に静かにして」
PRINTFORML 「戦列を突き破る！」	PRINTFORML 「戦列を突き破る！」
PRINTFORML 「串刺しにするよ！」	PRINTFORML 「串刺しにするよ！」
PRINTFORML 「掃除してあげる！」	PRINTFORML 「掃除してあげる！」
PRINTFORML 「私の間合いだよ！」	PRINTFORML 「私の間合いだよ！」
PRINTFORML 「はぁ……はぁ……」	PRINTFORML 「はぁ……はぁ……」
PRINTFORML 「次につなげる……」	PRINTFORML 「次につなげる……」
PRINTFORML 「げほっげほっ……」	PRINTFORML 「げほっげほっ……」
PRINTFORML 「ああああああっ！」	PRINTFORML 「ああああああっ！」
PRINTFORML 「やっ、やめぇぇ！」	PRINTFORML 「やっ、やめぇぇ！」
PRINTFORML 「きゃっ…離れろ！」	PRINTFORML 「きゃっ…離れろ！」
PRINTFORML 「きゃぁ！よくも！」	PRINTFORML 「きゃぁ！よくも！」
PRINTFORML 「反応が遅れた！？」	PRINTFORML 「反応が遅れた！？」
PRINTFORML 「誘い込まれた！？」	PRINTFORML 「誘い込まれた！？」
PRINTFORML 「い、今のって……」	PRINTFORML 「い、今のって……」
PRINTFORML 「よ、汚された……」	PRINTFORML 「よ、汚された……」
PRINTFORML 「……見すぎは駄目」	PRINTFORML 「……見すぎは駄目」
PRINTFORML 「止まらずにいく…」	PRINTFORML 「止まらずにいく…」
PRINTFORML （疼いてる……♥）	PRINTFORML （疼いてる……♥）
PRINTFORML 「ここは姉として」	PRINTFORML 「ここは姉として」
PRINTFORML 「誘いの調べを…」	PRINTFORML 「誘いの調べを…」
PRINTFORML 「全てを…流す！」	PRINTFORML 「全てを…流す！」
PRINTFORML 「次、踏み込む！」	PRINTFORML 「次、踏み込む！」
PRINTFORML 「たす…けて……」	PRINTFORML 「たす…けて……」
PRINTFORML 「挽回する、必ず」	PRINTFORML 「挽回する、必ず」
PRINTFORML 「絶対に嫌……！」	PRINTFORML 「絶対に嫌……！」
PRINTFORML 「何をしてぇ……」	PRINTFORML 「何をしてぇ……」
PRINTFORML 「げほっげほっ…」	PRINTFORML 「げほっげほっ…」
PRINTFORML 「く、苦しい……」	PRINTFORML 「く、苦しい……」
PRINTFORML 「や、やめっ……」	PRINTFORML 「や、やめっ……」
PRINTFORML 「やっ、やめっ！」	PRINTFORML 「やっ、やめっ！」
PRINTFORML 「少し、痛い……」	PRINTFORML 「少し、痛い……」
PRINTFORML 「痛く、ない…！」	PRINTFORML 「痛く、ない…！」
PRINTFORML 「乱暴しないで！」	PRINTFORML 「乱暴しないで！」
PRINTFORML 「気持ちいい……」	PRINTFORML 「気持ちいい……」
PRINTFORML 「んんんッ……！」	PRINTFORML 「んんんッ……！」
PRINTFORML 「や、やめてよ！」	PRINTFORML 「や、やめてよ！」
PRINTFORML （休憩したい……）	PRINTFORML （休憩したい……）
PRINTFORML 「すぅ…zzz」	PRINTFORML 「すぅ…zzz」
PRINTFORML 「近寄らないで」	PRINTFORML 「近寄らないで」
PRINTFORML 「掃除の時間！」	PRINTFORML 「掃除の時間！」
PRINTFORML 「逃がさないよ」	PRINTFORML 「逃がさないよ」
PRINTFORML 「きゃぁぁぁ！」	PRINTFORML 「きゃぁぁぁ！」
PRINTFORML 「あああぁ……」	PRINTFORML 「あああぁ……」
PRINTFORML 「……いじわる」	PRINTFORML 「……いじわる」
PRINTFORML 「それだめぇ…」	PRINTFORML 「それだめぇ…」
PRINTFORML 「呑まれる！？」	PRINTFORML 「呑まれる！？」
PRINTFORML 「パターン通り」	PRINTFORML 「パターン通り」
PRINTFORML 「よし、次……」	PRINTFORML 「よし、次……」
PRINTFORML 「うん。上出来」	PRINTFORML 「うん。上出来」
PRINTFORML 「ぅ…ぁぁ……」	PRINTFORML 「ぅ…ぁぁ……」
PRINTFORML 「ららばい……」	PRINTFORML 「ららばい……」
PRINTFORML 「響かせるよ」	PRINTFORML 「響かせるよ」
PRINTFORML 「届かせるよ」	PRINTFORML 「届かせるよ」
PRINTFORML 「げほっ……」	PRINTFORML 「げほっ……」
PRINTFORML 「うぇぇ……」	PRINTFORML 「うぇぇ……」
PRINTFORML 「かはっ……」	PRINTFORML 「かはっ……」
PRINTFORML 「やめぇ……」	PRINTFORML 「やめぇ……」
PRINTFORML 「やめてぇ…」	PRINTFORML 「やめてぇ…」
PRINTFORML 「しまった！」	PRINTFORML 「しまった！」
PRINTFORML 「速いっ！？」	PRINTFORML 「速いっ！？」
PRINTFORML 「そんな！？」	PRINTFORML 「そんな！？」
PRINTFORML 「手応えあり」	PRINTFORML 「手応えあり」
PRINTFORML 「逃げるよ」	PRINTFORML 「逃げるよ」
PRINTFORML 「はあっ！」	PRINTFORML 「はあっ！」
PRINTFORML 「ゃぁ……」	PRINTFORML 「ゃぁ……」
PRINTFORML 「ぉぇ……」	PRINTFORML 「ぉぇ……」
PRINTFORML 「……ぅぅ」	PRINTFORML 「……ぅぅ」
PRINTFORML 「力がっ…」	PRINTFORML 「力がっ…」
PRINTFORML 「瘴気！？」	PRINTFORML 「瘴気！？」
PRINTFORML 「すごぃ…」	PRINTFORML 「すごぃ…」
PRINTFORML 「あひぃ…」	PRINTFORML 「あひぃ…」
PRINTFORML 「うぅ……」	PRINTFORML 「うぅ……」
PRINTFORML 「小休止」	PRINTFORML 「小休止」
PRINTFORML 「痛っ…」	PRINTFORML 「痛っ…」
PRINTFORMDL …？	PRINTFORMDL …？
PRINTFORML 	PRINTFORML 
PRINTL 	PRINTL 
