//口上:

PRINTFORMDW 声とともに派手な音を立てて開く障子。それこそ紙が破れそうな勢いのそれを、紫はのんびり茶を飲んで迎えた。顔も合わせず。	PRINTFORMDW 声とともに派手な音を立てて開く障子。それこそ紙が破れそうな勢いのそれを、紫はのんびり茶を飲んで迎えた。顔も合わせず。
PRINTFORMW 「毎日のようにこんなつまらないことばっかりするのは飽き飽きです！　しかも母さまは家にこもりきりで、いつも私ひとり！」	PRINTFORMW 「毎日のようにこんなつまらないことばっかりするのは飽き飽きです！　しかも母さまは家にこもりきりで、いつも私ひとり！」
PRINTFORMW 　単に事態を知らないまま話すならまだしも……あの広い土地を自分の管理下において利用したいだけの者もいるでしょうね」	PRINTFORMW 　単に事態を知らないまま話すならまだしも……あの広い土地を自分の管理下において利用したいだけの者もいるでしょうね」
PRINTFORMW 「もちろん、生き残りの始末も入り口の封印確認も結界の細かい観察も！　母さま、前に私の強さを認めましたよね！？」	PRINTFORMW 「もちろん、生き残りの始末も入り口の封印確認も結界の細かい観察も！　母さま、前に私の強さを認めましたよね！？」
PRINTFORMW 「そして、私は見ての通り力が戻らないまま。このような状態では、管理役として不適切だと言われても反論は難しい。	PRINTFORMW 「そして、私は見ての通り力が戻らないまま。このような状態では、管理役として不適切だと言われても反論は難しい。
PRINTFORMDW 弾が女王の中心部を貫き、同時に穴の開いた体は音を立てて崩れ落ちていく。ついに限界を迎えたかのように。	PRINTFORMDW 弾が女王の中心部を貫き、同時に穴の開いた体は音を立てて崩れ落ちていく。ついに限界を迎えたかのように。
PRINTFORMW 「えぇ、確かに貴方は強いわね……けれど、まだ教えていないことがある。スキマから武器を選んで構えなさい」	PRINTFORMW 「えぇ、確かに貴方は強いわね……けれど、まだ教えていないことがある。スキマから武器を選んで構えなさい」
PRINTFORMW 「女の髪には力が宿るもの……私の式神である貴方なら、これを触媒にすれば私の位置を感知できるでしょう。	PRINTFORMW 「女の髪には力が宿るもの……私の式神である貴方なら、これを触媒にすれば私の位置を感知できるでしょう。
PRINTFORMW 「どうです、凄いでしょう私！　いくら母さまとは言え、私の強さは認めざるを得ないんじゃないですか！？」	PRINTFORMW 「どうです、凄いでしょう私！　いくら母さまとは言え、私の強さは認めざるを得ないんじゃないですか！？」
PRINTFORMW 「近々、あの迷宮をどうするか話し合う会合がある。私以外は、あの迷宮には欠片も触れていない連中ばかり。	PRINTFORMW 「近々、あの迷宮をどうするか話し合う会合がある。私以外は、あの迷宮には欠片も触れていない連中ばかり。
PRINTFORMDW 同時に、背中から地面へと押し付けられる圧力が伝わってくる。逆らって無理矢理に起きる気力はもうない。	PRINTFORMDW 同時に、背中から地面へと押し付けられる圧力が伝わってくる。逆らって無理矢理に起きる気力はもうない。
PRINTFORMDW 火花が爆ぜるような音と共に触手は千切れ、一人の少女が肉床に足を降ろす。大きすぎる服を揺らしながら。	PRINTFORMDW 火花が爆ぜるような音と共に触手は千切れ、一人の少女が肉床に足を降ろす。大きすぎる服を揺らしながら。
PRINTFORMDW ぷい、と目を背ける紫の表情はしかし、娘の言葉に反論できない母親というものを見事に演出していた。	PRINTFORMDW ぷい、と目を背ける紫の表情はしかし、娘の言葉に反論できない母親というものを見事に演出していた。
PRINTFORMDW 案の定消えた迷宮の出入口は見つかっていないし、突如として女のみが姿を消す異変も終わっていない。	PRINTFORMDW 案の定消えた迷宮の出入口は見つかっていないし、突如として女のみが姿を消す異変も終わっていない。
PRINTFORMW 「妖力の吸い方は体験させてもらったし、理解もできた。幻想郷の住人に手は出したくなかったけど……」	PRINTFORMW 「妖力の吸い方は体験させてもらったし、理解もできた。幻想郷の住人に手は出したくなかったけど……」
PRINTFORMDW 掴んだ部分から電流のように魔力が走る。足掻くように触手が震えたが、手中から逃れる事はできず……	PRINTFORMDW 掴んだ部分から電流のように魔力が走る。足掻くように触手が震えたが、手中から逃れる事はできず……
PRINTFORMDW また力を吸って体を維持しようとしたのか、道連れを欲しがったか、クイーンが触手を伸ばした瞬間――	PRINTFORMDW また力を吸って体を維持しようとしたのか、道連れを欲しがったか、クイーンが触手を伸ばした瞬間――
PRINTFORMDW しかめっ面で言う霊夢だったが、心も体の変化に影響を受けたのか紫が聞いた様子は無いようであった。	PRINTFORMDW しかめっ面で言う霊夢だったが、心も体の変化に影響を受けたのか紫が聞いた様子は無いようであった。
PRINTFORMW 「薬は本当にありがたいけど、こんな子供を助けるだけで放置してはいけないと思わない？　……冗談よ。	PRINTFORMW 「薬は本当にありがたいけど、こんな子供を助けるだけで放置してはいけないと思わない？　……冗談よ。
PRINTFORMDW 伝わってくる快楽も、衰えるどころか強まっていくだけだ。散々犯された身で耐えられるものではなく。	PRINTFORMDW 伝わってくる快楽も、衰えるどころか強まっていくだけだ。散々犯された身で耐えられるものではなく。
PRINTFORMW 　何より、母さまより強い私のほうが危険な場所に残るべきなんです。ささ、閉まってしまいますよ？」	PRINTFORMW 　何より、母さまより強い私のほうが危険な場所に残るべきなんです。ささ、閉まってしまいますよ？」
PRINTFORMDW そう言われてやっと、紫は娘の顔を真っ直ぐに見た。今度は逆に、娘のほうが視線を逸らしていたが。	PRINTFORMDW そう言われてやっと、紫は娘の顔を真っ直ぐに見た。今度は逆に、娘のほうが視線を逸らしていたが。
PRINTFORMDW この目論見は、藍が戻る前に紫が倒されればあっさり潰える。故に、迷宮もそれを狙ってくるだろう。	PRINTFORMDW この目論見は、藍が戻る前に紫が倒されればあっさり潰える。故に、迷宮もそれを狙ってくるだろう。
PRINTFORMDW また力を吸い体を維持しようとしたのか、道連れを欲しがったか、クイーンが触手を伸ばした瞬間――	PRINTFORMDW また力を吸い体を維持しようとしたのか、道連れを欲しがったか、クイーンが触手を伸ばした瞬間――
PRINTFORMDW 思わず絶句する。だが、あまりの事態に言葉も出ないはずだった紫の口は、歪んだ笑みを作り上げた。	PRINTFORMDW 思わず絶句する。だが、あまりの事態に言葉も出ないはずだった紫の口は、歪んだ笑みを作り上げた。
PRINTFORMDW 紫はその始末を終えた後も、何度も迷宮の跡地に潜り……そしてとうとう、目的のものを、見つけた。	PRINTFORMDW 紫はその始末を終えた後も、何度も迷宮の跡地に潜り……そしてとうとう、目的のものを、見つけた。
PRINTFORMW 「あんたがそーやって一々聞きに来るから！　私がやる羽目になるのよ！　少しは自分でやりなさい！」	PRINTFORMW 「あんたがそーやって一々聞きに来るから！　私がやる羽目になるのよ！　少しは自分でやりなさい！」
PRINTFORMDW 掴んだ部分から電流のように魔力が走る。クイーンに表情があるとすれば、更に顔を歪ませただろう。	PRINTFORMDW 掴んだ部分から電流のように魔力が走る。クイーンに表情があるとすれば、更に顔を歪ませただろう。
PRINTFORMW 「あんたの芸風には合わない気がするけどねぇ……向かいあった際に見上げられると、違和感酷いのよ」	PRINTFORMW 「あんたの芸風には合わない気がするけどねぇ……向かいあった際に見上げられると、違和感酷いのよ」
PRINTFORMDW 暗い、湿った迷宮の中。通常とは異なる気配に満ちたその空気の中で、何か千切れる音が響いていた。	PRINTFORMDW 暗い、湿った迷宮の中。通常とは異なる気配に満ちたその空気の中で、何か千切れる音が響いていた。
PRINTFORMDW もともと神隠しは紫の得意分野だ。それを勝手に幻想郷内で行なっている者がいる時点で業腹だが……	PRINTFORMDW もともと神隠しは紫の得意分野だ。それを勝手に幻想郷内で行なっている者がいる時点で業腹だが……
PRINTFORMW 「それなら、なおさら私が残るべきなんです。外に知り合いがいない私が出ても、意味はありません。	PRINTFORMW 「それなら、なおさら私が残るべきなんです。外に知り合いがいない私が出ても、意味はありません。
PRINTFORMW 「軍隊用……ではないほうでしょうねぇ、やっぱり。今の私じゃそういう用途には合わないのだけど」	PRINTFORMW 「軍隊用……ではないほうでしょうねぇ、やっぱり。今の私じゃそういう用途には合わないのだけど」
PRINTFORMW （……私の能力なら、体内にいるモノを掴んで取り出せる。育つ前でなおかつ自分の体限定だけれど。	PRINTFORMW （……私の能力なら、体内にいるモノを掴んで取り出せる。育つ前でなおかつ自分の体限定だけれど。
PRINTFORMDW 無論、相手がそういう気と分かれば脱出することは不可能ではなかったし、事実こうして成功した。	PRINTFORMDW 無論、相手がそういう気と分かれば脱出することは不可能ではなかったし、事実こうして成功した。
PRINTFORMDW そう言うと紫は自分の髪を一房ほど切り、藍に押し付けた。できるだけ早口で言葉を続けながら。	PRINTFORMDW そう言うと紫は自分の髪を一房ほど切り、藍に押し付けた。できるだけ早口で言葉を続けながら。
PRINTFORMW 　実際、ここは脱出するしか無いことが更に腹立たしいけれど……藍がいれば別だったでしょうに」	PRINTFORMW 　実際、ここは脱出するしか無いことが更に腹立たしいけれど……藍がいれば別だったでしょうに」
PRINTFORMW 「既にもう『八雲紫』はクイーンの本能をベースとしたものに生まれ変わっているのだし、それに」	PRINTFORMW 「既にもう『八雲紫』はクイーンの本能をベースとしたものに生まれ変わっているのだし、それに」
PRINTFORMDW 同時に、その体の崩壊は加速して……どうにかする時間も与えずに、粉微塵になり散っていった。	PRINTFORMDW 同時に、その体の崩壊は加速して……どうにかする時間も与えずに、粉微塵になり散っていった。
PRINTFORMDW そこに寝そべっているのはかつて迷宮に取り込まれ、陵辱され続け、精神を破壊された霊夢の姿。	PRINTFORMDW そこに寝そべっているのはかつて迷宮に取り込まれ、陵辱され続け、精神を破壊された霊夢の姿。
PRINTFORMDW 長いため息をつきながら愚痴をこぼしまくる妖怪の賢者。ちなみに、後処理は全て彼女がやった。	PRINTFORMDW 長いため息をつきながら愚痴をこぼしまくる妖怪の賢者。ちなみに、後処理は全て彼女がやった。
PRINTFORMDW ……藍が紫の八つ当たりを受けずに済むほど事態が進んだのは、もう一ヶ月後ほど後の話である。	PRINTFORMDW ……藍が紫の八つ当たりを受けずに済むほど事態が進んだのは、もう一ヶ月後ほど後の話である。
PRINTFORMDW 足掻くように触手が震えたが、手中から逃れる事はできず……一際、女王の断末魔が高く響いた。	PRINTFORMDW 足掻くように触手が震えたが、手中から逃れる事はできず……一際、女王の断末魔が高く響いた。
PRINTFORMW 「でも実際、この体って楽よ？　無駄な消耗は抑えることができるし、この状態でも十分戦えるし」	PRINTFORMW 「でも実際、この体って楽よ？　無駄な消耗は抑えることができるし、この状態でも十分戦えるし」
PRINTFORMDW ……後に服の裁縫図を受け取った香霖が変な声を上げたと言われているが、真相は定かではない。	PRINTFORMDW ……後に服の裁縫図を受け取った香霖が変な声を上げたと言われているが、真相は定かではない。
PRINTFORMDW うつ伏せのまま視線だけを後ろへ向けると……そこに立っていたのは、背が縮む前の自分だった。	PRINTFORMDW うつ伏せのまま視線だけを後ろへ向けると……そこに立っていたのは、背が縮む前の自分だった。
PRINTFORMDW 僅かに残った理性をかき集めて睨もうという気力も、股間から伝わってくる快楽の前に霧散した。	PRINTFORMDW 僅かに残った理性をかき集めて睨もうという気力も、股間から伝わってくる快楽の前に霧散した。
PRINTFORMW 「でも、生えていないならしょうがないので、んっ……一緒に、犯しあいましょう、母さ、まっ！」	PRINTFORMW 「でも、生えていないならしょうがないので、んっ……一緒に、犯しあいましょう、母さ、まっ！」
PRINTFORMDW 今までにない異様な気配に嫌なものを感じ、調査するべく単身で突入して調査を試みたものの……	PRINTFORMDW 今までにない異様な気配に嫌なものを感じ、調査するべく単身で突入して調査を試みたものの……
PRINTFORMDW 幻想郷で人妖を問わず行方不明者が続出する事態に、最も早く異常を感じ取ったのが彼女だった。	PRINTFORMDW 幻想郷で人妖を問わず行方不明者が続出する事態に、最も早く異常を感じ取ったのが彼女だった。
PRINTFORMDW 地面に倒れ断末魔の悲鳴をあげながら悶えていたガーディアンは、やがて完全に動きを止める。	PRINTFORMDW 地面に倒れ断末魔の悲鳴をあげながら悶えていたガーディアンは、やがて完全に動きを止める。
PRINTFORMDW 混乱している人影の群れを見つめていた紫の表情が歪む。同時に、周囲の空間も揺らいでいく。	PRINTFORMDW 混乱している人影の群れを見つめていた紫の表情が歪む。同時に、周囲の空間も揺らいでいく。
PRINTFORMW 「んー、力を取り戻してからずっと調子いいわー。ま、ずっと弱っていたのだから当たり前ね」、	PRINTFORMW 「んー、力を取り戻してからずっと調子いいわー。ま、ずっと弱っていたのだから当たり前ね」、
PRINTFORMDW 放っておいても、敵は死ぬだろう。だが、その前に返してもらわなくてはならないものがある。	PRINTFORMDW 放っておいても、敵は死ぬだろう。だが、その前に返してもらわなくてはならないものがある。
PRINTFORMDW 少なくとも力を取り戻せなかった紫では、どこに境界を引こうと昔の霊夢を導き出せなかった。	PRINTFORMDW 少なくとも力を取り戻せなかった紫では、どこに境界を引こうと昔の霊夢を導き出せなかった。
PRINTFORMDW 即座にスキマが開かれ、娘は迷宮で発掘した緋緋色金の剣を構えた。それに対し、紫は――――	PRINTFORMDW 即座にスキマが開かれ、娘は迷宮で発掘した緋緋色金の剣を構えた。それに対し、紫は――――
PRINTFORML またゲーム中に口上を変えると、状況と台詞が合わなくなる不具合が発生する可能性があります。	PRINTFORML またゲーム中に口上を変えると、状況と台詞が合わなくなる不具合が発生する可能性があります。
PRINTFORMW 『あら、目覚めたのね。もっとも、この姿はマグロを責めていてもつまらないと思う性分よね？』	PRINTFORMW 『あら、目覚めたのね。もっとも、この姿はマグロを責めていてもつまらないと思う性分よね？』
PRINTFORMDW 紡ごうとした問いは、嬌声に塗り替えられた。膣内に、もはや慣れ親しんだモノが入ってくる。	PRINTFORMDW 紡ごうとした問いは、嬌声に塗り替えられた。膣内に、もはや慣れ親しんだモノが入ってくる。
PRINTFORML 『ふふ、「私」ってとても素敵ねぇ。この姿も、貴方も手放さないわ。ずっと犯し続けてあげる。	PRINTFORML 『ふふ、「私」ってとても素敵ねぇ。この姿も、貴方も手放さないわ。ずっと犯し続けてあげる。
PRINTFORMDW ぼんやりと視線を上げると……そこに立っていたのは自分と瓜二つの、無邪気で残忍な、笑み。	PRINTFORMDW ぼんやりと視線を上げると……そこに立っていたのは自分と瓜二つの、無邪気で残忍な、笑み。
PRINTFORMDW 膣内で包まれた擬似陰茎は即座に反応し、射精しながらもその屹立を更に強いものとしていく。	PRINTFORMDW 膣内で包まれた擬似陰茎は即座に反応し、射精しながらもその屹立を更に強いものとしていく。
PRINTFORMDW 頭がぐちゃぐちゃになっている紫にすら、特別な何かがされている事が分かるほど異常だった。	PRINTFORMDW 頭がぐちゃぐちゃになっている紫にすら、特別な何かがされている事が分かるほど異常だった。
PRINTFORMDW 結果は弾幕勝負どころか話し合いの余地すらない相手に囚われ、苗床にされかかるという失態。	PRINTFORMDW 結果は弾幕勝負どころか話し合いの余地すらない相手に囚われ、苗床にされかかるという失態。
PRINTFORMDW だが、代償を支払わざるを得なかったこともまた、今の体では否定しようがない。なぜなら――	PRINTFORMDW だが、代償を支払わざるを得なかったこともまた、今の体では否定しようがない。なぜなら――
PRINTFORMDW 橙と同じくらいの背丈になった体で、破けた服をぷらぷらと振る紫。当然、丈は合っていない。	PRINTFORMDW 橙と同じくらいの背丈になった体で、破けた服をぷらぷらと振る紫。当然、丈は合っていない。
PRINTFORMW （さすがにあれの体内へ直接スキマを開くのは不可能……外からどうにかするしかない……！）	PRINTFORMW （さすがにあれの体内へ直接スキマを開くのは不可能……外からどうにかするしかない……！）
PRINTFORMDW %ARGS:0%%TACHI()%の攻撃が、ついにガーディアンの巨大な目玉を貫いた。	PRINTFORMDW %ARGS:0%%TACHI()%の攻撃が、ついにガーディアンの巨大な目玉を貫いた。
PRINTFORMW 　一人が片側から弄るだけではどうにもならない境界も、二人で対方向に操作すれば話は別……	PRINTFORMW 　一人が片側から弄るだけではどうにもならない境界も、二人で対方向に操作すれば話は別……
PRINTFORMW 「……私より貴方のほうが信用されそうな青臭さだと思うけれど、まぁいいわ。任せましょう」	PRINTFORMW 「……私より貴方のほうが信用されそうな青臭さだと思うけれど、まぁいいわ。任せましょう」
PRINTFORMW 「……恐らく、こちらが脱出した後は迷宮ごとどこかに転移して行方をくらます気でしょうね。	PRINTFORMW 「……恐らく、こちらが脱出した後は迷宮ごとどこかに転移して行方をくらます気でしょうね。
PRINTFORMDW 笑顔で体を伸ばす。あの頃に比べれば、よほどのことでない限り調子よく感じられるだろう。	PRINTFORMDW 笑顔で体を伸ばす。あの頃に比べれば、よほどのことでない限り調子よく感じられるだろう。
PRINTFORMDW 叫び返してから、周囲を見渡す。触手が溢れだすスキマからも、家具の影にも、気配はない。	PRINTFORMDW 叫び返してから、周囲を見渡す。触手が溢れだすスキマからも、家具の影にも、気配はない。
PRINTFORMDW 泣きながら紡いだせいで震えている声に、平常心だと言える余地はどこにもありはしない――	PRINTFORMDW 泣きながら紡いだせいで震えている声に、平常心だと言える余地はどこにもありはしない――
PRINTFORML 「必要なものの一つは実績。例えば――事態を解決して、事後処理もちゃんとしてきたという。	PRINTFORML 「必要なものの一つは実績。例えば――事態を解決して、事後処理もちゃんとしてきたという。
PRINTFORMDW 自宅で、ぐったりと机に両腕を投げ出す紫の姿があった。相変わらず体は小さいままである。	PRINTFORMDW 自宅で、ぐったりと机に両腕を投げ出す紫の姿があった。相変わらず体は小さいままである。
PRINTFORMW 「結局、力も取り戻させなかったし……はぁ、もう寝る！　ここ数年してなかった冬眠をする！	PRINTFORMW 「結局、力も取り戻させなかったし……はぁ、もう寝る！　ここ数年してなかった冬眠をする！
PRINTFORMDW 霊夢の指摘する通り、その背格好はクイーンに力を吸われ弱体化していた頃のままだったが。	PRINTFORMDW 霊夢の指摘する通り、その背格好はクイーンに力を吸われ弱体化していた頃のままだったが。
PRINTFORML 「……わざわざ小さくなったサイズに合わせて用意する辺り、連中は完全に遊んでいるようね」	PRINTFORML 「……わざわざ小さくなったサイズに合わせて用意する辺り、連中は完全に遊んでいるようね」
PRINTFORMW （少しずつ力が抜け始めている……やはり、体を縮ませるだけで済ませる気はなかったようね）	PRINTFORMW （少しずつ力が抜け始めている……やはり、体を縮ませるだけで済ませる気はなかったようね）
PRINTFORMDW 紫は必死に嬌声が漏れるのを抑え込んでいるが、快楽に溺れた腰はかくかくと震えている……	PRINTFORMDW 紫は必死に嬌声が漏れるのを抑え込んでいるが、快楽に溺れた腰はかくかくと震えている……
PRINTFORMW 「外の世界でもそれほど流通していなかった覚えがあるのだけれど……なぜ落ちているのやら」	PRINTFORMW 「外の世界でもそれほど流通していなかった覚えがあるのだけれど……なぜ落ちているのやら」
PRINTFORMDW 膣を抉られ息をつまらせる紫に、娘はそう囁いて……触手のもう片方を自らの股間に当てた。	PRINTFORMDW 膣を抉られ息をつまらせる紫に、娘はそう囁いて……触手のもう片方を自らの股間に当てた。
PRINTFORMDW 未通の秘所へ、娘は自ら触手を押し込んでいく。我が子の行為を、しかし紫は止められない。	PRINTFORMDW 未通の秘所へ、娘は自ら触手を押し込んでいく。我が子の行為を、しかし紫は止められない。
PRINTFORMDW 霊夢に動かないよう警告した上で、即座に片付けるべく元凶を探り当て乗り込んだものの――	PRINTFORMDW 霊夢に動かないよう警告した上で、即座に片付けるべく元凶を探り当て乗り込んだものの――
PRINTFORMDW しかし脱出するまでの間にかなりの力を奪われた事も、紫自身の体にはっきりと現れている。	PRINTFORMDW しかし脱出するまでの間にかなりの力を奪われた事も、紫自身の体にはっきりと現れている。
PRINTFORMW 「橙さん、私にお任せあれ。母さまより受け継ぎし力なら、貴方を守る事など簡単ですので！」	PRINTFORMW 「橙さん、私にお任せあれ。母さまより受け継ぎし力なら、貴方を守る事など簡単ですので！」
PRINTFORMDW 紫はため息をつきながら自分の娘を真正面から見つめようとして、やはり視線をずらした。	PRINTFORMDW 紫はため息をつきながら自分の娘を真正面から見つめようとして、やはり視線をずらした。
PRINTFORMW 　一人だけここに残るから、戦力をかき集めた上で私を目印にして再度乗り込んで来なさい」	PRINTFORMW 　一人だけここに残るから、戦力をかき集めた上で私を目印にして再度乗り込んで来なさい」
PRINTFORMDW つまり、紫は弱体化した状態で、今まで以上の猛攻を耐えなくてはならないことになる――	PRINTFORMDW つまり、紫は弱体化した状態で、今まで以上の猛攻を耐えなくてはならないことになる――
PRINTFORMDW そうして、新たなるクイーンは外へと歩き出す。眷属たちを吐き出すスキマを開いたまま。	PRINTFORMDW そうして、新たなるクイーンは外へと歩き出す。眷属たちを吐き出すスキマを開いたまま。
PRINTFORMDW それこそかつてと同じままであるのは外見だけで、それすら変わっている部分が存在する。	PRINTFORMDW それこそかつてと同じままであるのは外見だけで、それすら変わっている部分が存在する。
PRINTFORMDW 自宅の机で、紙を前に小さく息をつく紫の姿があった。相変わらず体は小さいままである。	PRINTFORMDW 自宅の机で、紙を前に小さく息をつく紫の姿があった。相変わらず体は小さいままである。
PRINTFORMW 「私は私の考える策の準備をして、我が子にはそれを手伝ってもらっているだけよ。不満？」	PRINTFORMW 「私は私の考える策の準備をして、我が子にはそれを手伝ってもらっているだけよ。不満？」
PRINTFORMW 　貴方には八雲紫を継ぐ者としてその会合に出席してもらうわ。そちらの勉強もしないとね」	PRINTFORMW 　貴方には八雲紫を継ぐ者としてその会合に出席してもらうわ。そちらの勉強もしないとね」
PRINTFORMDW それは真っ直ぐにクイーンの身体を貫き、断末魔の悲鳴と共に、全ての触手を打ち砕いた。	PRINTFORMDW それは真っ直ぐにクイーンの身体を貫き、断末魔の悲鳴と共に、全ての触手を打ち砕いた。
PRINTFORMW 　……ま、どれだけ少なく見積もっても普通の土地に戻せるまで十年は掛かりそうだけれど」	PRINTFORMW 　……ま、どれだけ少なく見積もっても普通の土地に戻せるまで十年は掛かりそうだけれど」
PRINTFORMW 「そうかしら。ならばこういう私を広めるために、正義の魔法少女でもやってみましょうか！	PRINTFORMW 「そうかしら。ならばこういう私を広めるために、正義の魔法少女でもやってみましょうか！
PRINTFORMDW 紫は少し不機嫌そうな顔をしたものの、薬の件に関しては礼を言い、その場を立ち去った…	PRINTFORMDW 紫は少し不機嫌そうな顔をしたものの、薬の件に関しては礼を言い、その場を立ち去った…
PRINTFORMDW スキマを使い胎内の寄生体を握りしめた紫だったが、淫液を分泌され慌てて手を離した……	PRINTFORMDW スキマを使い胎内の寄生体を握りしめた紫だったが、淫液を分泌され慌てて手を離した……
PRINTFORMW 「剣は数百年近く使っていなかったけれど……これ程の業物を死蔵するわけにもいかないか」	PRINTFORMW 「剣は数百年近く使っていなかったけれど……これ程の業物を死蔵するわけにもいかないか」
PRINTFORMDW まるで完全に知り尽くしているように、紫が感じてしまう部分を肉棒が的確に責めていく。	PRINTFORMDW まるで完全に知り尽くしているように、紫が感じてしまう部分を肉棒が的確に責めていく。
PRINTFORMDW 聞き慣れた声が頭に染みこんでくる様子は、まるで自分自身が喘いでいるかのようだった。	PRINTFORMDW 聞き慣れた声が頭に染みこんでくる様子は、まるで自分自身が喘いでいるかのようだった。
PRINTFORMDW 一向に収まらない快感、一向に収まらない射精。紫は絶頂から戻れないまま喘ぐしかない。	PRINTFORMDW 一向に収まらない快感、一向に収まらない射精。紫は絶頂から戻れないまま喘ぐしかない。
PRINTFORMDW 紫は僅かに身じろぎしたものの、腰を振られるたびにその瞳から抵抗の意志が消えていく。	PRINTFORMDW 紫は僅かに身じろぎしたものの、腰を振られるたびにその瞳から抵抗の意志が消えていく。
PRINTFORMDW その言葉が合図だったかのように、紫は自分の娘の腹が膨らむほど大量の精液を射精した。	PRINTFORMDW その言葉が合図だったかのように、紫は自分の娘の腹が膨らむほど大量の精液を射精した。
PRINTFORMDW 開発され終わった彼女の体は、触手越しに伝わる娘の膣の感覚ですら感じてしまっていた。	PRINTFORMDW 開発され終わった彼女の体は、触手越しに伝わる娘の膣の感覚ですら感じてしまっていた。
PRINTFORMW 　だから、快楽は共有しています。そのうち記憶も、感情も、全て私と一緒になるんだから」	PRINTFORMW 　だから、快楽は共有しています。そのうち記憶も、感情も、全て私と一緒になるんだから」
PRINTFORMDW やがて疲れきったのか、母親の体に倒れかかる娘。……しかし、紫は全く反応を見せない。	PRINTFORMDW やがて疲れきったのか、母親の体に倒れかかる娘。……しかし、紫は全く反応を見せない。
PRINTFORMDW 娘が立ち上がると、紫だったものの体が床に飲み込まれ始めた。だが、娘は目もくれない。	PRINTFORMDW 娘が立ち上がると、紫だったものの体が床に飲み込まれ始めた。だが、娘は目もくれない。
PRINTFORMDW 顔を顰めながらため息を吐いた少女の身なりは、背丈こそ小さくても八雲紫のそれだった。	PRINTFORMDW 顔を顰めながらため息を吐いた少女の身なりは、背丈こそ小さくても八雲紫のそれだった。
PRINTFORMDW %CALLNAME:TARGET%は橙の手を握りながら腕をぶんぶんと振っている……	PRINTFORMDW %CALLNAME:TARGET%は橙の手を握りながら腕をぶんぶんと振っている……
PRINTFORMW 「ふ、ぅうっ――――――――！？　は、ぐっ……わらひっ、こんなこと、してたの……？」	PRINTFORMW 「ふ、ぅうっ――――――――！？　は、ぐっ……わらひっ、こんなこと、してたの……？」
PRINTFORMDW ため息を付いて、空間を指でなぞる。瞬間、開いたスキマから多種多様な人影が落ちた。	PRINTFORMDW ため息を付いて、空間を指でなぞる。瞬間、開いたスキマから多種多様な人影が落ちた。
PRINTFORMDW もはや放っておいても崩れ落ちるだろう状況の中、紫は敢えてその巨体へ向けて跳んだ。	PRINTFORMDW もはや放っておいても崩れ落ちるだろう状況の中、紫は敢えてその巨体へ向けて跳んだ。
PRINTFORMW 　クイーンから力を奪い返した時――クイーンはその本能と能力をも貴方に吸わせた――』	PRINTFORMW 　クイーンから力を奪い返した時――クイーンはその本能と能力をも貴方に吸わせた――』
PRINTFORMDW 悼むように目を閉じて、首を振る。呼吸はしているし、脈はある。ただ、それだけだが。	PRINTFORMDW 悼むように目を閉じて、首を振る。呼吸はしているし、脈はある。ただ、それだけだが。
PRINTFORMDW けれど……体も心も触手に汚染されきった霊夢の、どこに昔と同じ部分があるのだろう？	PRINTFORMDW けれど……体も心も触手に汚染されきった霊夢の、どこに昔と同じ部分があるのだろう？
PRINTFORMDW の顔を少しだけ見た紫は、茶を飲み干すと静かに立ち上がる。その顔は、能面のようだ。	PRINTFORMDW の顔を少しだけ見た紫は、茶を飲み干すと静かに立ち上がる。その顔は、能面のようだ。
PRINTFORMDW そう言って玄関の扉を盛大に開けた藍は、主が凄まじい目付きで自分を睨む様子を見た。	PRINTFORMDW そう言って玄関の扉を盛大に開けた藍は、主が凄まじい目付きで自分を睨む様子を見た。
PRINTFORMDW 紫は眉を顰めている霊夢をにこやかにスルーして、さらっと話を切り替えることにした。	PRINTFORMDW 紫は眉を顰めている霊夢をにこやかにスルーして、さらっと話を切り替えることにした。
PRINTFORML 「偶然で何度もこのサイズが来るわけがない。間違いなく、意図的に用意されている……」	PRINTFORML 「偶然で何度もこのサイズが来るわけがない。間違いなく、意図的に用意されている……」
PRINTFORMW 「あら、ちょうどいいところに迷い込んでくれたわ。足りない背丈の穴埋めにしましょう」	PRINTFORMW 「あら、ちょうどいいところに迷い込んでくれたわ。足りない背丈の穴埋めにしましょう」
PRINTFORMW 　最初の出産がこんな体で異形を産む、だなんて想像しなかったし……したくなかったわ」	PRINTFORMW 　最初の出産がこんな体で異形を産む、だなんて想像しなかったし……したくなかったわ」
PRINTFORMW 「……スキマが使える私はともかく、他の人妖は嵩張る物をどうやって運んでいるのやら」	PRINTFORMW 「……スキマが使える私はともかく、他の人妖は嵩張る物をどうやって運んでいるのやら」
PRINTFORMW 「体力を回復するためにも、普段以上に睡眠時間が欲しいけれど……向こうも想定済みか」	PRINTFORMW 「体力を回復するためにも、普段以上に睡眠時間が欲しいけれど……向こうも想定済みか」
PRINTFORMW 「おはようございます、母さま。どうですか？　もう動く気力も残ってないはずですけど」	PRINTFORMW 「おはようございます、母さま。どうですか？　もう動く気力も残ってないはずですけど」
PRINTFORMW 「ああ、母さまのが更におっきく……出しきりそうなんですね、なら出して下さい、全部！	PRINTFORMW 「ああ、母さまのが更におっきく……出しきりそうなんですね、なら出して下さい、全部！
PRINTFORMDW 互いに手を握りしめながら、親子二人は最高の快楽を貪り尽くし、全身を震わせ続けた。	PRINTFORMDW 互いに手を握りしめながら、親子二人は最高の快楽を貪り尽くし、全身を震わせ続けた。
PRINTFORMW 「おねがいっ、もうやめへっ……とまらないのっ、しゃせーとまらなくなるんれすぅっ♪」	PRINTFORMW 「おねがいっ、もうやめへっ……とまらないのっ、しゃせーとまらなくなるんれすぅっ♪」
PRINTFORMW 　もっとも……母さまが後を私に任せ、隠居なさっても困りはしませんけれど。ふふん♪」	PRINTFORMW 　もっとも……母さまが後を私に任せ、隠居なさっても困りはしませんけれど。ふふん♪」
PRINTFORMW 「頼りにしているのですね？　私を頼りにしているのですね？　ふふん、分かりました！」	PRINTFORMW 「頼りにしているのですね？　私を頼りにしているのですね？　ふふん、分かりました！」
PRINTFORMDW 娘の視界から消えようとする前に、一度だけ振り返った。互いに視線を合わせながら。	PRINTFORMDW 娘の視界から消えようとする前に、一度だけ振り返った。互いに視線を合わせながら。
PRINTFORMW 「……しょうがないわね。解決のためには、どんな手を使っても回復しておかなければ」	PRINTFORMW 「……しょうがないわね。解決のためには、どんな手を使っても回復しておかなければ」
PRINTFORMDW もはや疑う余地もない自分の言葉。こうしている間にも、触手たちが溢れ出している。	PRINTFORMDW もはや疑う余地もない自分の言葉。こうしている間にも、触手たちが溢れ出している。
PRINTFORMDW あれから数日。女王を失った魔物たちは、幻想郷の住人たちに容易く全滅させられた。	PRINTFORMDW あれから数日。女王を失った魔物たちは、幻想郷の住人たちに容易く全滅させられた。
PRINTFORMDW 首を振って呟いた言葉に、何の説得力もないことを紫は自覚した。するしかなかった。	PRINTFORMDW 首を振って呟いた言葉に、何の説得力もないことを紫は自覚した。するしかなかった。
PRINTFORMW 「やっと異変の後始末が終わったわ……霊夢は細かい後処理なんてぜんっぜんしないし！	PRINTFORMW 「やっと異変の後始末が終わったわ……霊夢は細かい後処理なんてぜんっぜんしないし！
PRINTFORMDW 紫が握っていたのは数秒だったが、掴まれていた触手は完全に乾き、朽ち果てていた。	PRINTFORMDW 紫が握っていたのは数秒だったが、掴まれていた触手は完全に乾き、朽ち果てていた。
PRINTFORMW 「今の私にぴっちりくるようじゃ、着ることのできる者は限られると思うのだけど……」	PRINTFORMW 「今の私にぴっちりくるようじゃ、着ることのできる者は限られると思うのだけど……」
PRINTFORMDW 紫はスキマを使って胎内から取り出した寄生体を摘み上げると、無造作に握り潰した。	PRINTFORMDW 紫はスキマを使って胎内から取り出した寄生体を摘み上げると、無造作に握り潰した。
PRINTFORMDW 紫は体を起こそうとしたものの、幼体に膣内を擦られる感覚で卒倒しかけてしまう……	PRINTFORMDW 紫は体を起こそうとしたものの、幼体に膣内を擦られる感覚で卒倒しかけてしまう……
PRINTFORMW 「どんな事が起きても気付かないほどぐっすり寝たい……できないと分かっているけど」	PRINTFORMW 「どんな事が起きても気付かないほどぐっすり寝たい……できないと分かっているけど」
PRINTFORMDW それが誰のモノかは考えるまでもなかった。彼女は、今自分自身に犯されている……！	PRINTFORMDW それが誰のモノかは考えるまでもなかった。彼女は、今自分自身に犯されている……！
PRINTFORMDW 僅かな痛みに少し涙を浮かべる娘と、あっという間に絶頂へ導かれ射精してしまう紫。	PRINTFORMDW 僅かな痛みに少し涙を浮かべる娘と、あっという間に絶頂へ導かれ射精してしまう紫。
PRINTFORMW 「気付いていますか、母さま？　射精を通じて、母さまの魂を吸い出しているんですよ？	PRINTFORMW 「気付いていますか、母さま？　射精を通じて、母さまの魂を吸い出しているんですよ？
PRINTFORMW 　私達が親子で、念入りに犯して前準備をしてきたからこそ出来る技ですねっ、ん――」	PRINTFORMW 　私達が親子で、念入りに犯して前準備をしてきたからこそ出来る技ですねっ、ん――」
PRINTFORMDW 二重に膣を犯される感触に考えすらも奪われ、気づけば紫は自ら腰を降り始めていた。	PRINTFORMDW 二重に膣を犯される感触に考えすらも奪われ、気づけば紫は自ら腰を降り始めていた。
PRINTFORMW （あぁ、きもちいい……こんな形じゃなく、自分で腰を動かして誰か犯したいっ……！）	PRINTFORMW （あぁ、きもちいい……こんな形じゃなく、自分で腰を動かして誰か犯したいっ……！）
PRINTFORMW 　体が縮んだ事に比べれば、こんなモノがあるくらい……大したことじゃ、ないわ……）	PRINTFORMW 　体が縮んだ事に比べれば、こんなモノがあるくらい……大したことじゃ、ないわ……）
PRINTFORMW %CALLNAME:1%さんを消耗させてしまったぶん、私の力をお貸ししましょう」	PRINTFORMW %CALLNAME:1%さんを消耗させてしまったぶん、私の力をお貸ししましょう」
PRINTFORMDW 八雲紫は完璧に手遅れで助かる方法はなく、その事実に怯える時間もないと理解し。	PRINTFORMDW 八雲紫は完璧に手遅れで助かる方法はなく、その事実に怯える時間もないと理解し。
PRINTFORMDW どこか呆れたような紫の笑みに、その娘は満足気に胸を張った笑みを返すのだった。	PRINTFORMDW どこか呆れたような紫の笑みに、その娘は満足気に胸を張った笑みを返すのだった。
PRINTFORMW 「当然です！　私は貴方の召使いになるために、女王を裏切ったのではありません！」	PRINTFORMW 「当然です！　私は貴方の召使いになるために、女王を裏切ったのではありません！」
PRINTFORMW 　私の千分の一も生きていない小娘が認められるには、それくらいは必要でしょう？」	PRINTFORMW 　私の千分の一も生きていない小娘が認められるには、それくらいは必要でしょう？」
PRINTFORMW 　生き残りの始末とか入り口の封印とか、あの子は想像もしないんでしょうけど……」	PRINTFORMW 　生き残りの始末とか入り口の封印とか、あの子は想像もしないんでしょうけど……」
PRINTFORMW 　あれだけ広い空間を放置しておくのも危険だし、それ以上にもったいないでしょう。	PRINTFORMW 　あれだけ広い空間を放置しておくのも危険だし、それ以上にもったいないでしょう。
PRINTFORMW 「……そのうちどうなるか馬鹿でもわかるけれど、庇う余裕の有無も馬鹿でもわかる」	PRINTFORMW 「……そのうちどうなるか馬鹿でもわかるけれど、庇う余裕の有無も馬鹿でもわかる」
PRINTFORMW 「手がないわけではないけれど……一歩間違えばこの手が大惨事になりかねないわね」	PRINTFORMW 「手がないわけではないけれど……一歩間違えばこの手が大惨事になりかねないわね」
PRINTFORMDW 嬌声が漏れないよう口を閉ざすのが精一杯の紫に、自分と同じ声が更に響いてくる。	PRINTFORMDW 嬌声が漏れないよう口を閉ざすのが精一杯の紫に、自分と同じ声が更に響いてくる。
PRINTFORMDW 衰えた竿が引き抜かれていく感触に、紫は幼く高い声を使って愛らしく媚びていた。	PRINTFORMDW 衰えた竿が引き抜かれていく感触に、紫は幼く高い声を使って愛らしく媚びていた。
PRINTFORMDW まともに思考すら出来ない自らの母親に、娘は互いの手を絡ませながら問いかける。	PRINTFORMDW まともに思考すら出来ない自らの母親に、娘は互いの手を絡ませながら問いかける。
PRINTFORMW 　言ったでしょう、全てを貰うって。記憶も、感情も、全て私と一緒になるんだから」	PRINTFORMW 　言ったでしょう、全てを貰うって。記憶も、感情も、全て私と一緒になるんだから」
PRINTFORMDW そう言って、娘は紫に熱いキスをした。まるで口から捕食するようなディープキス。	PRINTFORMDW そう言って、娘は紫に熱いキスをした。まるで口から捕食するようなディープキス。
PRINTFORMW 「気付いていますか、母さま？　この触手は、私と母さまの魂を繋げているんですよ？	PRINTFORMW 「気付いていますか、母さま？　この触手は、私と母さまの魂を繋げているんですよ？
PRINTFORMDL 紫口上オープニング短縮版を見ますか？（見ない場合、素質変化処理のみ行います）	PRINTFORMDL 紫口上オープニング短縮版を見ますか？（見ない場合、素質変化処理のみ行います）
PRINTFORMW 「転移させて救出するには敵の拘束が強すぎる……なら、弱めればいいだけの話よ」	PRINTFORMW 「転移させて救出するには敵の拘束が強すぎる……なら、弱めればいいだけの話よ」
PRINTFORMDW だが、同時に出口も閉じ始め――それを見た紫は即座に自分の娘へと向き直った。	PRINTFORMDW だが、同時に出口も閉じ始め――それを見た紫は即座に自分の娘へと向き直った。
PRINTFORMW 　だから私は外に出て仲間を集め、外から挑めと……そういう話だと思いましたが」	PRINTFORMW 　だから私は外に出て仲間を集め、外から挑めと……そういう話だと思いましたが」
PRINTFORMW 　血の繋がりがある私達なら障害があろうとも連絡を取り合えると……その程度よ」	PRINTFORMW 　血の繋がりがある私達なら障害があろうとも連絡を取り合えると……その程度よ」
PRINTFORMW 「お馬鹿。空間の歪みからして、恐らく私達が脱出した後に迷宮ごと転移する気よ。	PRINTFORMW 「お馬鹿。空間の歪みからして、恐らく私達が脱出した後に迷宮ごと転移する気よ。
PRINTFORMW （……散々犯されてきた私の体は、クイーンの本能とやらにあっさり馴染んだと？）	PRINTFORMW （……散々犯されてきた私の体は、クイーンの本能とやらにあっさり馴染んだと？）
PRINTFORMW この会話が文字通りの自問自答であることを確かめるべく、言葉を口に出さず返す。	PRINTFORMW この会話が文字通りの自問自答であることを確かめるべく、言葉を口に出さず返す。
PRINTFORMW 「何を馬鹿な。博麗の巫女なんて……代わりを、見つければいい、だけなのだから」	PRINTFORMW 「何を馬鹿な。博麗の巫女なんて……代わりを、見つければいい、だけなのだから」
PRINTFORMW 「見ましたか、母さま！　この私があのクィーンを倒しました！　私が！　私が！」	PRINTFORMW 「見ましたか、母さま！　この私があのクィーンを倒しました！　私が！　私が！」
PRINTFORMW 「私と貴方が持つ力の境界――最期に、あるべき姿に戻させてもらいましょうか！」	PRINTFORMW 「私と貴方が持つ力の境界――最期に、あるべき姿に戻させてもらいましょうか！」
PRINTFORMDW 言葉とは裏腹に、紫の表情はまるで次を待ち焦がれるかのように蕩け切っている。	PRINTFORMDW 言葉とは裏腹に、紫の表情はまるで次を待ち焦がれるかのように蕩け切っている。
PRINTFORMW 「あ、あのねぇ……いくらなんでも、こんな体の私から吸おうとか血迷いすぎよ？」	PRINTFORMW 「あ、あのねぇ……いくらなんでも、こんな体の私から吸おうとか血迷いすぎよ？」
PRINTFORMW 「はぁっ、はぁっ……！　こうなる、前に、子作りを経験しておくべきだった……」	PRINTFORMW 「はぁっ、はぁっ……！　こうなる、前に、子作りを経験しておくべきだった……」
PRINTFORMW 　そんな都合のよいタイミングで落とす者が、そうそういるとは思えないわね……）	PRINTFORMW 　そんな都合のよいタイミングで落とす者が、そうそういるとは思えないわね……）
PRINTFORMW 「こういう状態だし、非常にありがたいわね。これがどこから来たのかはともかく」	PRINTFORMW 「こういう状態だし、非常にありがたいわね。これがどこから来たのかはともかく」
PRINTFORMDW ドッペルゲンガーと紫の表情に違いがあるとすれば、従う側と従わせる側の違い。	PRINTFORMDW ドッペルゲンガーと紫の表情に違いがあるとすれば、従う側と従わせる側の違い。
PRINTFORMW 「ねぇ母さま。私、母さまのこと大好きなんですよ？　はじめてをあげたいくらい」	PRINTFORMW 「ねぇ母さま。私、母さまのこと大好きなんですよ？　はじめてをあげたいくらい」
PRINTFORMDW 既に勃起しきっていた紫の竿を、彼女から生まれた娘の膣が容赦なく飲み込んだ。	PRINTFORMDW 既に勃起しきっていた紫の竿を、彼女から生まれた娘の膣が容赦なく飲み込んだ。
PRINTFORM 　精液は精液ですから、私、妊娠しちゃうかもしれないけど……母さまなら、いいです	PRINTFORM 　精液は精液ですから、私、妊娠しちゃうかもしれないけど……母さまなら、いいです
PRINTFORMDW 精液を吐き出すたびに考えすらも奪われ、気づけば紫は自ら腰を降り始めていた。	PRINTFORMDW 精液を吐き出すたびに考えすらも奪われ、気づけば紫は自ら腰を降り始めていた。
PRINTFORMDW 一向に収まらない快感は、まるで二重に膣内への愛撫を受けているかのようで……	PRINTFORMDW 一向に収まらない快感は、まるで二重に膣内への愛撫を受けているかのようで……
PRINTFORMW 「そう、そうです母さま！　私と心を一つにして、気持ちいいことに溺れて下さい！	PRINTFORMW 「そう、そうです母さま！　私と心を一つにして、気持ちいいことに溺れて下さい！
PRINTFORMW %CALLNAME:1%さんがどこまでやれるのか、拝見させてもらいましょう」	PRINTFORMW %CALLNAME:1%さんがどこまでやれるのか、拝見させてもらいましょう」
PRINTFORMW 「外の世界では『首おいてけ』なる妖怪が大人気とか……真似してみましょうか」	PRINTFORMW 「外の世界では『首おいてけ』なる妖怪が大人気とか……真似してみましょうか」
PRINTFORMW （我慢できない、戦えないから処理してもらう……それだけ、それだけ、よ……）	PRINTFORMW （我慢できない、戦えないから処理してもらう……それだけ、それだけ、よ……）
PRINTFORMDW にこやかに笑う娘だったが、その返事を聞いた紫は対照的にむっとした表情だ。	PRINTFORMDW にこやかに笑う娘だったが、その返事を聞いた紫は対照的にむっとした表情だ。
PRINTFORMW 「理解していますよ。母さまは目印としてこの迷宮に残るつもりだったのでしょ？	PRINTFORMW 「理解していますよ。母さまは目印としてこの迷宮に残るつもりだったのでしょ？
PRINTFORMDW ひときわ強くなった断末魔を共に触手は、そしてクイーンの本体は朽ちていく。	PRINTFORMDW ひときわ強くなった断末魔を共に触手は、そしてクイーンの本体は朽ちていく。
PRINTFORMW 『わからないの？　私は貴方自身。クイーンとしての使命を継いだ貴方自身……』	PRINTFORMW 『わからないの？　私は貴方自身。クイーンとしての使命を継いだ貴方自身……』
PRINTFORMDW 紫の行動を見たクイーンは、自らその体の中核を切り落とすという暴挙に出た。	PRINTFORMDW 紫の行動を見たクイーンは、自らその体の中核を切り落とすという暴挙に出た。
PRINTFORMDW 母親の思考がうっすら読めた彼女は、この会話から嫌なものを感じ取っている。	PRINTFORMDW 母親の思考がうっすら読めた彼女は、この会話から嫌なものを感じ取っている。
PRINTFORML 「一度くらいならたまたま小さくなった時用の服が入ってくるかもしれないわね。	PRINTFORML 「一度くらいならたまたま小さくなった時用の服が入ってくるかもしれないわね。
PRINTFORMW 「……放っておいたら、幻想郷の住人がすり替えられるのは目に見えているわね」	PRINTFORMW 「……放っておいたら、幻想郷の住人がすり替えられるのは目に見えているわね」
PRINTFORMW 　再生させられた偽りの純潔が散らされたところで……私に影響があるとでも！」	PRINTFORMW 　再生させられた偽りの純潔が散らされたところで……私に影響があるとでも！」
PRINTFORMDW 唇を噛み締めている紫の言葉が強がりであるのは、誰の目にも明らかだった……	PRINTFORMDW 唇を噛み締めている紫の言葉が強がりであるのは、誰の目にも明らかだった……
PRINTFORMW 「しゃきっとしなさい。自分より小さい主に会うのは、初めてではないでしょう」	PRINTFORMW 「しゃきっとしなさい。自分より小さい主に会うのは、初めてではないでしょう」
PRINTFORMDL 寄生の治療を試みますか？（この選択肢が出るタイミングはこの段階のみです）	PRINTFORMDL 寄生の治療を試みますか？（この選択肢が出るタイミングはこの段階のみです）
PRINTFORMW 「どうも、迷宮に迷い込んだ者を把握した上で置いてある気がするのよねぇ……」	PRINTFORMW 「どうも、迷宮に迷い込んだ者を把握した上で置いてある気がするのよねぇ……」
PRINTFORMW 「毒薬は口に苦けれども病に利あり……どんな作用で意識を取り戻させるのやら」	PRINTFORMW 「毒薬は口に苦けれども病に利あり……どんな作用で意識を取り戻させるのやら」
PRINTFORMW 「適度な睡眠時間は健康の秘訣――などと茶化せるような睡魔ではないわね……」	PRINTFORMW 「適度な睡眠時間は健康の秘訣――などと茶化せるような睡魔ではないわね……」
PRINTFORMW 「前より体が軽くなっているのは、あくまで物理的な重量の話だけだというのに」	PRINTFORMW 「前より体が軽くなっているのは、あくまで物理的な重量の話だけだというのに」
PRINTFORMW 「こういう場所がある以上は、外との繋がりもどこかにあると思いたいわね……」	PRINTFORMW 「こういう場所がある以上は、外との繋がりもどこかにあると思いたいわね……」
PRINTFORMW 「少なくともこういう場所がある以上、外との繋がりもどこかにあるでしょうね」	PRINTFORMW 「少なくともこういう場所がある以上、外との繋がりもどこかにあるでしょうね」
PRINTFORMDW 力を吸い尽くされ、意識を失っていた紫はひんやりとした感覚で目を覚ました。	PRINTFORMDW 力を吸い尽くされ、意識を失っていた紫はひんやりとした感覚で目を覚ました。
PRINTFORM 『ほら、気持ちいいでしょう？　気持ちいいわよね？　だって、ここ弱いんだものぉ	PRINTFORM 『ほら、気持ちいいでしょう？　気持ちいいわよね？　だって、ここ弱いんだものぉ
PRINTFORMDW すりすりと鈴口を自分の膣に合わせながら、娘はゆっくりと腰を下ろしていく。	PRINTFORMDW すりすりと鈴口を自分の膣に合わせながら、娘はゆっくりと腰を下ろしていく。
PRINTFORMDW 僅かな痛みに少し涙を浮かべる娘と、あっという間に絶頂へ導かれてしまう紫。	PRINTFORMDW 僅かな痛みに少し涙を浮かべる娘と、あっという間に絶頂へ導かれてしまう紫。
PRINTFORMW 母さまの恥ずかしい失敗談をご存知ならば、是非ともお聞きしたいところです♪」	PRINTFORMW 母さまの恥ずかしい失敗談をご存知ならば、是非ともお聞きしたいところです♪」
PRINTFORMW 「スキマを使って逃げようにも、相手とくっついたままじゃ意味がない……！」	PRINTFORMW 「スキマを使って逃げようにも、相手とくっついたままじゃ意味がない……！」
PRINTFORMW 「再生した処女を処女と呼べるかは疑問だけれど、渡してあげる義理もないわ」	PRINTFORMW 「再生した処女を処女と呼べるかは疑問だけれど、渡してあげる義理もないわ」
PRINTFORMW 　このまま無為に脱出すれば迷宮を見失い、また１からやり直すハメになるわ」	PRINTFORMW 　このまま無為に脱出すれば迷宮を見失い、また１からやり直すハメになるわ」
PRINTFORMDW 「しかし、そのお体では危険です。私と紫様の立場を逆にするべきでは……」	PRINTFORMDW 「しかし、そのお体では危険です。私と紫様の立場を逆にするべきでは……」
PRINTFORMDW 紫が唾を飲んだ音で、小さく喉が鳴る。実際の所、紫にはあまり余裕がない。	PRINTFORMDW 紫が唾を飲んだ音で、小さく喉が鳴る。実際の所、紫にはあまり余裕がない。
PRINTFORMDW 紫たちが脱出してから、半月後。紫は険しい顔で幻想郷の空に浮かんでいた。	PRINTFORMDW 紫たちが脱出してから、半月後。紫は険しい顔で幻想郷の空に浮かんでいた。
PRINTFORMDW そして、紫の姿は依然として小さいまま――つまり、何一つ解決していない。	PRINTFORMDW そして、紫の姿は依然として小さいまま――つまり、何一つ解決していない。
PRINTFORMW 「何を馬鹿なことを……クイーンは倒したわ、私自身の力も取り返した上で！」	PRINTFORMW 「何を馬鹿なことを……クイーンは倒したわ、私自身の力も取り返した上で！」
PRINTFORMDW 霊夢の「今」の境界を変え、「昔」に戻す――治すとすれば、それしかない。	PRINTFORMDW 霊夢の「今」の境界を変え、「昔」に戻す――治すとすれば、それしかない。
PRINTFORMDW 女王が自害したのは、霊夢と紫の状態をよくわかっていたからに違いない……	PRINTFORMDW 女王が自害したのは、霊夢と紫の状態をよくわかっていたからに違いない……
PRINTFORMW 「む、むりっ、慣れてないの、この体じゃぜんぜんしてないの、だからぁ！？」	PRINTFORMW 「む、むりっ、慣れてないの、この体じゃぜんぜんしてないの、だからぁ！？」
PRINTFORMW 「仕留めたところで、代わりの服の素材にはならないでしょうね……まったく」	PRINTFORMW 「仕留めたところで、代わりの服の素材にはならないでしょうね……まったく」
PRINTFORML 「体に合わせてこんなものを用意しておく辺り、大した趣向の持ち主だわ……」	PRINTFORML 「体に合わせてこんなものを用意しておく辺り、大した趣向の持ち主だわ……」
PRINTFORMW 「何度も見過ごしたら友人失格よね……幽々子は覚えていないでしょうけれど」	PRINTFORMW 「何度も見過ごしたら友人失格よね……幽々子は覚えていないでしょうけれど」
PRINTFORMW 　……もともと、再生させられた偽りの純潔。気にするほうが、おかしい……」	PRINTFORMW 　……もともと、再生させられた偽りの純潔。気にするほうが、おかしい……」
PRINTFORMW （ちっ、もう胸は膨らんでいたか……虚仮｛こけ｝にしてやろうと思ったのに）	PRINTFORMW （ちっ、もう胸は膨らんでいたか……虚仮｛こけ｝にしてやろうと思ったのに）
PRINTFORMW 「……助かったわ。体が縮んだまま元に戻れないくらい、追い込まれていたし」	PRINTFORMW 「……助かったわ。体が縮んだまま元に戻れないくらい、追い込まれていたし」
PRINTFORMW 「だめ……だわ、もしズレたら大変なことになるのに……集中が乱れたら……」	PRINTFORMW 「だめ……だわ、もしズレたら大変なことになるのに……集中が乱れたら……」
PRINTFORMW 「……不本意だけれど、このような状態では結界が十全かどうか自信がないわ」	PRINTFORMW 「……不本意だけれど、このような状態では結界が十全かどうか自信がないわ」
PRINTFORM 「結界の強度は問題ない……はずよ。そんな失敗するほど、弱っていないわ……」	PRINTFORM 「結界の強度は問題ない……はずよ。そんな失敗するほど、弱っていないわ……」
PRINTFORM 「結界が破られる心配はないから安心していいわよ？　そこまで弱っていないわ」	PRINTFORM 「結界が破られる心配はないから安心していいわよ？　そこまで弱っていないわ」
PRINTFORMW 「……一時の安全は確保できたとはいえ、危険な状況であるのは変わらないか」	PRINTFORMW 「……一時の安全は確保できたとはいえ、危険な状況であるのは変わらないか」
PRINTFORMDW 一度言ってしまった以上は我慢する必要はないと、そんな誤認をしてしまう。	PRINTFORMDW 一度言ってしまった以上は我慢する必要はないと、そんな誤認をしてしまう。
PRINTFORMDW 仰向けになって股を開く紫の瞳に、かつてのような意志が宿ることは、ない。	PRINTFORMDW 仰向けになって股を開く紫の瞳に、かつてのような意志が宿ることは、ない。
PRINTFORMDW もっとも……脱出することは不可能ではなかったし、事実こうして成功した。	PRINTFORMDW もっとも……脱出することは不可能ではなかったし、事実こうして成功した。
PRINTFORMW 「まったく、どこぞの異界から来た邪神か、遠い星の海に住む異種かしら……」	PRINTFORMW 「まったく、どこぞの異界から来た邪神か、遠い星の海に住む異種かしら……」
PRINTFORMW 「貴方が今の私より強いのは認めます。経験を積み、研鑽して越えますから！」	PRINTFORMW 「貴方が今の私より強いのは認めます。経験を積み、研鑽して越えますから！」
PRINTFORM 「ひぁ、あんっ、うあぁぁぁぁっ……！　はぁ、あ……き、切り替え、ないと……	PRINTFORM 「ひぁ、あんっ、うあぁぁぁぁっ……！　はぁ、あ……き、切り替え、ないと……
PRINTFORMW 「こんな戦い方をするからには、殺されても文句は言わないでしょうねぇ？」	PRINTFORMW 「こんな戦い方をするからには、殺されても文句は言わないでしょうねぇ？」
PRINTFORMW 「姿形は似ていても、私と貴方には決定的な違いがあるの。あいにくだけど」	PRINTFORMW 「姿形は似ていても、私と貴方には決定的な違いがあるの。あいにくだけど」
PRINTFORMW 「霊夢、私の声が耳に届いているでしょう！？　もうしばらく堪えなさい！」	PRINTFORMW 「霊夢、私の声が耳に届いているでしょう！？　もうしばらく堪えなさい！」
PRINTFORMDW だが、同時に出口も閉じ始め――それを見た紫は即座に藍へと向き直った。	PRINTFORMDW だが、同時に出口も閉じ始め――それを見た紫は即座に藍へと向き直った。
PRINTFORMDW 新しく生まれ変わった八雲紫が、かつて八雲紫だったモノの残滓を嘲笑う。	PRINTFORMDW 新しく生まれ変わった八雲紫が、かつて八雲紫だったモノの残滓を嘲笑う。
PRINTFORMDW は残りの力を振り絞り、満身創痍のクイーンへ向け、特大の弾幕を放った！	PRINTFORMDW は残りの力を振り絞り、満身創痍のクイーンへ向け、特大の弾幕を放った！
PRINTFORMDW 同様に朽ちていくクイーン本体を見上げ、紫は満足気にため息をついた――	PRINTFORMDW 同様に朽ちていくクイーン本体を見上げ、紫は満足気にため息をついた――
PRINTFORMW 「取り戻した力を還元せずに、あの迷宮の封印と中の整理に回しているもの。	PRINTFORMW 「取り戻した力を還元せずに、あの迷宮の封印と中の整理に回しているもの。
PRINTFORML 「ざん、ねぇんっ……♪　そっちの思い通りには、ならない、のよぉ……♪」	PRINTFORML 「ざん、ねぇんっ……♪　そっちの思い通りには、ならない、のよぉ……♪」
PRINTFORMW 「はぁ、霊夢が来る前に片付けたかったのに……やはり乗り込んできたのね」	PRINTFORMW 「はぁ、霊夢が来る前に片付けたかったのに……やはり乗り込んできたのね」
PRINTFORMW 「あの経験はあまり思い出したくないわね……また体験させられるのだけど」	PRINTFORMW 「あの経験はあまり思い出したくないわね……また体験させられるのだけど」
PRINTFORMW 「普通なら堕胎なんて簡単にできるのだけどね……中にいるものが普通なら」	PRINTFORMW 「普通なら堕胎なんて簡単にできるのだけどね……中にいるものが普通なら」
PRINTFORMW 「今の状況ならば、使える物はできるだけ使いこなしたい……けどねぇ……」	PRINTFORMW 「今の状況ならば、使える物はできるだけ使いこなしたい……けどねぇ……」
PRINTFORMW 「まぁ、サイズが大きすぎることはあっても小さすぎることはないでしょう」	PRINTFORMW 「まぁ、サイズが大きすぎることはあっても小さすぎることはないでしょう」
PRINTFORMW （結界は無事に起動しているけれど、肝心の私が寝たら意味が無いわね……）	PRINTFORMW （結界は無事に起動しているけれど、肝心の私が寝たら意味が無いわね……）
PRINTFORMW 「いくら安全とはいえ、一人で結界に篭っていても事態は進展しないか……」	PRINTFORMW 「いくら安全とはいえ、一人で結界に篭っていても事態は進展しないか……」
PRINTFORMW 「速度を得るよりも先に、体を癒したいというのが正直なところだけど……」	PRINTFORMW 「速度を得るよりも先に、体を癒したいというのが正直なところだけど……」
PRINTFORMW 「残念だけど、これだけじゃ落とし主が無事かどうかも分からないわね……」	PRINTFORMW 「残念だけど、これだけじゃ落とし主が無事かどうかも分からないわね……」
PRINTFORMW （っ！？　頭を、冷やさないとっ……同じミスを繰り返さないためにも……）	PRINTFORMW （っ！？　頭を、冷やさないとっ……同じミスを繰り返さないためにも……）
PRINTFORMDW 小さな体を震わせ、自分の精液が膣内に注がれていく快楽に溺れていく……	PRINTFORMDW 小さな体を震わせ、自分の精液が膣内に注がれていく快楽に溺れていく……
PRINTFORMDW まるで人形のように、四肢をだらんと弛緩させる紫を見て……娘は悦んだ。	PRINTFORMDW まるで人形のように、四肢をだらんと弛緩させる紫を見て……娘は悦んだ。
PRINTFORMDW その、恍惚とした表情。なぜなら、愛する母の全てを手に入れたのだから。	PRINTFORMDW その、恍惚とした表情。なぜなら、愛する母の全てを手に入れたのだから。
PRINTFORMDW 元の姿に戻すことも可能だが、今は少しでも力を節約しておきたい状況だ。	PRINTFORMDW 元の姿に戻すことも可能だが、今は少しでも力を節約しておきたい状況だ。
PRINTFORMW 「あいにく、母さまから受け継いだ力があれば近づく必要なんてないのです」	PRINTFORMW 「あいにく、母さまから受け継いだ力があれば近づく必要なんてないのです」
PRINTFORMW 「申し訳ありませんが、くんずほぐれつの流儀でお応えするのはやめました」	PRINTFORMW 「申し訳ありませんが、くんずほぐれつの流儀でお応えするのはやめました」
PRINTFORMW 「一度は不覚を取りましたが、その件だけで私の力を計られては困ります！」	PRINTFORMW 「一度は不覚を取りましたが、その件だけで私の力を計られては困ります！」
PRINTFORMDW そう言って、嫌味な娘は光量が減っていく出口を得意げに指さしている。	PRINTFORMDW そう言って、嫌味な娘は光量が減っていく出口を得意げに指さしている。
PRINTFORMW 「貴方に吸われていた分の力――最期に返していってもらいましょうか！」	PRINTFORMW 「貴方に吸われていた分の力――最期に返していってもらいましょうか！」
PRINTFORMDW もはや運命が定まった相手に、紫は小さく笑みを浮かべ悠然と宣言した。	PRINTFORMDW もはや運命が定まった相手に、紫は小さく笑みを浮かべ悠然と宣言した。
PRINTFORMW 『もっとも、触手に親和性のない相手ではうまくいかないのだけれど……』	PRINTFORMW 『もっとも、触手に親和性のない相手ではうまくいかないのだけれど……』
PRINTFORMW 『体だけで済むとでも？　精神もよ、もちろんね……理解できたかしら？』	PRINTFORMW 『体だけで済むとでも？　精神もよ、もちろんね……理解できたかしら？』
PRINTFORMDW ピシリと何かがひび割れる音が走り、女王の体が真っ二つに折れ始める。	PRINTFORMDW ピシリと何かがひび割れる音が走り、女王の体が真っ二つに折れ始める。
PRINTFORMW 「それはいいんだけどさ、紫。なんであんた、まだちっこいままなわけ？」	PRINTFORMW 「それはいいんだけどさ、紫。なんであんた、まだちっこいままなわけ？」
PRINTFORMW 「体が、重……けどしょうがないのよ、あのままじゃ戦えなかったし……」	PRINTFORMW 「体が、重……けどしょうがないのよ、あのままじゃ戦えなかったし……」
PRINTFORMW 「今の私にとって丈が短いスカートねぇ……誰ならまともに履けるのやら」	PRINTFORMW 「今の私にとって丈が短いスカートねぇ……誰ならまともに履けるのやら」
PRINTFORMW 「……手遅れだったと言うべきか、最悪の事態は避けられたと言うべきか」	PRINTFORMW 「……手遅れだったと言うべきか、最悪の事態は避けられたと言うべきか」
PRINTFORMW 「あら……こんなになった私よりも小さいのね。どことは言わないけれど」	PRINTFORMW 「あら……こんなになった私よりも小さいのね。どことは言わないけれど」
PRINTFORMW 「……生涯の千分の一にすら満たない時期に、随分と子供が増えるものね」	PRINTFORMW 「……生涯の千分の一にすら満たない時期に、随分と子供が増えるものね」
PRINTFORMW 「地蔵は人に代わって苦しみを受けるもの……なら、人形はどうかしらね」	PRINTFORMW 「地蔵は人に代わって苦しみを受けるもの……なら、人形はどうかしらね」
PRINTFORMW （陣を結ぶのに使った僅かな力すら、惜しく感じてしまうのが現状ね……）	PRINTFORMW （陣を結ぶのに使った僅かな力すら、惜しく感じてしまうのが現状ね……）
PRINTFORM （っ！？　頭を、冷やさないとっ……同じミスを繰り返さないためにもぉ……	PRINTFORM （っ！？　頭を、冷やさないとっ……同じミスを繰り返さないためにもぉ……
PRINTFORMW 「できれば、落とし主とも合流したいところだけど……手がかりはないか」	PRINTFORMW 「できれば、落とし主とも合流したいところだけど……手がかりはないか」
PRINTFORMDW 今の彼女が浮かべる表情は、ドッペルゲンガーのそれとほとんど同じだ。	PRINTFORMDW 今の彼女が浮かべる表情は、ドッペルゲンガーのそれとほとんど同じだ。
PRINTFORMDW だが、娘はその痛みに嬉しそうな表情を浮かべ、腰をぐりぐりと回した。	PRINTFORMDW だが、娘はその痛みに嬉しそうな表情を浮かべ、腰をぐりぐりと回した。
PRINTFORMW 「力を奪われた母さまには、スキマ妖怪である私に抗う術はありませんね？	PRINTFORMW 「力を奪われた母さまには、スキマ妖怪である私に抗う術はありませんね？
PRINTFORM 　私は私と母さまの境界をなくして、母さまを魂から私のモノにしたいんです	PRINTFORM 　私は私と母さまの境界をなくして、母さまを魂から私のモノにしたいんです
PRINTFORMW 「本当に、射精して……私のからだ、どんどん作り変えられてるっ……！」	PRINTFORMW 「本当に、射精して……私のからだ、どんどん作り変えられてるっ……！」
PRINTFORMW 「む、そこにいる猫は藍さんの式神だという子と外見的特徴が一致します。	PRINTFORMW 「む、そこにいる猫は藍さんの式神だという子と外見的特徴が一致します。
PRINTFORMW 　万全に力を振るう事ができれば……女王以外に負けはしませんから、私」	PRINTFORMW 　万全に力を振るう事ができれば……女王以外に負けはしませんから、私」
PRINTFORMW 「…………もしかして、かなりいけないことをしてしまったんでしょうか」	PRINTFORMW 「…………もしかして、かなりいけないことをしてしまったんでしょうか」
PRINTFORMW 「幻想郷のルールなんて知らないでしょう？　身を以って教えてあげる」	PRINTFORMW 「幻想郷のルールなんて知らないでしょう？　身を以って教えてあげる」
PRINTFORMW 「早くその子を離しなさい。今なら八つ裂きにするだけで許してあげる」	PRINTFORMW 「早くその子を離しなさい。今なら八つ裂きにするだけで許してあげる」
PRINTFORMW 「神隠しは私の本分……緊急事態なのだし、少しくらいはいいでしょう」	PRINTFORMW 「神隠しは私の本分……緊急事態なのだし、少しくらいはいいでしょう」
PRINTFORMDW ぴしりと何かひび割れる音が走り、女王の体が真っ二つに折れ始める。	PRINTFORMDW ぴしりと何かひび割れる音が走り、女王の体が真っ二つに折れ始める。
PRINTFORMW 『動ける間に自分で始末を付けようと考えるのは、素敵な覚悟だけれど。	PRINTFORMW 『動ける間に自分で始末を付けようと考えるのは、素敵な覚悟だけれど。
PRINTFORMW 　そもそも、貴方の知る私はわざわざ計画を実行前に教えるのかしら？」	PRINTFORMW 　そもそも、貴方の知る私はわざわざ計画を実行前に教えるのかしら？」
PRINTFORMW 　色々とお困りの是非曲直庁に対する取引に使うつもりだけれど……ね）	PRINTFORMW 　色々とお困りの是非曲直庁に対する取引に使うつもりだけれど……ね）
PRINTFORML コンセプトの都合上、開始時に能力が必ず変動しますのでご注意下さい。	PRINTFORML コンセプトの都合上、開始時に能力が必ず変動しますのでご注意下さい。
PRINTFORMW 「お、おっきしゅぎるっ、だめっ、そんなのなかにはいらないぃっ！？」	PRINTFORMW 「お、おっきしゅぎるっ、だめっ、そんなのなかにはいらないぃっ！？」
PRINTFORMW 「しょうがないけど、大きいわね……力のある衣服のようだし着るけど」	PRINTFORMW 「しょうがないけど、大きいわね……力のある衣服のようだし着るけど」
PRINTFORMW 『はじめまして、母さま。申し訳ありませんが――やらせてもらいます』	PRINTFORMW 『はじめまして、母さま。申し訳ありませんが――やらせてもらいます』
PRINTFORMDW 紫は慌てて姿勢を整えようとしたが、足が耐え切れずに手をついた……	PRINTFORMDW 紫は慌てて姿勢を整えようとしたが、足が耐え切れずに手をついた……
PRINTFORMW 「こちらも余裕が無い……なんて、今さら過ぎて言い訳にならないわね」	PRINTFORMW 「こちらも余裕が無い……なんて、今さら過ぎて言い訳にならないわね」
PRINTFORMW 「そう？　それならそれで、一人でなんとかする手段を考えましょうか」	PRINTFORMW 「そう？　それならそれで、一人でなんとかする手段を考えましょうか」
PRINTFORMW 「前に考えたような手は……胎内から弄られたでしょうし、もう無理ね」	PRINTFORMW 「前に考えたような手は……胎内から弄られたでしょうし、もう無理ね」
PRINTFORMW 「……無理に堕ろそうとすれば、私が壊れるだけか。相手が相手だもの」	PRINTFORMW 「……無理に堕ろそうとすれば、私が壊れるだけか。相手が相手だもの」
PRINTFORMW （胎内まで連中の住処になって……こんな体、元に戻せるのかしら……）	PRINTFORMW （胎内まで連中の住処になって……こんな体、元に戻せるのかしら……）
PRINTFORMW 「蹲っているだけでは、あぐっ、なにも、変わらない……準備、を……」	PRINTFORMW 「蹲っているだけでは、あぐっ、なにも、変わらない……準備、を……」
PRINTFORMW 「は、はやくっ、でていって……な、なか、ごりごり、しないでぇっ！」	PRINTFORMW 「は、はやくっ、でていって……な、なか、ごりごり、しないでぇっ！」
PRINTFORMW （いけない……気を抜くと、疲労と眠気で丸一日くらい寝てしまいそう）	PRINTFORMW （いけない……気を抜くと、疲労と眠気で丸一日くらい寝てしまいそう）
PRINTFORMW 「うーん、どうせなら速度とは違う方面の能力を取り戻したかったわね」	PRINTFORMW 「うーん、どうせなら速度とは違う方面の能力を取り戻したかったわね」
PRINTFORM 『ほら、言いなさい？　ここ、気持ちいい、きもちいい、きもちいいってぇ	PRINTFORM 『ほら、言いなさい？　ここ、気持ちいい、きもちいい、きもちいいってぇ
PRINTFORMDW どちらのものか分からない嬌声を響かせながら、紫は頂点へと達した。	PRINTFORMDW どちらのものか分からない嬌声を響かせながら、紫は頂点へと達した。
PRINTFORMDW 膣内に包まれた触手は即座に反応し、紫側へとその感触を伝えてくる。	PRINTFORMDW 膣内に包まれた触手は即座に反応し、紫側へとその感触を伝えてくる。
PRINTFORMW 「力は全て奪いました。あとはこうやって犯して、心の境界を崩すだけ。	PRINTFORMW 「力は全て奪いました。あとはこうやって犯して、心の境界を崩すだけ。
PRINTFORMDW 宙に一つのスキマが開くとともに、一人の女性がすとんと舞い降りた。	PRINTFORMDW 宙に一つのスキマが開くとともに、一人の女性がすとんと舞い降りた。
PRINTFORMW 　九尾は相当な妖であるのに、情けない扱いをされているそうですね？」	PRINTFORMW 　九尾は相当な妖であるのに、情けない扱いをされているそうですね？」
PRINTFORMDW 藍を挑発しながらにやつく彼女の性格は、間違いなく母親似である……	PRINTFORMDW 藍を挑発しながらにやつく彼女の性格は、間違いなく母親似である……
PRINTFORMW 「文字通りに、足を引っ張ってあげましょう……地面のスキマからね」	PRINTFORMW 「文字通りに、足を引っ張ってあげましょう……地面のスキマからね」
PRINTFORMDW 力が戻っていないのだから、事態を進展させられないのも当然だが。	PRINTFORMDW 力が戻っていないのだから、事態を進展させられないのも当然だが。
PRINTFORMDW 中には羽の生えた少女など、明らかに妖精や妖怪と思しき者もいた。	PRINTFORMDW 中には羽の生えた少女など、明らかに妖精や妖怪と思しき者もいた。
PRINTFORMDW さっき届いた返事の声色。それは紛れも無い、紫自身のものだった。	PRINTFORMDW さっき届いた返事の声色。それは紛れも無い、紫自身のものだった。
PRINTFORMW 「どう？　力の配分を弄るのは、貴方だけができることじゃないわよ」	PRINTFORMW 「どう？　力の配分を弄るのは、貴方だけができることじゃないわよ」
PRINTFORMW 「吸われた私の力が集められた先――貴方と見て、間違いなさそうね」	PRINTFORMW 「吸われた私の力が集められた先――貴方と見て、間違いなさそうね」
PRINTFORMW 「だ、だめっ……止まらないっ、この体じゃ絶頂とめられなぃっ！？」	PRINTFORMW 「だ、だめっ……止まらないっ、この体じゃ絶頂とめられなぃっ！？」
PRINTFORMW 「ゆるし、て、またっ……あ、あんっうあぁんっあぁぁぁぁぁっ！？」	PRINTFORMW 「ゆるし、て、またっ……あ、あんっうあぁんっあぁぁぁぁぁっ！？」
PRINTFORMW 「……なんか縮んでないか、って？　ちょっと一回捕まってしまって。	PRINTFORMW 「……なんか縮んでないか、って？　ちょっと一回捕まってしまって。
PRINTFORMW 「そういう相手はしっかりと考えた上で選ぶべきよ？　色んな意味で」	PRINTFORMW 「そういう相手はしっかりと考えた上で選ぶべきよ？　色んな意味で」
PRINTFORMW 「はぁっ、づぅっ……この感覚、何度受けても慣れそうにないわ……」	PRINTFORMW 「はぁっ、づぅっ……この感覚、何度受けても慣れそうにないわ……」
PRINTFORMW 「きもちいいなんて、変よっ……なか、いじくられてっ、やぁっ！？」	PRINTFORMW 「きもちいいなんて、変よっ……なか、いじくられてっ、やぁっ！？」
PRINTFORMW 「スキマを開くこの私に、壁から伸びる程度で不意を打てるとでも？」	PRINTFORMW 「スキマを開くこの私に、壁から伸びる程度で不意を打てるとでも？」
PRINTFORMDW 見れば、紫の膣内に娘が手に持った触手を押し込んだところだった。	PRINTFORMDW 見れば、紫の膣内に娘が手に持った触手を押し込んだところだった。
PRINTFORMDW そう言って娘は腰を下ろし、互いの膣に入った触手を動かし始める。	PRINTFORMDW そう言って娘は腰を下ろし、互いの膣に入った触手を動かし始める。
PRINTFORMDW ――妖力を吸われた紫の体は、橙と同じくらいの背丈になっていた。	PRINTFORMDW ――妖力を吸われた紫の体は、橙と同じくらいの背丈になっていた。
PRINTFORMW 「その体、どこまでへこませられるんでしたっけ。試してみましょう」	PRINTFORMW 「その体、どこまでへこませられるんでしたっけ。試してみましょう」
PRINTFORMW 「きゃああああっ、何を……されたかはわかりきってますけどっ！？」	PRINTFORMW 「きゃああああっ、何を……されたかはわかりきってますけどっ！？」
PRINTFORM （戦えない、なら、味方の代わりに……気持ちよく、ならないとぉ……	PRINTFORM （戦えない、なら、味方の代わりに……気持ちよく、ならないとぉ……
PRINTFORMW 「……汚染されて敵に回ったり……負けて、やられてしまったりは」	PRINTFORMW 「……汚染されて敵に回ったり……負けて、やられてしまったりは」
PRINTFORMDW 後処理も終え、原因究明も果たしたが、これと言って疲労はない。	PRINTFORMDW 後処理も終え、原因究明も果たしたが、これと言って疲労はない。
PRINTFORMDW 力尽きたクイーンの体が崩れ落ちる中で、紫は急ぐように跳んだ。	PRINTFORMDW 力尽きたクイーンの体が崩れ落ちる中で、紫は急ぐように跳んだ。
PRINTFORML （本当は土地不足などと虚偽をほざいている天人達を押し込んだり、	PRINTFORML （本当は土地不足などと虚偽をほざいている天人達を押し込んだり、
PRINTFORML 「……相手は、着替えをわざと設置していると見て間違いなさそう」	PRINTFORML 「……相手は、着替えをわざと設置していると見て間違いなさそう」
PRINTFORMW 「！……ふん、そういうこと。この言い草、誰に似たのでしょうね」	PRINTFORMW 「！……ふん、そういうこと。この言い草、誰に似たのでしょうね」
PRINTFORM 「んっ、あっ――はぁぁぁぁぁぁぁんっ♪　あぁ……きもち、いぃ……	PRINTFORM 「んっ、あっ――はぁぁぁぁぁぁぁんっ♪　あぁ……きもち、いぃ……
PRINTFORMW 「くぅんっ――――――♪　…………い、イってなどいないわよ！」	PRINTFORMW 「くぅんっ――――――♪　…………い、イってなどいないわよ！」
PRINTFORMW 「見ての通り……このような体になるくらい余裕のない状態なので」	PRINTFORMW 「見ての通り……このような体になるくらい余裕のない状態なので」
PRINTFORMW 　力は奪われ体も縮んだままで、正直に言うと私一人では辛いのよ」	PRINTFORMW 　力は奪われ体も縮んだままで、正直に言うと私一人では辛いのよ」
PRINTFORMW 「ぐっ……やはり、無茶してでも取っておくべきだったかしら……」	PRINTFORMW 「ぐっ……やはり、無茶してでも取っておくべきだったかしら……」
PRINTFORMW 「どうなるか知っていれば、手の打ちようも、ある、はずっ……！」	PRINTFORMW 「どうなるか知っていれば、手の打ちようも、ある、はずっ……！」
PRINTFORMW 「……そう、よね、子供が腹にいるのだから……母乳くらい、出る」	PRINTFORMW 「……そう、よね、子供が腹にいるのだから……母乳くらい、出る」
PRINTFORMW 「吸う、なっ、はなれっ……ひっ！　あっ、うぁぁぁぁぁぁっ！？」	PRINTFORMW 「吸う、なっ、はなれっ……ひっ！　あっ、うぁぁぁぁぁぁっ！？」
PRINTFORML 「このっ……たたきつぶしてやっ、うぁっ、あぁぁぁぁぁぁっ！？」	PRINTFORML 「このっ……たたきつぶしてやっ、うぁっ、あぁぁぁぁぁぁっ！？」
PRINTFORMW 「害のあるものではないし、確認は後にして放り込みましょう……」	PRINTFORMW 「害のあるものではないし、確認は後にして放り込みましょう……」
PRINTFORMW （この感触は、霊夢の書いたそれじゃない。なぜこんな物が……？）	PRINTFORMW （この感触は、霊夢の書いたそれじゃない。なぜこんな物が……？）
PRINTFORMW 「ただ走るよりは、能力を使って動くほうが安全で確実というもの」	PRINTFORMW 「ただ走るよりは、能力を使って動くほうが安全で確実というもの」
PRINTFORMW （あの色、どうも精液を思い出す……ここに毒されすぎなのかしら）	PRINTFORMW （あの色、どうも精液を思い出す……ここに毒されすぎなのかしら）
PRINTFORMW 「……さすがに、中のおぞましさを見ると馬鹿にする気も失せるわ」	PRINTFORMW 「……さすがに、中のおぞましさを見ると馬鹿にする気も失せるわ」
PRINTFORMW 「貴方は、最期まで安らかな眠りを得られなかったのね……幽々子」	PRINTFORMW 「貴方は、最期まで安らかな眠りを得られなかったのね……幽々子」
PRINTFORMDW 犯される本物と、犯す偽者という差だけは等しくなることはない。	PRINTFORMDW 犯される本物と、犯す偽者という差だけは等しくなることはない。
PRINTFORMW 「そういう気なのならば、私もそういう対応で応えるのみだけれど」	PRINTFORMW 「そういう気なのならば、私もそういう対応で応えるのみだけれど」
PRINTFORML 「貴方が博麗の巫女なのですね？　母さまが気にかけているとか……	PRINTFORML 「貴方が博麗の巫女なのですね？　母さまが気にかけているとか……
PRINTFORMW 「式神よりも娘のほうが役に立つということ、お見せしましょう♪」	PRINTFORMW 「式神よりも娘のほうが役に立つということ、お見せしましょう♪」
PRINTFORMW 「か弱い妖精を守るのが、母さまの力を受け継ぎし私の使命です！」	PRINTFORMW 「か弱い妖精を守るのが、母さまの力を受け継ぎし私の使命です！」
PRINTFORMW 「わかってはいたけど、この体ですらすぐ息切れするわね……！」	PRINTFORMW 「わかってはいたけど、この体ですらすぐ息切れするわね……！」
PRINTFORMW （中に入られれば、スキマで逃げ出すことすら難しくなる……！）	PRINTFORMW （中に入られれば、スキマで逃げ出すことすら難しくなる……！）
PRINTFORMDW 幻想郷のためになすべきことを、その頭脳で即座に弾き出した。	PRINTFORMDW 幻想郷のためになすべきことを、その頭脳で即座に弾き出した。
PRINTFORMDW 唖然とする紫の目前に、切り落とされた頭部がぽとりと堕ちる。	PRINTFORMDW 唖然とする紫の目前に、切り落とされた頭部がぽとりと堕ちる。
PRINTFORMDW 話しながら、紫はくるくると器用に筆を回す。その口のように。	PRINTFORMDW 話しながら、紫はくるくると器用に筆を回す。その口のように。
PRINTFORMDW 迷宮から帰還した紫は、神社で霊夢とのんびり茶を啜っていた。	PRINTFORMDW 迷宮から帰還した紫は、神社で霊夢とのんびり茶を啜っていた。
PRINTFORMW 「うーん、予想はしていたけれど大きくてサイズが合わない……」	PRINTFORMW 「うーん、予想はしていたけれど大きくてサイズが合わない……」
PRINTFORMDW 紫は自分の指をくわえ込み、必死に絶頂を隠そうとしている……	PRINTFORMDW 紫は自分の指をくわえ込み、必死に絶頂を隠そうとしている……
PRINTFORMW 「お前たちの思い通りになんて、させてたまるものですか……！」	PRINTFORMW 「お前たちの思い通りになんて、させてたまるものですか……！」
PRINTFORMW 「あら、鏡の世界なんてこの迷宮に存在しないと思いますけど？」	PRINTFORMW 「あら、鏡の世界なんてこの迷宮に存在しないと思いますけど？」
PRINTFORMW 「さて、わが子の境界はどの程度幻想郷に寄っているのかしらね」	PRINTFORMW 「さて、わが子の境界はどの程度幻想郷に寄っているのかしらね」
PRINTFORMW 「さて、この子の境界はどの程度幻想郷に寄っているのかしらね」	PRINTFORMW 「さて、この子の境界はどの程度幻想郷に寄っているのかしらね」
PRINTFORML 「認めたくはないけれど……この体ではやはり限界があるようで。	PRINTFORML 「認めたくはないけれど……この体ではやはり限界があるようで。
PRINTFORMW 「ぐっ……安定して治せる手段を用意できればいいのだけど……」	PRINTFORMW 「ぐっ……安定して治せる手段を用意できればいいのだけど……」
PRINTFORMW 「はぁっ、づぅっ……子を為した経験があるだけマシかしら……」	PRINTFORMW 「はぁっ、づぅっ……子を為した経験があるだけマシかしら……」
PRINTFORMW 「やはり成長は早いのね……母体が自由に動けるだけいいけれど」	PRINTFORMW 「やはり成長は早いのね……母体が自由に動けるだけいいけれど」
PRINTFORMW 「ぐっ……こいつ、ら、出てくる時、媚藥を……あっ、うぅっ！」	PRINTFORMW 「ぐっ……こいつ、ら、出てくる時、媚藥を……あっ、うぅっ！」
PRINTFORMW 「ひぎっ！？　な、にっ！　これ、まさかっ、うまれる……！？」	PRINTFORMW 「ひぎっ！？　な、にっ！　これ、まさかっ、うまれる……！？」
PRINTFORML （霊力が残留している……つまり、宣言中に落としたということ。	PRINTFORML （霊力が残留している……つまり、宣言中に落としたということ。
PRINTFORMW 　認めたくない、けれど……ただ、運がよかっただけ……ね……」	PRINTFORMW 　認めたくない、けれど……ただ、運がよかっただけ……ね……」
PRINTFORMW 「体の大きさが元に戻ったりはしないか。まあ、そうでしょうね」	PRINTFORMW 「体の大きさが元に戻ったりはしないか。まあ、そうでしょうね」
PRINTFORMW （……本当に味方をするつもりで、これを言っているのかしら？）	PRINTFORMW （……本当に味方をするつもりで、これを言っているのかしら？）
PRINTFORM 「き……気持ちいいっ！　気持ちいい、きもちいい、きもちいいのぉ	PRINTFORM 「き……気持ちいいっ！　気持ちいい、きもちいい、きもちいいのぉ
PRINTFORM 　今までと同じ調子で力を使い続ければ、すぐ限界が来るでしょうし	PRINTFORM 　今までと同じ調子で力を使い続ければ、すぐ限界が来るでしょうし
PRINTFORMW 「いつか、また……だめっ、そんなこと考えている場合では……」	PRINTFORMW 「いつか、また……だめっ、そんなこと考えている場合では……」
PRINTFORMW 「はぁ……これ以上体を弄られてはたまったものじゃないわ……」	PRINTFORMW 「はぁ……これ以上体を弄られてはたまったものじゃないわ……」
PRINTFORMW 「母さまのほうに立った以上、負けるわけにいきませんっ……！」	PRINTFORMW 「母さまのほうに立った以上、負けるわけにいきませんっ……！」
PRINTFORMW 「後ろにも注意するべきですよ？　たとえ、私が前にいようとも」	PRINTFORMW 「後ろにも注意するべきですよ？　たとえ、私が前にいようとも」
PRINTFORMW 「はひっ……お好きに、お使いください……あんっ、ふあぁっ♪」	PRINTFORMW 「はひっ……お好きに、お使いください……あんっ、ふあぁっ♪」
PRINTFORMW 「だめ、そんなのだめ、きもちよくなっちゃうからだめぇっ！？」	PRINTFORMW 「だめ、そんなのだめ、きもちよくなっちゃうからだめぇっ！？」
PRINTFORMW 　後は私に任せ、隠居なさってもよろしいのですよ？　ふふん♪」	PRINTFORMW 　後は私に任せ、隠居なさってもよろしいのですよ？　ふふん♪」
PRINTFORM 「あら、貴方が母さまのご友人である西行寺幽々子様ですか？　前に	PRINTFORM 「あら、貴方が母さまのご友人である西行寺幽々子様ですか？　前に
PRINTFORMW 「と、とけるっ、わたし、きもちいいのに、とけちゃっ――！？」	PRINTFORMW 「と、とけるっ、わたし、きもちいいのに、とけちゃっ――！？」
PRINTFORMW 「長期戦は不利……一か八かで速攻を仕掛けるしかないようね」	PRINTFORMW 「長期戦は不利……一か八かで速攻を仕掛けるしかないようね」
PRINTFORMDW 視線の先には、多種多様な触手たちが既に蠢き始めていた――	PRINTFORMDW 視線の先には、多種多様な触手たちが既に蠢き始めていた――
PRINTFORMDW だが、同時に出口も閉じ始め――紫の表情は不快そうに歪む。	PRINTFORMDW だが、同時に出口も閉じ始め――紫の表情は不快そうに歪む。
PRINTFORMDW 紫は狙い通りとばかりに、その触手をがっしりと掴んでいた。	PRINTFORMDW 紫は狙い通りとばかりに、その触手をがっしりと掴んでいた。
PRINTFORMW 『わかるでしょう？　さんざん戦ってきた、異種の眷属達……』	PRINTFORMW 『わかるでしょう？　さんざん戦ってきた、異種の眷属達……』
PRINTFORMDW 淀みなく答え、同時にその腕が自分の首を刎ねようと動き――	PRINTFORMDW 淀みなく答え、同時にその腕が自分の首を刎ねようと動き――
PRINTFORMW 「やれやれ……えぇ、認めましょう。貴方はとっても強いわね」	PRINTFORMW 「やれやれ……えぇ、認めましょう。貴方はとっても強いわね」
PRINTFORMD いつの間やら表情をからかうような笑顔に変えた紫とは対照的に	PRINTFORMD いつの間やら表情をからかうような笑顔に変えた紫とは対照的に
PRINTFORMW 「私の用事は終わったから、頑張って二人で練習しましょう？」	PRINTFORMW 「私の用事は終わったから、頑張って二人で練習しましょう？」
PRINTFORMDW 「いだっ！？　いや、前は命令を聞かず勝手に動くなと……」	PRINTFORMDW 「いだっ！？　いや、前は命令を聞かず勝手に動くなと……」
PRINTFORMDW 紫は狙い通りとばかりに、その触手をがっしりと握っていた。	PRINTFORMDW 紫は狙い通りとばかりに、その触手をがっしりと握っていた。
PRINTFORMW 「よくわからないけどやめておいたほうがいい気がするわ……」	PRINTFORMW 「よくわからないけどやめておいたほうがいい気がするわ……」
PRINTFORMW 「むり……無理よっ、そんな、たくさんっ、はいらなっ……！」	PRINTFORMW 「むり……無理よっ、そんな、たくさんっ、はいらなっ……！」
PRINTFORMW 　色々と余裕が無いから、力をセーブしておく必要があるのよ」	PRINTFORMW 　色々と余裕が無いから、力をセーブしておく必要があるのよ」
PRINTFORMW 「……こんな体なのだから、窮屈がって出ていけばいいものを」	PRINTFORMW 「……こんな体なのだから、窮屈がって出ていけばいいものを」
PRINTFORMW 「だ……め……こんどは、中から、ちから、吸われてっ……！」	PRINTFORMW 「だ……め……こんどは、中から、ちから、吸われてっ……！」
PRINTFORMW 「こんな体で何度も産まされて、私の身体は保つのかしら……」	PRINTFORMW 「こんな体で何度も産まされて、私の身体は保つのかしら……」
PRINTFORMW 「なっ、ぼにゅう……！？　からだ、どうなって、やぁっ！？」	PRINTFORMW 「なっ、ぼにゅう……！？　からだ、どうなって、やぁっ！？」
PRINTFORMW 「この環境で眠るのは嫌だけれど……眠らないのはもっと嫌ね」	PRINTFORMW 「この環境で眠るのは嫌だけれど……眠らないのはもっと嫌ね」
PRINTFORMW 「このような体調だからこそ……安全を確保しておかなくては」	PRINTFORMW 「このような体調だからこそ……安全を確保しておかなくては」
PRINTFORMW 「今の状態では、僅かな不安材料でも致命傷になりうる……！」	PRINTFORMW 「今の状態では、僅かな不安材料でも致命傷になりうる……！」
PRINTFORMW 「例え正面しか見えなくとも、私には三百六十度全てが見える」	PRINTFORMW 「例え正面しか見えなくとも、私には三百六十度全てが見える」
PRINTFORMW （……味は美味だけれど、後々後遺症が出たりしないかしら？）	PRINTFORMW （……味は美味だけれど、後々後遺症が出たりしないかしら？）
PRINTFORMW 「次に狙う時は、二階より低い天井を選定しておくことですわ」	PRINTFORMW 「次に狙う時は、二階より低い天井を選定しておくことですわ」
PRINTFORM 「ちから、抜ける、からっ……我慢しないと、いけないのにぃ……	PRINTFORM 「ちから、抜ける、からっ……我慢しないと、いけないのにぃ……
PRINTFORMW 「文字通りに、足を引っ張ってあげます……地面のスキマから」	PRINTFORMW 「文字通りに、足を引っ張ってあげます……地面のスキマから」
PRINTFORM 「は、ひぃんっ♪　あたまの、なか……きえちゃい、ますぅ……♪	PRINTFORM 「は、ひぃんっ♪　あたまの、なか……きえちゃい、ますぅ……♪
PRINTFORMW 「年長者には従うものよ……？　例え見た目が幼くてもね！」	PRINTFORMW 「年長者には従うものよ……？　例え見た目が幼くてもね！」
PRINTFORMW 「こういう生き物は、最後までしっかり粉砕しておかないと」	PRINTFORMW 「こういう生き物は、最後までしっかり粉砕しておかないと」
PRINTFORMW 「わざわざ私の声を繕って、何を……！　姿を現しなさい！」	PRINTFORMW 「わざわざ私の声を繕って、何を……！　姿を現しなさい！」
PRINTFORMW できれば反応してほしくなかったが、答えはすぐに出てきた。	PRINTFORMW できれば反応してほしくなかったが、答えはすぐに出てきた。
PRINTFORMDW 筆を取り出すと、先程まで持っていた紙を拾い上げていた。	PRINTFORMDW 筆を取り出すと、先程まで持っていた紙を拾い上げていた。
PRINTFORMW 「……まるで他にも足りないものがあるような口ぶりですね」	PRINTFORMW 「……まるで他にも足りないものがあるような口ぶりですね」
PRINTFORMW 「海でも作って私専用の一大リゾートにでもしようかしら？」	PRINTFORMW 「海でも作って私専用の一大リゾートにでもしようかしら？」
PRINTFORM （あたま、まっしろ……こんな状態で、考えるなんてむりぃ……	PRINTFORM （あたま、まっしろ……こんな状態で、考えるなんてむりぃ……
PRINTFORMW 「再生された処女だろうと、差し出してやらないわよ……！」	PRINTFORMW 「再生された処女だろうと、差し出してやらないわよ……！」
PRINTFORMDW 身動きしない紫の顔から、小さく涙がこぼれ落ちている……	PRINTFORMDW 身動きしない紫の顔から、小さく涙がこぼれ落ちている……
PRINTFORMW 「こんな急ペースで大家族ができるとは思わなかったわ……」	PRINTFORMW 「こんな急ペースで大家族ができるとは思わなかったわ……」
PRINTFORMDL にこやかな笑みを浮かべる紫の額に青筋が浮かんでいる……	PRINTFORMDL にこやかな笑みを浮かべる紫の額に青筋が浮かんでいる……
PRINTFORMW 「わざわざ縮めた挙句に何度も孕ませる辺り……いい趣味ね」	PRINTFORMW 「わざわざ縮めた挙句に何度も孕ませる辺り……いい趣味ね」
PRINTFORMW 「体が縮んでいなければ、もう少しマシだったのにっ……！」	PRINTFORMW 「体が縮んでいなければ、もう少しマシだったのにっ……！」
PRINTFORMW 「つ、つかまえてっ……あれを、つかまえっ、ないとぉ……」	PRINTFORMW 「つ、つかまえてっ……あれを、つかまえっ、ないとぉ……」
PRINTFORMW 「万全の状態なら頼ることも無かったのでしょうけれど……」	PRINTFORMW 「万全の状態なら頼ることも無かったのでしょうけれど……」
PRINTFORMW 「魔法少女！　クリアランスゆかり～ん♪　…………ごほん」	PRINTFORMW 「魔法少女！　クリアランスゆかり～ん♪　…………ごほん」
PRINTFORMW 「今の状況ならば、使える物はできるだけ使いこなさないと」	PRINTFORMW 「今の状況ならば、使える物はできるだけ使いこなさないと」
PRINTFORMW 「体の重さは気のせいではないのだけれど……しょうがない」	PRINTFORMW 「体の重さは気のせいではないのだけれど……しょうがない」
PRINTFORMW 「この、足を上ってきて……んあぁっ！？　な、中にぃっ！」	PRINTFORMW 「この、足を上ってきて……んあぁっ！？　な、中にぃっ！」
PRINTFORMW （境界が、薄い……本当に、ほとんど私と一体化してる……）	PRINTFORMW （境界が、薄い……本当に、ほとんど私と一体化してる……）
PRINTFORMW 　博麗の巫女なんて……すぐ、代わりが用意できるんだから」	PRINTFORMW 　博麗の巫女なんて……すぐ、代わりが用意できるんだから」
PRINTFORMDW 見れば、紫の擬似陰茎に娘がその膣口を擦り合わせている。	PRINTFORMDW 見れば、紫の擬似陰茎に娘がその膣口を擦り合わせている。
PRINTFORMW 「だから母さま？　代わりに、母さまの全てをちょうだい？」	PRINTFORMW 「だから母さま？　代わりに、母さまの全てをちょうだい？」
PRINTFORM 　まったく、ご丁寧に処女まで再生するだなんて……趣味が悪い	PRINTFORM 　まったく、ご丁寧に処女まで再生するだなんて……趣味が悪い
PRINTFORMDW 通常とは異なる気配に満ちたその空気が、突如として歪む。	PRINTFORMDW 通常とは異なる気配に満ちたその空気が、突如として歪む。
PRINTFORMW 「しょうがない。久しぶりに、この格好で活動しましょうか」	PRINTFORMW 「しょうがない。久しぶりに、この格好で活動しましょうか」
PRINTFORM （い、いけない……心まで相手の操作に従っては……だけどぉっ	PRINTFORM （い、いけない……心まで相手の操作に従っては……だけどぉっ
PRINTFORMW 「式神行使なんて、母さまの血を引く私には容易いこと……」	PRINTFORMW 「式神行使なんて、母さまの血を引く私には容易いこと……」
PRINTFORMW 「すごくいいですね、その位置……まとめて撃ち貫くには！」	PRINTFORMW 「すごくいいですね、その位置……まとめて撃ち貫くには！」
PRINTFORMW 　母さまがどこまでやれるのか、拝見させてもらいましょう。	PRINTFORMW 　母さまがどこまでやれるのか、拝見させてもらいましょう。
PRINTFORMW 「は……はんげきぃっ、しなきゃあぁぁぁぁあああぁんっ♪」	PRINTFORMW 「は……はんげきぃっ、しなきゃあぁぁぁぁあああぁんっ♪」
PRINTFORMW 「ふふ……純潔を貴方に捧げられて、私は、幸せです……♪」	PRINTFORMW 「ふふ……純潔を貴方に捧げられて、私は、幸せです……♪」
PRINTFORMW 「悪いけれど、真っ向勝負できる体ではないのよね……！」	PRINTFORMW 「悪いけれど、真っ向勝負できる体ではないのよね……！」
PRINTFORMW 「外の世界だと、こういうのは省エネって言うらしいわね」	PRINTFORMW 「外の世界だと、こういうのは省エネって言うらしいわね」
PRINTFORMW 「手先を転移させるくらい、まだまだ簡単にできるわよ？」	PRINTFORMW 「手先を転移させるくらい、まだまだ簡単にできるわよ？」
PRINTFORMW 「相変わらずの外見ね……見てると叩き潰したくなるわ！」	PRINTFORMW 「相変わらずの外見ね……見てると叩き潰したくなるわ！」
PRINTFORMDW 数日後。すべてを終えた紫は、自宅でのんびりしていた。	PRINTFORMDW 数日後。すべてを終えた紫は、自宅でのんびりしていた。
PRINTFORMDW 驚愕している所へ響いた声で、更に紫の思考は混乱する。	PRINTFORMDW 驚愕している所へ響いた声で、更に紫の思考は混乱する。
PRINTFORMDW 優しくその額を撫でたが、霊夢はぴくりとも反応しない。	PRINTFORMDW 優しくその額を撫でたが、霊夢はぴくりとも反応しない。
PRINTFORMW 「……力を取り戻せていれば、治せたかもしれないけれど」	PRINTFORMW 「……力を取り戻せていれば、治せたかもしれないけれど」
PRINTFORMDW 「紫様！　あの迷宮の結界に綻びが入ったと報告が……」	PRINTFORMDW 「紫様！　あの迷宮の結界に綻びが入ったと報告が……」
PRINTFORMW 「この服装だと、その辺のメイド妖精と間違われそうだわ」	PRINTFORMW 「この服装だと、その辺のメイド妖精と間違われそうだわ」
PRINTFORMW 「博麗の巫女を害した罰……その身で受けるがいい……！」	PRINTFORMW 「博麗の巫女を害した罰……その身で受けるがいい……！」
PRINTFORMW 「……重要な拠点のようだけど……本拠地ではないかしら」	PRINTFORMW 「……重要な拠点のようだけど……本拠地ではないかしら」
PRINTFORMW 「取り込まれる心配より、再び敵に回る心配が必要かしら」	PRINTFORMW 「取り込まれる心配より、再び敵に回る心配が必要かしら」
PRINTFORMW 「こ、ころしゅっ！　ぜったいころして、や、りゅうっ♪」	PRINTFORMW 「こ、ころしゅっ！　ぜったいころして、や、りゅうっ♪」
PRINTFORMDW 紫は改めて礼を言うと、涼しい顔でその場を立ち去った…	PRINTFORMDW 紫は改めて礼を言うと、涼しい顔でその場を立ち去った…
PRINTFORMW 「だ……め……また、中から、ちから、吸われてっ……！」	PRINTFORMW 「だ……め……また、中から、ちから、吸われてっ……！」
PRINTFORMW 「体調が不安定になる原因……心当たりがありすぎるわね」	PRINTFORMW 「体調が不安定になる原因……心当たりがありすぎるわね」
PRINTFORMW 「……手が届かないので、代わりに取ってくれないかしら」	PRINTFORMW 「……手が届かないので、代わりに取ってくれないかしら」
PRINTFORMW 「何故かまたサイズがぴったりだったりするんでしょうね」	PRINTFORMW 「何故かまたサイズがぴったりだったりするんでしょうね」
PRINTFORMW 「この異変が終わったら、一年くらいずっと眠りたい……」	PRINTFORMW 「この異変が終わったら、一年くらいずっと眠りたい……」
PRINTFORMW 「無闇に力を使える状況ではないし、走りましょうか……」	PRINTFORMW 「無闇に力を使える状況ではないし、走りましょうか……」
PRINTFORMDW 紫は自分の爪を強く掌に押し込んで意識を保っている……	PRINTFORMDW 紫は自分の爪を強く掌に押し込んで意識を保っている……
PRINTFORMW 「しまっ……た、自分から招き入れるような真似を……！」	PRINTFORMW 「しまっ……た、自分から招き入れるような真似を……！」
PRINTFORMW 「あぁ、ありがとう、母さま。これでずっと一緒ですよ？」	PRINTFORMW 「あぁ、ありがとう、母さま。これでずっと一緒ですよ？」
PRINTFORMW 「貴方達の境界はどこにあるか、私はよく知っているもの」	PRINTFORMW 「貴方達の境界はどこにあるか、私はよく知っているもの」
PRINTFORMW 「この体でも、結界を展開するくらいは造作も無いわね」	PRINTFORMW 「この体でも、結界を展開するくらいは造作も無いわね」
PRINTFORMW 「まさか、この歳になって妖忌の真似事をするとはねぇ」	PRINTFORMW 「まさか、この歳になって妖忌の真似事をするとはねぇ」
PRINTFORMW 「お前は幻想郷の住人じゃない……だから容赦は不要ね」	PRINTFORMW 「お前は幻想郷の住人じゃない……だから容赦は不要ね」
PRINTFORMW 「あいにく、私の攻撃には近づく必要なんてないのです」	PRINTFORMW 「あいにく、私の攻撃には近づく必要なんてないのです」
PRINTFORMW 「後ろにも注意するべきよ？　たとえ、私が前にいても」	PRINTFORMW 「後ろにも注意するべきよ？　たとえ、私が前にいても」
PRINTFORMW 「さすがに、ちゃんと踏み込んで叩きこまないとダメね」	PRINTFORMW 「さすがに、ちゃんと踏み込んで叩きこまないとダメね」
PRINTFORMDW それでも、心中の不安を振り切るように紫は振り返る。	PRINTFORMDW それでも、心中の不安を振り切るように紫は振り返る。
PRINTFORMDL もっとも、愚痴を言っても現状が変わるわけでもない。	PRINTFORMDL もっとも、愚痴を言っても現状が変わるわけでもない。
PRINTFORMDW 神隠しを解決するため、新たな神隠しが花開く――――	PRINTFORMDW 神隠しを解決するため、新たな神隠しが花開く――――
PRINTFORMW 「予想よりずっと早く終わったし、久々に冬眠でも……」	PRINTFORMW 「予想よりずっと早く終わったし、久々に冬眠でも……」
PRINTFORMW 「――既に、私の子供達は幻想郷に放たれているわよ？」	PRINTFORMW 「――既に、私の子供達は幻想郷に放たれているわよ？」
PRINTFORMDW そんなクイーンの負け惜しみを、紫は聞いた気がした。	PRINTFORMDW そんなクイーンの負け惜しみを、紫は聞いた気がした。
PRINTFORMW 「知らないわよそんなの！　いい加減私を眠らせろ～！」	PRINTFORMW 「知らないわよそんなの！　いい加減私を眠らせろ～！」
PRINTFORMW 「これにて迷宮は制圧完了、と。いやぁ、長かったわ～」	PRINTFORMW 「これにて迷宮は制圧完了、と。いやぁ、長かったわ～」
PRINTFORMW （これから先、消耗した状態になる事は避けないと……）	PRINTFORMW （これから先、消耗した状態になる事は避けないと……）
PRINTFORML 「……残念だけど、鏡の世界に来たわけではないようね。	PRINTFORML 「……残念だけど、鏡の世界に来たわけではないようね。
PRINTFORMW 「――幽々子の代わりに、私がお前を死に誘ってあげる」	PRINTFORMW 「――幽々子の代わりに、私がお前を死に誘ってあげる」
PRINTFORMW 「代わりの巫女を探すのは、あくまで最終手段よ……！」	PRINTFORMW 「代わりの巫女を探すのは、あくまで最終手段よ……！」
PRINTFORMW 「後はこれを取ってくれるとありがたいのだけれど……」	PRINTFORMW 「後はこれを取ってくれるとありがたいのだけれど……」
PRINTFORMW 「はぁっ、づぅっ……こんな感覚、全然知らない……！」	PRINTFORMW 「はぁっ、づぅっ……こんな感覚、全然知らない……！」
PRINTFORMW 「むしろ、今まで健康体だった事のほうが奇跡的かしら」	PRINTFORMW 「むしろ、今まで健康体だった事のほうが奇跡的かしら」
PRINTFORMW 「こんな体で産まされて、私の身体は保つのかしら……」	PRINTFORMW 「こんな体で産まされて、私の身体は保つのかしら……」
PRINTFORMW 　吸われるだけで――んんっ♪　うごけなくなるのぉ♪」	PRINTFORMW 　吸われるだけで――んんっ♪　うごけなくなるのぉ♪」
PRINTFORMW 「……そう言えばここ数年、冬眠していない気がするわ」	PRINTFORMW 「……そう言えばここ数年、冬眠していない気がするわ」
PRINTFORMW 「これ以上消耗しないためにも、注意を保たないと……」	PRINTFORMW 「これ以上消耗しないためにも、注意を保たないと……」
PRINTFORMW 「……さすがに、中のおぞましさを見るとぞっとするわ」	PRINTFORMW 「……さすがに、中のおぞましさを見るとぞっとするわ」
PRINTFORMD そう吐き捨てる紫は必死に真上を向いて顔を逸らしている	PRINTFORMD そう吐き捨てる紫は必死に真上を向いて顔を逸らしている
PRINTFORMDW その言葉が合図だったかのように、紫の体が反り返る。	PRINTFORMDW その言葉が合図だったかのように、紫の体が反り返る。
PRINTFORMDW 自分の中にいると思っている母親に、娘はそう呟いた。	PRINTFORMDW 自分の中にいると思っている母親に、娘はそう呟いた。
PRINTFORM 「……これでは、同じ調子で力を使い続けるのは辛いかしら	PRINTFORM 「……これでは、同じ調子で力を使い続けるのは辛いかしら
PRINTFORMW 「やられる前に、まとめてやるしかありませんね……！」	PRINTFORMW 「やられる前に、まとめてやるしかありませんね……！」
PRINTFORMW 「もし勝ち誇って遊んでいるつもりなら……殺しますよ」	PRINTFORMW 「もし勝ち誇って遊んでいるつもりなら……殺しますよ」
PRINTFORMW 「どうやら、私が頑張らなくてはならないようですね！」	PRINTFORMW 「どうやら、私が頑張らなくてはならないようですね！」
PRINTFORML 「信用できないかもしれませんが、頼りにして下さいね。	PRINTFORML 「信用できないかもしれませんが、頼りにして下さいね。
PRINTFORMW 「全力が出せないなら……搦め手を使うしか手はない」	PRINTFORMW 「全力が出せないなら……搦め手を使うしか手はない」
PRINTFORMW 「軽い攻撃なら、その場を動く必要すらありませんわ」	PRINTFORMW 「軽い攻撃なら、その場を動く必要すらありませんわ」
PRINTFORMW 「腕が短くなっていても、私の射程は変わらないのよ」	PRINTFORMW 「腕が短くなっていても、私の射程は変わらないのよ」
PRINTFORMW 「私の言いたいことを、何か勘違いしていないかしら」	PRINTFORMW 「私の言いたいことを、何か勘違いしていないかしら」
PRINTFORMW 「……ま、藍には無理だから私がやるしかないのよね」	PRINTFORMW 「……ま、藍には無理だから私がやるしかないのよね」
PRINTFORMDW 普段なら面倒な事も、今は心弾むように感じられる。	PRINTFORMDW 普段なら面倒な事も、今は心弾むように感じられる。
PRINTFORMDW と一緒に、紫は異変が終わったことを喜び合った……	PRINTFORMDW と一緒に、紫は異変が終わったことを喜び合った……
PRINTFORMW 「二重の意味で縮こまっていたのが功を奏したようね」	PRINTFORMW 「二重の意味で縮こまっていたのが功を奏したようね」
PRINTFORMW 「私の式神を奪った借り……返してもらいましょうか」	PRINTFORMW 「私の式神を奪った借り……返してもらいましょうか」
PRINTFORMW 「……自分がこんな状態では、助けられる保証もない」	PRINTFORMW 「……自分がこんな状態では、助けられる保証もない」
PRINTFORMW 「う、手が届かない……無駄な力を使いたくないのに」	PRINTFORMW 「う、手が届かない……無駄な力を使いたくないのに」
PRINTFORMW 「所詮、ここで消した物は末端に過ぎないけれど……」	PRINTFORMW 「所詮、ここで消した物は末端に過ぎないけれど……」
PRINTFORMW 「味だけが特上ではないようね。何かの神湯かしら？」	PRINTFORMW 「味だけが特上ではないようね。何かの神湯かしら？」
PRINTFORMDW それ以上に何か特殊なものが、この異変にはあった。	PRINTFORMDW それ以上に何か特殊なものが、この異変にはあった。
PRINTFORMW 「なか、だし……このままだと、いけませんっ……！」	PRINTFORMW 「なか、だし……このままだと、いけませんっ……！」
PRINTFORMW 「貴方が手段を選ばないなら、私も手段は選ばない」	PRINTFORMW 「貴方が手段を選ばないなら、私も手段は選ばない」
PRINTFORMW 「足元に気をつけることね。落とし穴が開いている」	PRINTFORMW 「足元に気をつけることね。落とし穴が開いている」
PRINTFORMW （初手を誤った時点で、この末路は決まっていた……	PRINTFORMW （初手を誤った時点で、この末路は決まっていた……
PRINTFORM 「はい、母さまは急いで脱出を。私はここに残ります」	PRINTFORM 「はい、母さまは急いで脱出を。私はここに残ります」
PRINTFORMDW 紫は閉じつつある出口へと向かって駆け出して……	PRINTFORMDW 紫は閉じつつある出口へと向かって駆け出して……
PRINTFORMW 「出口が閉じるからさっさと行きなさい。命令よ！」	PRINTFORMW 「出口が閉じるからさっさと行きなさい。命令よ！」
PRINTFORMDW それどころか、口にする言葉さえも変わっていく。	PRINTFORMDW それどころか、口にする言葉さえも変わっていく。
PRINTFORMDW その瞬間、紫の口から呆けた声が漏れた。当然だ。	PRINTFORMDW その瞬間、紫の口から呆けた声が漏れた。当然だ。
PRINTFORMDW ――私の負けだが、これで貴様も取り戻せまい――	PRINTFORMDW ――私の負けだが、これで貴様も取り戻せまい――
PRINTFORMW 「……しょせん、私は母さまより劣る存在だとでも」	PRINTFORMW 「……しょせん、私は母さまより劣る存在だとでも」
PRINTFORMW 「あらやだ、私のお肌に傷がついてしまいましたわ」	PRINTFORMW 「あらやだ、私のお肌に傷がついてしまいましたわ」
PRINTFORMW 「小さいからって、避けやすいとは限らないか……」	PRINTFORMW 「小さいからって、避けやすいとは限らないか……」
PRINTFORMW 「……私の見てくれについては、後で話しましょう」	PRINTFORMW 「……私の見てくれについては、後で話しましょう」
PRINTFORMW 「この程度の武器に頼るほど落ちぶれてはいないわ」	PRINTFORMW 「この程度の武器に頼るほど落ちぶれてはいないわ」
PRINTFORMW 「迷宮の中で金を作っても何も役に立たないけれど」	PRINTFORMW 「迷宮の中で金を作っても何も役に立たないけれど」
PRINTFORMW 「６時間と言わず半日くらい眠っていたいわね……」	PRINTFORMW 「６時間と言わず半日くらい眠っていたいわね……」
PRINTFORMW 「さすがに、そろそろ休まないと限界が来るわ……」	PRINTFORMW 「さすがに、そろそろ休まないと限界が来るわ……」
PRINTFORMW 「……いい加減、どこかで休憩を挟まないと危険ね」	PRINTFORMW 「……いい加減、どこかで休憩を挟まないと危険ね」
PRINTFORMW 「つくづく安全な場所なんてないのね……ここには」	PRINTFORMW 「つくづく安全な場所なんてないのね……ここには」
PRINTFORMW 「悪知恵を働かせるのも、八雲紫の娘である証っ！」	PRINTFORMW 「悪知恵を働かせるのも、八雲紫の娘である証っ！」
PRINTFORMW 「もしこれで助かったら……その、褒めてください」	PRINTFORMW 「もしこれで助かったら……その、褒めてください」
PRINTFORMW 「脆い境界の継ぎ目を見つけるなんて容易いこと！」	PRINTFORMW 「脆い境界の継ぎ目を見つけるなんて容易いこと！」
PRINTFORMW 　されるほうはぜんぜんわかんないんれすぅっ！？」	PRINTFORMW 　されるほうはぜんぜんわかんないんれすぅっ！？」
PRINTFORMW 「こ、こんなの……すぐ脱出できるんですからっ！」	PRINTFORMW 「こ、こんなの……すぐ脱出できるんですからっ！」
PRINTFORMW 「おや、そこにいる九尾は母さまの式神でしょうか。	PRINTFORMW 「おや、そこにいる九尾は母さまの式神でしょうか。
PRINTFORMDW 結界を展開した紫の額に、汗が浮かんでいる……	PRINTFORMDW 結界を展開した紫の額に、汗が浮かんでいる……
PRINTFORMW 「一気に力を使い果たすわけにもいかないか……」	PRINTFORMW 「一気に力を使い果たすわけにもいかないか……」
PRINTFORMW 「突っ立って休んでいる暇はないでしょうね……」	PRINTFORMW 「突っ立って休んでいる暇はないでしょうね……」
PRINTFORMW 「接近戦も力の乱用も、お断りなのだけれど……」	PRINTFORMW 「接近戦も力の乱用も、お断りなのだけれど……」
PRINTFORMW 「たとえ散開しようとも、私の弾は食らいつく！」	PRINTFORMW 「たとえ散開しようとも、私の弾は食らいつく！」
PRINTFORMW 「単純な相手……転移を先読みされる心配はない」	PRINTFORMW 「単純な相手……転移を先読みされる心配はない」
PRINTFORM （皆が楽に戦えるから……だから、早く襲ってぇ……	PRINTFORM （皆が楽に戦えるから……だから、早く襲ってぇ……
PRINTFORMDW 寝床へ転移しようとスキマを開いた、その瞬間。	PRINTFORMDW 寝床へ転移しようとスキマを開いた、その瞬間。
PRINTFORMDW 奪われた力だけは、絶対に取り返さなくては――	PRINTFORMDW 奪われた力だけは、絶対に取り返さなくては――
PRINTFORMW 　力が回復するまで、一年くらいずっと寝て……」	PRINTFORMW 　力が回復するまで、一年くらいずっと寝て……」
PRINTFORML 現在、通常の体格のゆかりんは対応していません。	PRINTFORML 現在、通常の体格のゆかりんは対応していません。
PRINTFORMW 「お返しはしますわ――私の流儀で、物理的にね」	PRINTFORMW 「お返しはしますわ――私の流儀で、物理的にね」
PRINTFORMW 「くぅっ……これ、なんとかしなければぁっ……」	PRINTFORMW 「くぅっ……これ、なんとかしなければぁっ……」
PRINTFORMW 「退くのかこのまま戦うか、早く決めないと……」	PRINTFORMW 「退くのかこのまま戦うか、早く決めないと……」
PRINTFORMW 「ついでに、今までの自分を悔いてみたらどう？」	PRINTFORMW 「ついでに、今までの自分を悔いてみたらどう？」
PRINTFORMW 「……ちゃんと、何か考えがあるんでしょうね？」	PRINTFORMW 「……ちゃんと、何か考えがあるんでしょうね？」
PRINTFORMW 「……藍はいったいどんな教育をしているのやら」	PRINTFORMW 「……藍はいったいどんな教育をしているのやら」
PRINTFORMW 「透視の真似事はできるけれど……疲れるのよね」	PRINTFORMW 「透視の真似事はできるけれど……疲れるのよね」
PRINTFORMW 　母さまの過去も、考えも、全てわかります……」	PRINTFORMW 　母さまの過去も、考えも、全てわかります……」
PRINTFORMDW なぜなら、そこにはもう母親はいないのだから。	PRINTFORMDW なぜなら、そこにはもう母親はいないのだから。
PRINTFORMW 「母さまなら、こういう時こそ頭を使うはず……」	PRINTFORMW 「母さまなら、こういう時こそ頭を使うはず……」
PRINTFORMW 「さすがに笑っている場合ではありません……！」	PRINTFORMW 「さすがに笑っている場合ではありません……！」
PRINTFORMW 「皆さんは最後までしっかり粉砕しておかないと」	PRINTFORMW 「皆さんは最後までしっかり粉砕しておかないと」
PRINTFORMW 　うん、藍さんよりは話が合いそうでよろしい！」	PRINTFORMW 　うん、藍さんよりは話が合いそうでよろしい！」
PRINTFORMW 「どちらがより多く狩れるか、勝負しましょう！」	PRINTFORMW 「どちらがより多く狩れるか、勝負しましょう！」
PRINTFORMW 「そんな様子では母さまに怒られますよ、藍さん」	PRINTFORMW 「そんな様子では母さまに怒られますよ、藍さん」
PRINTFORMW 　私が自分の純潔を気にする、資格なんてっ……」	PRINTFORMW 　私が自分の純潔を気にする、資格なんてっ……」
PRINTFORMW 「誘ってるの？　それなら、弾でも抱えなさい」	PRINTFORMW 「誘ってるの？　それなら、弾でも抱えなさい」
PRINTFORMW 「もったいぶっている場合ではないわね……！」	PRINTFORMW 「もったいぶっている場合ではないわね……！」
PRINTFORMW 「遠距離からのゼロ距離射撃、味わうといいわ」	PRINTFORMW 「遠距離からのゼロ距離射撃、味わうといいわ」
PRINTFORMW 「少しでも体を離せれば、私にはそれで十分！」	PRINTFORMW 「少しでも体を離せれば、私にはそれで十分！」
PRINTFORMW 　だって私は……母さまの血を引く、娘だから」	PRINTFORMW 　だって私は……母さまの血を引く、娘だから」
PRINTFORMW 「事態を運ぶための整理はついた……後は……」	PRINTFORMW 「事態を運ぶための整理はついた……後は……」
PRINTFORMW 「…………母さまが一緒なら、いいです、けど」	PRINTFORMW 「…………母さまが一緒なら、いいです、けど」
PRINTFORMW 　えぇ、私ならマスコットも用意できるわね！」	PRINTFORMW 　えぇ、私ならマスコットも用意できるわね！」
PRINTFORMW 「ぐ、体が重い……何やってるのよ私は……！」	PRINTFORMW 「ぐ、体が重い……何やってるのよ私は……！」
PRINTFORMW 「ふ……ふふふ……やってくれるじゃない……」	PRINTFORMW 「ふ……ふふふ……やってくれるじゃない……」
PRINTFORMW 「あら、ごきげんよう。今日も最悪の夕暮れね」	PRINTFORMW 「あら、ごきげんよう。今日も最悪の夕暮れね」
PRINTFORMW 「あら、こんにちは。今日も最悪の触手日和ね」	PRINTFORMW 「あら、こんにちは。今日も最悪の触手日和ね」
PRINTFORMW 「申し訳ないけど、頼りにさせて貰いましょう」	PRINTFORMW 「申し訳ないけど、頼りにさせて貰いましょう」
PRINTFORMW 「ここは、素直にお礼を言っておきましょうか」	PRINTFORMW 「ここは、素直にお礼を言っておきましょうか」
PRINTFORMW 「結界を展開する必要はないと思うけれど……」	PRINTFORMW 「結界を展開する必要はないと思うけれど……」
PRINTFORMW 「はぁっ、はぁっ、はぁ……ん、ぐぅっ……！」	PRINTFORMW 「はぁっ、はぁっ、はぁ……ん、ぐぅっ……！」
PRINTFORMW 「ふあーあ、急に冬眠したくなってきたわ……」	PRINTFORMW 「ふあーあ、急に冬眠したくなってきたわ……」
PRINTFORMW 　出すわよ、思いっきりイって射精するわよ？』	PRINTFORMW 　出すわよ、思いっきりイって射精するわよ？』
PRINTFORML 「無理に元の体に戻さないほうがよさそうね……	PRINTFORML 「無理に元の体に戻さないほうがよさそうね……
PRINTFORML 「負けてしまった以上はしょうがありませんね。	PRINTFORML 「負けてしまった以上はしょうがありませんね。
PRINTFORMW 「巫女を守らないと母さまに怒られますか……」	PRINTFORMW 「巫女を守らないと母さまに怒られますか……」
PRINTFORMW 「いい加減、貴方達の存在は見飽きてきたわ」	PRINTFORMW 「いい加減、貴方達の存在は見飽きてきたわ」
PRINTFORMW 「一人での包囲射撃と洒落こみましょうか！」	PRINTFORMW 「一人での包囲射撃と洒落こみましょうか！」
PRINTFORMW 「踏み込みなんていらない……私の力ならば」	PRINTFORMW 「踏み込みなんていらない……私の力ならば」
PRINTFORMW 　もう……どうしようも……ない、のね……）	PRINTFORMW 　もう……どうしようも……ない、のね……）
PRINTFORML 「大丈夫です。私は裏切りも負けもしません。	PRINTFORML 「大丈夫です。私は裏切りも負けもしません。
PRINTFORMDW が脱出した直後、出口は完全に光を失った。	PRINTFORMDW が脱出した直後、出口は完全に光を失った。
PRINTFORMW 「だ、めぇっ、からだ、たえきれないっ……」	PRINTFORMW 「だ、めぇっ、からだ、たえきれないっ……」
PRINTFORMW 「あぁ……なか、精液で、膨らんでるぅ……」	PRINTFORMW 「あぁ……なか、精液で、膨らんでるぅ……」
PRINTFORMW 「これは……だいぶ、参ったかしら……さて」	PRINTFORMW 「これは……だいぶ、参ったかしら……さて」
PRINTFORMW 「放っておく訳にもいかないでしょうね……」	PRINTFORMW 「放っておく訳にもいかないでしょうね……」
PRINTFORMW 「このまま冬眠できれば、どんなに楽か……」	PRINTFORMW 「このまま冬眠できれば、どんなに楽か……」
PRINTFORMW 「はぁ……規則正しかった生活は何処へやら」	PRINTFORMW 「はぁ……規則正しかった生活は何処へやら」
PRINTFORMW 「……っと、少しばかり注意が逸れていたか」	PRINTFORMW 「……っと、少しばかり注意が逸れていたか」
PRINTFORMW 「自分が神隠しされないよう気をつけないと」	PRINTFORMW 「自分が神隠しされないよう気をつけないと」
PRINTFORMDW が、背が縮んだせいで泣き顔が丸見えだ……	PRINTFORMDW が、背が縮んだせいで泣き顔が丸見えだ……
PRINTFORMW 「…………最後まで、余計な仕事を増やして。	PRINTFORMW 「…………最後まで、余計な仕事を増やして。
PRINTFORM 「……こ……の、おっ！？　あ、うあぁあっ……	PRINTFORM 「……こ……の、おっ！？　あ、うあぁあっ……
PRINTFORMW 「ぐっ……これ以上、体を弄られては……！」	PRINTFORMW 「ぐっ……これ以上、体を弄られては……！」
PRINTFORMW 「……体が鈍いなんて、気のせいなんです！」	PRINTFORMW 「……体が鈍いなんて、気のせいなんです！」
PRINTFORMW 「母さま、隙を作るので転移してください！」	PRINTFORMW 「母さま、隙を作るので転移してください！」
PRINTFORMW 「とっておき……『可愛らしい四重結界！』」	PRINTFORMW 「とっておき……『可愛らしい四重結界！』」
PRINTFORMW 「ちょっと体力がなくなったくらいで……！」	PRINTFORMW 「ちょっと体力がなくなったくらいで……！」
PRINTFORMW 「あーあ、無傷とはいかなかったようですね」	PRINTFORMW 「あーあ、無傷とはいかなかったようですね」
PRINTFORM 「ゆ、ゆるひて……もうっ、ゆるひてよぉっ……	PRINTFORM 「ゆ、ゆるひて……もうっ、ゆるひてよぉっ……
PRINTFORMW 「失礼。盾役は辞退させていただきますわ」	PRINTFORMW 「失礼。盾役は辞退させていただきますわ」
PRINTFORMW 「急所が外になかろうと、私には関係ない」	PRINTFORMW 「急所が外になかろうと、私には関係ない」
PRINTFORMW 「ああ、それと……えぇ、その、一つだけ。	PRINTFORMW 「ああ、それと……えぇ、その、一つだけ。
PRINTFORMD %CALLNAME:(FLAG:10)%	PRINTFORMD %CALLNAME:(FLAG:10)%
PRINTFORMD %CALLNAME:(FLAG:11)%	PRINTFORMD %CALLNAME:(FLAG:11)%
PRINTFORML 読んで字の如くロリなゆかりんの口上です。	PRINTFORML 読んで字の如くロリなゆかりんの口上です。
PRINTFORM 「あたま、しびれ……何も、考えられなっ……	PRINTFORM 「あたま、しびれ……何も、考えられなっ……
PRINTFORMW （凄い臭い……なにも、考えられなく……）	PRINTFORMW （凄い臭い……なにも、考えられなく……）
PRINTFORM 「おなかぁ……もぉ……たぷたぷですわぁ……	PRINTFORM 「おなかぁ……もぉ……たぷたぷですわぁ……
PRINTFORMW 「消耗は最低限に――効用はできるだけ！」	PRINTFORMW 「消耗は最低限に――効用はできるだけ！」
PRINTFORMW 「あら、ごきげんよう。今朝も最悪の朝ね」	PRINTFORMW 「あら、ごきげんよう。今朝も最悪の朝ね」
PRINTFORMW 能力を万全に使える状況ではないこと……）	PRINTFORMW 能力を万全に使える状況ではないこと……）
PRINTFORMW （……単に弱っているだけでは……ない？）	PRINTFORMW （……単に弱っているだけでは……ない？）
PRINTFORMW 「こんな武器にも頼らざるをえない……か」	PRINTFORMW 「こんな武器にも頼らざるをえない……か」
PRINTFORMW 「まだ普通に戦ったほうが早いわね。まだ」	PRINTFORMW 「まだ普通に戦ったほうが早いわね。まだ」
PRINTFORMW 「えぇい気持ち悪い、纏わりつくな……！」	PRINTFORMW 「えぇい気持ち悪い、纏わりつくな……！」
PRINTFORMW 「……いつか自分で生やしてみようかしら」	PRINTFORMW 「……いつか自分で生やしてみようかしら」
PRINTFORMW 「焦りは禁物ですね……こんな体では尚更」	PRINTFORMW 「焦りは禁物ですね……こんな体では尚更」
PRINTFORMW 「まだまだ体力はあるんですからっ……！」	PRINTFORMW 「まだまだ体力はあるんですからっ……！」
PRINTFORMW 「浪費に対する文句は後で聞きますので！」	PRINTFORMW 「浪費に対する文句は後で聞きますので！」
PRINTFORMW 「ぐっ、なぶり殺しじゃないですか……！」	PRINTFORMW 「ぐっ、なぶり殺しじゃないですか……！」
PRINTFORMW 　母さまも、こうやって、わたしを……♪」	PRINTFORMW 　母さまも、こうやって、わたしを……♪」
﻿PRINTFORMW 「舐めないでほしいわね、小娘が……！」	PRINTFORMW 「舐めないでほしいわね、小娘が……！」
PRINTFORMW 「焦りは禁物ね……こんな体では尚更に」	PRINTFORMW 「焦りは禁物ね……こんな体では尚更に」
PRINTFORMW 「あまり力を使いたくはないけれど……」	PRINTFORMW 「あまり力を使いたくはないけれど……」
PRINTFORM （駄目、だわ……からだ……あついのっ……	PRINTFORM （駄目、だわ……からだ……あついのっ……
PRINTFORMD 半ば蹴飛ばすような勢いで追い出された藍	PRINTFORMD 半ば蹴飛ばすような勢いで追い出された藍
PRINTFORMDW 断末魔と共に、女王の体が折れていく。	PRINTFORMDW 断末魔と共に、女王の体が折れていく。
PRINTFORMW 　…………難しいんじゃないでしょうか」	PRINTFORMW 　…………難しいんじゃないでしょうか」
PRINTFORMW （幽々子なら何か考えがあるはず……！）	PRINTFORMW （幽々子なら何か考えがあるはず……！）
PRINTFORML 　まだ、ちゃんと、自慰で絶頂できる……	PRINTFORML 　まだ、ちゃんと、自慰で絶頂できる……
PRINTFORM 　ぜんぜんぅ、へいき、ですわ、あ、あぁっ	PRINTFORM 　ぜんぜんぅ、へいき、ですわ、あ、あぁっ
PRINTFORML 「この、感覚……くっ……ふざけないで！	PRINTFORML 「この、感覚……くっ……ふざけないで！
PRINTFORMW 「うん、しっかりしているようで何より」	PRINTFORMW 「うん、しっかりしているようで何より」
PRINTFORMW 「あら、こんばんは。今夜も最悪の夜ね」	PRINTFORMW 「あら、こんばんは。今夜も最悪の夜ね」
PRINTFORMW 「地下に隠れていても気付くわよ、私は」	PRINTFORMW 「地下に隠れていても気付くわよ、私は」
PRINTFORMW 「みっともないところを……失、礼……」	PRINTFORMW 「みっともないところを……失、礼……」
PRINTFORMW 「だ、脱出を……間に合わなっ……！？」	PRINTFORMW 「だ、脱出を……間に合わなっ……！？」
PRINTFORMW 「罠だった時、どうしようもないわ……」	PRINTFORMW 「罠だった時、どうしようもないわ……」
PRINTFORMW 「透視くらいしておくべきだった……！」	PRINTFORMW 「透視くらいしておくべきだった……！」
PRINTFORMW 「…………大したことじゃ、ない、わ……	PRINTFORMW 「…………大したことじゃ、ない、わ……
PRINTFORMW 『んっ……はぁ、気持ちよかったわよ？』	PRINTFORMW 『んっ……はぁ、気持ちよかったわよ？』
PRINTFORML （た、ただ精液が出るくらい、だもの……	PRINTFORML （た、ただ精液が出るくらい、だもの……
PRINTFORMW 「一気に倒す余力くらい……あります！」	PRINTFORMW 「一気に倒す余力くらい……あります！」
PRINTFORMW 「弾数、一気に使わせてもらいますよ！」	PRINTFORMW 「弾数、一気に使わせてもらいますよ！」
PRINTFORMW 「斬り合いは趣味ではありませんけれど」	PRINTFORMW 「斬り合いは趣味ではありませんけれど」
PRINTFORMW 「……これ以上は受けていられませんね」	PRINTFORMW 「……これ以上は受けていられませんね」
PRINTFORMW 「三途の川で死神に運ばせてやるわ！」	PRINTFORMW 「三途の川で死神に運ばせてやるわ！」
PRINTFORMW 「そのはしゃぎ回る様……目障りよ！」	PRINTFORMW 「そのはしゃぎ回る様……目障りよ！」
PRINTFORMW 「可愛がってあげるわ、子猫ちゃん？」	PRINTFORMW 「可愛がってあげるわ、子猫ちゃん？」
PRINTFORMW 「やれるかしら……いえ、やるのよ！」	PRINTFORMW 「やれるかしら……いえ、やるのよ！」
PRINTFORMW 「花火の打ち上げと行きましょうか？」	PRINTFORMW 「花火の打ち上げと行きましょうか？」
PRINTFORMW 「さて、拾い物の使い魔だけれど……」	PRINTFORMW 「さて、拾い物の使い魔だけれど……」
PRINTFORMW 「どうやって潰してあげましょうか？」	PRINTFORMW 「どうやって潰してあげましょうか？」
PRINTFORMW 「一瞬でもいい、体を離せれば……！」	PRINTFORMW 「一瞬でもいい、体を離せれば……！」
PRINTFORMDW 小さな違和感には、気付かなかった。	PRINTFORMDW 小さな違和感には、気付かなかった。
PRINTFORMDW そこから、大量の触手が溢れ出した。	PRINTFORMDW そこから、大量の触手が溢れ出した。
PRINTFORMD 粉のように砕かれ、散るクィーンを見た	PRINTFORMD 粉のように砕かれ、散るクィーンを見た
PRINTFORMW 　――――後継者がいれば別だけれど」	PRINTFORMW 　――――後継者がいれば別だけれど」
PRINTFORMDW の苦難は、まだ始まったばかりだ……	PRINTFORMDW の苦難は、まだ始まったばかりだ……
PRINTFORMW 「ぁ、あっ、も、もうっ、だめっ――」	PRINTFORMW 「ぁ、あっ、も、もうっ、だめっ――」
PRINTFORMW 「ぐっ……やはり、この体では……！」	PRINTFORMW 「ぐっ……やはり、この体では……！」
PRINTFORMW 「無闇に戦っても……先は見えている」	PRINTFORMW 「無闇に戦っても……先は見えている」
PRINTFORMDL 紫をパーティーに加えてあげますか？	PRINTFORMDL 紫をパーティーに加えてあげますか？
PRINTFORMW 「では、ほどほどに頑張りましょうか」	PRINTFORMW 「では、ほどほどに頑張りましょうか」
PRINTFORMDL 紫は呆れるような目でこちらを見た。	PRINTFORMDL 紫は呆れるような目でこちらを見た。
PRINTFORMDL 紫は困ったような目でこちらを見た。	PRINTFORMDL 紫は困ったような目でこちらを見た。
PRINTFORM 「らめぇ、からだっ、おかしくされてるっ	PRINTFORM 「らめぇ、からだっ、おかしくされてるっ
PRINTFORMW 「あら……別に返さなくてもいいわね」	PRINTFORMW 「あら……別に返さなくてもいいわね」
PRINTFORMW 「体で手なずけるよりはずっとましか」	PRINTFORMW 「体で手なずけるよりはずっとましか」
PRINTFORMW 「短距離の転移ならまだまだ簡単よ？」	PRINTFORMW 「短距離の転移ならまだまだ簡単よ？」
PRINTFORMW 「鬼や蛇が出る程度で済めばいいわね」	PRINTFORMW 「鬼や蛇が出る程度で済めばいいわね」
PRINTFORMW 「それで潜んでいたつもりだとでも？」	PRINTFORMW 「それで潜んでいたつもりだとでも？」
PRINTFORMDW 薄暗い肉塊の底で、紫は首を振った。	PRINTFORMDW 薄暗い肉塊の底で、紫は首を振った。
PRINTFORMW 「はぁ、はぁ、はぁっ……ったく……」	PRINTFORMW 「はぁ、はぁ、はぁっ……ったく……」
PRINTFORMW 「こ、この状態でも戦えますもん……」	PRINTFORMW 「こ、この状態でも戦えますもん……」
PRINTFORMW 「裏切り者から弾幕のプレゼントです」	PRINTFORMW 「裏切り者から弾幕のプレゼントです」
PRINTFORMW 「直撃ですが、まだまだ私は平気です」	PRINTFORMW 「直撃ですが、まだまだ私は平気です」
PRINTFORMW 「加減のつもりなら、不要ですけど？」	PRINTFORMW 「加減のつもりなら、不要ですけど？」
PRINTFORMW 「まだ……まだ、終わりませんっ……」	PRINTFORMW 「まだ……まだ、終わりませんっ……」
PRINTFORMW 「ガキが……図に乗るんじゃない！」	PRINTFORMW 「ガキが……図に乗るんじゃない！」
PRINTFORMW 「……亡き者にしてほしいようね？」	PRINTFORMW 「……亡き者にしてほしいようね？」
PRINTFORMW 「こんな結界がどこまでもつか……」	PRINTFORMW 「こんな結界がどこまでもつか……」
PRINTFORMW 「寸分の差異もなく消えるがいい！」	PRINTFORMW 「寸分の差異もなく消えるがいい！」
PRINTFORMW 「折れ曲がる直進弾を見せてあげる」	PRINTFORMW 「折れ曲がる直進弾を見せてあげる」
PRINTFORMW 『やっぱり、理解できてないようね』	PRINTFORMW 『やっぱり、理解できてないようね』
PRINTFORMW 「次から次へと、こすい手を……！」	PRINTFORMW 「次から次へと、こすい手を……！」
PRINTFORMW 「まともにダンスも踊れないようね」	PRINTFORMW 「まともにダンスも踊れないようね」
PRINTFORMW 「この体では限度があるけれど……」	PRINTFORMW 「この体では限度があるけれど……」
PRINTFORMW 「……こういう戦いは避けたいわね」	PRINTFORMW 「……こういう戦いは避けたいわね」
PRINTFORMW 　動き出す前に割っておきましょう」	PRINTFORMW 　動き出す前に割っておきましょう」
PRINTFORMW 「耐えなさい。回収はするわ、必ず」	PRINTFORMW 「耐えなさい。回収はするわ、必ず」
PRINTFORMW 「こんな体にされているのに……！」	PRINTFORMW 「こんな体にされているのに……！」
PRINTFORMW 「あら……どうしましょうか、これ」	PRINTFORMW 「あら……どうしましょうか、これ」
PRINTFORMW 「なぁんだ、相変わらず無事なのね」	PRINTFORMW 「なぁんだ、相変わらず無事なのね」
PRINTFORMDL 紫は蔑むような目でこちらを見た。	PRINTFORMDL 紫は蔑むような目でこちらを見た。
PRINTFORMW その上に消耗までしていること……）	PRINTFORMW その上に消耗までしていること……）
PRINTFORMW 「……まともな映像は映るのかしら」	PRINTFORMW 「……まともな映像は映るのかしら」
PRINTFORMW 「今の私に合う服はあるのかしら？」	PRINTFORMW 「今の私に合う服はあるのかしら？」
PRINTFORML 「……げほっ、げほっげほっごほっ！	PRINTFORML 「……げほっ、げほっげほっごほっ！
PRINTFORMW 「うん……よっこらせ、っと……！」	PRINTFORMW 「うん……よっこらせ、っと……！」
PRINTFORMW 「真っ向勝負したくない気分……！」	PRINTFORMW 「真っ向勝負したくない気分……！」
PRINTFORMW 「地面を抱きしめさせてあげます！」	PRINTFORMW 「地面を抱きしめさせてあげます！」
PRINTFORMW 「ステキなスキマでさようならっ！」	PRINTFORMW 「ステキなスキマでさようならっ！」
PRINTFORMW 「あら、当たっちゃいましたか……」	PRINTFORMW 「あら、当たっちゃいましたか……」
PRINTFORM 私たちに犯されるのって、こんなに……	PRINTFORM 私たちに犯されるのって、こんなに……
PRINTFORM 母さまのまごができちゃいますよぉ……	PRINTFORM 母さまのまごができちゃいますよぉ……
PRINTFORMW 「は、はやく、逃げ、なきゃ……！」	PRINTFORMW 「は、はやく、逃げ、なきゃ……！」
PRINTFORMW 「あまり無茶はできないわね……」	PRINTFORMW 「あまり無茶はできないわね……」
PRINTFORMW 「直接、中身を狙ってあげるわ！」	PRINTFORMW 「直接、中身を狙ってあげるわ！」
PRINTFORMW （これは策……これは策っ……！）	PRINTFORMW （これは策……これは策っ……！）
PRINTFORMW 「藍、状況は分かっているわね？」	PRINTFORMW 「藍、状況は分かっているわね？」
PRINTFORMDW やむなく紫は迷宮を脱出した――	PRINTFORMDW やむなく紫は迷宮を脱出した――
PRINTFORMD 女王が完全に息絶えた事を確認した	PRINTFORMD 女王が完全に息絶えた事を確認した
PRINTFORMW （だめ……体の自由が、効かない）	PRINTFORMW （だめ……体の自由が、効かない）
PRINTFORMW 　子宮、おかしくなってぇっ！？」	PRINTFORMW 　子宮、おかしくなってぇっ！？」
PRINTFORMW 「今更……服がどうなろうと……」	PRINTFORMW 「今更……服がどうなろうと……」
PRINTFORMW 「はぁ、無傷とはいかなかったか」	PRINTFORMW 「はぁ、無傷とはいかなかったか」
PRINTFORMW 「…………？　境界が歪んで……」	PRINTFORMW 「…………？　境界が歪んで……」
PRINTFORMW 「ちょ、ちょっと、霊夢……！？」	PRINTFORMW 「ちょ、ちょっと、霊夢……！？」
PRINTFORM 　いっぱいイって、満足しないとぉっ	PRINTFORM 　いっぱいイって、満足しないとぉっ
PRINTFORML 「んっ、うぅ……………………！」	PRINTFORML 「んっ、うぅ……………………！」
PRINTFORMW 「気色悪いわね、まったく……！」	PRINTFORMW 「気色悪いわね、まったく……！」
PRINTFORMW 「収まった……と見ていいようね」	PRINTFORMW 「収まった……と見ていいようね」
PRINTFORMW 「眠れる時に寝ておくべきかしら」	PRINTFORMW 「眠れる時に寝ておくべきかしら」
PRINTFORMW 「体の小ささに助けられたわ……」	PRINTFORMW 「体の小ささに助けられたわ……」
PRINTFORMW 「罠を警戒して損はないでしょう」	PRINTFORMW 「罠を警戒して損はないでしょう」
PRINTFORM 「う、あぁっ……その、すが、たぁっ	PRINTFORM 「う、あぁっ……その、すが、たぁっ
PRINTFORM 「えぇ、イくの、中出しでイくのぉっ	PRINTFORM 「えぇ、イくの、中出しでイくのぉっ
PRINTFORM 　私と、ひとつになって下さいっ……	PRINTFORM 　私と、ひとつになって下さいっ……
PRINTFORMW 「はぁ……参ったわね、これ……」	PRINTFORMW 「はぁ……参ったわね、これ……」
PRINTFORMW 「それで逃げているつもりなの？」	PRINTFORMW 「それで逃げているつもりなの？」
PRINTFORM 赤ちゃんにかかっちゃいますよぉ……	PRINTFORM 赤ちゃんにかかっちゃいますよぉ……
PRINTFORMW 「っとと、さすがに危ない……！」	PRINTFORMW 「っとと、さすがに危ない……！」
PRINTFORMW 「……やはり、体が鈍いかしら」	PRINTFORMW 「……やはり、体が鈍いかしら」
PRINTFORMW 「仕掛けさせてもらいましょう」	PRINTFORMW 「仕掛けさせてもらいましょう」
PRINTFORMW 「地面と盛大なキスをなさい！」	PRINTFORMW 「地面と盛大なキスをなさい！」
PRINTFORMDW ここには、紫一人しかいない。	PRINTFORMDW ここには、紫一人しかいない。
PRINTFORML 『探しても無駄よ。私はあなた。	PRINTFORML 『探しても無駄よ。私はあなた。
PRINTFORMW 「えぇ、そんなこと言ったわね」	PRINTFORMW 「えぇ、そんなこと言ったわね」
PRINTFORMW 「ぐっ……このままでは……！」	PRINTFORMW 「ぐっ……このままでは……！」
PRINTFORMW 「やってくれるじゃない……！」	PRINTFORMW 「やってくれるじゃない……！」
PRINTFORML 　……一度くらいなら、だけど」	PRINTFORML 　……一度くらいなら、だけど」
PRINTFORMW 「やれやれ、休む暇もない……」	PRINTFORMW 「やれやれ、休む暇もない……」
PRINTFORMW 「今の体で、この状況は……！」	PRINTFORMW 「今の体で、この状況は……！」
PRINTFORMW 「……必ず後で折檻してやるわ」	PRINTFORMW 「……必ず後で折檻してやるわ」
PRINTFORMW 　合流させてもらえるかしら？」	PRINTFORMW 　合流させてもらえるかしら？」
PRINTFORM 　　問題は今の私がこんな状態で、	PRINTFORM 　　問題は今の私がこんな状態で、
PRINTFORMDW 紫は[発情]してしまった……	PRINTFORMDW 紫は[発情]してしまった……
PRINTFORMW 「……と、こんなものかしら？」	PRINTFORMW 「……と、こんなものかしら？」
PRINTFORMW 「背が低いとこういう時に得ね」	PRINTFORMW 「背が低いとこういう時に得ね」
PRINTFORM 「えぇ……とっても、うれしぃ……	PRINTFORM 「えぇ……とっても、うれしぃ……
PRINTFORM 「はっ……！　はな、れ、てぇ……	PRINTFORM 「はっ……！　はな、れ、てぇ……
PRINTFORMW 「な、に、こ……れぇ……！？」	PRINTFORMW 「な、に、こ……れぇ……！？」
PRINTFORMW 「面倒な位置にいるようで……」	PRINTFORMW 「面倒な位置にいるようで……」
PRINTFORMW 「弾のスキマを見切れますか？」	PRINTFORMW 「弾のスキマを見切れますか？」
PRINTFORMW 「も……たたかえ、ません……」	PRINTFORMW 「も……たたかえ、ません……」
PRINTFORMW 「や、やめ……もうやめっ――」	PRINTFORMW 「や、やめ……もうやめっ――」
PRINTFORMW 「この手は面白くありませんね」	PRINTFORMW 「この手は面白くありませんね」
PRINTFORM 「たいへん……れすぅ、これじゃ、	PRINTFORM 「たいへん……れすぅ、これじゃ、
PRINTFORMW 「相変わらずですね、皆さんは」	PRINTFORMW 「相変わらずですね、皆さんは」
PRINTFORMW 「……動きを止めておけば！」	PRINTFORMW 「……動きを止めておけば！」
PRINTFORMW 「私はいつまで戦える……？」	PRINTFORMW 「私はいつまで戦える……？」
PRINTFORMW 「肩慣らしといきましょうか」	PRINTFORMW 「肩慣らしといきましょうか」
PRINTFORMW 「まずは足を止めましょうか」	PRINTFORMW 「まずは足を止めましょうか」
PRINTFORMW 「あら、仕事は終わったの？」	PRINTFORMW 「あら、仕事は終わったの？」
PRINTFORMW 「だめ……避けられない！？」	PRINTFORMW 「だめ……避けられない！？」
PRINTFORMW 「油断していたかしら……！」	PRINTFORMW 「油断していたかしら……！」
PRINTFORM 　なか、染み込んできますぅ……	PRINTFORM 　なか、染み込んできますぅ……
PRINTFORMW 「こんな、ところでっ……！」	PRINTFORMW 「こんな、ところでっ……！」
PRINTFORMW 「服を食べる妖なのかしら？」	PRINTFORMW 「服を食べる妖なのかしら？」
PRINTFORMW 　からだ、持て余してっ……」	PRINTFORMW 　からだ、持て余してっ……」
PRINTFORMW 幼子にも勝てないのかしら？」	PRINTFORMW 幼子にも勝てないのかしら？」
PRINTFORM 　た、たいしたことなっ、あはぁ	PRINTFORM 　た、たいしたことなっ、あはぁ
PRINTFORMW 「えぇ、荒事ならつつがなく」	PRINTFORMW 「えぇ、荒事ならつつがなく」
PRINTFORMW 「…………うっ、あぁっ！？」	PRINTFORMW 「…………うっ、あぁっ！？」
PRINTFORMW 「……長い間生きてきたけど。	PRINTFORMW 「……長い間生きてきたけど。
PRINTFORMW 「即席の式神にはできそうね」	PRINTFORMW 「即席の式神にはできそうね」
PRINTFORMW 　ちから、すわれ、てっ……」	PRINTFORMW 　ちから、すわれ、てっ……」
PRINTFORMW 　わたし、もう……きえ――」	PRINTFORMW 　わたし、もう……きえ――」
PRINTFORMW 　ほんと、駄目な子よね……」	PRINTFORMW 　ほんと、駄目な子よね……」
PRINTFORM 『ええ、私は凄く気持ちいいのっ	PRINTFORM 『ええ、私は凄く気持ちいいのっ
PRINTFORMW 「戦局を変えなくては……！」	PRINTFORMW 「戦局を変えなくては……！」
PRINTFORMW 「なんとかしなくては……！」	PRINTFORMW 「なんとかしなくては……！」
PRINTFORMW 「情けないですよ？　母さま」	PRINTFORMW 「情けないですよ？　母さま」
PRINTFORMW 「吠え面をかかせてあげます」	PRINTFORMW 「吠え面をかかせてあげます」
PRINTFORMW 「地面からも弾は来ますよ？」	PRINTFORMW 「地面からも弾は来ますよ？」
PRINTFORMW 「そんな陣形は通用しません」	PRINTFORMW 「そんな陣形は通用しません」
PRINTFORM 「うぁ、だめぇ……だめれすぅっ	PRINTFORM 「うぁ、だめぇ……だめれすぅっ
PRINTFORMW 「せめ、て……やさしく……」	PRINTFORMW 「せめ、て……やさしく……」
PRINTFORMW 「……あっ！　私は……！？」	PRINTFORMW 「……あっ！　私は……！？」
PRINTFORMW 　少し……妬いてしまいます」	PRINTFORMW 　少し……妬いてしまいます」
PRINTFORMW 「母さまには負けませんよ？」	PRINTFORMW 「母さまには負けませんよ？」
PRINTFORMW 「これくらいでいいかしら」	PRINTFORMW 「これくらいでいいかしら」
PRINTFORMW 「全員整列！　一斉射撃！」	PRINTFORMW 「全員整列！　一斉射撃！」
PRINTFORMW 「どこに逃げても無駄よ？」	PRINTFORMW 「どこに逃げても無駄よ？」
PRINTFORML 「……そこまでじゃないわ。	PRINTFORML 「……そこまでじゃないわ。
PRINTFORMDW 「はい、早く脱出を……」	PRINTFORMDW 「はい、早く脱出を……」
PRINTFORMDW は、即座に手をかざした。	PRINTFORMDW は、即座に手をかざした。
PRINTFORMDW は即座に母親へ振り返る。	PRINTFORMDW は即座に母親へ振り返る。
PRINTFORMDL 心中の呟きは表に出さず。	PRINTFORMDL 心中の呟きは表に出さず。
PRINTFORM 　こんなに、されたら、あんっ	PRINTFORM 　こんなに、されたら、あんっ
PRINTFORMW 「醜悪なショーの始まりね」	PRINTFORMW 「醜悪なショーの始まりね」
PRINTFORMW 「……なんとかなるものね」	PRINTFORMW 「……なんとかなるものね」
PRINTFORMW 「……桃じゃすまないわよ」	PRINTFORMW 「……桃じゃすまないわよ」
PRINTFORM 「はぁっ……はぁ……あっ――	PRINTFORM 「はぁっ……はぁ……あっ――
PRINTFORMDL ［寄生]を治療しました！	PRINTFORMDL ［寄生]を治療しました！
PRINTFORMW 「……諦めるしか無いわね」	PRINTFORMW 「……諦めるしか無いわね」
PRINTFORMW 「ぐっ……この症状は……」	PRINTFORMW 「ぐっ……この症状は……」
PRINTFORMW 「反乱の心配はなさそうね」	PRINTFORMW 「反乱の心配はなさそうね」
PRINTFORMW 「ゴミを処分しましょうか」	PRINTFORMW 「ゴミを処分しましょうか」
PRINTFORMW 　どう、嬉しいでしょう？』	PRINTFORMW 　どう、嬉しいでしょう？』
PRINTFORMW 「大事なのはバランス……」	PRINTFORMW 「大事なのはバランス……」
PRINTFORMW 「仕掛けさせてもらいます」	PRINTFORMW 「仕掛けさせてもらいます」
PRINTFORMW 「降り注いで、私の弾幕！」	PRINTFORMW 「降り注いで、私の弾幕！」
PRINTFORMW 「さぁ、恐れて下さいな？」	PRINTFORMW 「さぁ、恐れて下さいな？」
PRINTFORMW 「これでバラバラですね！」	PRINTFORMW 「これでバラバラですね！」
PRINTFORMW 「は、離れなさいっ……！」	PRINTFORMW 「は、離れなさいっ……！」
PRINTFORM %CALLNAME:1%さん	PRINTFORM %CALLNAME:1%さん
PRINTFORML 「一緒に頑張りましょう！」	PRINTFORML 「一緒に頑張りましょう！」
PRINTFORMW 「ちぃっ、結界を……！」	PRINTFORMW 「ちぃっ、結界を……！」
PRINTFORMW 「頼らざるを得ないわね」	PRINTFORMW 「頼らざるを得ないわね」
PRINTFORMW 「なっ、これは……！？」	PRINTFORMW 「なっ、これは……！？」
PRINTFORMW 「よく、理解できたわ！」	PRINTFORMW 「よく、理解できたわ！」
PRINTFORMDW ぴったりと、止まった。	PRINTFORMDW ぴったりと、止まった。
PRINTFORMW 「その隙、貰いました！」	PRINTFORMW 「その隙、貰いました！」
PRINTFORMW 「はいはい、見ましたわ」	PRINTFORMW 「はいはい、見ましたわ」
PRINTFORMW 「礼儀……そう、礼儀……	PRINTFORMW 「礼儀……そう、礼儀……
PRINTFORMW 「ふーん、何に使うのよ」	PRINTFORMW 「ふーん、何に使うのよ」
PRINTFORMW 「耐えて、私の体……！」	PRINTFORMW 「耐えて、私の体……！」
PRINTFORMW 「っと、危ないわね……」	PRINTFORMW 「っと、危ないわね……」
PRINTFORMW 「も……げんか、い……」	PRINTFORMW 「も……げんか、い……」
PRINTFORM 「はぁ、ふぅ、イけ……るっ	PRINTFORM 「はぁ、ふぅ、イけ……るっ
PRINTFORMW 「は……離れなさいっ！」	PRINTFORMW 「は……離れなさいっ！」
PRINTFORMW 「対策を取らないと……」	PRINTFORMW 「対策を取らないと……」
PRINTFORMW 「さて、何が来るのやら」	PRINTFORMW 「さて、何が来るのやら」
PRINTFORMW 　うぅ……あ、え……？」	PRINTFORMW 　うぅ……あ、え……？」
PRINTFORMW 「……動きを止めないと」	PRINTFORMW 「……動きを止めないと」
PRINTFORMW 「この程度で十分ですね」	PRINTFORMW 「この程度で十分ですね」
PRINTFORMW 「そーら、撃ちなさい！」	PRINTFORMW 「そーら、撃ちなさい！」
PRINTFORMW 「圧力よ、爆ぜなさい！」	PRINTFORMW 「圧力よ、爆ぜなさい！」
PRINTFORMW 「やっ、はなして……！」	PRINTFORMW 「やっ、はなして……！」
PRINTFORM 「あは……でて、ますぅ……	PRINTFORM 「あは……でて、ますぅ……
PRINTFORMW 「今更……服くらい……」	PRINTFORMW 「今更……服くらい……」
PRINTFORML 「はじめまして、母さま。	PRINTFORML 「はじめまして、母さま。
PRINTFORMW 「身の程を知りなさい」	PRINTFORMW 「身の程を知りなさい」
PRINTFORMW 「無茶言うわねぇ……」	PRINTFORMW 「無茶言うわねぇ……」
PRINTFORM 「時間がないわ。私は――	PRINTFORM 「時間がないわ。私は――
PRINTFORMW 「信用できませんか？」	PRINTFORMW 「信用できませんか？」
PRINTFORMD もう一人の仲間と共に、	PRINTFORMD もう一人の仲間と共に、
PRINTFORMDL 紫の笑みは消えない。	PRINTFORMDL 紫の笑みは消えない。
PRINTFORMDW は難しい顔になった。	PRINTFORMDW は難しい顔になった。
PRINTFORMW 「……退治していい？」	PRINTFORMW 「……退治していい？」
PRINTFORMW 「……怒らせたいの？」	PRINTFORMW 「……怒らせたいの？」
PRINTFORMW 「鈍いわよ、生き方が」	PRINTFORMW 「鈍いわよ、生き方が」
PRINTFORMW 「……服？　これが？」	PRINTFORMW 「……服？　これが？」
PRINTFORMW 「はっ……戦況は！？」	PRINTFORMW 「はっ……戦況は！？」
PRINTFORMW 「えぇい、もう……！」	PRINTFORMW 「えぇい、もう……！」
PRINTFORMW 「大したことないわね」	PRINTFORMW 「大したことないわね」
PRINTFORMW 「お話になりませんわ」	PRINTFORMW 「お話になりませんわ」
PRINTFORM 　だから……今のうちにっ	PRINTFORM 　だから……今のうちにっ
PRINTFORM 「こ、こんなのぉ、ひんっ	PRINTFORM 「こ、こんなのぉ、ひんっ
PRINTFORM 「は、はなれなさいぃ……	PRINTFORM 「は、はなれなさいぃ……
PRINTFORMDW 紫は更に消耗した……	PRINTFORMDW 紫は更に消耗した……
PRINTFORM 　あああああああぁぁぁっ	PRINTFORM 　あああああああぁぁぁっ
PRINTFORMW 「準備体操の時間です」	PRINTFORMW 「準備体操の時間です」
PRINTFORMW 「耐えられるかしら？」	PRINTFORMW 「耐えられるかしら？」
PRINTFORMW からお話を聞きました。	PRINTFORMW からお話を聞きました。
PRINTFORMW 「疾く往ぬがいい！」	PRINTFORMW 「疾く往ぬがいい！」
PRINTFORMW 「この程度で十分よ」	PRINTFORMW 「この程度で十分よ」
PRINTFORMW ちょっと待ちなさい」	PRINTFORMW ちょっと待ちなさい」
PRINTFORMW 「……………………」	PRINTFORMW 「……………………」
PRINTFORMW 「これで一段落……」	PRINTFORMW 「これで一段落……」
PRINTFORMDW 「あの……紫様？」	PRINTFORMDW 「あの……紫様？」
PRINTFORMW 「みのがし、て……」	PRINTFORMW 「みのがし、て……」
PRINTFORMW 「ゃ……やめっ……」	PRINTFORMW 「ゃ……やめっ……」
PRINTFORMW 「――――――――」	PRINTFORMW 「――――――――」
PRINTFORML 「あ……この感覚……	PRINTFORML 「あ……この感覚……
PRINTFORML 「き、える、の……？	PRINTFORML 「き、える、の……？
PRINTFORML 「……失敗したわね」	PRINTFORML 「……失敗したわね」
PRINTFORMW 「ほら、真っ二つ！」	PRINTFORMW 「ほら、真っ二つ！」
PRINTFORMW 「…………は、んっ」	PRINTFORMW 「…………は、んっ」
PRINTFORMW 「お触りは禁止です」	PRINTFORMW 「お触りは禁止です」
PRINTFORMW 「も……だ、め……」	PRINTFORMW 「も……だ、め……」
PRINTFORMW 「やったわね……！」	PRINTFORMW 「やったわね……！」
PRINTFORMW 「あれれ、服が……」	PRINTFORMW 「あれれ、服が……」
PRINTFORMW 「――消えなさい」	PRINTFORMW 「――消えなさい」
PRINTFORMW 「――ふん、だ！」	PRINTFORMW 「――ふん、だ！」
PRINTFORMW 「つ、疲れた……」	PRINTFORMW 「つ、疲れた……」
PRINTFORMW 「……妙な真似を」	PRINTFORMW 「……妙な真似を」
PRINTFORMW 「……作戦ミスね」	PRINTFORMW 「……作戦ミスね」
PRINTFORML 「…………ぐっ……	PRINTFORML 「…………ぐっ……
PRINTFORMW 「……目障りよ」	PRINTFORMW 「……目障りよ」
PRINTFORMDW 食事が始まる。	PRINTFORMDW 食事が始まる。
PRINTFORMW 「なっ……！？」	PRINTFORMW 「なっ……！？」
PRINTFORMW 「――あっ！？」	PRINTFORMW 「――あっ！？」
PRINTFORMW 「…………筆？」	PRINTFORMW 「…………筆？」
PRINTFORMW 「……えっと？」	PRINTFORMW 「……えっと？」
PRINTFORMW 「………………」	PRINTFORMW 「………………」
PRINTFORMW 「う……ぁ……」	PRINTFORMW 「う……ぁ……」
PRINTFORMW 「ま、まずい！」	PRINTFORMW 「ま、まずい！」
PRINTFORM 「んぅっ、はぁ……	PRINTFORM 「んぅっ、はぁ……
PRINTFORM 「あらあら、こんな	PRINTFORM 「あらあら、こんな
PRINTFORMW 「ええ、喜んで」	PRINTFORMW 「ええ、喜んで」
PRINTFORMW 「…………むっ」	PRINTFORMW 「…………むっ」
PRINTFORMDL [1] いいえ	PRINTFORMDL [1] いいえ
PRINTFORML 「う……あっ……	PRINTFORML 「う……あっ……
PRINTFORMW 　もっとぉ……」	PRINTFORMW 　もっとぉ……」
PRINTFORM 「これが……母さま	PRINTFORM 「これが……母さま
PRINTFORMW 「前に出ます！」	PRINTFORMW 「前に出ます！」
PRINTFORMW 「――これで！」	PRINTFORMW 「――これで！」
PRINTFORMW 「行きますよ？」	PRINTFORMW 「行きますよ？」
PRINTFORMW 「捉えました！」	PRINTFORMW 「捉えました！」
PRINTFORMW 「……やん……」	PRINTFORMW 「……やん……」
PRINTFORM 「あぁ、はぁっ……	PRINTFORM 「あぁ、はぁっ……
PRINTFORMW 「行くわよ？」	PRINTFORMW 「行くわよ？」
PRINTFORMW 「降り注げ！」	PRINTFORMW 「降り注げ！」
PRINTFORMW 　また、ね？」	PRINTFORMW 　また、ね？」
PRINTFORMW 「消えなさい」	PRINTFORMW 「消えなさい」
PRINTFORMW 「あ……！？」	PRINTFORMW 「あ……！？」
PRINTFORMW 「馬鹿な……」	PRINTFORMW 「馬鹿な……」
PRINTFORMW 「構えなさい」	PRINTFORMW 「構えなさい」
PRINTFORMW 「…………っ」	PRINTFORMW 「…………っ」
PRINTFORMDL [0] はい	PRINTFORMDL [0] はい
PRINTFORMW 「……………」	PRINTFORMW 「……………」
PRINTFORMW 「後退します」	PRINTFORMW 「後退します」
PRINTFORMW 「ぁぐっ……」	PRINTFORMW 「ぁぐっ……」
PRINTFORMW 「やる……！」	PRINTFORMW 「やる……！」
PRINTFORMW 「はい……♪」	PRINTFORMW 「はい……♪」
PRINTFORMW 「……さて」	PRINTFORMW 「……さて」
PRINTFORMW 「――え？」	PRINTFORMW 「――え？」
PRINTFORMW 「……そう」	PRINTFORMW 「……そう」
PRINTFORMW 「…………」	PRINTFORMW 「…………」
PRINTFORMDL 屈みこむ。	PRINTFORMDL 屈みこむ。
PRINTFORMDW 一ヶ月後。	PRINTFORMDW 一ヶ月後。
PRINTFORMW 「母さま！」	PRINTFORMW 「母さま！」
PRINTFORMW 「そう、筆」	PRINTFORMW 「そう、筆」
PRINTFORMDW その時は。	PRINTFORMDW その時は。
PRINTFORMW 「……ふん」	PRINTFORMW 「……ふん」
PRINTFORML 「…………」	PRINTFORML 「…………」
PRINTFORMW 「――祓え」	PRINTFORMW 「――祓え」
PRINTFORMW 「い・や♪」	PRINTFORMW 「い・や♪」
PRINTFORM 　は……あぁっ	PRINTFORM 　は……あぁっ
PRINTFORM 　はひぃいぃっ	PRINTFORM 　はひぃいぃっ
PRINTFORM 　んむぅっ……	PRINTFORM 　んむぅっ……
PRINTFORMDW …………	PRINTFORMDW …………
PRINTFORMD それを見た	PRINTFORMD それを見た
PRINTFORMW 「う……」	PRINTFORMW 「う……」
PRINTFORM 「はぁっ……	PRINTFORM 「はぁっ……
PRINTFORMD （見た目）	PRINTFORMD （見た目）
PRINTFORMW 「ぁ……」	PRINTFORMW 「ぁ……」
PRINTFORM 　はぁっ……	PRINTFORM 　はぁっ……
PRINTFORMD そのまま	PRINTFORMD そのまま
PRINTFORMDW ………	PRINTFORMDW ………
PRINTFORMW 「！？」	PRINTFORMW 「！？」
PRINTFORML 「礼儀。	PRINTFORML 「礼儀。
PRINTFORM 「こんなっ	PRINTFORM 「こんなっ
PRINTFORMW 「ふん」	PRINTFORMW 「ふん」
PRINTFORM 　はっ……	PRINTFORM 　はっ……
PRINTFORM 「あぁんっ	PRINTFORM 「あぁんっ
PRINTFORMDW ……	PRINTFORMDW ……
PRINTFORMW 「！」	PRINTFORMW 「！」
PRINTFORM 「は……	PRINTFORM 「は……
PRINTFORM 　ああっ	PRINTFORM 　ああっ
PRINTFORM 「あんっ	PRINTFORM 「あんっ
PRINTFORM 「はんっ	PRINTFORM 「はんっ
PRINTFORM 　うあぁ	PRINTFORM 　うあぁ
PRINTFORMDW …	PRINTFORMDW …
PRINTFORM 　うあ	PRINTFORM 　うあ
PRINTFORM 　はっ	PRINTFORM 　はっ
PRINTFORM 「はっ	PRINTFORM 「はっ
PRINTFORM 　おっ	PRINTFORM 　おっ
PRINTFORM 母さま	PRINTFORM 母さま
PRINTFORM 「はぁ	PRINTFORM 「はぁ
PRINTFORMW 　」	PRINTFORMW 　」
PRINTFORMW ）	PRINTFORMW ）
PRINTFORMD 達	PRINTFORMD 達
PRINTFORMDL 	PRINTFORMDL 
PRINTFORMW 」	PRINTFORMW 」
PRINTFORMDW 	PRINTFORMDW 
PRINTFORMW 「	PRINTFORMW 「
PRINTFORMW 』	PRINTFORMW 』
PRINTFORM 「あ	PRINTFORM 「あ
PRINTFORML  	PRINTFORML  
PRINTFORMW 。	PRINTFORMW 。
PRINTFORML 	PRINTFORML 
PRINTFORMW 	PRINTFORMW 
PRINTFORMW	PRINTFORMW
