//口上:

PRINTFORMDW %CALLNAME:TARGET%は変なポーズをとった。　どうやら催眠が効いているようだ…	PRINTFORMDW %CALLNAME:TARGET%は変なポーズをとった。　どうやら催眠が効いているようだ…
PRINTFORMDW %CALLNAME:TARGET%はいやらしく腰を振っている…　シッカリ効いているようだ	PRINTFORMDW %CALLNAME:TARGET%はいやらしく腰を振っている…　シッカリ効いているようだ
PRINTFORMW 「んお˝おぉ❤精液きてるっ…でりゅぅううぅ！！」（ﾋﾞｭｰﾙﾙｩｯ、ﾋﾞｭｸﾋﾞｭｸ…！）	PRINTFORMW 「んお˝おぉ❤精液きてるっ…でりゅぅううぅ！！」（ﾋﾞｭｰﾙﾙｩｯ、ﾋﾞｭｸﾋﾞｭｸ…！）
PRINTFORMW 「これが私たちの『セックス見せつけ攻撃』だ！シッカリ見ろ！」（ｼﾞｭｯﾌﾟｽﾞｯﾌﾟ❤）	PRINTFORMW 「これが私たちの『セックス見せつけ攻撃』だ！シッカリ見ろ！」（ｼﾞｭｯﾌﾟｽﾞｯﾌﾟ❤）
PRINTFORMW 「これが私たちの『公開おまんこ合わせ攻撃』だ！ちゃんと見とけ！」（ｸﾞﾘｯｸﾞﾘﾘｯ❤）	PRINTFORMW 「これが私たちの『公開おまんこ合わせ攻撃』だ！ちゃんと見とけ！」（ｸﾞﾘｯｸﾞﾘﾘｯ❤）
PRINTFORMW （ﾁｭﾌﾟﾁｭﾌﾟ…ﾌﾟﾊｯ）「どうだ、私のベロチューテクの恐ろしさに声も出まい！」	PRINTFORMW （ﾁｭﾌﾟﾁｭﾌﾟ…ﾌﾟﾊｯ）「どうだ、私のベロチューテクの恐ろしさに声も出まい！」
PRINTFORMW 「じゃ、いくよ❤　…はーい、きょにゅーパイズリ～❤」（ﾆｭﾌﾟﾆｭﾌﾟﾆｭﾌﾟ…❤）	PRINTFORMW 「じゃ、いくよ❤　…はーい、きょにゅーパイズリ～❤」（ﾆｭﾌﾟﾆｭﾌﾟﾆｭﾌﾟ…❤）
PRINTFORMW 「じゃ、いくよ❤　…ほーら、パイズリおにだぞ～、ガオー❤」（ｼｭｺｼｭｺｼｭｺ…❤）	PRINTFORMW 「じゃ、いくよ❤　…ほーら、パイズリおにだぞ～、ガオー❤」（ｼｭｺｼｭｺｼｭｺ…❤）
PRINTFORMW 「ね～ぇ…%CALLNAME:TARGET%、いっぱいエッチな事してほしーなー❤」	PRINTFORMW 「ね～ぇ…%CALLNAME:TARGET%、いっぱいエッチな事してほしーなー❤」
PRINTFORMDL %CALLNAME:TARGET%は自分の陰茎を弄りたくてしょうがないようだ…	PRINTFORMDL %CALLNAME:TARGET%は自分の陰茎を弄りたくてしょうがないようだ…
PRINTFORMW 「一体誰が…こんな場所に呼び寄せて、伊吹瓢を盗んで、能力の封印までするなんて…」	PRINTFORMW 「一体誰が…こんな場所に呼び寄せて、伊吹瓢を盗んで、能力の封印までするなんて…」
PRINTFORMDW そう良いながら%CALLNAME:TARGET%は相手に向かって走っている…	PRINTFORMDW そう良いながら%CALLNAME:TARGET%は相手に向かって走っている…
PRINTFORMW 「よし、効いてるぞ！あいつは私たちの『レズセックス見せつけ攻撃』に釘付けだ！」	PRINTFORMW 「よし、効いてるぞ！あいつは私たちの『レズセックス見せつけ攻撃』に釘付けだ！」
PRINTFORMDW 狂わされた%CALLNAME:TARGET%の頭は痛みをも快楽に変えている…	PRINTFORMDW 狂わされた%CALLNAME:TARGET%の頭は痛みをも快楽に変えている…
PRINTFORMDL しかし、いつもの怪力が発揮できない。おまけに萃める能力さえも封じられていた。	PRINTFORMDL しかし、いつもの怪力が発揮できない。おまけに萃める能力さえも封じられていた。
PRINTFORML （絶対セックスされる…！　おまんこパンパンして…子宮にズコズコ挿入れて…❤）	PRINTFORML （絶対セックスされる…！　おまんこパンパンして…子宮にズコズコ挿入れて…❤）
PRINTFORML （紫は簡単にやられるような奴じゃない…奴ら想像以上にやばいのかもしれん…！）	PRINTFORML （紫は簡単にやられるような奴じゃない…奴ら想像以上にやばいのかもしれん…！）
PRINTFORMDW %CALLNAME:TARGET%は熱にうかされ腰を前後に揺らしている…	PRINTFORMDW %CALLNAME:TARGET%は熱にうかされ腰を前後に揺らしている…
PRINTFORMW 「寝てる間は舐めるなりハメるなり自由にしろ！じゃオヤスミ！…ｸﾞｶﾞｧ…」	PRINTFORMW 「寝てる間は舐めるなりハメるなり自由にしろ！じゃオヤスミ！…ｸﾞｶﾞｧ…」
PRINTFORMW 「私の必殺技を見せてやる…『フミフミ足コキ地獄』をな！」（ｸﾞﾆｸﾞﾆ！）	PRINTFORMW 「私の必殺技を見せてやる…『フミフミ足コキ地獄』をな！」（ｸﾞﾆｸﾞﾆ！）
PRINTFORMDW %CALLNAME:TARGET%は一心不乱に股間を押し付け合っている…	PRINTFORMDW %CALLNAME:TARGET%は一心不乱に股間を押し付け合っている…
PRINTFORML （ﾋﾞｸｯ、ﾌﾟｼｨｯ❤）「なんだ？鬼が潮吹きするのは当たり前じゃないか」	PRINTFORML （ﾋﾞｸｯ、ﾌﾟｼｨｯ❤）「なんだ？鬼が潮吹きするのは当たり前じゃないか」
PRINTFORMDW %CALLNAME:TARGET%は癇癪を起こして弾をばら撒いている！	PRINTFORMDW %CALLNAME:TARGET%は癇癪を起こして弾をばら撒いている！
PRINTFORMW 「やぁん❤くっさーいおちんぽ❤…臭いのぜーんぶﾁｭｳﾁｭｳしちゃうね♪」	PRINTFORMW 「やぁん❤くっさーいおちんぽ❤…臭いのぜーんぶﾁｭｳﾁｭｳしちゃうね♪」
PRINTFORMW 「じゃ、いくよ❤　…はーい、ひんにゅーパイズリ～❤」（ｺｼｺｼｺｼ…❤）	PRINTFORMW 「じゃ、いくよ❤　…はーい、ひんにゅーパイズリ～❤」（ｺｼｺｼｺｼ…❤）
PRINTFORML （ﾋﾞｸｯ、ﾋﾞｭﾙｩ❤）「なんだ？鬼が射精するのは当たり前じゃないか」	PRINTFORML （ﾋﾞｸｯ、ﾋﾞｭﾙｩ❤）「なんだ？鬼が射精するのは当たり前じゃないか」
PRINTFORMDW %CALLNAME:TARGET%は快楽に震えながら力を溜めている！	PRINTFORMDW %CALLNAME:TARGET%は快楽に震えながら力を溜めている！
PRINTFORMDW %CALLNAME:TARGET%は熱にうかされ陰茎を揺らしている…	PRINTFORMDW %CALLNAME:TARGET%は熱にうかされ陰茎を揺らしている…
PRINTFORMDW %CALLNAME:TARGET%は熱にうかされ女性器を広げている…	PRINTFORMDW %CALLNAME:TARGET%は熱にうかされ女性器を広げている…
PRINTFORMW 「今からオナニーするからな！しっかり見とけよ！」（ｸﾞｯﾁｭｸﾁｭ❤）	PRINTFORMW 「今からオナニーするからな！しっかり見とけよ！」（ｸﾞｯﾁｭｸﾁｭ❤）
PRINTFORMDW %CALLNAME:TARGET%は想定外の事態にオロオロしている…	PRINTFORMDW %CALLNAME:TARGET%は想定外の事態にオロオロしている…
PRINTFORMDL %CALLNAME:TARGET%は悩まし気に体をくねらせている……	PRINTFORMDL %CALLNAME:TARGET%は悩まし気に体をくねらせている……
PRINTFORMDL %CALLNAME:TARGET%は恨めしそうに自分の腹を見ている…	PRINTFORMDL %CALLNAME:TARGET%は恨めしそうに自分の腹を見ている…
PRINTFORMDW 萃香は迷宮を脱出するため、そして元凶をぶっ飛ばすため、立ち上がった。	PRINTFORMDW 萃香は迷宮を脱出するため、そして元凶をぶっ飛ばすため、立ち上がった。
PRINTFORMW 「脱がしにかかるならまだしも、操って脱がせるなんて…悪趣味野郎…！」	PRINTFORMW 「脱がしにかかるならまだしも、操って脱がせるなんて…悪趣味野郎…！」
PRINTFORMW 「そ、それだけは！いやだ！やめてくれぇ！……ングウウゥウゥーー！！」	PRINTFORMW 「そ、それだけは！いやだ！やめてくれぇ！……ングウウゥウゥーー！！」
PRINTFORMW 「んおぉおお❤お膣にっ❤孕ませ汁がドックドクきてりゅうぅううぅ❤❤」	PRINTFORMW 「んおぉおお❤お膣にっ❤孕ませ汁がドックドクきてりゅうぅううぅ❤❤」
PRINTFORMW 「言っとくけど、全力じゃないからな？全力ならとっくに消し飛んでるぞ」	PRINTFORMW 「言っとくけど、全力じゃないからな？全力ならとっくに消し飛んでるぞ」
PRINTFORMDW %CALLNAME:TARGET%はほんの少しだけ背筋が寒くなった	PRINTFORMDW %CALLNAME:TARGET%はほんの少しだけ背筋が寒くなった
PRINTFORMW 「あそうだ、博麗神社に置いてあった玉だ！…持って帰って神社に返そう」	PRINTFORMW 「あそうだ、博麗神社に置いてあった玉だ！…持って帰って神社に返そう」
PRINTFORML 「…Zzz…次の、曲は…伸び伸び…耳たぶのテーマ……ｽﾋﾟｽﾋﾟ…」	PRINTFORML 「…Zzz…次の、曲は…伸び伸び…耳たぶのテーマ……ｽﾋﾟｽﾋﾟ…」
PRINTFORMDL 今までの萃香は、気ままにうろつき酒を飲む、気楽な日常を送っていた。	PRINTFORMDL 今までの萃香は、気ままにうろつき酒を飲む、気楽な日常を送っていた。
PRINTFORMDW %CALLNAME:TARGET%は熱にうかされ尻を振っている…	PRINTFORMDW %CALLNAME:TARGET%は熱にうかされ尻を振っている…
PRINTFORMDW %CALLNAME:TARGET%は熱にうかされ乳を揉んでいる…	PRINTFORMDW %CALLNAME:TARGET%は熱にうかされ乳を揉んでいる…
PRINTFORMW 「眠姦したいの？…わかった～！寝てるから好きにしてね❤…ぐぅ…❤」	PRINTFORMW 「眠姦したいの？…わかった～！寝てるから好きにしてね❤…ぐぅ…❤」
PRINTFORMDW %CALLNAME:TARGET%はまともに食らってむせている…	PRINTFORMDW %CALLNAME:TARGET%はまともに食らってむせている…
PRINTFORMDW %CALLNAME:TARGET%は蟹股でポージングをしている…	PRINTFORMDW %CALLNAME:TARGET%は蟹股でポージングをしている…
PRINTFORMW 「萃香ちゃんのストリップショーがそんなに見たいの～？嬉しいな～❤」	PRINTFORMW 「萃香ちゃんのストリップショーがそんなに見たいの～？嬉しいな～❤」
PRINTFORMDL %CALLNAME:TARGET%は大きく膨れた自分の腹を見た…	PRINTFORMDL %CALLNAME:TARGET%は大きく膨れた自分の腹を見た…
PRINTFORMDL %CALLNAME:TARGET%は股間から愛液を垂らしている…	PRINTFORMDL %CALLNAME:TARGET%は股間から愛液を垂らしている…
PRINTFORML 「無茶苦茶に酔った時でも、裸になった事なんて無いよ…恥ずかしい…」	PRINTFORML 「無茶苦茶に酔った時でも、裸になった事なんて無いよ…恥ずかしい…」
PRINTFORMDW が、今日は違った。目が覚めて伸びをすると、そこは迷宮の中だった。	PRINTFORMDW が、今日は違った。目が覚めて伸びをすると、そこは迷宮の中だった。
PRINTFORML 「…まぁいいか。相手が誰だろうと、こんな事されて黙ってられるか！」	PRINTFORML 「…まぁいいか。相手が誰だろうと、こんな事されて黙ってられるか！」
PRINTFORMDW %CALLNAME:TARGET%は身を震わせながら守っている	PRINTFORMDW %CALLNAME:TARGET%は身を震わせながら守っている
PRINTFORMW 「お、おらおら！催眠なんか関係あるか！」（ﾄﾞｶﾊﾞｷﾎﾞｺ！）	PRINTFORMW 「お、おらおら！催眠なんか関係あるか！」（ﾄﾞｶﾊﾞｷﾎﾞｺ！）
PRINTFORMW 「いいの？踏みつけすぎても知らないよ？」（ｹﾞｼｯ！ｸﾞｼｬ！）	PRINTFORMW 「いいの？踏みつけすぎても知らないよ？」（ｹﾞｼｯ！ｸﾞｼｬ！）
PRINTFORMW 「おイタしちゃだ～め❤後でゆっくりさせてあげるから我慢してね❤」	PRINTFORMW 「おイタしちゃだ～め❤後でゆっくりさせてあげるから我慢してね❤」
PRINTFORMW 「口まんこでビュービュー口内出しさせてやる！精々たっぷり出せ！」	PRINTFORMW 「口まんこでビュービュー口内出しさせてやる！精々たっぷり出せ！」
PRINTFORMW （何でこんなことしてるんだろ…でも、ちょっとだけならいいか…❤）	PRINTFORMW （何でこんなことしてるんだろ…でも、ちょっとだけならいいか…❤）
PRINTFORMDW %CALLNAME:TARGET%は一心不乱に腰を振っている…	PRINTFORMDW %CALLNAME:TARGET%は一心不乱に腰を振っている…
PRINTFORMDW %CALLNAME:TARGET%は憎らしげに相手を睨んでいる	PRINTFORMDW %CALLNAME:TARGET%は憎らしげに相手を睨んでいる
PRINTFORMDW %CALLNAME:TARGET%の体は脱力し、グッタリした…	PRINTFORMDW %CALLNAME:TARGET%の体は脱力し、グッタリした…
PRINTFORMDW %CALLNAME:TARGET%は仲間に引きずられて助かった	PRINTFORMDW %CALLNAME:TARGET%は仲間に引きずられて助かった
PRINTFORMW 「へ？またあった…そんなにホイホイ無い筈なんだけど…あれぇ？？」	PRINTFORMW 「へ？またあった…そんなにホイホイ無い筈なんだけど…あれぇ？？」
PRINTFORMDW %CALLNAME:TARGET%は真顔のまま潮を吹いている…	PRINTFORMDW %CALLNAME:TARGET%は真顔のまま潮を吹いている…
PRINTFORMW 「ぐっ…で、出る…ふあぁぁあぁうっ❤」（ﾄﾞﾌﾟﾌﾟﾌﾟｩｯ❤）	PRINTFORMW 「ぐっ…で、出る…ふあぁぁあぁうっ❤」（ﾄﾞﾌﾟﾌﾟﾌﾟｩｯ❤）
PRINTFORMDW %CALLNAME:TARGET%は愛液をまき散らし絶頂した！	PRINTFORMDW %CALLNAME:TARGET%は愛液をまき散らし絶頂した！
PRINTFORML 「（ｽﾔｽﾔ）……くらえ…50文、キックゥ……（ｸﾞｳｸﾞｳ）」	PRINTFORML 「（ｽﾔｽﾔ）……くらえ…50文、キックゥ……（ｸﾞｳｸﾞｳ）」
PRINTFORML 「……サンタさん？…なんだ…社長だったのかぁ……ｸﾞｩｸﾞｩ…」	PRINTFORML 「……サンタさん？…なんだ…社長だったのかぁ……ｸﾞｩｸﾞｩ…」
PRINTFORMDL %CALLNAME:TARGET%はどうにかしようとしている…	PRINTFORMDL %CALLNAME:TARGET%はどうにかしようとしている…
PRINTFORMDW %CALLNAME:TARGET%は尻を突き出しアピールした	PRINTFORMDW %CALLNAME:TARGET%は尻を突き出しアピールした
PRINTFORMDW %CALLNAME:TARGET%は胸を突き出しアピールした	PRINTFORMDW %CALLNAME:TARGET%は胸を突き出しアピールした
PRINTFORMDW %CALLNAME:TARGET%は腰を突き出しアピールした	PRINTFORMDW %CALLNAME:TARGET%は腰を突き出しアピールした
PRINTFORMW 「あれ？エッチしちゃダメなんだっけ？…うぅ、分かんない…っ！」	PRINTFORMW 「あれ？エッチしちゃダメなんだっけ？…うぅ、分かんない…っ！」
PRINTFORMDW %CALLNAME:TARGET%はそのままパーではたいた！	PRINTFORMDW %CALLNAME:TARGET%はそのままパーではたいた！
PRINTFORMW 「孕ませてぇっ❤淫乱チビっ子鬼にもっとお仕置き種付けしてぇ❤」	PRINTFORMW 「孕ませてぇっ❤淫乱チビっ子鬼にもっとお仕置き種付けしてぇ❤」
PRINTFORMDW %CALLNAME:TARGET%は熱っぽい視線で敵を見た…	PRINTFORMDW %CALLNAME:TARGET%は熱っぽい視線で敵を見た…
PRINTFORMDW %CALLNAME:TARGET%は白濁液を舐め取っている…	PRINTFORMDW %CALLNAME:TARGET%は白濁液を舐め取っている…
PRINTFORMW 「一応まだ元気みたいね。まぁ紫に限ってやられるへまはしないか」	PRINTFORMW 「一応まだ元気みたいね。まぁ紫に限ってやられるへまはしないか」
PRINTFORMW 「これは…服か！ここじゃ幾つ有っても足りなそうだし取っとこう」	PRINTFORMW 「これは…服か！ここじゃ幾つ有っても足りなそうだし取っとこう」
PRINTFORMDW %CALLNAME:TARGET%は真顔のまま射精している…	PRINTFORMDW %CALLNAME:TARGET%は真顔のまま射精している…
PRINTFORMW 「今からっ、絶頂、しましゅ…！　…ふあぁぁああぁぁあぁ～～❤」	PRINTFORMW 「今からっ、絶頂、しましゅ…！　…ふあぁぁああぁぁあぁ～～❤」
PRINTFORMW 「い、イクぅ❤すいかのお潮吹き、見ててねぇ…イクぅうぅぅ！！」	PRINTFORMW 「い、イクぅ❤すいかのお潮吹き、見ててねぇ…イクぅうぅぅ！！」
PRINTFORMW 「ぐっ…い、イク…ふあぁぁあぁうっ❤」（ﾌﾟｼ、ﾌﾟｼｨｯ❤）	PRINTFORMW 「ぐっ…い、イク…ふあぁぁあぁうっ❤」（ﾌﾟｼ、ﾌﾟｼｨｯ❤）
PRINTFORMDW %CALLNAME:TARGET%は精液をぶちまけ絶頂した！	PRINTFORMDW %CALLNAME:TARGET%は精液をぶちまけ絶頂した！
PRINTFORMDW %CALLNAME:TARGET%は涙を流しながら絶頂した…	PRINTFORMDW %CALLNAME:TARGET%は涙を流しながら絶頂した…
PRINTFORMDW %CALLNAME:TARGET%は滅茶苦茶に撃っている！	PRINTFORMDW %CALLNAME:TARGET%は滅茶苦茶に撃っている！
PRINTFORMDW %CALLNAME:TARGET%はだらしなく笑っている…	PRINTFORMDW %CALLNAME:TARGET%はだらしなく笑っている…
PRINTFORML 「お前の催眠なんか効くわけないだろ、マヌケ！」（ﾌﾘﾌﾘ❤）	PRINTFORML 「お前の催眠なんか効くわけないだろ、マヌケ！」（ﾌﾘﾌﾘ❤）
PRINTFORMW 「イチャイチャするの楽しー❤もっと♪もっと激しく来てぇ❤❤」	PRINTFORMW 「イチャイチャするの楽しー❤もっと♪もっと激しく来てぇ❤❤」
PRINTFORMW 「おっおっおほぅっ❤出ちゃうっ❤しゃせーしちゃうのおぉ❤❤」	PRINTFORMW 「おっおっおほぅっ❤出ちゃうっ❤しゃせーしちゃうのおぉ❤❤」
PRINTFORMDW %CALLNAME:TARGET%の体の火照りは最高潮だ！	PRINTFORMDW %CALLNAME:TARGET%の体の火照りは最高潮だ！
PRINTFORML 「いい加減諦めろよ。お前の催眠なんか効くか！」（ﾍｺﾍｺ❤）	PRINTFORML 「いい加減諦めろよ。お前の催眠なんか効くか！」（ﾍｺﾍｺ❤）
PRINTFORMDW %CALLNAME:TARGET%は自ら体液を吸っている…	PRINTFORMDW %CALLNAME:TARGET%は自ら体液を吸っている…
PRINTFORMDW %CALLNAME:TARGET%は美味そうに飲んでいる…	PRINTFORMDW %CALLNAME:TARGET%は美味そうに飲んでいる…
PRINTFORMW 「鬼に喧嘩売ってその程度で済んだんだから、ありがたく思え！」	PRINTFORMW 「鬼に喧嘩売ってその程度で済んだんだから、ありがたく思え！」
PRINTFORMDW %CALLNAME:TARGET%は仲間に置いて行かれた…	PRINTFORMDW %CALLNAME:TARGET%は仲間に置いて行かれた…
PRINTFORMDW %CALLNAME:TARGET%は疑いの目を向けている…	PRINTFORMDW %CALLNAME:TARGET%は疑いの目を向けている…
PRINTFORMW 「……いやすまんすまん。天界の事スッカリ忘れててね…ハハハ」	PRINTFORMW 「……いやすまんすまん。天界の事スッカリ忘れててね…ハハハ」
PRINTFORMDW %CALLNAME:TARGET%は殺意を露わにしている…	PRINTFORMDW %CALLNAME:TARGET%は殺意を露わにしている…
PRINTFORMDW %CALLNAME:TARGET%は辛うじて助かったようだ	PRINTFORMDW %CALLNAME:TARGET%は辛うじて助かったようだ
PRINTFORML 「へッ……ヘキシィッ！　…う～、流石に裸だと風邪ひくかも…」	PRINTFORML 「へッ……ヘキシィッ！　…う～、流石に裸だと風邪ひくかも…」
PRINTFORMDW 昨日も日課の酒盛りを終え、いつものように眠りについていた。	PRINTFORMDW 昨日も日課の酒盛りを終え、いつものように眠りについていた。
PRINTFORMDW %CALLNAME:TARGET%は股を開きアピールした	PRINTFORMDW %CALLNAME:TARGET%は股を開きアピールした
PRINTFORMW 「こんなちゃちな催眠なんかで…鬼の動きが止まるかぁ…っ！」	PRINTFORMW 「こんなちゃちな催眠なんかで…鬼の動きが止まるかぁ…っ！」
PRINTFORMW 「脈打ってて、たくましい…❤　早くパンパンしたいなぁ～❤」	PRINTFORMW 「脈打ってて、たくましい…❤　早くパンパンしたいなぁ～❤」
PRINTFORMW 「もっとぉ❤変態すいかをもっとブッ叩いてドＭにしてぇ～❤」	PRINTFORMW 「もっとぉ❤変態すいかをもっとブッ叩いてドＭにしてぇ～❤」
PRINTFORMW 「おごご…❤　キツイっ❤ロリまんこにギチギチ来てるぅっ❤」	PRINTFORMW 「おごご…❤　キツイっ❤ロリまんこにギチギチ来てるぅっ❤」
PRINTFORMW （あぁ…チャポチャポ言ってる…どんだけ出すんだっ…///）	PRINTFORMW （あぁ…チャポチャポ言ってる…どんだけ出すんだっ…///）
PRINTFORML 「…？何も起きないじゃない、こけおどしか何か？」（ｸｲｯ）	PRINTFORML 「…？何も起きないじゃない、こけおどしか何か？」（ｸｲｯ）
PRINTFORML （あ…あ…❤　もう頭が、グルグル～ってして…ダメだぁ…❤）	PRINTFORML （あ…あ…❤　もう頭が、グルグル～ってして…ダメだぁ…❤）
PRINTFORMW 「萃香ちゃんのスッポンポン姿だよ❤しっかり見てってね～❤」	PRINTFORMW 「萃香ちゃんのスッポンポン姿だよ❤しっかり見てってね～❤」
PRINTFORMW （滅茶苦茶に頑丈な体を持ってたはずだが…どういうことだ…）	PRINTFORMW （滅茶苦茶に頑丈な体を持ってたはずだが…どういうことだ…）
PRINTFORMDW %CALLNAME:TARGET%は慌てふためいている…	PRINTFORMDW %CALLNAME:TARGET%は慌てふためいている…
PRINTFORMW 「…まさか、知ってる人のじゃあないよね…？考えすぎかね？」	PRINTFORMW 「…まさか、知ってる人のじゃあないよね…？考えすぎかね？」
PRINTFORMW 「すいか、イきますぅ❤変態アクメキメましゅうぅうー！❤❤」	PRINTFORMW 「すいか、イきますぅ❤変態アクメキメましゅうぅうー！❤❤」
PRINTFORMW 「犯してぇ…萃香のロリまんこをずっぽずっぽしてぇっ…❤」	PRINTFORMW 「犯してぇ…萃香のロリまんこをずっぽずっぽしてぇっ…❤」
PRINTFORMW 「ストリップ攻撃は鬼の十八番だからな！よ～く見て驚け！」	PRINTFORMW 「ストリップ攻撃は鬼の十八番だからな！よ～く見て驚け！」
PRINTFORML 「なに？もう寝る時間？　…じゃあしょうがない、寝るぞ！」	PRINTFORML 「なに？もう寝る時間？　…じゃあしょうがない、寝るぞ！」
PRINTFORMW 「おかしいぞ…なんか色々間違ってる気が…う、頭がっ…！」	PRINTFORMW 「おかしいぞ…なんか色々間違ってる気が…う、頭がっ…！」
PRINTFORMW 「へし折ってやるぞ！こんな極太おちんぽ！」（ｺﾞｷｨ！）	PRINTFORMW 「へし折ってやるぞ！こんな極太おちんぽ！」（ｺﾞｷｨ！）
PRINTFORML （捕まえたってことは、おまんこパンパンしてくれるんだ❤）	PRINTFORML （捕まえたってことは、おまんこパンパンしてくれるんだ❤）
PRINTFORML 「あへえぇ❤ボテ腹しきゅーにビュクビュク射精されてるぅ❤	PRINTFORML 「あへえぇ❤ボテ腹しきゅーにビュクビュク射精されてるぅ❤
PRINTFORML 「見ないでぇ…おちんぽ大好きな変態になっちゃうよぉ…❤」	PRINTFORML 「見ないでぇ…おちんぽ大好きな変態になっちゃうよぉ…❤」
PRINTFORML （…鬼の力が…及ばない…こんなのに、屈する…なん…て…）	PRINTFORML （…鬼の力が…及ばない…こんなのに、屈する…なん…て…）
PRINTFORMDW %CALLNAME:TARGET%は心底安堵している…	PRINTFORMDW %CALLNAME:TARGET%は心底安堵している…
PRINTFORMW 「な…なんて…ことだ……全滅なんて…嘘だぁ…うっうぅ…」	PRINTFORMW 「な…なんて…ことだ……全滅なんて…嘘だぁ…うっうぅ…」
PRINTFORMW 「れ、霊夢！？しっかり！…息は…ある、か。良かったぁ…」	PRINTFORMW 「れ、霊夢！？しっかり！…息は…ある、か。良かったぁ…」
PRINTFORMW （勇儀程の手練れも呼び寄せるとは…奴ら結構侮れないな…）	PRINTFORMW （勇儀程の手練れも呼び寄せるとは…奴ら結構侮れないな…）
PRINTFORMW 「霊夢のところのお札か。効きそうだが扱う自信が無いな…」	PRINTFORMW 「霊夢のところのお札か。効きそうだが扱う自信が無いな…」
PRINTFORMW 「…こんなにあったっけ…？　まあ全部持って行けばいいか」	PRINTFORMW 「…こんなにあったっけ…？　まあ全部持って行けばいいか」
PRINTFORMW 「もひとつ見っけ！　これが無いとやってられないよね～♪」	PRINTFORMW 「もひとつ見っけ！　これが無いとやってられないよね～♪」
PRINTFORMW （鬼の力だって…無理な時は無理だよね…ぁは……は………）	PRINTFORMW （鬼の力だって…無理な時は無理だよね…ぁは……は………）
PRINTFORML （服も無しで眠気で倒れたら、十中八九犯されるだろうな…）	PRINTFORML （服も無しで眠気で倒れたら、十中八九犯されるだろうな…）
PRINTFORML 「ちんぽがぁ…ビクビクってしてるぅ…❤」（ﾕﾗﾕﾗ❤）	PRINTFORML 「ちんぽがぁ…ビクビクってしてるぅ…❤」（ﾕﾗﾕﾗ❤）
PRINTFORMW 「犯してぇ…ロリ妊婦におちんぽでお仕置きしてぇっ…❤」	PRINTFORMW 「犯してぇ…ロリ妊婦におちんぽでお仕置きしてぇっ…❤」
PRINTFORMW 「うわ、気持ち悪っ…ねっとりじっとりしてる…うえぇ…」	PRINTFORMW 「うわ、気持ち悪っ…ねっとりじっとりしてる…うえぇ…」
PRINTFORML 「つるぺたおっぱいが好きなんて、ロリコンさんだね～❤」	PRINTFORML 「つるぺたおっぱいが好きなんて、ロリコンさんだね～❤」
PRINTFORML 「たぷたぷおっぱいが好きなんて、甘えんぼさんだね～❤」	PRINTFORML 「たぷたぷおっぱいが好きなんて、甘えんぼさんだね～❤」
PRINTFORMW 「おまんまんいじんないでぇ…おっきくなっちゃうよぉ…」	PRINTFORMW 「おまんまんいじんないでぇ…おっきくなっちゃうよぉ…」
PRINTFORMW （膣壁っ❤ゴリゴリ擦られてっ❤気持ちいひぃいいぃ❤❤）	PRINTFORMW （膣壁っ❤ゴリゴリ擦られてっ❤気持ちいひぃいいぃ❤❤）
PRINTFORMDW %CALLNAME:TARGET%は涙を流している…	PRINTFORMDW %CALLNAME:TARGET%は涙を流している…
PRINTFORMW 「ぜぇ…ひゅう…おのれ、力さえ出せればあんな奴ら…！」	PRINTFORMW 「ぜぇ…ひゅう…おのれ、力さえ出せればあんな奴ら…！」
PRINTFORMW 「お！霊夢、こんなところに居たのか！大丈夫だったか？」	PRINTFORMW 「お！霊夢、こんなところに居たのか！大丈夫だったか？」
PRINTFORML 「……見たかこの変態絶頂っぷり！恐ろしくなっただろ！」	PRINTFORML 「……見たかこの変態絶頂っぷり！恐ろしくなっただろ！」
PRINTFORMW 「イッてる！すいかイッてるぅ❤きもちいいいぃ～～！❤」	PRINTFORMW 「イッてる！すいかイッてるぅ❤きもちいいいぃ～～！❤」
PRINTFORML 「さっさと治さないと…取り返しの付かない事になるな…」	PRINTFORML 「さっさと治さないと…取り返しの付かない事になるな…」
PRINTFORML （ｸﾞｲｸﾞｲ）「うえぇ、もうどうしようも無いのか…」	PRINTFORML （ｸﾞｲｸﾞｲ）「うえぇ、もうどうしようも無いのか…」
PRINTFORML （ﾊｯ）「…寝てないぞ。全然。少しも寝てないな。うん」	PRINTFORML （ﾊｯ）「…寝てないぞ。全然。少しも寝てないな。うん」
PRINTFORMDW %CALLNAME:TARGET%はまだ寝ている…	PRINTFORMDW %CALLNAME:TARGET%はまだ寝ている…
PRINTFORMDW %CALLNAME:TARGET%は挑発している！	PRINTFORMDW %CALLNAME:TARGET%は挑発している！
PRINTFORMW 「チクショウ…こんな事してる場合じゃ…ふぃいっ❤！」	PRINTFORMW 「チクショウ…こんな事してる場合じゃ…ふぃいっ❤！」
PRINTFORML 「クリが…ヒクヒクして辛いのぉっ…❤」（ｶｸｶｸ❤）	PRINTFORML 「クリが…ヒクヒクして辛いのぉっ…❤」（ｶｸｶｸ❤）
PRINTFORML （リスクは高いけど…その分油断も誘いやすいはず…！）	PRINTFORML （リスクは高いけど…その分油断も誘いやすいはず…！）
PRINTFORMW 「エッチしてくれるの？やったー❤」（ﾇｷﾞﾇｷﾞ…）	PRINTFORMW 「エッチしてくれるの？やったー❤」（ﾇｷﾞﾇｷﾞ…）
PRINTFORMW 「ペチペチする度に震えちゃって…可愛いおちんちん❤」	PRINTFORMW 「ペチペチする度に震えちゃって…可愛いおちんちん❤」
PRINTFORML 「鬼のおっぱいが好きなんて、怖いもの知らずだね～❤」	PRINTFORML 「鬼のおっぱいが好きなんて、怖いもの知らずだね～❤」
PRINTFORMW 「あっあっ❤出るぅ❤こんなのがまんできないいぃい❤」	PRINTFORMW 「あっあっ❤出るぅ❤こんなのがまんできないいぃい❤」
PRINTFORMW 「あっ…ああぁ…❤」（頭がキモチイイで一杯にぃ…❤）	PRINTFORMW 「あっ…ああぁ…❤」（頭がキモチイイで一杯にぃ…❤）
PRINTFORMDW %CALLNAME:TARGET%は期待している…	PRINTFORMDW %CALLNAME:TARGET%は期待している…
PRINTFORMW （でもなんかちょっと…❤　いやそんなはず無いっ…！）	PRINTFORMW （でもなんかちょっと…❤　いやそんなはず無いっ…！）
PRINTFORMDW %CALLNAME:TARGET%は怖がっている…	PRINTFORMDW %CALLNAME:TARGET%は怖がっている…
PRINTFORMW 「本当に鬼に敵うと思ってたのか？お目出度い奴らだな」	PRINTFORMW 「本当に鬼に敵うと思ってたのか？お目出度い奴らだな」
PRINTFORMW （直接の子でないとは言え、放っとくのは気分が悪いな）	PRINTFORMW （直接の子でないとは言え、放っとくのは気分が悪いな）
PRINTFORMW 「おお、スペルカードだ！…って、一体誰のなんだ…？」	PRINTFORMW 「おお、スペルカードだ！…って、一体誰のなんだ…？」
PRINTFORMW 「矢鱈派手で貧弱そうな棒だなぁ…」（ﾌﾞﾝﾌﾞﾝ…）	PRINTFORMW 「矢鱈派手で貧弱そうな棒だなぁ…」（ﾌﾞﾝﾌﾞﾝ…）
PRINTFORMW 「まぁもってくか、うん。…意外と強いかもしれないし」	PRINTFORMW 「まぁもってくか、うん。…意外と強いかもしれないし」
PRINTFORMW 「お～、こんなところに！無くしたかと思ってたよ～！」	PRINTFORMW 「お～、こんなところに！無くしたかと思ってたよ～！」
PRINTFORMW （このまま壊されて、おもちゃにされるんだ…あはは…）	PRINTFORMW （このまま壊されて、おもちゃにされるんだ…あはは…）
PRINTFORML （うぅダメだ…気を抜くと変なことを想像しちゃう…❤）	PRINTFORML （うぅダメだ…気を抜くと変なことを想像しちゃう…❤）
PRINTFORMW 「ん…んんぅ～っ…！　……え？ここ、ドコ？…洞窟？」	PRINTFORMW 「ん…んんぅ～っ…！　……え？ここ、ドコ？…洞窟？」
PRINTFORMDW さらには片時も手放すことの無い伊吹瓢も消えていた。	PRINTFORMDW さらには片時も手放すことの無い伊吹瓢も消えていた。
PRINTFORML 「妊娠してるのに…満足したいっ…❤」（ｸﾊﾟｧ❤）	PRINTFORML 「妊娠してるのに…満足したいっ…❤」（ｸﾊﾟｧ❤）
PRINTFORMW 「秘儀『肉棒扱き』！鬼の技を食らえ、素敵ちんぽ！」	PRINTFORMW 「秘儀『肉棒扱き』！鬼の技を食らえ、素敵ちんぽ！」
PRINTFORMW 「おらっ❤そらっ❤鬼のちんぽは気持ち良いだろ～♪」	PRINTFORMW 「おらっ❤そらっ❤鬼のちんぽは気持ち良いだろ～♪」
PRINTFORMW 「おちんちんいじんないでぇ…ばかになっちゃうぅ…」	PRINTFORMW 「おちんちんいじんないでぇ…ばかになっちゃうぅ…」
PRINTFORMW 「んおおお！おまんこミチミチ言ってりゅうぅ！！❤」	PRINTFORMW 「んおおお！おまんこミチミチ言ってりゅうぅ！！❤」
PRINTFORMW 「…………」（…もう、玩具にされるのは…嫌だぁ…）	PRINTFORMW 「…………」（…もう、玩具にされるのは…嫌だぁ…）
PRINTFORMW 「たしゅけてえ❤私おかしくされるぅうぅううぅ❤❤」	PRINTFORMW 「たしゅけてえ❤私おかしくされるぅうぅううぅ❤❤」
PRINTFORMW （集中できれば、当たらなかったはずなのにぃっ…❤）	PRINTFORMW （集中できれば、当たらなかったはずなのにぃっ…❤）
PRINTFORMW （迂闊っ…こんな状態の奴狙わない筈が無いのに…！）	PRINTFORMW （迂闊っ…こんな状態の奴狙わない筈が無いのに…！）
PRINTFORMW 「あ˝あぁあ！！中出しっ❤精液出されたあぁっ！❤」	PRINTFORMW 「あ˝あぁあ！！中出しっ❤精液出されたあぁっ！❤」
PRINTFORMW 「ゲホ……ふうっ！？お、おまたが熱いぃっ…///」	PRINTFORMW 「ゲホ……ふうっ！？お、おまたが熱いぃっ…///」
PRINTFORML 「わあっ♪いっぱい出たね～❤」（ﾍﾟﾛﾍﾟﾛ…❤）	PRINTFORML 「わあっ♪いっぱい出たね～❤」（ﾍﾟﾛﾍﾟﾛ…❤）
PRINTFORMW 「こんな状態だからって、油断してんじゃないのか？」	PRINTFORMW 「こんな状態だからって、油断してんじゃないのか？」
PRINTFORMW 「戦闘は避けたかったが…仕方ない、かかって来い！」	PRINTFORMW 「戦闘は避けたかったが…仕方ない、かかって来い！」
PRINTFORMW 「逃げを取らざるを得ないとは…ちょっと悔しいな…」	PRINTFORMW 「逃げを取らざるを得ないとは…ちょっと悔しいな…」
PRINTFORMW 「ゆ…勇儀！？おい、大丈夫か！しっかりしてくれ！」	PRINTFORMW 「ゆ…勇儀！？おい、大丈夫か！しっかりしてくれ！」
PRINTFORMW 「まさか、こんなところで自分の娘に出会うとはね…」	PRINTFORMW 「まさか、こんなところで自分の娘に出会うとはね…」
PRINTFORMW 「え？落としてない？…でも間違いなく博麗神社の？」	PRINTFORMW 「え？落としてない？…でも間違いなく博麗神社の？」
PRINTFORMW 「お！酒だぁ～！！これは有り難い！　お酒♪お酒♪」	PRINTFORMW 「お！酒だぁ～！！これは有り難い！　お酒♪お酒♪」
PRINTFORMDW %CALLNAME:TARGET%は誇らしげだ…	PRINTFORMDW %CALLNAME:TARGET%は誇らしげだ…
PRINTFORML 「………ハズレ…ハズレは、ポン酢…責め…ｽﾔｧ…」	PRINTFORML 「………ハズレ…ハズレは、ポン酢…責め…ｽﾔｧ…」
PRINTFORML （こんなの生やした上に全裸徘徊は流石にマズイ…！）	PRINTFORML （こんなの生やした上に全裸徘徊は流石にマズイ…！）
PRINTFORMW 「鬼を怒らせるとどうなるか、教えてやろうか…！」	PRINTFORMW 「鬼を怒らせるとどうなるか、教えてやろうか…！」
PRINTFORMW （ダメだ…止められないっ…❤）「く…あんっ…❤」	PRINTFORMW （ダメだ…止められないっ…❤）「く…あんっ…❤」
PRINTFORMW 「そっちばっかり攻めててずるいぞ！攻守交代だ❤」	PRINTFORMW 「そっちばっかり攻めててずるいぞ！攻守交代だ❤」
PRINTFORMW 「はぁ…う…悪いな…が、我慢できないんだっ…❤」	PRINTFORMW 「はぁ…う…悪いな…が、我慢できないんだっ…❤」
PRINTFORMW （もうこれ以上、孕まないのだけはましかな…っ❤）	PRINTFORMW （もうこれ以上、孕まないのだけはましかな…っ❤）
PRINTFORML 「はぁ、はぁ…あついぃ…からだ、あちゅいぃ…❤」	PRINTFORML 「はぁ、はぁ…あついぃ…からだ、あちゅいぃ…❤」
PRINTFORMW 「な、なんてもんを…ぐええぇ～っ…絶対許さん！」	PRINTFORMW 「な、なんてもんを…ぐええぇ～っ…絶対許さん！」
PRINTFORML 「おげ、ぐげ…ゲホゲホ、ゲホぉっ！！…うげぇ…」	PRINTFORML 「おげ、ぐげ…ゲホゲホ、ゲホぉっ！！…うげぇ…」
PRINTFORMW （こ、こんな濃厚なの、一気に出すかフツー…っ❤）	PRINTFORMW （こ、こんな濃厚なの、一気に出すかフツー…っ❤）
PRINTFORMW （さっさと倒さんと何されるか分からんからな…！）	PRINTFORMW （さっさと倒さんと何されるか分からんからな…！）
PRINTFORMW 「あ、天人…てんこ、じゃない。てんし、だったな」	PRINTFORMW 「あ、天人…てんこ、じゃない。てんし、だったな」
PRINTFORMW 「……悪かった。人の名前を覚えるのが苦手でね…」	PRINTFORMW 「……悪かった。人の名前を覚えるのが苦手でね…」
PRINTFORML 「……そうか、勇儀も異変に巻き込まれてたのか…」	PRINTFORML 「……そうか、勇儀も異変に巻き込まれてたのか…」
PRINTFORML （あぁ…シたい……エッチなこと…したいっ…！❤）	PRINTFORML （あぁ…シたい……エッチなこと…したいっ…！❤）
PRINTFORML （…敵がいないなら戦闘態勢じゃなくてもいいよね）	PRINTFORML （…敵がいないなら戦闘態勢じゃなくてもいいよね）
PRINTFORML 「酒ぇ～！お酒が飲みたい～、飲み会がしたい～…」	PRINTFORML 「酒ぇ～！お酒が飲みたい～、飲み会がしたい～…」
PRINTFORMW 「…なーんか怪しいな…準備運動でもしておくか！」	PRINTFORMW 「…なーんか怪しいな…準備運動でもしておくか！」
PRINTFORMW 「霧状に撃てれば楽なんだけど…しょうがないか」	PRINTFORMW 「霧状に撃てれば楽なんだけど…しょうがないか」
PRINTFORMDW %CALLNAME:TARGET%は諦めた…	PRINTFORMDW %CALLNAME:TARGET%は諦めた…
PRINTFORML 「あぅ…我慢できないぃ…❤」（ﾓﾐｭﾓﾐｭ❤）	PRINTFORML 「あぅ…我慢できないぃ…❤」（ﾓﾐｭﾓﾐｭ❤）
PRINTFORML （孕んでいる今ならリスクは軽減されてる…か？）	PRINTFORML （孕んでいる今ならリスクは軽減されてる…か？）
PRINTFORMW 「私の全力パイズリで幸せ射精でもするんだな！」	PRINTFORMW 「私の全力パイズリで幸せ射精でもするんだな！」
PRINTFORMW 「く、くそぉ…こんな時にセックスはマズイ…！」	PRINTFORMW 「く、くそぉ…こんな時にセックスはマズイ…！」
PRINTFORMW 「や、やめろ…お尻をっ❤ひぎひぎするなぁ…！」	PRINTFORMW 「や、やめろ…お尻をっ❤ひぎひぎするなぁ…！」
PRINTFORMW 「おむねがあぁあぁ！おがじぐなりゅぅうぅ❤❤」	PRINTFORMW 「おむねがあぁあぁ！おがじぐなりゅぅうぅ❤❤」
PRINTFORMW 「んひいぃいぃやめへぇ❤今お豆敏感なのぉっ❤」	PRINTFORMW 「んひいぃいぃやめへぇ❤今お豆敏感なのぉっ❤」
PRINTFORMW 「お膣にいいぃ❤ゴリゴリ挿入って来てるうぅ❤」	PRINTFORMW 「お膣にいいぃ❤ゴリゴリ挿入って来てるうぅ❤」
PRINTFORMW 「準備は出来てるよ❤たくさんパコパコしてね❤」	PRINTFORMW 「準備は出来てるよ❤たくさんパコパコしてね❤」
PRINTFORML 　お腹の赤ちゃんも喜んでるのが分かるよおぉ❤」	PRINTFORML 　お腹の赤ちゃんも喜んでるのが分かるよおぉ❤」
PRINTFORMW （この膨れた腹が見えないのか、コイツはぁっ…）	PRINTFORMW （この膨れた腹が見えないのか、コイツはぁっ…）
PRINTFORMW 「ま、まさか…射精っ…！？　…うああぁあぁ！」	PRINTFORMW 「ま、まさか…射精っ…！？　…うああぁあぁ！」
PRINTFORML （一滴も逃さないぞぉ…❤）（ﾁｭｳﾁｭｳ…❤）	PRINTFORML （一滴も逃さないぞぉ…❤）（ﾁｭｳﾁｭｳ…❤）
PRINTFORMW （よ、避けるたび、体がちょっとずつ熱くっ…❤）	PRINTFORMW （よ、避けるたび、体がちょっとずつ熱くっ…❤）
PRINTFORMW 「ちょ、ちょっと…嘘…！？　待ってくれぇ～！」	PRINTFORMW 「ちょ、ちょっと…嘘…！？　待ってくれぇ～！」
PRINTFORML 「…まさか霊夢が、こんな事になるなんてっ…！」	PRINTFORML 「…まさか霊夢が、こんな事になるなんてっ…！」
PRINTFORMW 「…私がぶっ倒れてる。何度見ても訳分からん…」	PRINTFORMW 「…私がぶっ倒れてる。何度見ても訳分からん…」
PRINTFORMW （歩いてる紫に出会うのって、何気に珍しいな…）	PRINTFORMW （歩いてる紫に出会うのって、何気に珍しいな…）
PRINTFORMW 「え～っと、あ！何時ぞやの天人か。久しぶり～」	PRINTFORMW 「え～っと、あ！何時ぞやの天人か。久しぶり～」
PRINTFORMW 「イキたくないぃ！イギだぐないいぃいぃっ！！」	PRINTFORMW 「イキたくないぃ！イギだぐないいぃいぃっ！！」
PRINTFORMW 「はぁ…はぁ…うん、何とか立ち上がれそう…！」	PRINTFORMW 「はぁ…はぁ…うん、何とか立ち上がれそう…！」
PRINTFORML （い、いまオナニーしたら最高なんだろうな…❤）	PRINTFORML （い、いまオナニーしたら最高なんだろうな…❤）
PRINTFORML 「熱っぽさが、引かないっ…！　……くぅう…❤」	PRINTFORML 「熱っぽさが、引かないっ…！　……くぅう…❤」
PRINTFORML （ｸﾞﾆｸﾞﾆ）「まだ、治せる…ってことか？」	PRINTFORML （ｸﾞﾆｸﾞﾆ）「まだ、治せる…ってことか？」
PRINTFORML （眠いと危険も増す…早く寝床を確保しないと…）	PRINTFORML （眠いと危険も増す…早く寝床を確保しないと…）
PRINTFORML （『つわり』ってヤツか…二日酔いより酷い……）	PRINTFORML （『つわり』ってヤツか…二日酔いより酷い……）
PRINTFORML 「ここはどうも密閉感があって好きじゃないなぁ」	PRINTFORML 「ここはどうも密閉感があって好きじゃないなぁ」
PRINTFORML 「ム…いや、イライラするっ！まとめて撃つ！」	PRINTFORML 「ム…いや、イライラするっ！まとめて撃つ！」
PRINTFORML 「ほら…ぶち込んで来い…っ❤」（ｸﾊﾟｧ❤）	PRINTFORML 「ほら…ぶち込んで来い…っ❤」（ｸﾊﾟｧ❤）
PRINTFORMW 「よーし、今から合体攻撃でぶっ倒すからな！」	PRINTFORMW 「よーし、今から合体攻撃でぶっ倒すからな！」
PRINTFORMW 「とっとと萎びろ！このビキビキ勃起ちんぽ！」	PRINTFORMW 「とっとと萎びろ！このビキビキ勃起ちんぽ！」
PRINTFORMW （私…どうしてこんな事…でも…触りたい…❤）	PRINTFORMW （私…どうしてこんな事…でも…触りたい…❤）
PRINTFORMW 「ぐっ…ち、ちがう！私のせいじゃないって！」	PRINTFORMW 「ぐっ…ち、ちがう！私のせいじゃないって！」
PRINTFORMW 「きひゅうぅ！ひいぃううぅうううぁ～！❤❤」	PRINTFORMW 「きひゅうぅ！ひいぃううぅうううぁ～！❤❤」
PRINTFORMW 「ちんぽがあぁあ！ちんぽもげるううぅぅう！」	PRINTFORMW 「ちんぽがあぁあ！ちんぽもげるううぅぅう！」
PRINTFORMW 「くりがぁあぁ！クリが壊れりゅううぅう！！」	PRINTFORMW 「くりがぁあぁ！クリが壊れりゅううぅう！！」
PRINTFORMW 「あ、ああぁあ…こんな、酷い…ううぅっ……」	PRINTFORMW 「あ、ああぁあ…こんな、酷い…ううぅっ……」
PRINTFORMW （こ、こんなの、今すぐ吐きたいぐらいだわ…）	PRINTFORMW （こ、こんなの、今すぐ吐きたいぐらいだわ…）
PRINTFORMW （多少おぼつかないけど、このぐらいなら…！）	PRINTFORMW （多少おぼつかないけど、このぐらいなら…！）
PRINTFORMW 「邪なことを考えてたんだろ？残念だったな！」	PRINTFORMW 「邪なことを考えてたんだろ？残念だったな！」
PRINTFORMW 「お前らにはこのくらいのハンデで十分だ…！」	PRINTFORMW 「お前らにはこのくらいのハンデで十分だ…！」
PRINTFORMW 「…こいつは覚えがない…孫か、もっと下か…」	PRINTFORMW 「…こいつは覚えがない…孫か、もっと下か…」
PRINTFORMW 「どうやら、こっちと同じ遭難者みたいだねぇ」	PRINTFORMW 「どうやら、こっちと同じ遭難者みたいだねぇ」
PRINTFORML 「…いやダメだ、そんな簡単に流されちゃ…！」	PRINTFORML 「…いやダメだ、そんな簡単に流されちゃ…！」
PRINTFORML 「暑くは無いし寒くも無い…でも湿気が多いな」	PRINTFORML 「暑くは無いし寒くも無い…でも湿気が多いな」
PRINTFORMW 「ぶち当たってとっとと帰れ！…うぃひ…❤」	PRINTFORMW 「ぶち当たってとっとと帰れ！…うぃひ…❤」
PRINTFORMW （当たってくれっ…！）「…どぉりゃー！！」	PRINTFORMW （当たってくれっ…！）「…どぉりゃー！！」
PRINTFORMW （来るんじゃないぞ…手元が狂うからな…！）	PRINTFORMW （来るんじゃないぞ…手元が狂うからな…！）
PRINTFORMW 「こういうのの扱いは苦手なんだけどなぁ…」	PRINTFORMW 「こういうのの扱いは苦手なんだけどなぁ…」
PRINTFORMW 「えっと、ここをこうで…いいのかねぇ…？」	PRINTFORMW 「えっと、ここをこうで…いいのかねぇ…？」
PRINTFORML 「状況を変える！…おりゃりゃりゃりゃ！！」	PRINTFORML 「状況を変える！…おりゃりゃりゃりゃ！！」
PRINTFORMW 「転んでぶっ倒れててくれないかな…無理か」	PRINTFORMW 「転んでぶっ倒れててくれないかな…無理か」
PRINTFORMW 「あううっ…こんな恥ずかしい…くぅう…❤」	PRINTFORMW 「あううっ…こんな恥ずかしい…くぅう…❤」
PRINTFORMW 「はぁっ…はあぁ…おなに～気持ち良いぃ❤」	PRINTFORMW 「はぁっ…はあぁ…おなに～気持ち良いぃ❤」
PRINTFORMW 「女の子同士で、いちゃーちゃしよーよぉ❤」	PRINTFORMW 「女の子同士で、いちゃーちゃしよーよぉ❤」
PRINTFORMW 「やめろ…眠く…なん…か…ぁ……ｽﾔｧ…」	PRINTFORMW 「やめろ…眠く…なん…か…ぁ……ｽﾔｧ…」
PRINTFORMW 「あんまり効いてないな…一旦解散するぞ！」	PRINTFORMW 「あんまり効いてないな…一旦解散するぞ！」
PRINTFORML 「はっ…はっ…❤　…あはぁっ、はああっ❤」	PRINTFORML 「はっ…はっ…❤　…あはぁっ、はああっ❤」
PRINTFORMW 「お˝ぉお❤おひりっ❤千切れりゅう！❤❤」	PRINTFORMW 「お˝ぉお❤おひりっ❤千切れりゅう！❤❤」
PRINTFORMW 「あっあっ❤…そんな風に弄っちゃ…っ…❤」	PRINTFORMW 「あっあっ❤…そんな風に弄っちゃ…っ…❤」
PRINTFORMW 「あががあぁぁあ！！お乳が壊れるぅう…！」	PRINTFORMW 「あががあぁぁあ！！お乳が壊れるぅう…！」
PRINTFORMW 「んぎゅぐぐ…ぐるじいぃ……離れろぉ…！」	PRINTFORMW 「んぎゅぐぐ…ぐるじいぃ……離れろぉ…！」
PRINTFORMW 「らめっ❤おちんぽしごかないでえぇえぇ❤」	PRINTFORMW 「らめっ❤おちんぽしごかないでえぇえぇ❤」
PRINTFORMW 「らめっ❤クリクリ抓まないででえぇえぇ❤」	PRINTFORMW 「らめっ❤クリクリ抓まないででえぇえぇ❤」
PRINTFORMW 「ううっ…な、中にいっ…たっぷりっ…！❤」	PRINTFORMW 「ううっ…な、中にいっ…たっぷりっ…！❤」
PRINTFORML 「ん～っ❤んっんっんっ❤」（ｺｸｺｸ…❤）	PRINTFORML 「ん～っ❤んっんっんっ❤」（ｺｸｺｸ…❤）
PRINTFORMW （あぁ、マズイ…次は確実に襲われる…っ❤）	PRINTFORMW （あぁ、マズイ…次は確実に襲われる…っ❤）
PRINTFORML 「フ、フン！かえって動きやすくなったわ！」	PRINTFORML 「フ、フン！かえって動きやすくなったわ！」
PRINTFORMW 「変なところが見えて無けりゃ問題ないっ！」	PRINTFORMW 「変なところが見えて無けりゃ問題ないっ！」
PRINTFORMW 「放っといても死なない…とは言い切れんな」	PRINTFORMW 「放っといても死なない…とは言い切れんな」
PRINTFORML 「霊夢、また落ちてたよ！これも拾っとくね」	PRINTFORML 「霊夢、また落ちてたよ！これも拾っとくね」
PRINTFORMW 「この球、どっかで見た気が…何だったか…」	PRINTFORMW 「この球、どっかで見た気が…何だったか…」
PRINTFORMW 「お茶かぁ…たまには良いよね、落ち着くし」	PRINTFORMW 「お茶かぁ…たまには良いよね、落ち着くし」
PRINTFORMW 「我慢っ…できっ…うあああぁあぅあぁ！❤」	PRINTFORMW 「我慢っ…できっ…うあああぁあぅあぁ！❤」
PRINTFORMW 「も、ムリっ…イクうぅうぅううぅっ！！❤」	PRINTFORMW 「も、ムリっ…イクうぅうぅううぅっ！！❤」
PRINTFORML （ﾍﾞﾁｬｯ）「………う…ぐ…ここは…？」	PRINTFORML （ﾍﾞﾁｬｯ）「………う…ぐ…ここは…？」
PRINTFORML 「はぁ…はぁ…っ！ダメだっ、そんな事…！」	PRINTFORML 「はぁ…はぁ…っ！ダメだっ、そんな事…！」
PRINTFORML 「あ…ふぁぅ…こんな場所じゃ無理は禁物だ」	PRINTFORML 「あ…ふぁぅ…こんな場所じゃ無理は禁物だ」
PRINTFORML 「ほら、打って来な。どうせ効かないから」	PRINTFORML 「ほら、打って来な。どうせ効かないから」
PRINTFORMW 「ちょいと弱いけど…これなら当たるだろ」	PRINTFORMW 「ちょいと弱いけど…これなら当たるだろ」
PRINTFORMW 「今の状態で…うっ❤…当てられるか…？」	PRINTFORMW 「今の状態で…うっ❤…当てられるか…？」
PRINTFORMW 「さっさとご退場願おうか！さもないと…」	PRINTFORMW 「さっさとご退場願おうか！さもないと…」
PRINTFORML 「ええい、使い方がよくわからないっ！！」	PRINTFORML 「ええい、使い方がよくわからないっ！！」
PRINTFORMW 「こんなんじゃぶれないよ…ぅふぅっ…❤」	PRINTFORMW 「こんなんじゃぶれないよ…ぅふぅっ…❤」
PRINTFORMW 「変なことしないよう寝かしつけてやる！」	PRINTFORMW 「変なことしないよう寝かしつけてやる！」
PRINTFORMW 「はぁ…はあぁっ…ひ、引っ付くなぁっ❤」	PRINTFORMW 「はぁ…はあぁっ…ひ、引っ付くなぁっ❤」
PRINTFORMW （一気に出られれば、まだ勝機はある…！）	PRINTFORMW （一気に出られれば、まだ勝機はある…！）
PRINTFORMW （く…勝手が分かんなくて守りにくい…！）	PRINTFORMW （く…勝手が分かんなくて守りにくい…！）
PRINTFORMW 「やめろぉ…こんなことしたくないぃ…❤」	PRINTFORMW 「やめろぉ…こんなことしたくないぃ…❤」
PRINTFORML 「殴れば問題な…あ！？手が握れない？！」	PRINTFORML 「殴れば問題な…あ！？手が握れない？！」
PRINTFORML 「やだっ…顔の近くに寄せるな…ひあぁ！」	PRINTFORML 「やだっ…顔の近くに寄せるな…ひあぁ！」
PRINTFORMW （しめた！今のうちに体制を整えよう…！）	PRINTFORMW （しめた！今のうちに体制を整えよう…！）
PRINTFORML 「あんっ♪はんっ♪…気持ち、良いよぉ❤」	PRINTFORML 「あんっ♪はんっ♪…気持ち、良いよぉ❤」
PRINTFORMW 「ギュッて、揉みしだいて欲しいのぉ…❤」	PRINTFORMW 「ギュッて、揉みしだいて欲しいのぉ…❤」
PRINTFORMW 「んひぃ！」（び、敏感なところをっ…❤）	PRINTFORMW 「んひぃ！」（び、敏感なところをっ…❤）
PRINTFORMW 「ぐひいぃいいぃ！さ、裂けるうぅう！！」	PRINTFORMW 「ぐひいぃいいぃ！さ、裂けるうぅう！！」
PRINTFORMW 「な、なにを…！」（体が動かない…！？）	PRINTFORMW 「な、なにを…！」（体が動かない…！？）
PRINTFORMW 「あは❤くっさいちんぽ汁がこんなに…❤」	PRINTFORMW 「あは❤くっさいちんぽ汁がこんなに…❤」
PRINTFORMW 「こんぐらいなら今の私でも避けれるわ！」	PRINTFORMW 「こんぐらいなら今の私でも避けれるわ！」
PRINTFORMW 「手負いの輩にも当たらないのかねぇ～？」	PRINTFORMW 「手負いの輩にも当たらないのかねぇ～？」
PRINTFORMW （身体自体を狙わない…ということは…！）	PRINTFORMW （身体自体を狙わない…ということは…！）
PRINTFORMW 「ふぅ、勝てたか…」（次はマズイか…？）	PRINTFORMW 「ふぅ、勝てたか…」（次はマズイか…？）
PRINTFORML 「え、嫌だっ…置いてかないでくれぇ…！」	PRINTFORML 「え、嫌だっ…置いてかないでくれぇ…！」
PRINTFORMW （姿は完全に私だ。…いやそんなはずは…）	PRINTFORMW （姿は完全に私だ。…いやそんなはずは…）
PRINTFORMW （この子は…娘？　いや違う、孫…かな？）	PRINTFORMW （この子は…娘？　いや違う、孫…かな？）
PRINTFORMW 「勇儀！こんなところで何をしてるんだ？」	PRINTFORMW 「勇儀！こんなところで何をしてるんだ？」
PRINTFORMW 「遠距離武器か…あんまり得意じゃないな」	PRINTFORMW 「遠距離武器か…あんまり得意じゃないな」
PRINTFORMW 「もう嫌ぁ…いやぁあぁぁあっぁああ！！」	PRINTFORMW 「もう嫌ぁ…いやぁあぁぁあっぁああ！！」
PRINTFORML 「うぅ…手じゃ隠すのにも限界があるぞ…」	PRINTFORML 「うぅ…手じゃ隠すのにも限界があるぞ…」
PRINTFORML 「まぁ、服があって隠せるだけマシだな…」	PRINTFORML 「まぁ、服があって隠せるだけマシだな…」
PRINTFORMW 「さっさとご退場願おうか…ぅっく❤…」	PRINTFORMW 「さっさとご退場願おうか…ぅっく❤…」
PRINTFORMW 「節約か…性に合わないが、今は大事か」	PRINTFORMW 「節約か…性に合わないが、今は大事か」
PRINTFORMW 「あうぅっ…❤　…く、負けないぞ…！」	PRINTFORMW 「あうぅっ…❤　…く、負けないぞ…！」
PRINTFORMW 「射撃もだいぶ慣れたもんかね～っと！」	PRINTFORMW 「射撃もだいぶ慣れたもんかね～っと！」
PRINTFORMW 「月をも砕くこのパワー…受けてみろ！」	PRINTFORMW 「月をも砕くこのパワー…受けてみろ！」
PRINTFORMW 「危険な時こそ小技を生かす…そこだ！」	PRINTFORMW 「危険な時こそ小技を生かす…そこだ！」
PRINTFORMW 「まさかこれで倒れたりしないよねぇ？」	PRINTFORMW 「まさかこれで倒れたりしないよねぇ？」
PRINTFORML 「こ、降参する…もうやめてくれぇ……」	PRINTFORML 「こ、降参する…もうやめてくれぇ……」
PRINTFORMW 「い、いやだあっ！来ないでくれぇ…！」	PRINTFORMW 「い、いやだあっ！来ないでくれぇ…！」
PRINTFORML 「頼むぅ…お尻がぁ…❤」（ﾌﾘﾌﾘ❤）	PRINTFORML 「頼むぅ…お尻がぁ…❤」（ﾌﾘﾌﾘ❤）
PRINTFORML （他の所を差し出すよりはマシかな…？）	PRINTFORML （他の所を差し出すよりはマシかな…？）
PRINTFORMW 「くっ…頭では逃げてるはずなのに…！」	PRINTFORMW 「くっ…頭では逃げてるはずなのに…！」
PRINTFORMW 「い、いやだ…止めろぉっ！…ムグゥ！」	PRINTFORMW 「い、いやだ…止めろぉっ！…ムグゥ！」
PRINTFORMW 「うりゃうりゃ♪存分にイカせてやる❤」	PRINTFORMW 「うりゃうりゃ♪存分にイカせてやる❤」
PRINTFORMW 「ひゃめえぇえぇ！出ちゃうよおぉ！❤」	PRINTFORMW 「ひゃめえぇえぇ！出ちゃうよおぉ！❤」
PRINTFORMW 「いやだあぁっ…！　お、おごおおぉ…」	PRINTFORMW 「いやだあぁっ…！　お、おごおおぉ…」
PRINTFORMW 「おっおお˝っ…ぶっといぃいぃぃ…❤」	PRINTFORMW 「おっおお˝っ…ぶっといぃいぃぃ…❤」
PRINTFORMW 「は、入らないからっ…やめろおぉ…！」	PRINTFORMW 「は、入らないからっ…やめろおぉ…！」
PRINTFORMW 「やっああぁ！おまんこ広がるぅう！！」	PRINTFORMW 「やっああぁ！おまんこ広がるぅう！！」
PRINTFORMW 「はぅん❤萃香腰砕けになっちゃうぅ❤」	PRINTFORMW 「はぅん❤萃香腰砕けになっちゃうぅ❤」
PRINTFORMW 「やだぁっ！…ああぁあぁあ～～！！！」	PRINTFORMW 「やだぁっ！…ああぁあぁあ～～！！！」
PRINTFORMW 「ゴホッ……目暗ましか、小賢しいっ！」	PRINTFORMW 「ゴホッ……目暗ましか、小賢しいっ！」
PRINTFORMW 「ゲホ……う、しまっ…眠り粉、か……」	PRINTFORMW 「ゲホ……う、しまっ…眠り粉、か……」
PRINTFORMW 「やっ、なんか吸われてるぅ…うひぃ❤」	PRINTFORMW 「やっ、なんか吸われてるぅ…うひぃ❤」
PRINTFORMW 「やめてえぇ…もう逆らわないからぁ…」	PRINTFORMW 「やめてえぇ…もう逆らわないからぁ…」
PRINTFORMW （流石にちょーっと、危なかったかね…）	PRINTFORMW （流石にちょーっと、危なかったかね…）
PRINTFORMW （へ、変なところ、見えて無いよね…？）	PRINTFORMW （へ、変なところ、見えて無いよね…？）
PRINTFORMW 「形勢は悪いが…倒させてもらうぞ…！」	PRINTFORMW 「形勢は悪いが…倒させてもらうぞ…！」
PRINTFORMW （なんだ？一体何が起きてるんだ…！？）	PRINTFORMW （なんだ？一体何が起きてるんだ…！？）
PRINTFORMW 「まぁなんにせよ、会えて安心したよ…」	PRINTFORMW 「まぁなんにせよ、会えて安心したよ…」
PRINTFORMW 「それにしても誰がばら撒いたんだか…」	PRINTFORMW 「それにしても誰がばら撒いたんだか…」
PRINTFORMW 「またあったか。　…罠じゃないよな？」	PRINTFORMW 「またあったか。　…罠じゃないよな？」
PRINTFORML 「うっ…イクぞ！　…うああぁあぁっ！」	PRINTFORML 「うっ…イクぞ！　…うああぁあぁっ！」
PRINTFORML （あ、壊れる…もうすぐ壊れるんだ、私）	PRINTFORML （あ、壊れる…もうすぐ壊れるんだ、私）
PRINTFORMW 「…う……私は…まだ、生きてるぞ…！」	PRINTFORMW 「…う……私は…まだ、生きてるぞ…！」
PRINTFORML 「はぁ…はあぁ…いつもの5倍疲れる…」	PRINTFORML 「はぁ…はあぁ…いつもの5倍疲れる…」
PRINTFORML 「ん～、やっぱイマイチ調子出ないな～」	PRINTFORML 「ん～、やっぱイマイチ調子出ないな～」
PRINTFORMW 「ピンチだからこそ、まとめて倒す！」	PRINTFORMW 「ピンチだからこそ、まとめて倒す！」
PRINTFORMW 「危ない時こそ落ち着いて…撃てっ！」	PRINTFORMW 「危ない時こそ落ち着いて…撃てっ！」
PRINTFORMW （しまった、ちょっと軽かったか…？）	PRINTFORMW （しまった、ちょっと軽かったか…？）
PRINTFORMW 「出さないと内側からぶっ壊すぞー！」	PRINTFORMW 「出さないと内側からぶっ壊すぞー！」
PRINTFORML （尻ならまぁ、リスクは少ない…か？）	PRINTFORML （尻ならまぁ、リスクは少ない…か？）
PRINTFORML 「………よ…っと…///」（ｸﾞｯ）	PRINTFORML 「………よ…っと…///」（ｸﾞｯ）
PRINTFORML （身体へ影響が薄いのは…ここかな…）	PRINTFORML （身体へ影響が薄いのは…ここかな…）
PRINTFORML 「…………くっ…///」（ｸﾞｲｯ）	PRINTFORML 「…………くっ…///」（ｸﾞｲｯ）
PRINTFORMW 「お、お前なんかに操られないぞ…！」	PRINTFORMW 「お、お前なんかに操られないぞ…！」
PRINTFORML 「えへへー❤キスしちゃったねぇ～❤」	PRINTFORML 「えへへー❤キスしちゃったねぇ～❤」
PRINTFORMW 「もういいの？なぁんだガッカリ～…」	PRINTFORMW 「もういいの？なぁんだガッカリ～…」
PRINTFORMW 「やめっ…こんな時に…ひぁああぁ❤」	PRINTFORMW 「やめっ…こんな時に…ひぁああぁ❤」
PRINTFORMW 「やっ、腰が勝手にぃ…はうぅ…っ❤」	PRINTFORMW 「やっ、腰が勝手にぃ…はうぅ…っ❤」
PRINTFORMW 「萃香のケツ穴❤たくさん使ってぇ❤」	PRINTFORMW 「萃香のケツ穴❤たくさん使ってぇ❤」
PRINTFORMW 「うっく、刺激がっ…あうあぁぁ…！」	PRINTFORMW 「うっく、刺激がっ…あうあぁぁ…！」
PRINTFORMW 「ま、まさぐっちゃ、はああぁぁ！！」	PRINTFORMW 「ま、まさぐっちゃ、はああぁぁ！！」
PRINTFORMW 「んぐぅ…き、気持ち良くなんて…！」	PRINTFORMW 「んぐぅ…き、気持ち良くなんて…！」
PRINTFORMW 「んあぁっ❤これすっごいいぃ～っ❤」	PRINTFORMW 「んあぁっ❤これすっごいいぃ～っ❤」
PRINTFORMW 「嫌っ…逆らわないから、離してぇ…」	PRINTFORMW 「嫌っ…逆らわないから、離してぇ…」
PRINTFORMW （妊娠中でもおかまいなしか…っ！！）	PRINTFORMW （妊娠中でもおかまいなしか…っ！！）
PRINTFORMW （孕ませるつもりだ…コイツっ…！！）	PRINTFORMW （孕ませるつもりだ…コイツっ…！！）
PRINTFORMW 「ぜっ、はぁ…」（まだいけるか…？）	PRINTFORMW 「ぜっ、はぁ…」（まだいけるか…？）
PRINTFORMW 「やだ…そんなことしないでくれぇ…」	PRINTFORMW 「やだ…そんなことしないでくれぇ…」
PRINTFORMW 「ちょっとだけだよー？　んふふ～❤」	PRINTFORMW 「ちょっとだけだよー？　んふふ～❤」
PRINTFORMW （何とか逃げ切れたか…んくぅう…❤）	PRINTFORMW （何とか逃げ切れたか…んくぅう…❤）
PRINTFORMW 「無暗に消耗するのはまずいからな…」	PRINTFORMW 「無暗に消耗するのはまずいからな…」
PRINTFORMW 「どうにかして回復させなきゃだな…」	PRINTFORMW 「どうにかして回復させなきゃだな…」
PRINTFORMW 「あんたも異変に巻き込まれた口か…」	PRINTFORMW 「あんたも異変に巻き込まれた口か…」
PRINTFORML 「嫌だっ…ひあらぁあぁあぁあぁ！！」	PRINTFORML 「嫌だっ…ひあらぁあぁあぁあぁ！！」
PRINTFORML 「そのうち取れるんだろうな、コレ…」	PRINTFORML 「そのうち取れるんだろうな、コレ…」
PRINTFORML 「服があるだけ、良しとしよう…うん」	PRINTFORML 「服があるだけ、良しとしよう…うん」
PRINTFORML 「………………………………ｽｩ……」	PRINTFORML 「………………………………ｽｩ……」
PRINTFORML （…やっぱりいつもと勝手が違う…！）	PRINTFORML （…やっぱりいつもと勝手が違う…！）
PRINTFORML 幼さより鬼らしさを重視しています。	PRINTFORML 幼さより鬼らしさを重視しています。
PRINTFORMW （近寄らせたくない…これで撃つか）	PRINTFORMW （近寄らせたくない…これで撃つか）
PRINTFORMW 「避けるなよ？当たらないからな！」	PRINTFORMW 「避けるなよ？当たらないからな！」
PRINTFORMW 「まぁこれくらいで…十分だろっ！」	PRINTFORMW 「まぁこれくらいで…十分だろっ！」
PRINTFORMW 「手間かけさせるんじゃないよ…！」	PRINTFORMW 「手間かけさせるんじゃないよ…！」
PRINTFORMW 「食らったら、おとなしくしてろ！」	PRINTFORMW 「食らったら、おとなしくしてろ！」
PRINTFORMW （ふぅ…ふぅ…❤　今に見ていろ…）	PRINTFORMW （ふぅ…ふぅ…❤　今に見ていろ…）
PRINTFORMW （迂闊に暴れて体力消耗は下策か…）	PRINTFORMW （迂闊に暴れて体力消耗は下策か…）
PRINTFORMW 「やめろ…弄ろうとするなぁっ…❤」	PRINTFORMW 「やめろ…弄ろうとするなぁっ…❤」
PRINTFORMDW 無理やりパイズリさせられ涙目だ…	PRINTFORMDW 無理やりパイズリさせられ涙目だ…
PRINTFORMW 「よし！今から二人で合体攻撃だ！」	PRINTFORMW 「よし！今から二人で合体攻撃だ！」
PRINTFORMW （ぜぇ…はぁ…）「…こいつ……！」	PRINTFORMW （ぜぇ…はぁ…）「…こいつ……！」
PRINTFORMW 「うぎっひぃいいいぃぃいぃい❤❤」	PRINTFORMW 「うぎっひぃいいいぃぃいぃい❤❤」
PRINTFORMW 「やんっあんっ❤もっと優しくっ❤」	PRINTFORMW 「やんっあんっ❤もっと優しくっ❤」
PRINTFORMW 「ひゃめろっ…しゃわるにゃぁ…❤」	PRINTFORMW 「ひゃめろっ…しゃわるにゃぁ…❤」
PRINTFORML 「おっほぉ❤…ひぎっ、んひぎぃ❤」	PRINTFORML 「おっほぉ❤…ひぎっ、んひぎぃ❤」
PRINTFORMW 「ふひぃい！ひぃいぃぃいいっ！！」	PRINTFORMW 「ふひぃい！ひぃいぃぃいいっ！！」
PRINTFORMW 「やだあっ！もうやめてえぇ……！」	PRINTFORMW 「やだあっ！もうやめてえぇ……！」
PRINTFORMW 「うぐっ…」（逃げられないっ…！）	PRINTFORMW 「うぐっ…」（逃げられないっ…！）
PRINTFORMW （孕むのは流石にマズイいいっ…❤）	PRINTFORMW （孕むのは流石にマズイいいっ…❤）
PRINTFORMW 「な、中に何か入ってくるっ…！！」	PRINTFORMW 「な、中に何か入ってくるっ…！！」
PRINTFORML 「く…変な術を使いやがってぇ…！」	PRINTFORML 「く…変な術を使いやがってぇ…！」
PRINTFORMW （流石にこんな臭いものに欲情は…）	PRINTFORMW （流石にこんな臭いものに欲情は…）
PRINTFORMW 「お…おえ…ぐすっ…うええぇっ…」	PRINTFORMW 「お…おえ…ぐすっ…うええぇっ…」
PRINTFORMW （ﾋｭｯ）「どこ見てんだかねぇ…」	PRINTFORMW （ﾋｭｯ）「どこ見てんだかねぇ…」
PRINTFORMW 「っ！？…ダメだ想像しちゃ…っ！」	PRINTFORMW 「っ！？…ダメだ想像しちゃ…っ！」
PRINTFORMW 「やだぁっ…見ないでくれぇっ…❤」	PRINTFORMW 「やだぁっ…見ないでくれぇっ…❤」
PRINTFORMW 「うわ！…この変態どもがぁっ…！」	PRINTFORMW 「うわ！…この変態どもがぁっ…！」
PRINTFORMW 「…この落っこちてる奴、私か…？」	PRINTFORMW 「…この落っこちてる奴、私か…？」
PRINTFORMW （元同属にも容赦無しか…クソッ！）	PRINTFORMW （元同属にも容赦無しか…クソッ！）
PRINTFORMW 「………もう何が何だか分からん！」	PRINTFORMW 「………もう何が何だか分からん！」
PRINTFORMW 「お～勇儀、そっちはまだ元気か？」	PRINTFORMW 「お～勇儀、そっちはまだ元気か？」
PRINTFORML 「霊夢、お札落としてるよ？…ホラ」	PRINTFORML 「霊夢、お札落としてるよ？…ホラ」
PRINTFORMW 「またあったよ～。全部持ってくね」	PRINTFORMW 「またあったよ～。全部持ってくね」
PRINTFORMW 「ああぁっ…わああぁあぁぁっ！！」	PRINTFORMW 「ああぁっ…わああぁあぁぁっ！！」
PRINTFORML 「借りは…必ず、返す…必ずっ！！」	PRINTFORML 「借りは…必ず、返す…必ずっ！！」
PRINTFORML （…いやもうなってるか…これは…）	PRINTFORML （…いやもうなってるか…これは…）
PRINTFORMDL 萃香は周囲を見回し警戒している…	PRINTFORMDL 萃香は周囲を見回し警戒している…
PRINTFORML （今は、不味いかっ…ぐぅっ❤…）	PRINTFORML （今は、不味いかっ…ぐぅっ❤…）
PRINTFORMW （迂闊に攻めたら思う壺…か…！）	PRINTFORMW （迂闊に攻めたら思う壺…か…！）
PRINTFORMW 「動くんじゃない…！　んっ…❤」	PRINTFORMW 「動くんじゃない…！　んっ…❤」
PRINTFORMW （今は近寄りたくない…んくっ❤）	PRINTFORMW （今は近寄りたくない…んくっ❤）
PRINTFORMW 「こっちに来るなよ…ぃひぅっ❤」	PRINTFORMW 「こっちに来るなよ…ぃひぅっ❤」
PRINTFORML 「しゃらくさい！まとめて撃つ！」	PRINTFORML 「しゃらくさい！まとめて撃つ！」
PRINTFORMW 「お前なんかこれで十分だっ…❤」	PRINTFORMW 「お前なんかこれで十分だっ…❤」
PRINTFORMW （はぅう…❤　力が抜けてく～…）	PRINTFORMW （はぅう…❤　力が抜けてく～…）
PRINTFORML （このままだと…喰われる…！？）	PRINTFORML （このままだと…喰われる…！？）
PRINTFORMW 「らめらぁ❤ちからぬけりゅ…❤」	PRINTFORMW 「らめらぁ❤ちからぬけりゅ…❤」
PRINTFORMW 「こんなところ責められたら…！」	PRINTFORMW 「こんなところ責められたら…！」
PRINTFORMW 「そう易々やらせてたまるか…！」	PRINTFORMW 「そう易々やらせてたまるか…！」
PRINTFORMW 「あなる…あなるに欲しいの…❤」	PRINTFORMW 「あなる…あなるに欲しいの…❤」
PRINTFORMW 「おちち…おちちいじってぇ…❤」	PRINTFORMW 「おちち…おちちいじってぇ…❤」
PRINTFORMW 「おちんぽが…せつないよぉ…❤」	PRINTFORMW 「おちんぽが…せつないよぉ…❤」
PRINTFORMW 「クリが疼いて…辛いのぉっ…❤」	PRINTFORMW 「クリが疼いて…辛いのぉっ…❤」
PRINTFORMW 「んっ…チュゥ❤…チャプッ❤…」	PRINTFORMW 「んっ…チュゥ❤…チャプッ❤…」
PRINTFORMW 「ん…っ❤」（もっと、奥まで…）	PRINTFORMW 「ん…っ❤」（もっと、奥まで…）
PRINTFORMW 「おほぉお❤アナル責め来たぁ❤」	PRINTFORMW 「おほぉお❤アナル責め来たぁ❤」
PRINTFORMW 「やめへくれぇ…尻が壊れるぅ…」	PRINTFORMW 「やめへくれぇ…尻が壊れるぅ…」
PRINTFORMW 「ケツが…ぐ、ぐるじぃ…ぐぇ…」	PRINTFORMW 「ケツが…ぐ、ぐるじぃ…ぐぇ…」
PRINTFORMW 「やだぁ……さわら…ないでぇ…」	PRINTFORMW 「やだぁ……さわら…ないでぇ…」
PRINTFORMW 「おぎゅぎゅううぅ～～！！❤❤」	PRINTFORMW 「おぎゅぎゅううぅ～～！！❤❤」
PRINTFORMW 「まっ…やぁあ！摘まむなっ…！」	PRINTFORMW 「まっ…やぁあ！摘まむなっ…！」
PRINTFORMW 「そ、そこはっ…やだあぁっ…！」	PRINTFORMW 「そ、そこはっ…やだあぁっ…！」
PRINTFORMW 「ダメっ…中はイヤだぁあぁあ！」	PRINTFORMW 「ダメっ…中はイヤだぁあぁあ！」
PRINTFORMW 「ああぁ…吸っちゃ、らめぇ～…」	PRINTFORMW 「ああぁ…吸っちゃ、らめぇ～…」
PRINTFORMW 「臭いっ…臭いよぉ…うえぇっ…」	PRINTFORMW 「臭いっ…臭いよぉ…うえぇっ…」
PRINTFORMW 「自分の無力さを思い知ったか！」	PRINTFORMW 「自分の無力さを思い知ったか！」
PRINTFORMW 「よし、何とか先手は取れた…！」	PRINTFORMW 「よし、何とか先手は取れた…！」
PRINTFORMW 「さて、どうしてやろうかぁ！？」	PRINTFORMW 「さて、どうしてやろうかぁ！？」
PRINTFORMW 「ぶっ飛ばしてやる、覚悟しろ！」	PRINTFORMW 「ぶっ飛ばしてやる、覚悟しろ！」
PRINTFORMW 「捕まらなかっただけ、マシか…」	PRINTFORMW 「捕まらなかっただけ、マシか…」
PRINTFORMW 「…次は絶対ぶっ飛ばすからな！」	PRINTFORMW 「…次は絶対ぶっ飛ばすからな！」
PRINTFORMW 「うふぅっ…何とかなったか…❤」	PRINTFORMW 「うふぅっ…何とかなったか…❤」
PRINTFORMW 「しまった！…戻る隙は無い…か」	PRINTFORMW 「しまった！…戻る隙は無い…か」
PRINTFORML 「…辛うじて、生きてはいるな…」	PRINTFORML 「…辛うじて、生きてはいるな…」
PRINTFORMW 「霊夢～、そっちは問題ないか？」	PRINTFORMW 「霊夢～、そっちは問題ないか？」
PRINTFORMW 「紫！あんたもここに居たのか…」	PRINTFORMW 「紫！あんたもここに居たのか…」
PRINTFORMW （それにしても私に似てるなぁ…）	PRINTFORMW （それにしても私に似てるなぁ…）
PRINTFORMW （こ、こんなのでイクなんて…！）	PRINTFORMW （こ、こんなのでイクなんて…！）
PRINTFORML 「やぅ…ひぃっ…あぁああぁ…！」	PRINTFORML 「やぅ…ひぃっ…あぁああぁ…！」
PRINTFORMW 「うぁ…た、助かったよ…有難う」	PRINTFORMW 「うぁ…た、助かったよ…有難う」
﻿PRINTFORML 初心者が作った萃香の口上です。	PRINTFORML 初心者が作った萃香の口上です。
PRINTFORMW 「ぼやぼやしてると当たるよ！」	PRINTFORMW 「ぼやぼやしてると当たるよ！」
PRINTFORMW 「ピンチの時こそ計画的に…！」	PRINTFORMW 「ピンチの時こそ計画的に…！」
PRINTFORMW 「お前なんかこれで十分だ…！」	PRINTFORMW 「お前なんかこれで十分だ…！」
PRINTFORMW 「こんなんじゃぶれないよ…！」	PRINTFORMW 「こんなんじゃぶれないよ…！」
PRINTFORMW 「鬼の一撃…食らってみるか！」	PRINTFORMW 「鬼の一撃…食らってみるか！」
PRINTFORMW 「あんたの弱みは…ここかな？」	PRINTFORMW 「あんたの弱みは…ここかな？」
PRINTFORMW 「やめろぉっ❤放せえぇっ…❤」	PRINTFORMW 「やめろぉっ❤放せえぇっ…❤」
PRINTFORML （このままは流石に不味い…！）	PRINTFORML （このままは流石に不味い…！）
PRINTFORMW （クソォ…力が萃まらない…❤）	PRINTFORMW （クソォ…力が萃まらない…❤）
PRINTFORMW （なんだか、癖になりそう…❤）	PRINTFORMW （なんだか、癖になりそう…❤）
PRINTFORMW 「ふぅ、やっと離れられたか…」	PRINTFORMW 「ふぅ、やっと離れられたか…」
PRINTFORMW （く…今のは流石に効いた…！）	PRINTFORMW （く…今のは流石に効いた…！）
PRINTFORMW 「ふん、こんなのかすり傷だよ」	PRINTFORMW 「ふん、こんなのかすり傷だよ」
PRINTFORMW 「その程度じゃ倒れないぞ…！」	PRINTFORMW 「その程度じゃ倒れないぞ…！」
PRINTFORMW 「おぎゅううぅうぅう～～！！」	PRINTFORMW 「おぎゅううぅうぅう～～！！」
PRINTFORMW 「もう嫌ぁ……ひいぃあぁ…！」	PRINTFORMW 「もう嫌ぁ……ひいぃあぁ…！」
PRINTFORMW （うああぁ…頭が蕩けるぅ…❤）	PRINTFORMW （うああぁ…頭が蕩けるぅ…❤）
PRINTFORMW 「まっ…やぁあ！擦るなっ…！」	PRINTFORMW 「まっ…やぁあ！擦るなっ…！」
PRINTFORMW 「おひいぃ！ひぃいいぃん❤❤」	PRINTFORMW 「おひいぃ！ひぃいいぃん❤❤」
PRINTFORMW 「くうぅっ…気持ち悪いっ…！」	PRINTFORMW 「くうぅっ…気持ち悪いっ…！」
PRINTFORML 「んんう！んうぅううぅ…っ…」	PRINTFORML 「んんう！んうぅううぅ…っ…」
PRINTFORML 「！　っ…とと、余裕よ、余裕」	PRINTFORML 「！　っ…とと、余裕よ、余裕」
PRINTFORMW 「全力が出せんでも問題ない！」	PRINTFORMW 「全力が出せんでも問題ない！」
PRINTFORMW 「くっそっ……こぉの、下種！」	PRINTFORMW 「くっそっ……こぉの、下種！」
PRINTFORML 「に…ふぇ…？　…んにゃぁ…」	PRINTFORML 「に…ふぇ…？　…んにゃぁ…」
PRINTFORMW 「危ない…ところだったかな…」	PRINTFORMW 「危ない…ところだったかな…」
PRINTFORMW 「天人…だったよな？コイツ…」	PRINTFORMW 「天人…だったよな？コイツ…」
PRINTFORMW 「霊夢～、これ霊夢のでしょ？」	PRINTFORMW 「霊夢～、これ霊夢のでしょ？」
PRINTFORML 「……ﾝﾑﾆｬ…ﾝﾑﾝﾑ……」	PRINTFORML 「……ﾝﾑﾆｬ…ﾝﾑﾝﾑ……」
PRINTFORML 「くそ、もう取れないのか…！」	PRINTFORML 「くそ、もう取れないのか…！」
PRINTFORML 「うぅ…眠気が…不味いなぁ…」	PRINTFORML 「うぅ…眠気が…不味いなぁ…」
PRINTFORML （なんか見られてる気がする…）	PRINTFORML （なんか見られてる気がする…）
PRINTFORMDL 萃香は身体を手で隠している…	PRINTFORMDL 萃香は身体を手で隠している…
PRINTFORMW 「グゥ～……すぴぴぃ～っ……」	PRINTFORMW 「グゥ～……すぴぴぃ～っ……」
PRINTFORMW （隙ができるまで我慢だ…！）	PRINTFORMW （隙ができるまで我慢だ…！）
PRINTFORMW （今は当てる事を考えるか…）	PRINTFORMW （今は当てる事を考えるか…）
PRINTFORMW 「さーて、本気出すかな…！」	PRINTFORMW 「さーて、本気出すかな…！」
PRINTFORMW 「うっとおしい！全部倒す！」	PRINTFORMW 「うっとおしい！全部倒す！」
PRINTFORMW 「これで一網打尽…て訳よ！」	PRINTFORMW 「これで一網打尽…て訳よ！」
PRINTFORMW 「…早く出せ！このぉ～！！」	PRINTFORMW 「…早く出せ！このぉ～！！」
PRINTFORMW 「くうぅ…❤ぬめりがぁ…！」	PRINTFORMW 「くうぅ…❤ぬめりがぁ…！」
PRINTFORMW 「くっそぉ…！　早く出せ！」	PRINTFORMW 「くっそぉ…！　早く出せ！」
PRINTFORMW 「…早く放せ！このぉ～！！」	PRINTFORMW 「…早く放せ！このぉ～！！」
PRINTFORMW （無暗に暴れても無駄だな…）	PRINTFORMW （無暗に暴れても無駄だな…）
PRINTFORML 「ここまでついて来てみろ！」	PRINTFORML 「ここまでついて来てみろ！」
PRINTFORMW 「よし、分散して敵を叩く！」	PRINTFORMW 「よし、分散して敵を叩く！」
PRINTFORMW 「こ、このサディストめ…！」	PRINTFORMW 「こ、このサディストめ…！」
PRINTFORMW 「ぐふ…く、屈さんぞぉ…❤」	PRINTFORMW 「ぐふ…く、屈さんぞぉ…❤」
PRINTFORMW 「ふひぃ！…ひいぃいぃ…❤」	PRINTFORMW 「ふひぃ！…ひいぃいぃ…❤」
PRINTFORMW 「ん˝ああ˝ぁあぁ～～！！」	PRINTFORMW 「ん˝ああ˝ぁあぁ～～！！」
PRINTFORMW 「おごぉ！んぐいぃいぃ！！」	PRINTFORMW 「おごぉ！んぐいぃいぃ！！」
PRINTFORMW 「抜いて…抜いてくれぇ……」	PRINTFORMW 「抜いて…抜いてくれぇ……」
PRINTFORMW 「お˝っひ❤…んひぃぃ❤…」	PRINTFORMW 「お˝っひ❤…んひぃぃ❤…」
PRINTFORMW 「く…はあぁっ…あはぁっ❤」	PRINTFORMW 「く…はあぁっ…あはぁっ❤」
PRINTFORML 「エホッ、ゲホケホッ……！」	PRINTFORML 「エホッ、ゲホケホッ……！」
PRINTFORMW 「うえぇえぇ…おええぇっ…」	PRINTFORMW 「うえぇえぇ…おええぇっ…」
PRINTFORMW 「お前が親玉か…ブッ倒す！」	PRINTFORMW 「お前が親玉か…ブッ倒す！」
PRINTFORMW 「変な事をされる前に潰す！」	PRINTFORMW 「変な事をされる前に潰す！」
PRINTFORMW （いずれにせよ、不味いな…）	PRINTFORMW （いずれにせよ、不味いな…）
PRINTFORML 「まさか、勇儀が…こんな…」	PRINTFORML 「まさか、勇儀が…こんな…」
PRINTFORML 「…………」（ｼﾞﾛｰﾘ…）	PRINTFORML 「…………」（ｼﾞﾛｰﾘ…）
PRINTFORMW 「……こ、こいつはっ…？！」	PRINTFORMW 「……こ、こいつはっ…？！」
PRINTFORMW 「お茶だ、拾って入れとこう」	PRINTFORMW 「お茶だ、拾って入れとこう」
PRINTFORML 「う…うぇ～…気持ち悪い…」	PRINTFORML 「う…うぇ～…気持ち悪い…」
PRINTFORMW （今の状態で当たるか…？）	PRINTFORMW （今の状態で当たるか…？）
PRINTFORMW （動きを抑えれば楽か…？）	PRINTFORMW （動きを抑えれば楽か…？）
PRINTFORMW 「しまっ…あ❤…ひぃ…❤」	PRINTFORMW 「しまっ…あ❤…ひぃ…❤」
PRINTFORMW 「やめて…触んないで…❤」	PRINTFORMW 「やめて…触んないで…❤」
PRINTFORMW 「…胸を見るな！触るな！」	PRINTFORMW 「…胸を見るな！触るな！」
PRINTFORML 「…………ん…く…///」	PRINTFORML 「…………ん…く…///」
PRINTFORMW 「キモイ！こっちくんな！」	PRINTFORMW 「キモイ！こっちくんな！」
PRINTFORMW 「フヒヒ♪…観念しろ～❤」	PRINTFORMW 「フヒヒ♪…観念しろ～❤」
PRINTFORMW 「やぁん♪いったぁーい❤」	PRINTFORMW 「やぁん♪いったぁーい❤」
PRINTFORMW 「うぎぃ…く、くそっ…！」	PRINTFORMW 「うぎぃ…く、くそっ…！」
PRINTFORMW 「お˝ひぃ…おひぃいぃ…」	PRINTFORMW 「お˝ひぃ…おひぃいぃ…」
PRINTFORMW 「くっ…乳なんか触るな！」	PRINTFORMW 「くっ…乳なんか触るな！」
PRINTFORMW 「へうぅううぅ～～っ…❤」	PRINTFORMW 「へうぅううぅ～～っ…❤」
PRINTFORMW 「いひいぅうぅううぅ！！」	PRINTFORMW 「いひいぅうぅううぅ！！」
PRINTFORMW 「ひいぁあぁうううぅ！！」	PRINTFORMW 「ひいぁあぁうううぅ！！」
PRINTFORMW 「へうぅ！んへぇえぇっ！」	PRINTFORMW 「へうぅ！んへぇえぇっ！」
PRINTFORML 「なっ、し、しまっ…！！」	PRINTFORML 「なっ、し、しまっ…！！」
PRINTFORML 「ひぃ！？…きゃあうっ！」	PRINTFORML 「ひぃ！？…きゃあうっ！」
PRINTFORMW 「うわっ、しまったっ…！」	PRINTFORMW 「うわっ、しまったっ…！」
PRINTFORMW 「ぬるいねぇ、全く手緩い」	PRINTFORMW 「ぬるいねぇ、全く手緩い」
PRINTFORMW 「手こずらせやがって…！」	PRINTFORMW 「手こずらせやがって…！」
PRINTFORMW 「弱い！脆い！柔すぎる！」	PRINTFORMW 「弱い！脆い！柔すぎる！」
PRINTFORMW 「く…て、抵抗できない！」	PRINTFORMW 「く…て、抵抗できない！」
PRINTFORMW （まだ、平気だ…まだ、な）	PRINTFORMW （まだ、平気だ…まだ、な）
PRINTFORMW 「潰される前にブッ潰す！」	PRINTFORMW 「潰される前にブッ潰す！」
PRINTFORMW 「死ぬ覚悟はできたか…？」	PRINTFORMW 「死ぬ覚悟はできたか…？」
PRINTFORMW 「くぅ…早く倒さないと…」	PRINTFORMW 「くぅ…早く倒さないと…」
PRINTFORMW 「うわっ、こりゃエグい…」	PRINTFORMW 「うわっ、こりゃエグい…」
PRINTFORML 「やぁ、また会ったねえ紫」	PRINTFORML 「やぁ、また会ったねえ紫」
PRINTFORMW 「ん、これも使えそうかな」	PRINTFORMW 「ん、これも使えそうかな」
PRINTFORML 「んあ…はぁぁっ～～！！」	PRINTFORML 「んあ…はぁぁっ～～！！」
PRINTFORML 「さて、どっちに行くか…」	PRINTFORML 「さて、どっちに行くか…」
PRINTFORML 「うっとおしいな…コレ…」	PRINTFORML 「うっとおしいな…コレ…」
PRINTFORML （それに、身重だし…な…）	PRINTFORML （それに、身重だし…な…）
PRINTFORML 詳しくはリードミーにて。	PRINTFORML 詳しくはリードミーにて。
PRINTFORMW 「今は節約…くぅぁ…❤」	PRINTFORMW 「今は節約…くぅぁ…❤」
PRINTFORMW 「こ、こなくそぉっ…❤」	PRINTFORMW 「こ、こなくそぉっ…❤」
PRINTFORMW 「とっととどっか行け！」	PRINTFORMW 「とっととどっか行け！」
PRINTFORMW 「密着するな！退けー！」	PRINTFORMW 「密着するな！退けー！」
PRINTFORML 「…………んっ…///」	PRINTFORML 「…………んっ…///」
PRINTFORMW 「うわぁ！よ、避けて！」	PRINTFORMW 「うわぁ！よ、避けて！」
PRINTFORMW 「げ、は……ぐぅう…！」	PRINTFORMW 「げ、は……ぐぅう…！」
PRINTFORMW 「やめ…はあぁうっ…！」	PRINTFORMW 「やめ…はあぁうっ…！」
PRINTFORMW 「うぎぎぎっ…んいい！」	PRINTFORMW 「うぎぎぎっ…んいい！」
PRINTFORMW 「ひっぎぃ…助けてぇ…」	PRINTFORMW 「ひっぎぃ…助けてぇ…」
PRINTFORMW 「あっはっ…はううぅ❤」	PRINTFORMW 「あっはっ…はううぅ❤」
PRINTFORMW 「うぐ…ふうぅ～っ…！」	PRINTFORMW 「うぐ…ふうぅ～っ…！」
PRINTFORMW 「な、なに…何するの…」	PRINTFORMW 「な、なに…何するの…」
PRINTFORML 「ぐえ、汚ったなぁっ…」	PRINTFORML 「ぐえ、汚ったなぁっ…」
PRINTFORMW 「ぐえ、汚ったなぁっ…」	PRINTFORMW 「ぐえ、汚ったなぁっ…」
PRINTFORMW 「オラオラどうした！？」	PRINTFORMW 「オラオラどうした！？」
PRINTFORMDW おそらく半分は虚勢だ…	PRINTFORMDW おそらく半分は虚勢だ…
PRINTFORMW 「すぅすぅ…くゃくゃ…」	PRINTFORMW 「すぅすぅ…くゃくゃ…」
PRINTFORMW 「い、今はマズイぃ…！」	PRINTFORMW 「い、今はマズイぃ…！」
PRINTFORMW 「こんな時に…クソっ！」	PRINTFORMW 「こんな時に…クソっ！」
PRINTFORMW 「ふん、当然の結果だよ」	PRINTFORMW 「ふん、当然の結果だよ」
PRINTFORMW 「まだ回復してないか…」	PRINTFORMW 「まだ回復してないか…」
PRINTFORMW 「…おい、大丈夫か！？」	PRINTFORMW 「…おい、大丈夫か！？」
PRINTFORMW 「なんか前のと違うな？」	PRINTFORMW 「なんか前のと違うな？」
PRINTFORMW 「これで十分だ…っ❤」	PRINTFORMW 「これで十分だ…っ❤」
PRINTFORMW 「まだ倒れないぞ…！」	PRINTFORMW 「まだ倒れないぞ…！」
PRINTFORMW 「大玉だっ…食らえ！」	PRINTFORMW 「大玉だっ…食らえ！」
PRINTFORMW 「当ててみせるぞ…！」	PRINTFORMW 「当ててみせるぞ…！」
PRINTFORMW 「ガツーンと砕けろ！」	PRINTFORMW 「ガツーンと砕けろ！」
PRINTFORMW （今に見ていろよ…！）	PRINTFORMW （今に見ていろよ…！）
PRINTFORMW 「お尻はダメだぁ…❤」	PRINTFORMW 「お尻はダメだぁ…❤」
PRINTFORMW 「ふあ！ひああぁ…❤」	PRINTFORMW 「ふあ！ひああぁ…❤」
PRINTFORMW 「く、効かんぞぉ…❤」	PRINTFORMW 「く、効かんぞぉ…❤」
PRINTFORMW 「ふあ！ひああぁ…！」	PRINTFORMW 「ふあ！ひああぁ…！」
PRINTFORMW 「はっ…ひいいぅっ！」	PRINTFORMW 「はっ…ひいいぅっ！」
PRINTFORMW 「やっ…触るなっ…！」	PRINTFORMW 「やっ…触るなっ…！」
PRINTFORML 「うえ、くっさぁ…っ」	PRINTFORML 「うえ、くっさぁ…っ」
PRINTFORMW 「うえ、くっさぁ…っ」	PRINTFORMW 「うえ、くっさぁ…っ」
PRINTFORMW 「う、油断したか…❤」	PRINTFORMW 「う、油断したか…❤」
PRINTFORMW 「よ、寄るな来るな！」	PRINTFORMW 「よ、寄るな来るな！」
PRINTFORMW 「なっ、しまった？！」	PRINTFORMW 「なっ、しまった？！」
PRINTFORMW 「このまま圧し潰す！」	PRINTFORMW 「このまま圧し潰す！」
PRINTFORMW （く、こんな時に…❤）	PRINTFORMW （く、こんな時に…❤）
PRINTFORMW 「はぁ…くたびれた…」	PRINTFORMW 「はぁ…くたびれた…」
PRINTFORMW 「全く…邪魔な奴らだ」	PRINTFORMW 「全く…邪魔な奴らだ」
PRINTFORMW 「げ…は…ぐ、はぁ…」	PRINTFORMW 「げ…は…ぐ、はぁ…」
PRINTFORML 「んっ、…んぅ…っ❤」	PRINTFORML 「んっ、…んぅ…っ❤」
PRINTFORMW 「ん…すぅ…う……」	PRINTFORMW 「ん…すぅ…う……」
PRINTFORMW 「…ぐ……んみゅ…」	PRINTFORMW 「…ぐ……んみゅ…」
PRINTFORMW 「どっ…せーいっ！」	PRINTFORMW 「どっ…せーいっ！」
PRINTFORMW 「まーだまだぁっ！」	PRINTFORMW 「まーだまだぁっ！」
PRINTFORMW 「足元がお留守だ！」	PRINTFORMW 「足元がお留守だ！」
PRINTFORML 「ひぃ…へぇ…っ！」	PRINTFORML 「ひぃ…へぇ…っ！」
PRINTFORMW 「尻なんか触るな！」	PRINTFORMW 「尻なんか触るな！」
PRINTFORMW 「あ、がっ………！」	PRINTFORMW 「あ、がっ………！」
PRINTFORMW 「う…痛ぅ～っ……」	PRINTFORMW 「う…痛ぅ～っ……」
PRINTFORMW 「んぎ、んぎぃ…❤」	PRINTFORMW 「んぎ、んぎぃ…❤」
PRINTFORMW 「き、効かんぞ…！」	PRINTFORMW 「き、効かんぞ…！」
PRINTFORMW 「んっきううぅ！！」	PRINTFORMW 「んっきううぅ！！」
PRINTFORMW 「あっ、ああぁっ…」	PRINTFORMW 「あっ、ああぁっ…」
PRINTFORMW 「ひぃ…っくぅ…❤」	PRINTFORMW 「ひぃ…っくぅ…❤」
PRINTFORMW 「不意打ちだと！？」	PRINTFORMW 「不意打ちだと！？」
PRINTFORML 「あぁ…助かった…」	PRINTFORML 「あぁ…助かった…」
PRINTFORMW 「また落ちてたか…」	PRINTFORMW 「また落ちてたか…」
PRINTFORMW 「よし、近接武器だ」	PRINTFORMW 「よし、近接武器だ」
PRINTFORMW 「どぉりゃー！！」	PRINTFORMW 「どぉりゃー！！」
PRINTFORMW 「小突いてやる！」	PRINTFORMW 「小突いてやる！」
PRINTFORMW 「放せ！このっ！」	PRINTFORMW 「放せ！このっ！」
PRINTFORMW 「ぐ…え……っ…」	PRINTFORMW 「ぐ…え……っ…」
PRINTFORMW 「お、おふぅ…っ」	PRINTFORMW 「お、おふぅ…っ」
PRINTFORMW 「ふんいぃっ！？」	PRINTFORMW 「ふんいぃっ！？」
PRINTFORMW 「ぎゅうっ……❤」	PRINTFORMW 「ぎゅうっ……❤」
PRINTFORMW 「ふぎゅぅうぅ❤」	PRINTFORMW 「ふぎゅぅうぅ❤」
PRINTFORMW 「よし、次だ…！」	PRINTFORMW 「よし、次だ…！」
PRINTFORMW 「よし、次だっ！」	PRINTFORMW 「よし、次だっ！」
PRINTFORML 「うっ！服が…！」	PRINTFORML 「うっ！服が…！」
PRINTFORMW 「う、ヤバい…！」	PRINTFORMW 「う、ヤバい…！」
PRINTFORMW 「油断したか…！」	PRINTFORMW 「油断したか…！」
PRINTFORMW 「腕が鳴るな…！」	PRINTFORMW 「腕が鳴るな…！」
PRINTFORMW 「…ゆ…紫が…！」	PRINTFORMW 「…ゆ…紫が…！」
PRINTFORMW 「酷い有様だな…」	PRINTFORMW 「酷い有様だな…」
PRINTFORMW 「ぐ……ぐぅ…」	PRINTFORMW 「ぐ……ぐぅ…」
PRINTFORMW 「そら食らえ！」	PRINTFORMW 「そら食らえ！」
PRINTFORMW 「そーらよっ！」	PRINTFORMW 「そーらよっ！」
PRINTFORMW 「消し飛びな！」	PRINTFORMW 「消し飛びな！」
PRINTFORMW 「んぎいぃ…！」	PRINTFORMW 「んぎいぃ…！」
PRINTFORMW 「んひゅぅ…❤」	PRINTFORMW 「んひゅぅ…❤」
PRINTFORMW 「ひあ…は…❤」	PRINTFORMW 「ひあ…は…❤」
PRINTFORMW 「くゅうぅ…❤」	PRINTFORMW 「くゅうぅ…❤」
PRINTFORMW 「んひゅぅ…！」	PRINTFORMW 「んひゅぅ…！」
PRINTFORMW 「ひにゃあっ❤」	PRINTFORMW 「ひにゃあっ❤」
PRINTFORMW 「ひっ…ぎ…❤」	PRINTFORMW 「ひっ…ぎ…❤」
PRINTFORMW 「あぎぃいぃ！」	PRINTFORMW 「あぎぃいぃ！」
PRINTFORMW 「やあぁっ…❤」	PRINTFORMW 「やあぁっ…❤」
PRINTFORMW 「ほ…ひいぃ…」	PRINTFORMW 「ほ…ひいぃ…」
PRINTFORMW 「ほっ！…とぉ」	PRINTFORMW 「ほっ！…とぉ」
PRINTFORML 「あ、ああぁ…」	PRINTFORML 「あ、ああぁ…」
PRINTFORMW 「いけるか…？」	PRINTFORMW 「いけるか…？」
PRINTFORMW 「…霊夢………」	PRINTFORMW 「…霊夢………」
PRINTFORMW 「おらおら！」	PRINTFORMW 「おらおら！」
PRINTFORMW 「うりゃー！」	PRINTFORMW 「うりゃー！」
PRINTFORML 「は…ひ…❤」	PRINTFORML 「は…ひ…❤」
PRINTFORMW 「ひゃう…！」	PRINTFORMW 「ひゃう…！」
PRINTFORMW 「あ…うぅ…」	PRINTFORMW 「あ…うぅ…」
PRINTFORMW 「ぐひぃ…っ」	PRINTFORMW 「ぐひぃ…っ」
PRINTFORMW 「はうぅ…っ」	PRINTFORMW 「はうぅ…っ」
PRINTFORMW 「全員倒す！」	PRINTFORMW 「全員倒す！」
PRINTFORMW 「そりゃ！」	PRINTFORMW 「そりゃ！」
PRINTFORMW 「ぐあっ！」	PRINTFORMW 「ぐあっ！」
PRINTFORML 「ふ…っ！」	PRINTFORML 「ふ…っ！」
PRINTFORMW 「勇儀……」	PRINTFORMW 「勇儀……」
PRINTFORMW 「ひ…！」	PRINTFORMW 「ひ…！」
PRINTFORMW 「」	PRINTFORMW 「」
PRINTFORMW （）	PRINTFORMW （）
PRINTFORMDL 	PRINTFORMDL 
