//口上:

PRINTFORMDW %ARGS:0%が%ARGS:1%の胸に押し付けながら射精すると、%ARGS:1%は驚くこともなく体についた精液を舐めとっていく……	PRINTFORMDW %ARGS:0%が%ARGS:1%の胸に押し付けながら射精すると、%ARGS:1%は驚くこともなく体についた精液を舐めとっていく……
PRINTFORMDW %ARGS:0%が自分の竿を%ARGS:1%の顔に押し付けても、%ARGS:1%は嫌がるどころか喜んで奉仕を続けていく……	PRINTFORMDW %ARGS:0%が自分の竿を%ARGS:1%の顔に押し付けても、%ARGS:1%は嫌がるどころか喜んで奉仕を続けていく……
PRINTFORMW 「ごめんなさい、ごめんなさい、ごめんなさい、ごめんなさい、ごめんなさい、ごめんなさい、ごめんなさい、ごめんなさい……」	PRINTFORMW 「ごめんなさい、ごめんなさい、ごめんなさい、ごめんなさい、ごめんなさい、ごめんなさい、ごめんなさい、ごめんなさい……」
PRINTFORMDW さっそく%ARGS:0%が自分の竿を突き入れると、%ARGS:1%は拒むこともなくただくぐもった嬌声を漏らした……	PRINTFORMDW さっそく%ARGS:0%が自分の竿を突き入れると、%ARGS:1%は拒むこともなくただくぐもった嬌声を漏らした……
PRINTFORMDW さっそく%ARGS:0%が自分の竿を突き入れると、%ARGS:1%は拒むこともせずただくぐもった嬌声を漏らした……	PRINTFORMDW さっそく%ARGS:0%が自分の竿を突き入れると、%ARGS:1%は拒むこともせずただくぐもった嬌声を漏らした……
PRINTFORMDW %ARGS:0%は%ARGS:1%の腰を押さえつけると、膣から溢れ出すほど大量の白濁液を射精した……	PRINTFORMDW %ARGS:0%は%ARGS:1%の腰を押さえつけると、膣から溢れ出すほど大量の白濁液を射精した……
PRINTFORMDL %ARGS:1%から見つめられた途端、鈴仙はぼんやりとした笑顔で股を開き、指で女性器を露わにした。	PRINTFORMDL %ARGS:1%から見つめられた途端、鈴仙はぼんやりとした笑顔で股を開き、指で女性器を露わにした。
PRINTFORMDW %ARGS:0%は中に幼体がいることも構わず、%ARGS:1%の子宮へと大量の白濁液を射精した……	PRINTFORMDW %ARGS:0%は中に幼体がいることも構わず、%ARGS:1%の子宮へと大量の白濁液を射精した……
PRINTFORMDW %ARGS:0%が射精した精液を、%ARGS:1%は少しこぼしながらもゆっくりと飲み込んでいく……	PRINTFORMDW %ARGS:0%が射精した精液を、%ARGS:1%は少しこぼしながらもゆっくりと飲み込んでいく……
PRINTFORMDW 脱出した先には何の変哲もない平原が広げるだけで、いま抜けだしたはずの迷宮は完全に消滅していた……	PRINTFORMDW 脱出した先には何の変哲もない平原が広げるだけで、いま抜けだしたはずの迷宮は完全に消滅していた……
PRINTFORMDW 脱出した先には何の変哲もない平原が広げるだけで、いま抜けだしたはずの迷宮は完全に消滅していた。	PRINTFORMDW 脱出した先には何の変哲もない平原が広げるだけで、いま抜けだしたはずの迷宮は完全に消滅していた。
PRINTFORMW 「はぁっ……硬くて、形もぴったりでっ♪　貴方と私のっ、あいしょお……んんっ！　ばっちりですぅ♪」	PRINTFORMW 「はぁっ……硬くて、形もぴったりでっ♪　貴方と私のっ、あいしょお……んんっ！　ばっちりですぅ♪」
PRINTFORMDW 何かが這いずった痕跡――例えば、噂の液体がまばらに残っている様とか――はその中へと進んでいる。	PRINTFORMDW 何かが這いずった痕跡――例えば、噂の液体がまばらに残っている様とか――はその中へと進んでいる。
PRINTFORMDW 迷ったからという可能性はない。そもそも、迷いの竹林にこんな洞窟は一つも存在していないのだから。	PRINTFORMDW 迷ったからという可能性はない。そもそも、迷いの竹林にこんな洞窟は一つも存在していないのだから。
PRINTFORMDW 鈴仙は現実に呼び戻されるや否や自分に何が起こったかを直視させられ、顔を青ざめて悲鳴を上げた。	PRINTFORMDW 鈴仙は現実に呼び戻されるや否や自分に何が起こったかを直視させられ、顔を青ざめて悲鳴を上げた。
PRINTFORMDL %ARGS:1%から視線を受けた鈴仙は近くの触手を優しく握りしめ、自分の膣内へと挿れていく。	PRINTFORMDL %ARGS:1%から視線を受けた鈴仙は近くの触手を優しく握りしめ、自分の膣内へと挿れていく。
PRINTFORM 「このままじゃ、はぁっ、戦えない、から……だから、もっと、犯してぇ！　早く満足させたいんですぅ	PRINTFORM 「このままじゃ、はぁっ、戦えない、から……だから、もっと、犯してぇ！　早く満足させたいんですぅ
PRINTFORMDL 鈴仙口上において催眠系のコマンドは主に発情・感情操作系（触手が好きになる）を想定しています	PRINTFORMDL 鈴仙口上において催眠系のコマンドは主に発情・感情操作系（触手が好きになる）を想定しています
PRINTFORMW （こんな目にあって、なぜこの人はいつも通りなの……？　それとも……いつも通りじゃ、ないの？）	PRINTFORMW （こんな目にあって、なぜこの人はいつも通りなの……？　それとも……いつも通りじゃ、ないの？）
PRINTFORM 「このままじゃ、はぁっ、戦えない、から……だから、もっと、犯してぇ！　早く満足させてあげるぅ	PRINTFORM 「このままじゃ、はぁっ、戦えない、から……だから、もっと、犯してぇ！　早く満足させてあげるぅ
PRINTFORMDW %ARGS:0%%TACHI()%の攻撃がついにガーディアンを貫き、その息の根を止めた。	PRINTFORMDW %ARGS:0%%TACHI()%の攻撃がついにガーディアンを貫き、その息の根を止めた。
PRINTFORMDL %ARGS:1%の目が光ると共に鈴仙は触手に股間を密着させ、熱っぽい表情で擦り始めた……	PRINTFORMDL %ARGS:1%の目が光ると共に鈴仙は触手に股間を密着させ、熱っぽい表情で擦り始めた……
PRINTFORMDL 催眠を受け自ら触手を膣内へ入れようとした鈴仙だったが、何かに気付いたように腰を止めた。	PRINTFORMDL 催眠を受け自ら触手を膣内へ入れようとした鈴仙だったが、何かに気付いたように腰を止めた。
PRINTFORMW 「て、手伝います、手伝いますから。だから月から逃げ出したことは……見逃して下さい、ね？」	PRINTFORMW 「て、手伝います、手伝いますから。だから月から逃げ出したことは……見逃して下さい、ね？」
PRINTFORMDW 迷いの竹林の片隅、低く草が生い茂る場所で。鈴仙の前に、ぽっかりと洞窟が口を開けていた。	PRINTFORMDW 迷いの竹林の片隅、低く草が生い茂る場所で。鈴仙の前に、ぽっかりと洞窟が口を開けていた。
PRINTFORMDW 明らかに異常な光景に……だが、鈴仙は戸惑うどころか、むしろ得心したように笑っていた。	PRINTFORMDW 明らかに異常な光景に……だが、鈴仙は戸惑うどころか、むしろ得心したように笑っていた。
PRINTFORML 全般的にテンション低めです。また、催眠に関しては主に発情・感情操作系に対応しています。	PRINTFORML 全般的にテンション低めです。また、催眠に関しては主に発情・感情操作系に対応しています。
PRINTFORMDW 自分の瞳で自分の波長を狂わせた鈴仙は、蕩けた視線で純潔を奪った相手を見つめはじめた。	PRINTFORMDW 自分の瞳で自分の波長を狂わせた鈴仙は、蕩けた視線で純潔を奪った相手を見つめはじめた。
PRINTFORMDL %ARGS:1%が触手を動かすと鈴仙は自ら後ろを向き、尻を振って触手を招き入れた……	PRINTFORMDL %ARGS:1%が触手を動かすと鈴仙は自ら後ろを向き、尻を振って触手を招き入れた……
PRINTFORMDL 中で触手が少しずつ動き始めるのを感じ、鈴仙は%ARGS:1%を愛しそうに見つめた……	PRINTFORMDL 中で触手が少しずつ動き始めるのを感じ、鈴仙は%ARGS:1%を愛しそうに見つめた……
PRINTFORMW 「て、てゐったら……冗談にしては質が悪いわよ。やられたふりしてるんでしょ？　ね、ね？」	PRINTFORMW 「て、てゐったら……冗談にしては質が悪いわよ。やられたふりしてるんでしょ？　ね、ね？」
PRINTFORMW 「……あれ、こんな所にも玉兎がいるの？　不思議なくらい私にそっくりだけど、なんでだろ」	PRINTFORMW 「……あれ、こんな所にも玉兎がいるの？　不思議なくらい私にそっくりだけど、なんでだろ」
PRINTFORMW 「あ……あぁ、いや、いやぁ……！　私に子供なんていない、子供じゃないっ、あんなの……」	PRINTFORMW 「あ……あぁ、いや、いやぁ……！　私に子供なんていない、子供じゃないっ、あんなの……」
PRINTFORMDW 手も脚も頭もなく、ただ細長い胴体だけをしならせる異形の群れが出口に立ち塞がっていた。	PRINTFORMDW 手も脚も頭もなく、ただ細長い胴体だけをしならせる異形の群れが出口に立ち塞がっていた。
PRINTFORMW 「あはっ、もうやめられないぃ♪　きゅうきゅう締められるの大好き、中出しだいすきぃっ♪」	PRINTFORMW 「あはっ、もうやめられないぃ♪　きゅうきゅう締められるの大好き、中出しだいすきぃっ♪」
PRINTFORMDW %ARGS:0%は自分の上で腰を振る%ARGS:1%に蕩けきった視線を向けている……	PRINTFORMDW %ARGS:0%は自分の上で腰を振る%ARGS:1%に蕩けきった視線を向けている……
PRINTFORMW 「これじゃ、他のみんなを探してから逃げるなんて……だから仕方ない、仕方ない……よね」	PRINTFORMW 「これじゃ、他のみんなを探してから逃げるなんて……だから仕方ない、仕方ない……よね」
PRINTFORMDW 崩れる通路の中を、間一髪で駆け抜けた%ARGS:0%%TACHI()%だったが――	PRINTFORMDW 崩れる通路の中を、間一髪で駆け抜けた%ARGS:0%%TACHI()%だったが――
PRINTFORMDW 脱出したあの日、完全に消えた迷宮を見た鈴仙は……あれは夢だったと理解したのだった。	PRINTFORMDW 脱出したあの日、完全に消えた迷宮を見た鈴仙は……あれは夢だったと理解したのだった。
PRINTFORMDW 他のイナバも消えたりしている以上、数少ない帰還者に対策を考えて貰わないといけない。	PRINTFORMDW 他のイナバも消えたりしている以上、数少ない帰還者に対策を考えて貰わないといけない。
PRINTFORMW 　夢……夢……ほら、周りの視界がぼやけてきた……だから、この風景は見なくていい……」	PRINTFORMW 　夢……夢……ほら、周りの視界がぼやけてきた……だから、この風景は見なくていい……」
PRINTFORMW 「はぁっ、ふぅぅんっ……♪　こんな、寸前で止められたらっ……もうわたひだめれすぅ♪」	PRINTFORMW 「はぁっ、ふぅぅんっ……♪　こんな、寸前で止められたらっ……もうわたひだめれすぅ♪」
PRINTFORMDL 触手が怪しく蠢いた途端、鈴仙はフラフラと近づいて触手をその胸で挟み、しごき始めた。	PRINTFORMDL 触手が怪しく蠢いた途端、鈴仙はフラフラと近づいて触手をその胸で挟み、しごき始めた。
PRINTFORMDL そのまま恋人のように抱きついた鈴仙を、%ARGS:1%の触手が優しく撫でている……	PRINTFORMDL そのまま恋人のように抱きついた鈴仙を、%ARGS:1%の触手が優しく撫でている……
PRINTFORMW 「んうっ……せーえきでナカたぷたぷしてる、すごく熱くて、もっとしたくなっちゃうぅ♪」	PRINTFORMW 「んうっ……せーえきでナカたぷたぷしてる、すごく熱くて、もっとしたくなっちゃうぅ♪」
PRINTFORM 「お腹が膨らんだ姫様も綺麗です……だって、私を気持ちよくさせようと動いてるんだもの……	PRINTFORM 「お腹が膨らんだ姫様も綺麗です……だって、私を気持ちよくさせようと動いてるんだもの……
PRINTFORMDW ……何もなかったように、というのは語弊がある。彼女の中では、本当に何もなかった。	PRINTFORMDW ……何もなかったように、というのは語弊がある。彼女の中では、本当に何もなかった。
PRINTFORMW 「なんで……なんで、こんなことに……！　私のはじめてが、最悪な形で穢されて……？」	PRINTFORMW 「なんで……なんで、こんなことに……！　私のはじめてが、最悪な形で穢されて……？」
PRINTFORMDW 鈴仙は自分の処女を散らした相手に、心ここにあらずといった様子で笑いかけている……	PRINTFORMDW 鈴仙は自分の処女を散らした相手に、心ここにあらずといった様子で笑いかけている……
PRINTFORMW 「かえちゃえ……相手が、かえられないのなら……わたしを、かえちゃえばいいのよ……」	PRINTFORMW 「かえちゃえ……相手が、かえられないのなら……わたしを、かえちゃえばいいのよ……」
PRINTFORMW 「あうっ、おしりぃ……んふ、だいじょぶですぅ♪　あなたのためなら、我慢しますぅ♪」	PRINTFORMW 「あうっ、おしりぃ……んふ、だいじょぶですぅ♪　あなたのためなら、我慢しますぅ♪」
PRINTFORMW 「あはぁっ、なかだしされてるぅ♪　わたしっ、しろいのだされてぇ、よろこんでるぅ！」	PRINTFORMW 「あはぁっ、なかだしされてるぅ♪　わたしっ、しろいのだされてぇ、よろこんでるぅ！」
PRINTFORMDW 悲痛な叫び声を上げ続ける鈴仙に構うことなく、膣内の奥深くまで異物は侵入していく。	PRINTFORMDW 悲痛な叫び声を上げ続ける鈴仙に構うことなく、膣内の奥深くまで異物は侵入していく。
PRINTFORMW 「無事なあたり、さすがにお強いですね。あ、だからって訓練は勘弁してほしいです……」	PRINTFORMW 「無事なあたり、さすがにお強いですね。あ、だからって訓練は勘弁してほしいです……」
PRINTFORMDW 鈴仙は言葉を理解しないまま頷くと、自ら胸を差し出して自慰をするように絞り始めた。	PRINTFORMDW 鈴仙は言葉を理解しないまま頷くと、自ら胸を差し出して自慰をするように絞り始めた。
PRINTFORMDW 鈴仙は自分の頭を抑えながら、うつろな瞳でブツブツと独り言をつぶやき続けている……	PRINTFORMDW 鈴仙は自分の頭を抑えながら、うつろな瞳でブツブツと独り言をつぶやき続けている……
PRINTFORMDW 湿気った生暖かい空気が溢れてくるばかりで、奥は見えない。思わず鈴仙は首をひねる。	PRINTFORMDW 湿気った生暖かい空気が溢れてくるばかりで、奥は見えない。思わず鈴仙は首をひねる。
PRINTFORMW 「はぁ……わかったんですっ♪　私、ずっとこうしたかったんです、好きだったんですっ！	PRINTFORMW 「はぁ……わかったんですっ♪　私、ずっとこうしたかったんです、好きだったんですっ！
PRINTFORM 「ちっちゃなお尻、そんなに振って……見てるだけで興奮できるけど、やっぱり挿れないとぉ	PRINTFORM 「ちっちゃなお尻、そんなに振って……見てるだけで興奮できるけど、やっぱり挿れないとぉ
PRINTFORMDW 度重なる陵辱で壊れかかっていた彼女の精神は、そんな逃避を選んで悪夢を忘却した。	PRINTFORMDW 度重なる陵辱で壊れかかっていた彼女の精神は、そんな逃避を選んで悪夢を忘却した。
PRINTFORMDW 自分の瞳で自分の波長を狂わせた鈴仙は、現実から目を逸らしてまた眠りについた……	PRINTFORMDW 自分の瞳で自分の波長を狂わせた鈴仙は、現実から目を逸らしてまた眠りについた……
PRINTFORMDL まだ頃合いではないと気付いた%ARGS:1%は、膣内を浅く抉るだけに留めた……	PRINTFORMDL まだ頃合いではないと気付いた%ARGS:1%は、膣内を浅く抉るだけに留めた……
PRINTFORMDL %ARGS:1%の魔眼が光ると、鈴仙は蕩けきった目付きでフラフラと歩き出した。	PRINTFORMDL %ARGS:1%の魔眼が光ると、鈴仙は蕩けきった目付きでフラフラと歩き出した。
PRINTFORM 「あうあぁ！？　きてる、まだきてるっ、これじゃイきっぱなしでもどれなくなるよおぉっ	PRINTFORM 「あうあぁ！？　きてる、まだきてるっ、これじゃイきっぱなしでもどれなくなるよおぉっ
PRINTFORMDW 『厳密には違うわね。未知の粘液……あ、これだけど……が各所で見つかっているの。	PRINTFORMDW 『厳密には違うわね。未知の粘液……あ、これだけど……が各所で見つかっているの。
PRINTFORMDW そう分かっていても、普通とは違う波長の相手から距離を取るため奥へ進むしかなく。	PRINTFORMDW そう分かっていても、普通とは違う波長の相手から距離を取るため奥へ進むしかなく。
PRINTFORMW 「だ、だって、てゐなら……いつも通り相手を騙して、すぐ逃げ出す、はず、じゃ……」	PRINTFORMW 「だ、だって、てゐなら……いつも通り相手を騙して、すぐ逃げ出す、はず、じゃ……」
PRINTFORM 「んふっ……♪　元はあいつらの仲間だったんだもの、もっと上手くできるよね……ほらぁ	PRINTFORM 「んふっ……♪　元はあいつらの仲間だったんだもの、もっと上手くできるよね……ほらぁ
PRINTFORMW 「歪んだ視界で避けられるかしら？　……私達と同じ視界があるのかは、怪しいけど」	PRINTFORMW 「歪んだ視界で避けられるかしら？　……私達と同じ視界があるのかは、怪しいけど」
PRINTFORMDW 鈴仙は衝動のまま%ARGS:1%の唇を求めると、貪るように舌を絡め始めた……	PRINTFORMDW 鈴仙は衝動のまま%ARGS:1%の唇を求めると、貪るように舌を絡め始めた……
PRINTFORMDW 髪を振り乱していた鈴仙だったが、ふとある一点を見つめてブツブツと呟き始める。	PRINTFORMDW 髪を振り乱していた鈴仙だったが、ふとある一点を見つめてブツブツと呟き始める。
PRINTFORMW 「そう――夢。これは夢なのよ。私が見てるのは夢で、起きればまた永遠亭にいる……	PRINTFORMW 「そう――夢。これは夢なのよ。私が見てるのは夢で、起きればまた永遠亭にいる……
PRINTFORMDW いよいよ膣内の深くへ潜ろうとする触手に、とろんとした表情で鈴仙は首を傾げた。	PRINTFORMDW いよいよ膣内の深くへ潜ろうとする触手に、とろんとした表情で鈴仙は首を傾げた。
PRINTFORMDW 自分の初めてが喪われかけている状況で、鈴仙は怯えるどころか股を開いていく……	PRINTFORMDW 自分の初めてが喪われかけている状況で、鈴仙は怯えるどころか股を開いていく……
PRINTFORMW 「んっうっ、離さないでぇっ♪　わらひっ、貴方の手で、きもちよくなりたぃんっ♪」	PRINTFORMW 「んっうっ、離さないでぇっ♪　わらひっ、貴方の手で、きもちよくなりたぃんっ♪」
PRINTFORMW 「はーっ、あーっ、いきたいぃ、もっと！　きもちよくなりたいぃっ♪　もっとぉ♪」	PRINTFORMW 「はーっ、あーっ、いきたいぃ、もっと！　きもちよくなりたいぃっ♪　もっとぉ♪」
PRINTFORMW 「あたまっ、あたま変になるぅぅ！　わらひ、わらひぃっ……だめになるぅぅぅぅ♪」	PRINTFORMW 「あたまっ、あたま変になるぅぅ！　わらひ、わらひぃっ……だめになるぅぅぅぅ♪」
PRINTFORMW 「え、えっと……なんで月の兎がここにいるのかしら……他兎のことは言えないけど」	PRINTFORMW 「え、えっと……なんで月の兎がここにいるのかしら……他兎のことは言えないけど」
PRINTFORMW 「もういや、出産なんてもう――ち、ちがう、わ、わたしに、子供なんて……いない」	PRINTFORMW 「もういや、出産なんてもう――ち、ちがう、わ、わたしに、子供なんて……いない」
PRINTFORMW 「っあ、うぁっ、はぁあっ！？　なんでっ、なんで産むの、こんな、きもちいっ……」	PRINTFORMW 「っあ、うぁっ、はぁあっ！？　なんでっ、なんで産むの、こんな、きもちいっ……」
PRINTFORMDW ……半刻ほど前、この痕跡に気付いた鈴仙は嫌々ながらも追跡を開始したのだった。	PRINTFORMDW ……半刻ほど前、この痕跡に気付いた鈴仙は嫌々ながらも追跡を開始したのだった。
PRINTFORMW 「この薬草って、摘んじゃうとそのうち効果が失われていくのよね。すぐ使わないと」	PRINTFORMW 「この薬草って、摘んじゃうとそのうち効果が失われていくのよね。すぐ使わないと」
PRINTFORMW 「そんな綺麗だったら求婚されるの当たり前ですよぅ、私だって興奮しちゃいますぅ♪	PRINTFORMW 「そんな綺麗だったら求婚されるの当たり前ですよぅ、私だって興奮しちゃいますぅ♪
PRINTFORMW 　このままじゃ化物としちゃうっ、股ひらいちゃうから、な、なんとか、するぅ♪」	PRINTFORMW 　このままじゃ化物としちゃうっ、股ひらいちゃうから、な、なんとか、するぅ♪」
PRINTFORMDW 彼女が現実に向きあうとすれば、それはもう一度あの迷宮に捕らわれた時であり。	PRINTFORMDW 彼女が現実に向きあうとすれば、それはもう一度あの迷宮に捕らわれた時であり。
PRINTFORMDW 脱出したあの日、鈴仙は即座に永遠亭へ帰ってそのまま一歩も外に出なくなった。	PRINTFORMDW 脱出したあの日、鈴仙は即座に永遠亭へ帰ってそのまま一歩も外に出なくなった。
PRINTFORMDW 心中でそう吐き捨てながらずんずんと歩いていくてゐをよそに、鈴仙は動かない。	PRINTFORMDW 心中でそう吐き捨てながらずんずんと歩いていくてゐをよそに、鈴仙は動かない。
PRINTFORMW 「あ……あ、れ……？　ご、ごめんなさい、や、やっぱりはじめては怖いです……」	PRINTFORMW 「あ……あ、れ……？　ご、ごめんなさい、や、やっぱりはじめては怖いです……」
PRINTFORMW 「こ、今度は逃げたままで終わりませんから……そのための行動、ですから……！」	PRINTFORMW 「こ、今度は逃げたままで終わりませんから……そのための行動、ですから……！」
PRINTFORMW 「私にわざわざこんな薬を使ってくれるくらいですし、頼りにしていいですよね？」	PRINTFORMW 「私にわざわざこんな薬を使ってくれるくらいですし、頼りにしていいですよね？」
PRINTFORMDW 昏倒するどころか、異形の群れはまるでタガが外れたように暴れだしたのだから。	PRINTFORMDW 昏倒するどころか、異形の群れはまるでタガが外れたように暴れだしたのだから。
PRINTFORM 　ししょー、孕んでくださいっ……あはぁっ、師匠の子供、双子にしちゃいますからぁ	PRINTFORM 　ししょー、孕んでくださいっ……あはぁっ、師匠の子供、双子にしちゃいますからぁ
PRINTFORMW 「いっつも辛いこと私に押し付けてるんだから、仕返しだわっ……んっ、うぅっ♪」	PRINTFORMW 「いっつも辛いこと私に押し付けてるんだから、仕返しだわっ……んっ、うぅっ♪」
PRINTFORMDW これで脱出できると鈴仙が喜んだのも束の間、出口が音を立てて閉じ始める……	PRINTFORMDW これで脱出できると鈴仙が喜んだのも束の間、出口が音を立てて閉じ始める……
PRINTFORML もし殺人事件が起こったら「こんな所もういやっ！　私は部屋に戻るからね！？」	PRINTFORML もし殺人事件が起こったら「こんな所もういやっ！　私は部屋に戻るからね！？」
PRINTFORMDW 呆然としていた鈴仙だったが、ふとある一点を見つめてブツブツと呟き始める。	PRINTFORMDW 呆然としていた鈴仙だったが、ふとある一点を見つめてブツブツと呟き始める。
PRINTFORMW 「だ、だめ、見たら相手の暗示にかかっちゃうのに……目が、離せないよぉ……」	PRINTFORMW 「だ、だめ、見たら相手の暗示にかかっちゃうのに……目が、離せないよぉ……」
PRINTFORM 「ふぅっ、ふううううんっ♪　くるっちゃうぅ、きもちいい事にくるっちゃうぅ……	PRINTFORM 「ふぅっ、ふううううんっ♪　くるっちゃうぅ、きもちいい事にくるっちゃうぅ……
PRINTFORMW 「あん……♪　はいっ、て……っ！？　だ、だめ、だめだめだめだめだめぇっ！」	PRINTFORMW 「あん……♪　はいっ、て……っ！？　だ、だめ、だめだめだめだめだめぇっ！」
PRINTFORMW 「ご、ごめんなさい、ごめんなさいごめんなさい、私の……私のせいです……！」	PRINTFORMW 「ご、ごめんなさい、ごめんなさいごめんなさい、私の……私のせいです……！」
PRINTFORMW 「すごい深そうな洞窟だけど……そんな場所があればてゐが知ってるはずなのに」	PRINTFORMW 「すごい深そうな洞窟だけど……そんな場所があればてゐが知ってるはずなのに」
PRINTFORMW 「何かの薬なの？　体にいいのはわかったけど、やっぱりべとべとして汚い……」	PRINTFORMW 「何かの薬なの？　体にいいのはわかったけど、やっぱりべとべとして汚い……」
PRINTFORMW 「しょ、しょうがなかったのよ！　だって、そうしなきゃ、私が、私、が……！」	PRINTFORMW 「しょ、しょうがなかったのよ！　だって、そうしなきゃ、私が、私、が……！」
PRINTFORM 「し、師匠、なにを、あ、だめです、いくら師匠でも、あっ、あぁぁぁああああっ	PRINTFORM 「し、師匠、なにを、あ、だめです、いくら師匠でも、あっ、あぁぁぁああああっ
PRINTFORM 「あいつらに犯されながら私にも犯されれば、もっと気持ちよくなれますよぉ……	PRINTFORM 「あいつらに犯されながら私にも犯されれば、もっと気持ちよくなれますよぉ……
PRINTFORMDW 舌打ちをしながらトレイを置く。わざわざてゐが世話をしているのは簡単だ。	PRINTFORMDW 舌打ちをしながらトレイを置く。わざわざてゐが世話をしているのは簡単だ。
PRINTFORMDW （そんな理由がなければ、速攻で見捨てて孤独死させるんだけど……ふん！）	PRINTFORMDW （そんな理由がなければ、速攻で見捨てて孤独死させるんだけど……ふん！）
PRINTFORMDW 瞳が向いた先は触手の体液が零れ落ちて作った、鈴仙の顔を映す水面だった。	PRINTFORMDW 瞳が向いた先は触手の体液が零れ落ちて作った、鈴仙の顔を映す水面だった。
PRINTFORMW 「元は、ここの住人なんだし……少しくらいなら、悪く……ないんだから……」	PRINTFORMW 「元は、ここの住人なんだし……少しくらいなら、悪く……ないんだから……」
PRINTFORMW 「こ、今度は逃げたままで終わらないから……そのための行動、だから……！」	PRINTFORMW 「こ、今度は逃げたままで終わらないから……そのための行動、だから……！」
PRINTFORMW 「……産んで、ない……あんなの、わたしの子供じゃない、わたしのじゃ……」	PRINTFORMW 「……産んで、ない……あんなの、わたしの子供じゃない、わたしのじゃ……」
PRINTFORMW 「ゆ、ゆっくり歩きません……？　ほら、足音は抑えたほうがいいんだし……」	PRINTFORMW 「ゆ、ゆっくり歩きません……？　ほら、足音は抑えたほうがいいんだし……」
PRINTFORMDW 　人里から調べてほしいと頼まれているから、見かけたら教えてちょうだい』	PRINTFORMDW 　人里から調べてほしいと頼まれているから、見かけたら教えてちょうだい』
PRINTFORMW 「吸われてるぅっ♪　ナカで締め付けられるのが、こんなにいいだなんてぇ♪」	PRINTFORMW 「吸われてるぅっ♪　ナカで締め付けられるのが、こんなにいいだなんてぇ♪」
PRINTFORM 「んうっ、すごい……裏までぜんぶ、舐められたら……もうだめ、出る、出るぅっ	PRINTFORM 「んうっ、すごい……裏までぜんぶ、舐められたら……もうだめ、出る、出るぅっ
PRINTFORM 「はぁっ、んんっ……てゐが私のいいなりになって、私の精液を欲しがってる……	PRINTFORM 「はぁっ、んんっ……てゐが私のいいなりになって、私の精液を欲しがってる……
PRINTFORMW 「私の眼なら、単発でも複数に見せられる！　……相手が普通の人妖ならね」	PRINTFORMW 「私の眼なら、単発でも複数に見せられる！　……相手が普通の人妖ならね」
PRINTFORM 「あいつらに犯されながら私にも犯されれば、もっと気持ちよくなれるよぉ……	PRINTFORM 「あいつらに犯されながら私にも犯されれば、もっと気持ちよくなれるよぉ……
PRINTFORMDW 何もなかったように、永琳が作り置きしていた薬を人里へ売りに行く毎日。	PRINTFORMDW 何もなかったように、永琳が作り置きしていた薬を人里へ売りに行く毎日。
PRINTFORMW 「ほら、私に攻撃したら、痛い目に遭うんだから……もう攻撃しないでよ！」	PRINTFORMW 「ほら、私に攻撃したら、痛い目に遭うんだから……もう攻撃しないでよ！」
PRINTFORMDL 自分の裸が見られていることに気付いた鈴仙は、虚ろな目つきで笑った……	PRINTFORMDL 自分の裸が見られていることに気付いた鈴仙は、虚ろな目つきで笑った……
PRINTFORMW 「充血が悪化したみたい、有り得ないものが見える……目薬刺さなきゃ……」	PRINTFORMW 「充血が悪化したみたい、有り得ないものが見える……目薬刺さなきゃ……」
PRINTFORMW 「しかも、今度はこんな状況で……さ、最低だ、わたし、最低の玉兎だ……」	PRINTFORMW 「しかも、今度はこんな状況で……さ、最低だ、わたし、最低の玉兎だ……」
PRINTFORMW 「は、離して、こないでっ！　せ、せめて方向感覚だけでも狂わせて……！」	PRINTFORMW 「は、離して、こないでっ！　せ、せめて方向感覚だけでも狂わせて……！」
PRINTFORMW 「でも……しょうがないよね……無理やり奪われるよりはずっといいし……」	PRINTFORMW 「でも……しょうがないよね……無理やり奪われるよりはずっといいし……」
PRINTFORMW 「憎んでください、恨んでください、私は反省しない最低の玉兎です……！」	PRINTFORMW 「憎んでください、恨んでください、私は反省しない最低の玉兎です……！」
PRINTFORMDW 自分の体調に気付いた鈴仙は、どこか挙動不審な様子で体を撫でている……	PRINTFORMDW 自分の体調に気付いた鈴仙は、どこか挙動不審な様子で体を撫でている……
PRINTFORMW 「いつもの調子で動くのはいいけど、ここじゃどうなってもしらないわよ？」	PRINTFORMW 「いつもの調子で動くのはいいけど、ここじゃどうなってもしらないわよ？」
PRINTFORM 　きもちいいことだけ見て、快楽にくるうのは……こんなに、すてきだから……	PRINTFORM 　きもちいいことだけ見て、快楽にくるうのは……こんなに、すてきだから……
PRINTFORMW 「もうだめっ、射精したい……！　せーえき、いっぱい出したいよぅ……♪」	PRINTFORMW 「もうだめっ、射精したい……！　せーえき、いっぱい出したいよぅ……♪」
PRINTFORMW 「視界を歪ませるのは慣れてるけど、歪まされるのは全然慣れてない……」	PRINTFORMW 「視界を歪ませるのは慣れてるけど、歪まされるのは全然慣れてない……」
PRINTFORM 「あいつらに犯されるより、私に犯される方が穢れないじゃないですかぁ……	PRINTFORM 「あいつらに犯されるより、私に犯される方が穢れないじゃないですかぁ……
PRINTFORMD 例え{DAY}日も日付が進んでいても、周りから誰かが消えていっても、	PRINTFORMD 例え{DAY}日も日付が進んでいても、周りから誰かが消えていっても、
PRINTFORMDW 鈴仙はその度に自分の瞳で自分を狂わせ、不都合な記憶を消していった。	PRINTFORMDW 鈴仙はその度に自分の瞳で自分を狂わせ、不都合な記憶を消していった。
PRINTFORMDW 誤魔化しようのなくなった彼女の心は、その時に限界を迎えるだろう――	PRINTFORMDW 誤魔化しようのなくなった彼女の心は、その時に限界を迎えるだろう――
PRINTFORMDW 他のイナバも消えたりしている以上、一緒に対策を考えないといけない。	PRINTFORMDW 他のイナバも消えたりしている以上、一緒に対策を考えないといけない。
PRINTFORMDW 鈴仙は右腕で構えながらも、もう片方の腕で必死に股間を隠している……	PRINTFORMDW 鈴仙は右腕で構えながらも、もう片方の腕で必死に股間を隠している……
PRINTFORMDL 触手が鈴仙の擬似陰茎に巻き付くと、鈴仙は自分から腰を動かし始めた。	PRINTFORMDL 触手が鈴仙の擬似陰茎に巻き付くと、鈴仙は自分から腰を動かし始めた。
PRINTFORMDL そのまま自分で腰を揺らし、愛液を溢れさせながら触手を受け入れた……	PRINTFORMDL そのまま自分で腰を揺らし、愛液を溢れさせながら触手を受け入れた……
PRINTFORM 「うあっ、穢されてる……なか、せーえきで穢されてるのに、きもちいぃ……	PRINTFORM 「うあっ、穢されてる……なか、せーえきで穢されてるのに、きもちいぃ……
PRINTFORMW 「輝夜さまなら、大丈夫、やられたり……しない……死なない、んだから」	PRINTFORMW 「輝夜さまなら、大丈夫、やられたり……しない……死なない、んだから」
PRINTFORMW 「あ、あぁっ、うわああああああっ！　私、また、またやったの……！？」	PRINTFORMW 「あ、あぁっ、うわああああああっ！　私、また、またやったの……！？」
PRINTFORMW 「逃げてる……私、今度は本当に、目の前で仲間を見捨てて逃げてる……」	PRINTFORMW 「逃げてる……私、今度は本当に、目の前で仲間を見捨てて逃げてる……」
PRINTFORMW 「こ……こんなパーティにいられないわ！　私は一人で逃げるからね！？」	PRINTFORMW 「こ……こんなパーティにいられないわ！　私は一人で逃げるからね！？」
PRINTFORMDW 他の催眠に拘りを持っていないのであれば変更することをおすすめします	PRINTFORMDW 他の催眠に拘りを持っていないのであれば変更することをおすすめします
PRINTFORMDW ともあれ、これ以上深入りする必要はない。外に出ようと振り返って……	PRINTFORMDW ともあれ、これ以上深入りする必要はない。外に出ようと振り返って……
PRINTFORMW 「これ、効いてない……んじゃなくて、違う効果になって……きゃっ！？」	PRINTFORMW 「これ、効いてない……んじゃなくて、違う効果になって……きゃっ！？」
PRINTFORMW 「使っても……いいよね。拾いに戻ってくる可能性なんて低いんだし……」	PRINTFORMW 「使っても……いいよね。拾いに戻ってくる可能性なんて低いんだし……」
PRINTFORMW 「吸われてるぅ……わたしのせーえき、ごくごく飲み込まれてるよぉっ♪」	PRINTFORMW 「吸われてるぅ……わたしのせーえき、ごくごく飲み込まれてるよぉっ♪」
PRINTFORM 「貴方の子宮、こどもと、私のせーえきでっ、いっぱいにしちゃいますからぁ	PRINTFORM 「貴方の子宮、こどもと、私のせーえきでっ、いっぱいにしちゃいますからぁ
PRINTFORM 「貴方の子宮、こどもと、私のせーえきでっ、いっぱいにしちゃうんだからぁ	PRINTFORM 「貴方の子宮、こどもと、私のせーえきでっ、いっぱいにしちゃうんだからぁ
PRINTFORMW 　あ……きました、せーえき来ましたっ、受け取って下さいひめさまぁ！」	PRINTFORMW 　あ……きました、せーえき来ましたっ、受け取って下さいひめさまぁ！」
﻿PRINTFORMDW 触手を見つめる鈴仙の顔からは、表情というものが抜け落ちている……	PRINTFORMDW 触手を見つめる鈴仙の顔からは、表情というものが抜け落ちている……
PRINTFORMW 「見えない弾は避けられない。でも……そもそも視界があればの話よね」	PRINTFORMW 「見えない弾は避けられない。でも……そもそも視界があればの話よね」
PRINTFORMW 「波長を狂わせ過ぎると、逆にやりづらくなるかな？　相手が相手だし」	PRINTFORMW 「波長を狂わせ過ぎると、逆にやりづらくなるかな？　相手が相手だし」
PRINTFORMW 「ご、ごめんなさい荒っぽくして……でも師匠が悪いんですからね！？」	PRINTFORMW 「ご、ごめんなさい荒っぽくして……でも師匠が悪いんですからね！？」
PRINTFORMW 「ご、ごめんなさい荒っぽくして……でも姫様が悪いんですからね！？」	PRINTFORMW 「ご、ごめんなさい荒っぽくして……でも姫様が悪いんですからね！？」
PRINTFORMW 「ご、ごめんなさい荒っぽくして……でも貴方が悪いんですからね！？」	PRINTFORMW 「ご、ごめんなさい荒っぽくして……でも貴方が悪いんですからね！？」
PRINTFORMDW そんな中で、脱出してからずっと鈴仙は永遠亭から一歩も外に出ない。	PRINTFORMDW そんな中で、脱出してからずっと鈴仙は永遠亭から一歩も外に出ない。
PRINTFORMW 「あんっ、はぁぁんっ♪　も、もっと、もっとつよくしていいよ……！」	PRINTFORMW 「あんっ、はぁぁんっ♪　も、もっと、もっとつよくしていいよ……！」
PRINTFORMW 「だいすきっ、えっちなことだいすきだから、そのままつづけてぇっ！」	PRINTFORMW 「だいすきっ、えっちなことだいすきだから、そのままつづけてぇっ！」
PRINTFORM 「いやぁあっ！　そこっ、こするのっ、きもちいいからっ、いやぁぁっ……	PRINTFORM 「いやぁあっ！　そこっ、こするのっ、きもちいいからっ、いやぁぁっ……
PRINTFORMW 「ご、ごめんなさい、師匠……で、でも、でもっ、私は死にたくない！」	PRINTFORMW 「ご、ごめんなさい、師匠……で、でも、でもっ、私は死にたくない！」
PRINTFORMW 「飲まれてますぅ♪　ごくごくって音がしてるの、伝わってきますぅ♪」	PRINTFORMW 「飲まれてますぅ♪　ごくごくって音がしてるの、伝わってきますぅ♪」
PRINTFORMW 「は、反省してます、反省してますから、訓練特別コースは勘弁です！」	PRINTFORMW 「は、反省してます、反省してますから、訓練特別コースは勘弁です！」
PRINTFORMW 「あ、ししょー！　師匠じゃないですかー！　いてくれてよかったー！」	PRINTFORMW 「あ、ししょー！　師匠じゃないですかー！　いてくれてよかったー！」
PRINTFORMW 「眼が……あんまり効かないの、この辺りはどうなってるか……教えて」	PRINTFORMW 「眼が……あんまり効かないの、この辺りはどうなってるか……教えて」
PRINTFORMW 「ふぅっ、うぁ、あはぁっ♪　いっぱい……飲んでくださいねぇ……？」	PRINTFORMW 「ふぅっ、うぁ、あはぁっ♪　いっぱい……飲んでくださいねぇ……？」
PRINTFORMW 「悪路を走る訓練はしてないのよね……月にこういう穢れた所はないし」	PRINTFORMW 「悪路を走る訓練はしてないのよね……月にこういう穢れた所はないし」
PRINTFORMW 「倒れてる人も、念入りに洗わなきゃ……敵が、来ないようにっ……！」	PRINTFORMW 「倒れてる人も、念入りに洗わなきゃ……敵が、来ないようにっ……！」
PRINTFORMDW 相手がただの動物にせよ妖怪にせよ、普通ならこれで昏倒するはずだ。	PRINTFORMDW 相手がただの動物にせよ妖怪にせよ、普通ならこれで昏倒するはずだ。
PRINTFORMDW 暴走しているのか、異形は味方ごと殴り倒そうと体を叩きつけてくる。	PRINTFORMDW 暴走しているのか、異形は味方ごと殴り倒そうと体を叩きつけてくる。
PRINTFORMW 「しゃ、しゃせーするのしゅごいぃ、こんなの我慢するのむりぃぃっ♪」	PRINTFORMW 「しゃ、しゃせーするのしゅごいぃ、こんなの我慢するのむりぃぃっ♪」
PRINTFORM 　ししょー、孕んでくださいっ……あはぁっ、私の子供、産んでくださいぃ	PRINTFORM 　ししょー、孕んでくださいっ……あはぁっ、私の子供、産んでくださいぃ
PRINTFORM 「妊娠して下さいっ！　月に、私のこどもっ、連れてかえってくださいぃっ	PRINTFORM 「妊娠して下さいっ！　月に、私のこどもっ、連れてかえってくださいぃっ
PRINTFORM 「てゐが私のいいなりになって、私を誘ってる……尻尾ふりふりしてぇ……	PRINTFORM 「てゐが私のいいなりになって、私を誘ってる……尻尾ふりふりしてぇ……
PRINTFORMW 「相手を狂わせる以前に、私の視界が狂ってたらどうしようも……！」	PRINTFORMW 「相手を狂わせる以前に、私の視界が狂ってたらどうしようも……！」
PRINTFORMW 「相手が相手だし、あんまりギミックを捻って撃っても無駄かな……」	PRINTFORMW 「相手が相手だし、あんまりギミックを捻って撃っても無駄かな……」
PRINTFORMW 「弾数はいつもの倍、幻覚でいつもの倍！　……に見えて欲しいなぁ」	PRINTFORMW 「弾数はいつもの倍、幻覚でいつもの倍！　……に見えて欲しいなぁ」
PRINTFORMW （逃げられない……私、このまま終わるんだ……好き放題されて……）	PRINTFORMW （逃げられない……私、このまま終わるんだ……好き放題されて……）
PRINTFORMW 「……ししょー、最近見当たらないけど……いつ帰ってくるんだろ？」	PRINTFORMW 「……ししょー、最近見当たらないけど……いつ帰ってくるんだろ？」
PRINTFORMW 　っっっっっっ！？　あ、あぁっ、う、嘘よね、こんなの嘘よね！？」	PRINTFORMW 　っっっっっっ！？　あ、あぁっ、う、嘘よね、こんなの嘘よね！？」
PRINTFORMW 「あ、あぁ……私……わたしの……はじめての相手は……これ……？」	PRINTFORMW 「あ、あぁ……私……わたしの……はじめての相手は……これ……？」
PRINTFORM 「そう……もっと、速くしていいですからぁ……あなたを、感じさせてぇ	PRINTFORM 「そう……もっと、速くしていいですからぁ……あなたを、感じさせてぇ
PRINTFORMW 「あ……そんな、ナカに挿れないので満足しちゃうんですかぁ……？」	PRINTFORMW 「あ……そんな、ナカに挿れないので満足しちゃうんですかぁ……？」
PRINTFORMW 「そ、そんな、そんなっ……わたしの、わたしのなかに……精液、が」	PRINTFORMW 「そ、そんな、そんなっ……わたしの、わたしのなかに……精液、が」
PRINTFORMW 　ああなっても、きっとだいじょうぶよ。自分で、なんとか、するよ」	PRINTFORMW 　ああなっても、きっとだいじょうぶよ。自分で、なんとか、するよ」
PRINTFORMW 「がまん……できないぃ、トんじゃう、わたしの頭トんじゃうぅっ！」	PRINTFORMW 「がまん……できないぃ、トんじゃう、わたしの頭トんじゃうぅっ！」
PRINTFORMW 「私がやられたら、貴方を助けることもできないの……そう思って！」	PRINTFORMW 「私がやられたら、貴方を助けることもできないの……そう思って！」
PRINTFORMW 「いつか、輝夜さまを助けに戻ってきますから……だ、だから……！」	PRINTFORMW 「いつか、輝夜さまを助けに戻ってきますから……だ、だから……！」
PRINTFORMW 「そ、その、えっと……あ、厚かましいとわかっています、けど……」	PRINTFORMW 「そ、その、えっと……あ、厚かましいとわかっています、けど……」
PRINTFORMW 「許してくれなんていいません、でも、せめて意識だけは戻して……」	PRINTFORMW 「許してくれなんていいません、でも、せめて意識だけは戻して……」
PRINTFORMW 「……いきなり下からどばーっと触手が沸いてきたり、しないよね？」	PRINTFORMW 「……いきなり下からどばーっと触手が沸いてきたり、しないよね？」
PRINTFORMDW 刺激臭に鼻を抑えながら、鈴仙は慎重に、数歩だけ足を踏み入れる。	PRINTFORMDW 刺激臭に鼻を抑えながら、鈴仙は慎重に、数歩だけ足を踏み入れる。
PRINTFORMDW 頭に浮かべる地図と今までの道筋を比べても、ここはまだ竹林の中。	PRINTFORMDW 頭に浮かべる地図と今までの道筋を比べても、ここはまだ竹林の中。
PRINTFORMDW 後退しながら射撃をする鈴仙だが、下がれば下がれるほど当然に――	PRINTFORMDW 後退しながら射撃をする鈴仙だが、下がれば下がれるほど当然に――
PRINTFORMDW 鈴仙が敵を全滅させた頃には、出口も完全に見えなくなっていた……	PRINTFORMDW 鈴仙が敵を全滅させた頃には、出口も完全に見えなくなっていた……
PRINTFORMW 「やっ、やだぁっ！　だからこんな色の泉には入りたくなったのに！」	PRINTFORMW 「やっ、やだぁっ！　だからこんな色の泉には入りたくなったのに！」
PRINTFORMW 「凄い、持ち帰ったら調合に役だ……あれ、なんか分量が減ってる？」	PRINTFORMW 「凄い、持ち帰ったら調合に役だ……あれ、なんか分量が減ってる？」
PRINTFORMW 「ひっ！？　触られてる、うえもしたも犯されてイっちゃうぅっ！？」	PRINTFORMW 「ひっ！？　触られてる、うえもしたも犯されてイっちゃうぅっ！？」
PRINTFORMW 「……実感ないなぁ。悲しんでると、ニヤつきながら現れそうだから」	PRINTFORMW 「……実感ないなぁ。悲しんでると、ニヤつきながら現れそうだから」
PRINTFORMW （体は無事でも、こんな酷い目に遭った心の方は、どうなのかな……）	PRINTFORMW （体は無事でも、こんな酷い目に遭った心の方は、どうなのかな……）
PRINTFORMW （手遅れだ、私……自分で、これが取れないほうがいいと思ってる……	PRINTFORMW （手遅れだ、私……自分で、これが取れないほうがいいと思ってる……
PRINTFORMW 「あはぁっ♪　私のおちんちん、胸の中に吸い込まれるよぉっ……♪」	PRINTFORMW 「あはぁっ♪　私のおちんちん、胸の中に吸い込まれるよぉっ……♪」
PRINTFORM 「あぁ、輝夜さま……ほんとに綺麗で、見てるだけで勃っちゃうよぅ……	PRINTFORM 「あぁ、輝夜さま……ほんとに綺麗で、見てるだけで勃っちゃうよぅ……
PRINTFORML 「あはぁっ♪　私のおちんちん、胸の中に吸い込まれるよぉっ……♪」	PRINTFORML 「あはぁっ♪　私のおちんちん、胸の中に吸い込まれるよぉっ……♪」
PRINTFORMW 「あ、あんっ、したいっ、きもちいい事したいっ、我慢できないっ！	PRINTFORMW 「あ、あんっ、したいっ、きもちいい事したいっ、我慢できないっ！
PRINTFORMW 「だいじょうぶですよぉ……？　私のじゅんび、ばっちりです……」	PRINTFORMW 「だいじょうぶですよぉ……？　私のじゅんび、ばっちりです……」
PRINTFORMW 「こ、これ以上は……だめ、です……でも、よかったら、後で……」	PRINTFORMW 「こ、これ以上は……だめ、です……でも、よかったら、後で……」
PRINTFORMW 「はぁ、はぁっ……もう、こんな事してる場合じゃないのに……！」	PRINTFORMW 「はぁ、はぁっ……もう、こんな事してる場合じゃないのに……！」
PRINTFORMW 　お顔を、お顔を見せて……そしたら、もっと興奮できますぅっ！」	PRINTFORMW 　お顔を、お顔を見せて……そしたら、もっと興奮できますぅっ！」
PRINTFORMDW 里の住民から聞いた話に、無愛想な営業スマイルで鈴仙は答える。	PRINTFORMDW 里の住民から聞いた話に、無愛想な営業スマイルで鈴仙は答える。
PRINTFORMDW その後も異変は終わらず、行方不明になる者は後を絶たなかった。	PRINTFORMDW その後も異変は終わらず、行方不明になる者は後を絶たなかった。
PRINTFORMW 「ここにいれば、きっと捕まらない……ここが私の逃げる場所……」	PRINTFORMW 「ここにいれば、きっと捕まらない……ここが私の逃げる場所……」
PRINTFORML こんな格好じゃ、あっちがその気ならすぐ入れられちゃうぅ……♪」	PRINTFORML こんな格好じゃ、あっちがその気ならすぐ入れられちゃうぅ……♪」
PRINTFORMW 「ひぃっ！？　いや、いやっ、粘液が……粘液が染みこんでくる！」	PRINTFORMW 「ひぃっ！？　いや、いやっ、粘液が……粘液が染みこんでくる！」
PRINTFORMW （なんで……？　なんでこれだけで、お腹が熱くなってぇ……！？）	PRINTFORMW （なんで……？　なんでこれだけで、お腹が熱くなってぇ……！？）
PRINTFORMW 「そんなに吸い付かないでぇ！　イっちゃう、またイっちゃうぅ！」	PRINTFORMW 「そんなに吸い付かないでぇ！　イっちゃう、またイっちゃうぅ！」
PRINTFORMW （ましてや、こんな状態で会えることなんて、きっともう一生……）	PRINTFORMW （ましてや、こんな状態で会えることなんて、きっともう一生……）
PRINTFORMW 「ひぃっ！　ごめんなさい輝夜さま！　見捨ててごめんなさいっ！」	PRINTFORMW 「ひぃっ！　ごめんなさい輝夜さま！　見捨ててごめんなさいっ！」
PRINTFORMDW 現実を直視しない狂った瞳で、鈴仙は自分の娘を見つめている……	PRINTFORMDW 現実を直視しない狂った瞳で、鈴仙は自分の娘を見つめている……
PRINTFORMW 「地上には私の知らない、いろんな生物がいるものなんですね……」	PRINTFORMW 「地上には私の知らない、いろんな生物がいるものなんですね……」
PRINTFORMW 「で、できれば、役に立つ月の道具を少し譲っていただければ……」	PRINTFORMW 「で、できれば、役に立つ月の道具を少し譲っていただければ……」
PRINTFORMW 「やったぁ！　ししょーが一緒に来てくれるなら絶対大丈夫です！」	PRINTFORMW 「やったぁ！　ししょーが一緒に来てくれるなら絶対大丈夫です！」
PRINTFORMDW 永琳がぐったりしているのを見た鈴仙は、明らかに不安そうだ……	PRINTFORMDW 永琳がぐったりしているのを見た鈴仙は、明らかに不安そうだ……
PRINTFORMW 「体調が……前にも、こんな、こと――なかった、なかったのよ！」	PRINTFORMW 「体調が……前にも、こんな、こと――なかった、なかったのよ！」
PRINTFORMW 「無闇に全力疾走するんじゃなくて、速度を一定にしないと駄目ね」	PRINTFORMW 「無闇に全力疾走するんじゃなくて、速度を一定にしないと駄目ね」
PRINTFORMW 「あれ、何かあったような。……気のせいだったほうがいいのかな」	PRINTFORMW 「あれ、何かあったような。……気のせいだったほうがいいのかな」
PRINTFORMW 「ここにあるものって、本当に使っても大丈夫なのか気になる……」	PRINTFORMW 「ここにあるものって、本当に使っても大丈夫なのか気になる……」
PRINTFORMDW 鈴仙は口までお湯に沈めて、疲れきったように泡を吐いている……	PRINTFORMDW 鈴仙は口までお湯に沈めて、疲れきったように泡を吐いている……
PRINTFORMW 「ま、待って下さいししょー！？　師匠がいなかったら、私……！」	PRINTFORMW 「ま、待って下さいししょー！？　師匠がいなかったら、私……！」
PRINTFORMW 「ひっ！？　の、呑まれ……いやっ、イく、すぐイっちゃうぅ！？」	PRINTFORMW 「ひっ！？　の、呑まれ……いやっ、イく、すぐイっちゃうぅ！？」
PRINTFORMW 「あはっ、吸われてるぅ……おちんちん、びゅーびゅしちゃうぅ♪」	PRINTFORMW 「あはっ、吸われてるぅ……おちんちん、びゅーびゅしちゃうぅ♪」
PRINTFORMW 「ひっ、いや……おかしくなる、おちんちん熱くなるぅっ……！？」	PRINTFORMW 「ひっ、いや……おかしくなる、おちんちん熱くなるぅっ……！？」
PRINTFORM 　ずっと射精したいって、おもっちゃってるし……なくしたくない……	PRINTFORM 　ずっと射精したいって、おもっちゃってるし……なくしたくない……
PRINTFORM 「ししょー、凄いですぅ、腰使いもナカもほんとに気持ちいいんですぅ	PRINTFORM 「ししょー、凄いですぅ、腰使いもナカもほんとに気持ちいいんですぅ
PRINTFORMW 　いいよ、今せーえき出すからね、ちゃんと受け取ってねっ……！」	PRINTFORMW 　いいよ、今せーえき出すからね、ちゃんと受け取ってねっ……！」
PRINTFORMW 「さすがに、幻覚じゃ誤魔化せないわね……ちゃんと当てなきゃ」	PRINTFORMW 「さすがに、幻覚じゃ誤魔化せないわね……ちゃんと当てなきゃ」
PRINTFORM 「あいつらに犯されるより、私に犯される方が穢れないじゃない……	PRINTFORM 「あいつらに犯されるより、私に犯される方が穢れないじゃない……
PRINTFORM 「ほらぁ、こっち向いて下さいよ……一緒にいじり合いましょうよぉ	PRINTFORM 「ほらぁ、こっち向いて下さいよ……一緒にいじり合いましょうよぉ
PRINTFORMDW 今の彼女は逃げることすらできない、ただの怯える兎だった……	PRINTFORMDW 今の彼女は逃げることすらできない、ただの怯える兎だった……
PRINTFORML とか言って逃げ出して犠牲になりそうな、そんなうどんげの口上。	PRINTFORML とか言って逃げ出して犠牲になりそうな、そんなうどんげの口上。
PRINTFORMW 「いや……いやぁ……変えて、こんなの汚いの……かえ、て……」	PRINTFORMW 「いや……いやぁ……変えて、こんなの汚いの……かえ、て……」
PRINTFORMDW 裸の状態で体を締め付けられ、鈴仙は顔を真っ青にしている……	PRINTFORMDW 裸の状態で体を締め付けられ、鈴仙は顔を真っ青にしている……
PRINTFORMW 「えへへ、どうですかぁ……尻尾も触って、いいですよぉ……？」	PRINTFORMW 「えへへ、どうですかぁ……尻尾も触って、いいですよぉ……？」
PRINTFORM 「ん……れろぉ、舌と胸で責めて、しゃせーさせちゃうんですからぁ	PRINTFORM 「ん……れろぉ、舌と胸で責めて、しゃせーさせちゃうんですからぁ
PRINTFORMW 「お、おかしくなるっ、このままじゃわらひ、おかしくなるぅ♪」	PRINTFORMW 「お、おかしくなるっ、このままじゃわらひ、おかしくなるぅ♪」
PRINTFORMW 「あ……あぁ、あああああああああっ！　ぬ、抜いて、ぬいてっ！	PRINTFORMW 「あ……あぁ、あああああああああっ！　ぬ、抜いて、ぬいてっ！
PRINTFORMW 「やぁ……いやぁ……どうして、どうして私が、こんな目に……」	PRINTFORMW 「やぁ……いやぁ……どうして、どうして私が、こんな目に……」
PRINTFORMW 「ごめんなさい……私は、恩知らずで厚顔無恥な卑怯者です……」	PRINTFORMW 「ごめんなさい……私は、恩知らずで厚顔無恥な卑怯者です……」
PRINTFORMW 「……い、行っちゃうから。起きるなら今がチャンスよ？　ねぇ」	PRINTFORMW 「……い、行っちゃうから。起きるなら今がチャンスよ？　ねぇ」
PRINTFORMW 「いつもの調子だと、お互いバラバラに動いたほうがよさそうね」	PRINTFORMW 「いつもの調子だと、お互いバラバラに動いたほうがよさそうね」
PRINTFORMW 「いつか、師匠を助けに戻ってきますから……だ、だから……！」	PRINTFORMW 「いつか、師匠を助けに戻ってきますから……だ、だから……！」
PRINTFORMW 「月から逃げなくても、結局この異変に巻き込まれたのかな……」	PRINTFORMW 「月から逃げなくても、結局この異変に巻き込まれたのかな……」
PRINTFORMW 「そ、その、えっと……あ、厚かましいとわかってる、けど……」	PRINTFORMW 「そ、その、えっと……あ、厚かましいとわかってる、けど……」
PRINTFORMW 「突撃って言っても全力疾走しないで、速度を合わせて下さいね」	PRINTFORMW 「突撃って言っても全力疾走しないで、速度を合わせて下さいね」
PRINTFORMW 「ん……なんか、やる気出てきました。もう少しくらい行けます」	PRINTFORMW 「ん……なんか、やる気出てきました。もう少しくらい行けます」
PRINTFORMW 「普通の目なら、無色透明なガスなんて見えないだろうけど……」	PRINTFORMW 「普通の目なら、無色透明なガスなんて見えないだろうけど……」
PRINTFORMW 「……わ、私は、悪くない。今回は、逃げたわけじゃないんだし！	PRINTFORMW 「……わ、私は、悪くない。今回は、逃げたわけじゃないんだし！
PRINTFORMW 「私は、生きてる……無事にいる……こうなった人妖と違って……	PRINTFORMW 「私は、生きてる……無事にいる……こうなった人妖と違って……
PRINTFORMW 　なら、私が生きるために使っても文句は言われないよね……？」	PRINTFORMW 　なら、私が生きるために使っても文句は言われないよね……？」
PRINTFORMW 　はぁっ、いいっ……♪　びゅーびゅーするの、気持ちいぃ……」	PRINTFORMW 　はぁっ、いいっ……♪　びゅーびゅーするの、気持ちいぃ……」
PRINTFORMW 「ししょー、ごめんなさいっ……でも、我慢できないんですぅ♪」	PRINTFORMW 「ししょー、ごめんなさいっ……でも、我慢できないんですぅ♪」
PRINTFORML 　そんなに欲しいのね、それならすぐ射精してあげるからねっ♪」	PRINTFORML 　そんなに欲しいのね、それならすぐ射精してあげるからねっ♪」
PRINTFORML 　腰使い、気持ちいいっ、あ、くるっ、しゃせーしちゃうぅ！？」	PRINTFORML 　腰使い、気持ちいいっ、あ、くるっ、しゃせーしちゃうぅ！？」
PRINTFORMW 「かあさま……おねがいします、おねがいします、わたしを……」	PRINTFORMW 「かあさま……おねがいします、おねがいします、わたしを……」
PRINTFORM 　元を考えれば、仕方、ないよね……犯されるのも、犯すのも……	PRINTFORM 　元を考えれば、仕方、ないよね……犯されるのも、犯すのも……
PRINTFORMW 「な、なにをっ、ふやっ！？　ひめさま、ひめさまぁっ！！！」	PRINTFORMW 「な、なにをっ、ふやっ！？　ひめさま、ひめさまぁっ！！！」
PRINTFORMDW 全裸で敵を見つめる鈴仙の股から、愛液が滴り落ちている……	PRINTFORMDW 全裸で敵を見つめる鈴仙の股から、愛液が滴り落ちている……
PRINTFORMW 「うふふ……まかせて下さい、きもちよくしてあげますぅ……」	PRINTFORMW 「うふふ……まかせて下さい、きもちよくしてあげますぅ……」
PRINTFORM 「ふぅ、ふぅっ、んんっ……からだ、かってに反応しちゃうぅ……	PRINTFORM 「ふぅ、ふぅっ、んんっ……からだ、かってに反応しちゃうぅ……
PRINTFORMW 「いやっ、いやぁっ！　なかだしは、なかだしはだめぇっ……」	PRINTFORMW 「いやっ、いやぁっ！　なかだしは、なかだしはだめぇっ……」
PRINTFORMW 「やっ……やぁっ……そのおくちで、母乳吸わないでよぅ……」	PRINTFORMW 「やっ……やぁっ……そのおくちで、母乳吸わないでよぅ……」
PRINTFORM 「もっとぉ……♪　そのまま吸い付いて、もっとイかせてねぇ……	PRINTFORM 「もっとぉ……♪　そのまま吸い付いて、もっとイかせてねぇ……
PRINTFORMW 「やられちゃったのね……気をつけないと、明日は我が身かも」	PRINTFORMW 「やられちゃったのね……気をつけないと、明日は我が身かも」
PRINTFORMW 「さ、さすがはてゐ。無事だって、し、信じてたから。ほんと」	PRINTFORMW 「さ、さすがはてゐ。無事だって、し、信じてたから。ほんと」
PRINTFORMW 　……まぁ、ここの地面なんて掘り返したくないとは思うけど」	PRINTFORMW 　……まぁ、ここの地面なんて掘り返したくないとは思うけど」
PRINTFORML 「ここにいる相手って私の眼があんまり効かないんですよね……	PRINTFORML 「ここにいる相手って私の眼があんまり効かないんですよね……
PRINTFORMW 「謎解きは得意分野……ですよね？　かける方専門でしたっけ」	PRINTFORMW 「謎解きは得意分野……ですよね？　かける方専門でしたっけ」
PRINTFORMW 「さすがにこういう状況なら、てゐも真面目にやるでしょうし」	PRINTFORMW 「さすがにこういう状況なら、てゐも真面目にやるでしょうし」
PRINTFORMW 「どんな菌や呪いを持っているか、分かったものじゃないしね」	PRINTFORMW 「どんな菌や呪いを持っているか、分かったものじゃないしね」
PRINTFORMW 「ここから逃げないとだめ、ここから逃げないとだめ……あぅ」	PRINTFORMW 「ここから逃げないとだめ、ここから逃げないとだめ……あぅ」
PRINTFORMW 「……綺麗なお水。化物がこれを飲んでないといいんだけどね」	PRINTFORMW 「……綺麗なお水。化物がこれを飲んでないといいんだけどね」
PRINTFORMW 「……もう……疲れた。どうせ助かる保証なんて、ないんだし」	PRINTFORMW 「……もう……疲れた。どうせ助かる保証なんて、ないんだし」
PRINTFORMW 「あはぁっ♪　おしりを犯すのが、こんなにいいだなんてぇ♪」	PRINTFORMW 「あはぁっ♪　おしりを犯すのが、こんなにいいだなんてぇ♪」
PRINTFORM 「妊娠して下さいっ！　月に、私のこどもっ、連れてかえってぇっ	PRINTFORM 「妊娠して下さいっ！　月に、私のこどもっ、連れてかえってぇっ
PRINTFORM 「こんなっ……なか、締め付けられたら、イく、すぐイっちゃうぅ	PRINTFORM 「こんなっ……なか、締め付けられたら、イく、すぐイっちゃうぅ
PRINTFORM 「ここまで、やってくれるんだ……うあぁっ、も、我慢できないっ	PRINTFORM 「ここまで、やってくれるんだ……うあぁっ、も、我慢できないっ
PRINTFORMW 「本当は逃げたいけど……そういうわけにもいかないし……」	PRINTFORMW 「本当は逃げたいけど……そういうわけにもいかないし……」
PRINTFORMW 「……早く倒したいのに……早くいなくなってほしいのに！」	PRINTFORMW 「……早く倒したいのに……早くいなくなってほしいのに！」
PRINTFORMW 「も、もうだめれすっ、はつじょー抑えられなくなりますっ！	PRINTFORMW 「も、もうだめれすっ、はつじょー抑えられなくなりますっ！
PRINTFORMW 「は、波長を……！　方向感覚を狂わせるくらいはっ……！」	PRINTFORMW 「は、波長を……！　方向感覚を狂わせるくらいはっ……！」
PRINTFORM 「あはっ！　触手たちのおかげでっ、もうナカがとろとろですぅ	PRINTFORM 「あはっ！　触手たちのおかげでっ、もうナカがとろとろですぅ
PRINTFORMDW ぼんやりとした目付きで、鈴仙は迷いの竹林を歩いて行く。	PRINTFORMDW ぼんやりとした目付きで、鈴仙は迷いの竹林を歩いて行く。
PRINTFORMDW あのお姫様がいない今、ここで一番偉いのは私なんだけど」	PRINTFORMDW あのお姫様がいない今、ここで一番偉いのは私なんだけど」
PRINTFORMW 「……出たくない。この異変が終わったって聞くまで出ない」	PRINTFORMW 「……出たくない。この異変が終わったって聞くまで出ない」
PRINTFORMDW 「怖いのを武器でごまかしてるってふうに見えるけどねぇ」	PRINTFORMDW 「怖いのを武器でごまかしてるってふうに見えるけどねぇ」
PRINTFORMW 「やめて……痛いのも気持ちいいのも耐えられないよぅ……」	PRINTFORMW 「やめて……痛いのも気持ちいいのも耐えられないよぅ……」
PRINTFORMW 「こういう時、不死身だと便利だなーって……ごめんなさい」	PRINTFORMW 「こういう時、不死身だと便利だなーって……ごめんなさい」
PRINTFORMW 「あ、あの後から月ではどんな訓練してるのかなーって……」	PRINTFORMW 「あ、あの後から月ではどんな訓練してるのかなーって……」
PRINTFORMW 「べとべとしてる所や生き物ばっかりで、嫌になります……」	PRINTFORMW 「べとべとしてる所や生き物ばっかりで、嫌になります……」
PRINTFORMW （……渡してくれたらくれたで、変なもの渡されそうだけど）	PRINTFORMW （……渡してくれたらくれたで、変なもの渡されそうだけど）
PRINTFORMW 「また一人で逃げるような、情けないことはできないから！」	PRINTFORMW 「また一人で逃げるような、情けないことはできないから！」
PRINTFORMW 「いろいろ手間はかかりそうですけど……頼りにしてます！」	PRINTFORMW 「いろいろ手間はかかりそうですけど……頼りにしてます！」
PRINTFORMW 「師匠がいるならきっと大丈夫ですね！　頼りにしてます！」	PRINTFORMW 「師匠がいるならきっと大丈夫ですね！　頼りにしてます！」
PRINTFORMW 「許してくれなんていいませんけど……助けられるなら……」	PRINTFORMW 「許してくれなんていいませんけど……助けられるなら……」
PRINTFORMW 「産まれ、ちゃうっ……このままじゃ、産んじゃ、う……！」	PRINTFORMW 「産まれ、ちゃうっ……このままじゃ、産んじゃ、う……！」
PRINTFORMW 「やだ、なりたくない、母親になんかなりたくないよぅ……」	PRINTFORMW 「やだ、なりたくない、母親になんかなりたくないよぅ……」
PRINTFORMW 「気分が重い……こんな所にずっといたら、当たり前だけど」	PRINTFORMW 「気分が重い……こんな所にずっといたら、当たり前だけど」
PRINTFORMW うあぁっ！？　吸い上げてる、ちくび、ぎゅってしてるぅ♪」	PRINTFORMW うあぁっ！？　吸い上げてる、ちくび、ぎゅってしてるぅ♪」
PRINTFORMW 「……しっかり見張っておいて下さいね……おやすみなさい」	PRINTFORMW 「……しっかり見張っておいて下さいね……おやすみなさい」
PRINTFORMW 「やっぱり、ちゃんと片付けておかなきゃ安心できないです」	PRINTFORMW 「やっぱり、ちゃんと片付けておかなきゃ安心できないです」
PRINTFORMW 「……ここまで確認しておけば、後は師匠に任せていいよね」	PRINTFORMW 「……ここまで確認しておけば、後は師匠に任せていいよね」
PRINTFORMW 「汚れを落としても、やっぱりまた穢されちゃうのかな……」	PRINTFORMW 「汚れを落としても、やっぱりまた穢されちゃうのかな……」
PRINTFORMW 　だから、助けられなくても気にする必要は……ない、よね？	PRINTFORMW 　だから、助けられなくても気にする必要は……ない、よね？
PRINTFORML 　腰使い、気持ちいいっ、あ、くる、しゃせーしちゃうぅ！」	PRINTFORML 　腰使い、気持ちいいっ、あ、くる、しゃせーしちゃうぅ！」
PRINTFORML 「ちっちゃなお胸……♪　すりすりされるの、きもちいい♪」	PRINTFORML 「ちっちゃなお胸……♪　すりすりされるの、きもちいい♪」
PRINTFORM 　そんなに私を想ってくれてるんですね、ならしゃせーします、	PRINTFORM 　そんなに私を想ってくれてるんですね、ならしゃせーします、
PRINTFORMW 「がんばらなきゃ……かあさまにみとめてもらわなきゃ……」	PRINTFORMW 「がんばらなきゃ……かあさまにみとめてもらわなきゃ……」
PRINTFORMW 「……ここでがんばれば、かあさまはみとめてくれるのかな」	PRINTFORMW 「……ここでがんばれば、かあさまはみとめてくれるのかな」
PRINTFORMDW 鈴仙は無表情で何かブツブツと呟きながら攻撃を放った！	PRINTFORMDW 鈴仙は無表情で何かブツブツと呟きながら攻撃を放った！
PRINTFORMW 「……こういう状態だと、私の能力って役立たずになるの」	PRINTFORMW 「……こういう状態だと、私の能力って役立たずになるの」
PRINTFORM 「はぁ、はぁっ、出したい、射精したい、なかだししたいぃっ	PRINTFORM 「はぁ、はぁっ、出したい、射精したい、なかだししたいぃっ
PRINTFORMDW 閉めきった室内で体育座りのまま、自分の足を掻き抱く。	PRINTFORMDW 閉めきった室内で体育座りのまま、自分の足を掻き抱く。
PRINTFORMDW 小さく、誰にも聞こえない言葉を薄暗い部屋の中で呟く。	PRINTFORMDW 小さく、誰にも聞こえない言葉を薄暗い部屋の中で呟く。
PRINTFORMW 「胸も隠したいけど、両腕ふさいだら戦えないし……うぅ」	PRINTFORMW 「胸も隠したいけど、両腕ふさいだら戦えないし……うぅ」
PRINTFORMW 「な、なにこれっ、こんなのっ、こんなのされたらぁっ♪」	PRINTFORMW 「な、なにこれっ、こんなのっ、こんなのされたらぁっ♪」
PRINTFORMW 「もう、ただでさえ湿気で服が変な感じになってるのに！」	PRINTFORMW 「もう、ただでさえ湿気で服が変な感じになってるのに！」
PRINTFORMDW そう言ってごまかす鈴仙の声は、明らかに震えていた……	PRINTFORMDW そう言ってごまかす鈴仙の声は、明らかに震えていた……
PRINTFORML （改めて見ると、輝夜さまってなんて美人なんだろう……）	PRINTFORML （改めて見ると、輝夜さまってなんて美人なんだろう……）
PRINTFORMW 「べとべとしてる所や生き物ばっかりで、嫌になるわ……」	PRINTFORMW 「べとべとしてる所や生き物ばっかりで、嫌になるわ……」
PRINTFORMW 「師匠の薬なら、子供を……いえ、なんでもないです……」	PRINTFORMW 「師匠の薬なら、子供を……いえ、なんでもないです……」
PRINTFORMW 「私達は……ずっと月にいるべきだったんでしょうか……」	PRINTFORMW 「私達は……ずっと月にいるべきだったんでしょうか……」
PRINTFORML 「敵が使う媚薬成分、師匠ならなんとかできないんですか？	PRINTFORML 「敵が使う媚薬成分、師匠ならなんとかできないんですか？
PRINTFORMW 「こんな所じゃ、月は見えませんし餅もつけませんね……」	PRINTFORMW 「こんな所じゃ、月は見えませんし餅もつけませんね……」
PRINTFORMW 「月からなにか、役に立ちそうなものを持ってきてない？」	PRINTFORMW 「月からなにか、役に立ちそうなものを持ってきてない？」
PRINTFORMW 「治った……よかった、気のせいだったのね。前とは……」	PRINTFORMW 「治った……よかった、気のせいだったのね。前とは……」
PRINTFORMW 「胸、張ってるっ……出ちゃう、母乳、出ちゃうぅ……！」	PRINTFORMW 「胸、張ってるっ……出ちゃう、母乳、出ちゃうぅ……！」
PRINTFORMW 　きもちいぃ、産むの……きもちいぃんっ、あ、あぁっ♪」	PRINTFORMW 　きもちいぃ、産むの……きもちいぃんっ、あ、あぁっ♪」
PRINTFORMW 「うわ……撃ちこむたびに変な液体がぐじゅぐじゅと……」	PRINTFORMW 「うわ……撃ちこむたびに変な液体がぐじゅぐじゅと……」
PRINTFORMW 「ちっちゃなお胸……♪　すりすりするの、きもちいい♪」	PRINTFORMW 「ちっちゃなお胸……♪　すりすりするの、きもちいい♪」
PRINTFORMW 　犯しちゃいますっ、私のモノにしちゃいますからぁっ♪」	PRINTFORMW 　犯しちゃいますっ、私のモノにしちゃいますからぁっ♪」
PRINTFORM 「ごめんなさいい、でもっ、でもぉ、きもちいいんですっ……	PRINTFORM 「ごめんなさいい、でもっ、でもぉ、きもちいいんですっ……
PRINTFORMW 「わ、私が前に出るんですか？　分かりましたけど……」	PRINTFORMW 「わ、私が前に出るんですか？　分かりましたけど……」
PRINTFORMW 「や、やっぱり、私が前に出なきゃいけないのかな……」	PRINTFORMW 「や、やっぱり、私が前に出なきゃいけないのかな……」
PRINTFORMW 「当てた所から変な液体とか噴き出しませんように……」	PRINTFORMW 「当てた所から変な液体とか噴き出しませんように……」
PRINTFORMW 「足を止めておけば、離れた後も追いかけられない……」	PRINTFORMW 「足を止めておけば、離れた後も追いかけられない……」
PRINTFORMW （なら、もう、諦めちゃおう……気持ちいい事に溺れて）	PRINTFORMW （なら、もう、諦めちゃおう……気持ちいい事に溺れて）
PRINTFORMW 「あうぅ……焦らさないで、早くしてくださいよぉ……」	PRINTFORMW 「あうぅ……焦らさないで、早くしてくださいよぉ……」
PRINTFORMW 　だめです、師匠にこんなことされたら……わたしっ！」	PRINTFORMW 　だめです、師匠にこんなことされたら……わたしっ！」
PRINTFORM 「あはっ！　触手たちのおかげでっ、もうナカがとろとろぉ	PRINTFORM 「あはっ！　触手たちのおかげでっ、もうナカがとろとろぉ
PRINTFORMDW 永遠亭の一室、その扉の前でてゐから呼びかけている。	PRINTFORMDW 永遠亭の一室、その扉の前でてゐから呼びかけている。
PRINTFORMW 　私のはじめて、ちゃんと、もらってくださいねぇ……」	PRINTFORMW 　私のはじめて、ちゃんと、もらってくださいねぇ……」
PRINTFORMDW 鈴仙が触手を見つめる瞳は、完全に蕩け切っている……	PRINTFORMDW 鈴仙が触手を見つめる瞳は、完全に蕩け切っている……
PRINTFORMW 「ひっ！？　へ、変なことしないで、お願いだからっ！」	PRINTFORMW 「ひっ！？　へ、変なことしないで、お願いだからっ！」
PRINTFORMW （これは……罰なのかな……それとも、自業自得……？）	PRINTFORMW （これは……罰なのかな……それとも、自業自得……？）
PRINTFORMW 「んんっ♪　みるく、びゅーびゅーってしてるぅ……♪」	PRINTFORMW 「んんっ♪　みるく、びゅーびゅーってしてるぅ……♪」
PRINTFORMW 　でていって、わたしの……私の中に入らないでぇ……」	PRINTFORMW 　でていって、わたしの……私の中に入らないでぇ……」
PRINTFORMW （無事だったなんて……最近の玉兎って凄いのかな……）	PRINTFORMW （無事だったなんて……最近の玉兎って凄いのかな……）
PRINTFORMW 「ひ、日頃からいろいろ騙し取られてるんだもの……！」	PRINTFORMW 「ひ、日頃からいろいろ騙し取られてるんだもの……！」
PRINTFORMW 　理性はもちろん、合わせる目がない相手も多いですし」	PRINTFORMW 　理性はもちろん、合わせる目がない相手も多いですし」
PRINTFORMW 「私の知ってることを、できるだけ教えますから……！」	PRINTFORMW 「私の知ってることを、できるだけ教えますから……！」
PRINTFORMW 「できれば、何か余っている物を渡してくれませんか？」	PRINTFORMW 「できれば、何か余っている物を渡してくれませんか？」
PRINTFORMW 「や、やっぱり、私の診断なんてあてにならないよね！」	PRINTFORMW 「や、やっぱり、私の診断なんてあてにならないよね！」
PRINTFORMW 「目を閉じれば、お腹に何かいるのも見えなくなる……」	PRINTFORMW 「目を閉じれば、お腹に何かいるのも見えなくなる……」
PRINTFORMW 「無理に起きてると、波長を読み取る精度が悪くなるし」	PRINTFORMW 「無理に起きてると、波長を読み取る精度が悪くなるし」
PRINTFORMW 「ああ、やっぱり尻尾がボサボサになっちゃってる……」	PRINTFORMW 「ああ、やっぱり尻尾がボサボサになっちゃってる……」
PRINTFORMW 「待ってよ、逃げな……！　……ごめん、なんでもない」	PRINTFORMW 「待ってよ、逃げな……！　……ごめん、なんでもない」
PRINTFORMDW 立ち並ぶ生物から、あの粘液が大量に零れ落ちている。	PRINTFORMDW 立ち並ぶ生物から、あの粘液が大量に零れ落ちている。
PRINTFORMW 「わ、凄い……！　どんな成分が流れ込んでるのかな？」	PRINTFORMW 「わ、凄い……！　どんな成分が流れ込んでるのかな？」
PRINTFORMW 「っ……はぁんっ、こ、こんなのっ、こんなの吸ったら！	PRINTFORMW 「っ……はぁんっ、こ、こんなのっ、こんなの吸ったら！
PRINTFORMW 「えっと……今はご無事なようで何よりです、輝夜さま」	PRINTFORMW 「えっと……今はご無事なようで何よりです、輝夜さま」
PRINTFORMW 　私のなかにだすの……残しておいてくださいね……」	PRINTFORMW 　私のなかにだすの……残しておいてくださいね……」
PRINTFORM 　勝てないんだから……このまま、ふたりで……ずっとぉ	PRINTFORM 　勝てないんだから……このまま、ふたりで……ずっとぉ
PRINTFORMW 「もう……だめぇっ！　いれる、いれちゃうからぁ！」	PRINTFORMW 「もう……だめぇっ！　いれる、いれちゃうからぁ！」
PRINTFORMW 「もう……だめぇっ！　いれる、いれちゃいますぅ！」	PRINTFORMW 「もう……だめぇっ！　いれる、いれちゃいますぅ！」
PRINTFORMDW またあの迷宮に攫われるのを恐れ、自室に篭る毎日。	PRINTFORMDW またあの迷宮に攫われるのを恐れ、自室に篭る毎日。
PRINTFORMW 「相手の波長を読んで……たら、なんか汚染されそう」	PRINTFORMW 「相手の波長を読んで……たら、なんか汚染されそう」
PRINTFORMW 「や、やっぱり……じろじろ見られてるんだよね……」	PRINTFORMW 「や、やっぱり……じろじろ見られてるんだよね……」
PRINTFORM 「うあぁ、ぬめぬめがきもちいぃ……癖になっちゃうぅっ	PRINTFORM 「うあぁ、ぬめぬめがきもちいぃ……癖になっちゃうぅっ
PRINTFORMW やっちゃったぁ、はじめて、無駄にしちゃったぁ……」	PRINTFORMW やっちゃったぁ、はじめて、無駄にしちゃったぁ……」
PRINTFORMW 「てゐ、大丈夫だった……って聞くまでもないかしら」	PRINTFORMW 「てゐ、大丈夫だった……って聞くまでもないかしら」
PRINTFORMW （って、ここにいることを喜んじゃ駄目じゃない……）	PRINTFORMW （って、ここにいることを喜んじゃ駄目じゃない……）
PRINTFORMW 「え、えっと……なんでここにいるんでしょうか……」	PRINTFORMW 「え、えっと……なんでここにいるんでしょうか……」
PRINTFORMW 「座って……話させて。立つだけでも、つらいし……」	PRINTFORMW 「座って……話させて。立つだけでも、つらいし……」
PRINTFORMW （普通に談笑してるのが……怖いです……すごく……）	PRINTFORMW （普通に談笑してるのが……怖いです……すごく……）
PRINTFORMW 「私の知ってることを、できるだけ教えるから……！」	PRINTFORMW 「私の知ってることを、できるだけ教えるから……！」
PRINTFORMW 「おねがい……少しの間でいいから、私を助けて……」	PRINTFORMW 「おねがい……少しの間でいいから、私を助けて……」
PRINTFORMW 「も、もう逃げ出しませんから！　今度こそ絶対に！」	PRINTFORMW 「も、もう逃げ出しませんから！　今度こそ絶対に！」
PRINTFORMW 「許してくれないだろうけど……助けられるなら……」	PRINTFORMW 「許してくれないだろうけど……助けられるなら……」
PRINTFORMW 「…………前なんて、なかった、なかったんだから！」	PRINTFORMW 「…………前なんて、なかった、なかったんだから！」
PRINTFORMW 「わ、私……本当に赤ちゃん、できちゃったの……？」	PRINTFORMW 「わ、私……本当に赤ちゃん、できちゃったの……？」
PRINTFORMW 「うぅん、そろそろ交代の時間……しゃんとしなきゃ」	PRINTFORMW 「うぅん、そろそろ交代の時間……しゃんとしなきゃ」
PRINTFORMW 「こんな地面だし、ほふく前進はしたくないわね……」	PRINTFORMW 「こんな地面だし、ほふく前進はしたくないわね……」
PRINTFORMW 「あうう、耳がよれよれ……今のうちに整えなくちゃ」	PRINTFORMW 「あうう、耳がよれよれ……今のうちに整えなくちゃ」
PRINTFORMDL 鈴仙の瞳が光る。波長の乱れが、異形の体内を走る。	PRINTFORMDL 鈴仙の瞳が光る。波長の乱れが、異形の体内を走る。
PRINTFORMW 「あんなのに纏われつくなんて、想像するだけで……」	PRINTFORMW 「あんなのに纏われつくなんて、想像するだけで……」
PRINTFORMW 　わたし、はつじょーしますっ、しちゃいますぅっ♪」	PRINTFORMW 　わたし、はつじょーしますっ、しちゃいますぅっ♪」
PRINTFORMW （も、もし吸ってたら……考えるだけでぞくぞくする）	PRINTFORMW （も、もし吸ってたら……考えるだけでぞくぞくする）
PRINTFORMW 「やっ、胸にきてる、ちくび吸い付かれてるよぅ！？」	PRINTFORMW 「やっ、胸にきてる、ちくび吸い付かれてるよぅ！？」
PRINTFORMW 「こ、これ……ま、まさか、私が見捨てたせい……で」	PRINTFORMW 「こ、これ……ま、まさか、私が見捨てたせい……で」
PRINTFORMW 「こんな状態で近づくなんて、自殺行為なのに……」	PRINTFORMW 「こんな状態で近づくなんて、自殺行為なのに……」
PRINTFORMW 「他のところ以上に、変な感触がしそうだけど……」	PRINTFORMW 「他のところ以上に、変な感触がしそうだけど……」
PRINTFORMW 「や、やめっ、やめなさっ、あっ、やぁぁぁっ！？」	PRINTFORMW 「や、やめっ、やめなさっ、あっ、やぁぁぁっ！？」
PRINTFORMW 「へぇ、神隠しが起こってるんですか。怖いですね」	PRINTFORMW 「へぇ、神隠しが起こってるんですか。怖いですね」
PRINTFORMDW 世話を焼かせるな、というのがてゐの本音だった。	PRINTFORMDW 世話を焼かせるな、というのがてゐの本音だった。
PRINTFORMW 「はい……これでぇ、入りやすくなりましたよぉ……	PRINTFORMW 「はい……これでぇ、入りやすくなりましたよぉ……
PRINTFORMW 「ち、ちがう、ちがうぅ……催眠の、せいでぇ……」	PRINTFORMW 「ち、ちがう、ちがうぅ……催眠の、せいでぇ……」
PRINTFORMW 「こ、こんなの……こんなので受精するわけが……」	PRINTFORMW 「こ、こんなの……こんなので受精するわけが……」
PRINTFORMW 「て、てゐって、いっつも先に逃げたすタイプだし。	PRINTFORMW 「て、てゐって、いっつも先に逃げたすタイプだし。
PRINTFORMW 　吸ってぇ、乳首ちゅーってされるの気持ちいい♪」	PRINTFORMW 　吸ってぇ、乳首ちゅーってされるの気持ちいい♪」
PRINTFORMW 「おっぱい、おっぱいつかまれたらっ、母乳がぁ！」	PRINTFORMW 「おっぱい、おっぱいつかまれたらっ、母乳がぁ！」
PRINTFORMW 「ご、ご無事でなななな何よりですしししししょー」	PRINTFORMW 「ご、ご無事でなななな何よりですしししししょー」
PRINTFORMW 「もしかしてここ、月と繋がってたりするのかな？」	PRINTFORMW 「もしかしてここ、月と繋がってたりするのかな？」
PRINTFORMW 「できれば、何か余っている物を渡してくれない？」	PRINTFORMW 「できれば、何か余っている物を渡してくれない？」
PRINTFORMW 「ここに落ちてる珍しい物、集めたりしてません？」	PRINTFORMW 「ここに落ちてる珍しい物、集めたりしてません？」
PRINTFORMW 「……動けないんなら、私を騙す余裕もないわよね」	PRINTFORMW 「……動けないんなら、私を騙す余裕もないわよね」
PRINTFORMW 「も、もう逃げ出さないから！　今度こそ絶対に！」	PRINTFORMW 「も、もう逃げ出さないから！　今度こそ絶対に！」
PRINTFORMW 「逃亡兵が信用できるわけ……ない、ですよね……」	PRINTFORMW 「逃亡兵が信用できるわけ……ない、ですよね……」
PRINTFORMW 「し、師匠は私が守ります……力の及ぶ範囲で……」	PRINTFORMW 「し、師匠は私が守ります……力の及ぶ範囲で……」
PRINTFORMW 「わ、わかったよ……後は自分でなんとかする……」	PRINTFORMW 「わ、わかったよ……後は自分でなんとかする……」
PRINTFORMW 「わかりました……後は自分でなんとかします……」	PRINTFORMW 「わかりました……後は自分でなんとかします……」
PRINTFORMW 「やっ！？　……潰した壁から液体が跳ねてきてる」	PRINTFORMW 「やっ！？　……潰した壁から液体が跳ねてきてる」
PRINTFORMW 「こ、こんな状態で放り出さないで下さいよ～！？」	PRINTFORMW 「こ、こんな状態で放り出さないで下さいよ～！？」
PRINTFORMDW 思わず鈴仙の口から悲鳴が漏れた。理由は単純だ。	PRINTFORMDW 思わず鈴仙の口から悲鳴が漏れた。理由は単純だ。
PRINTFORM いいよ、今挿れてあげるからね、せーえき出すからぁっ	PRINTFORM いいよ、今挿れてあげるからね、せーえき出すからぁっ
PRINTFORM 「あぅ、あぅっ、ううっ……からだ、おかしくてぇ……	PRINTFORM 「あぅ、あぅっ、ううっ……からだ、おかしくてぇ……
PRINTFORMW 「かあさま……わたしは、わたしは、あなたの……」	PRINTFORMW 「かあさま……わたしは、わたしは、あなたの……」
PRINTFORMW 「こいつらの近くで大振りするの、やだなぁ……」	PRINTFORMW 「こいつらの近くで大振りするの、やだなぁ……」
PRINTFORMW 「はぁ、はぁっ……もうやめてよこういう事は！」	PRINTFORMW 「はぁ、はぁっ……もうやめてよこういう事は！」
PRINTFORMW 「や、やめっ、やめてっ、あっ、やぁぁぁっ！？」	PRINTFORMW 「や、やめっ、やめてっ、あっ、やぁぁぁっ！？」
PRINTFORMDW 「……食事、いつも通りのとこに置いとくから」	PRINTFORMDW 「……食事、いつも通りのとこに置いとくから」
PRINTFORMDW また攫われて、あの迷宮に捕らわれないように。	PRINTFORMDW また攫われて、あの迷宮に捕らわれないように。
PRINTFORMW 「あ……私のはじめて……欲しいんですか……？」	PRINTFORMW 「あ……私のはじめて……欲しいんですか……？」
PRINTFORMDW 今の彼女の瞳には、何が映っているのだろうか…	PRINTFORMDW 今の彼女の瞳には、何が映っているのだろうか…
PRINTFORM 「いいよぉ……そこ、どんどんこすっていってぇ……	PRINTFORM 「いいよぉ……そこ、どんどんこすっていってぇ……
PRINTFORMW 「ぐっ……おねが、い、からだ、動いてっ……！」	PRINTFORMW 「ぐっ……おねが、い、からだ、動いてっ……！」
PRINTFORMW そのまま子供に、飲ませてあげて下さいね……♪」	PRINTFORMW そのまま子供に、飲ませてあげて下さいね……♪」
PRINTFORMW 「うん、逃げ道は確保できてるよね？　これなら」	PRINTFORMW 「うん、逃げ道は確保できてるよね？　これなら」
PRINTFORM （きもちぃ、よすぎてぇ、目……チカチカするぅ……	PRINTFORM （きもちぃ、よすぎてぇ、目……チカチカするぅ……
PRINTFORMW 「大丈夫だよね、私、穢されてないよね……！？」	PRINTFORMW 「大丈夫だよね、私、穢されてないよね……！？」
PRINTFORMW 「で、では私は私なりに脱出路を探しますので！」	PRINTFORMW 「で、では私は私なりに脱出路を探しますので！」
PRINTFORMW 「こうでもしないと、私が生き残れないから……」	PRINTFORMW 「こうでもしないと、私が生き残れないから……」
PRINTFORMW 「一人じゃ、ここから逃げ出せそうにないし……」	PRINTFORMW 「一人じゃ、ここから逃げ出せそうにないし……」
PRINTFORMW 「私に押し付けて逃げたりしないでしょうね……」	PRINTFORMW 「私に押し付けて逃げたりしないでしょうね……」
PRINTFORMW 「師匠の薬には、劣るかもしれませんけど……！」	PRINTFORMW 「師匠の薬には、劣るかもしれませんけど……！」
PRINTFORMW 「ゆっくり歩きたいな……足音でないし、楽だし」	PRINTFORMW 「ゆっくり歩きたいな……足音でないし、楽だし」
PRINTFORMW （そっか……べつに、逃げなくてよかったんだ……	PRINTFORMW （そっか……べつに、逃げなくてよかったんだ……
PRINTFORMW 「し、しっぽに触らないで、おしりこないでぇ！」	PRINTFORMW 「し、しっぽに触らないで、おしりこないでぇ！」
PRINTFORMW 「スペースデブリを避けるよりは、よっぽど楽よ」	PRINTFORMW 「スペースデブリを避けるよりは、よっぽど楽よ」
PRINTFORMW 「だめ、出ちゃうっ、しゃせーしちゃうぅっ！？」	PRINTFORMW 「だめ、出ちゃうっ、しゃせーしちゃうぅっ！？」
PRINTFORMW 「ちかづきたくないですけど、ちかづきます……」	PRINTFORMW 「ちかづきたくないですけど、ちかづきます……」
PRINTFORMW 「やめて、ください……ださないでください……」	PRINTFORMW 「やめて、ください……ださないでください……」
PRINTFORMW 「おねがいします……みすてないでください……」	PRINTFORMW 「おねがいします……みすてないでください……」
PRINTFORMW 「今の状態じゃ、ちょっとやられるだけで……」	PRINTFORMW 「今の状態じゃ、ちょっとやられるだけで……」
PRINTFORMW 「ちゃんと相手を見つめて……狙いを……うぅ」	PRINTFORMW 「ちゃんと相手を見つめて……狙いを……うぅ」
PRINTFORM 「ほらぁ、こっち向いてよ……一緒にいじってよぉ	PRINTFORM 「ほらぁ、こっち向いてよ……一緒にいじってよぉ
PRINTFORMW 「くるっちゃえ……わたし、くるっちゃえ……」	PRINTFORMW 「くるっちゃえ……わたし、くるっちゃえ……」
PRINTFORMW 「いやぁ！　ぬるぬるに触られるのいやぁっ！」	PRINTFORMW 「いやぁ！　ぬるぬるに触られるのいやぁっ！」
PRINTFORMW 「い、嫌っ、嫌ぁっ、ああああああああッ！？」	PRINTFORMW 「い、嫌っ、嫌ぁっ、ああああああああッ！？」
PRINTFORMW 「あはっ……私が、ははおやになってるよぅ……	PRINTFORMW 「あはっ……私が、ははおやになってるよぅ……
PRINTFORM 「さきっぽだけで、満足しようよ……おたがい……	PRINTFORM 「さきっぽだけで、満足しようよ……おたがい……
PRINTFORMW 「わたしの、せいで……私が、逃げたから……」	PRINTFORMW 「わたしの、せいで……私が、逃げたから……」
PRINTFORMW 「倒れてる……こんなところで、無防備に……」	PRINTFORMW 「倒れてる……こんなところで、無防備に……」
PRINTFORMW （私の目の前で……無防備な体を、晒して……）	PRINTFORMW （私の目の前で……無防備な体を、晒して……）
PRINTFORMW 「輝夜さま、輝夜さま、しっかりして下さい！」	PRINTFORMW 「輝夜さま、輝夜さま、しっかりして下さい！」
PRINTFORMW 「これってやっぱり、罰、なんでしょうか……」	PRINTFORMW 「これってやっぱり、罰、なんでしょうか……」
PRINTFORMW 「お願い、なにか……助けになるものを……！」	PRINTFORMW 「お願い、なにか……助けになるものを……！」
PRINTFORMW 「ししょー、何か薬を作ったりしてませんか？」	PRINTFORMW 「ししょー、何か薬を作ったりしてませんか？」
PRINTFORMW 「逃亡兵が信用できるわけ……ない、よね……」	PRINTFORMW 「逃亡兵が信用できるわけ……ない、よね……」
PRINTFORMW 「……お願いします。しばらく、助けて下さい」	PRINTFORMW 「……お願いします。しばらく、助けて下さい」
PRINTFORMW 「ご、ごめんなさい……今の私じゃ無理です！」	PRINTFORMW 「ご、ごめんなさい……今の私じゃ無理です！」
PRINTFORMW 「盾になってくれ、なんて言えませんから……」	PRINTFORMW 「盾になってくれ、なんて言えませんから……」
PRINTFORMW 「寝かしたままのほうがいい気もするけど……」	PRINTFORMW 「寝かしたままのほうがいい気もするけど……」
PRINTFORMW 「……何度も逃げ出すわけにはいきませんから」	PRINTFORMW 「……何度も逃げ出すわけにはいきませんから」
PRINTFORMW 「あ、ありがとうございます……助かりました」	PRINTFORMW 「あ、ありがとうございます……助かりました」
PRINTFORM 「す、すわないでぇ……わらひ、胸は、胸はぁ……	PRINTFORM 「す、すわないでぇ……わらひ、胸は、胸はぁ……
PRINTFORMW 「堕胎の方法って、確か……でも、器材が……」	PRINTFORMW 「堕胎の方法って、確か……でも、器材が……」
PRINTFORMW ひぃっ！？　ぼにゅぅ、母乳すわないでぇっ！」	PRINTFORMW ひぃっ！？　ぼにゅぅ、母乳すわないでぇっ！」
PRINTFORMW 「目がにじんでる……仮眠を取らないとだめね」	PRINTFORMW 「目がにじんでる……仮眠を取らないとだめね」
PRINTFORMW 「ひっ！？　ふ、ふぅ……気のせいみたい……」	PRINTFORMW 「ひっ！？　ふ、ふぅ……気のせいみたい……」
PRINTFORMW 「右よし、左よし、後ろよし……うん、大丈夫」	PRINTFORMW 「右よし、左よし、後ろよし……うん、大丈夫」
PRINTFORMDW 眠いのか、鈴仙は何度も目をこすっている……	PRINTFORMDW 眠いのか、鈴仙は何度も目をこすっている……
PRINTFORMW 「～～～～～～～～～………………（ぶくぶく」	PRINTFORMW 「～～～～～～～～～………………（ぶくぶく」
PRINTFORMW 「わかりました。では、どこかに隠れています」	PRINTFORMW 「わかりました。では、どこかに隠れています」
PRINTFORMW 「ど、どうしよ……これじゃ出られない……！」	PRINTFORMW 「ど、どうしよ……これじゃ出られない……！」
PRINTFORMW 「今まで何回落ちたかな……てゐの落とし穴に」	PRINTFORMW 「今まで何回落ちたかな……てゐの落とし穴に」
PRINTFORMW 「ひ、あぁっ！？　吸い付いてこないでぇっ！」	PRINTFORMW 「ひ、あぁっ！？　吸い付いてこないでぇっ！」
PRINTFORMW 「きてるっ、奥から何かのぼってきてぇっ！？」	PRINTFORMW 「きてるっ、奥から何かのぼってきてぇっ！？」
PRINTFORM 「そこまで動くくらいせーえき欲しいんですねっ、	PRINTFORM 「そこまで動くくらいせーえき欲しいんですねっ、
PRINTFORMW 「……まだわたしは、はなれちゃだめなんです」	PRINTFORMW 「……まだわたしは、はなれちゃだめなんです」
PRINTFORMW 「こんな、の……わたし、へんですっ……！？」	PRINTFORMW 「こんな、の……わたし、へんですっ……！？」
PRINTFORM 「いたく、ないです……きもちいいです、から……	PRINTFORM 「いたく、ないです……きもちいいです、から……
PRINTFORMW 「いやっ、もうこんな化物との戦いは嫌っ！」	PRINTFORMW 「いやっ、もうこんな化物との戦いは嫌っ！」
PRINTFORMW 「叩き落せば、あとは何とかなるはず……！」	PRINTFORMW 「叩き落せば、あとは何とかなるはず……！」
PRINTFORMW 「反応が本能的だし、止めやすいのは確かね」	PRINTFORMW 「反応が本能的だし、止めやすいのは確かね」
PRINTFORM 「はぁ、はぁっ、だめぇ、もっとぉ、んむぅ……	PRINTFORM 「はぁ、はぁっ、だめぇ、もっとぉ、んむぅ……
PRINTFORM 「んふっ……♪　よろしく、お願いしますぅ……	PRINTFORM 「んふっ……♪　よろしく、お願いしますぅ……
PRINTFORM 　へんになる、お腹ふくれて変になっちゃうぅっ	PRINTFORM 　へんになる、お腹ふくれて変になっちゃうぅっ
PRINTFORMW （どっちにしろ、私には責められないよ……）	PRINTFORMW （どっちにしろ、私には責められないよ……）
PRINTFORML 　あひっ、あうぅ、はぁぁぁぁぁぁぁんっ♪」	PRINTFORML 　あひっ、あうぅ、はぁぁぁぁぁぁぁんっ♪」
PRINTFORM 　それにっ……ふ、うぅ、きもちよかったし……	PRINTFORM 　それにっ……ふ、うぅ、きもちよかったし……
PRINTFORMW 「ごめんなさい……私は、恩知らずです……」	PRINTFORMW 「ごめんなさい……私は、恩知らずです……」
PRINTFORMW 「ついでだし、蜂の巣にしていってもいい？」	PRINTFORMW 「ついでだし、蜂の巣にしていってもいい？」
PRINTFORMW 「薬が欲しい……何もかも忘れられるような」	PRINTFORMW 「薬が欲しい……何もかも忘れられるような」
PRINTFORMW 「ひっ！？　びしびし地面叩かないでー！？」	PRINTFORMW 「ひっ！？　びしびし地面叩かないでー！？」
PRINTFORMW 「私の眼に映ってきたことは、これで全部よ」	PRINTFORMW 「私の眼に映ってきたことは、これで全部よ」
PRINTFORMW 「どうですか、師匠？　何か分かりました？」	PRINTFORMW 「どうですか、師匠？　何か分かりました？」
PRINTFORMW 「せめて今だけは、私が面倒を見ないと……」	PRINTFORMW 「せめて今だけは、私が面倒を見ないと……」
PRINTFORMW 「盾になってくれ、なんて言えないから……」	PRINTFORMW 「盾になってくれ、なんて言えないから……」
PRINTFORMW 「逃げるなら、散らばったほうが楽でしょ？」	PRINTFORMW 「逃げるなら、散らばったほうが楽でしょ？」
PRINTFORMW 「……何度も逃げ出すわけにはいかないから」	PRINTFORMW 「……何度も逃げ出すわけにはいかないから」
PRINTFORMW 「薬……！　堕ろす薬とか、あればっ……！」	PRINTFORMW 「薬……！　堕ろす薬とか、あればっ……！」
PRINTFORMW 「ここまで来たら、堕ろせない……もう……」	PRINTFORMW 「ここまで来たら、堕ろせない……もう……」
PRINTFORMDW 鈴仙は神経質に湯船の底をつついている……	PRINTFORMDW 鈴仙は神経質に湯船の底をつついている……
PRINTFORMW 「やっぱり、師匠の言ってた液体だよね……」	PRINTFORMW 「やっぱり、師匠の言ってた液体だよね……」
PRINTFORMDW ――洞窟の奥深くへと足を踏み入れていく。	PRINTFORMDW ――洞窟の奥深くへと足を踏み入れていく。
PRINTFORMW 「そ、そこに潜られたらっ、わたしぃっ！？」	PRINTFORMW 「そ、そこに潜られたらっ、わたしぃっ！？」
PRINTFORMW 「う、あぁっ、す、吸われ、てぇっ……！？」	PRINTFORMW 「う、あぁっ、す、吸われ、てぇっ……！？」
PRINTFORM 「ごめん、でもっ、でもぉ、きもちいいのっ……	PRINTFORM 「ごめん、でもっ、でもぉ、きもちいいのっ……
PRINTFORM 「ん……すごい、奥までぴったり飲み込んでるぅ	PRINTFORM 「ん……すごい、奥までぴったり飲み込んでるぅ
PRINTFORMW 「ゆるして……もう、ゆるしてください……」	PRINTFORMW 「ゆるして……もう、ゆるしてください……」
PRINTFORM 「前に襲ってきたのは、そっち、なんだからぁ	PRINTFORM 「前に襲ってきたのは、そっち、なんだからぁ
PRINTFORMDW 自分で自分を永遠亭の中に捕らえながら。	PRINTFORMDW 自分で自分を永遠亭の中に捕らえながら。
PRINTFORMW 「だれか……だれか、たすけ、てよぉ……」	PRINTFORMW 「だれか……だれか、たすけ、てよぉ……」
PRINTFORMW 「あっ……私の体、きれいですかぁ……？」	PRINTFORMW 「あっ……私の体、きれいですかぁ……？」
PRINTFORMW 「い、や……か、らだ、かって、にぃ！？」	PRINTFORMW 「い、や……か、らだ、かって、にぃ！？」
PRINTFORMW 「ゆ、ゆるして……もうゆるしてぇっ……」	PRINTFORMW 「ゆ、ゆるして……もうゆるしてぇっ……」
PRINTFORMW ぜったい子供、じゅせーしましたぁ……♪」	PRINTFORMW ぜったい子供、じゅせーしましたぁ……♪」
PRINTFORMW 「う……あっ……！？　この目、は……！」	PRINTFORMW 「う……あっ……！？　この目、は……！」
PRINTFORMW 「もう……逃げられないんだ、わたし……」	PRINTFORMW 「もう……逃げられないんだ、わたし……」
PRINTFORMW 「――――――z＿＿＿＿っ！！！！！？」	PRINTFORMW 「――――――z＿＿＿＿っ！！！！！？」
PRINTFORM 「き……てるぅ……♪　またイっちゃうぅ……	PRINTFORM 「き……てるぅ……♪　またイっちゃうぅ……
PRINTFORML （月の住人……私が残してきた故郷の……）	PRINTFORML （月の住人……私が残してきた故郷の……）
PRINTFORMW 「よ、よかった、輝夜さまもここにいた！」	PRINTFORMW 「よ、よかった、輝夜さまもここにいた！」
PRINTFORMW 「……ごめんなさい。助ける余力はないの」	PRINTFORMW 「……ごめんなさい。助ける余力はないの」
PRINTFORMW 「そ、そんな……助けて、助けてよ……！」	PRINTFORMW 「そ、そんな……助けて、助けてよ……！」
PRINTFORMW 「いやぁ……や、やめて、やめてよぉ……」	PRINTFORMW 「いやぁ……や、やめて、やめてよぉ……」
PRINTFORMW 「ただの病気で終わって……お願い……！」	PRINTFORMW 「ただの病気で終わって……お願い……！」
PRINTFORMW 「せめて、悪夢じゃありませんように……」	PRINTFORMW 「せめて、悪夢じゃありませんように……」
PRINTFORMW 「はぁ、潰しても潰してもキリがない……」	PRINTFORMW 「はぁ、潰しても潰してもキリがない……」
PRINTFORMW 「こんな状態じゃ、警戒しても視野が……」	PRINTFORMW 「こんな状態じゃ、警戒しても視野が……」
PRINTFORMW 「すぐ……また、呼び戻して下さいね……」	PRINTFORMW 「すぐ……また、呼び戻して下さいね……」
PRINTFORMW 『新薬……ですか、師匠？　それとも毒？』	PRINTFORMW 『新薬……ですか、師匠？　それとも毒？』
PRINTFORMW 「うあぁっ……この虫、何か、薬を……！」	PRINTFORMW 「うあぁっ……この虫、何か、薬を……！」
PRINTFORMW 「師匠なら……きっと大丈夫……大丈夫よ」	PRINTFORMW 「師匠なら……きっと大丈夫……大丈夫よ」
PRINTFORM 「んんっ、姫様が腰を振ってます、私の上でっ	PRINTFORM 「んんっ、姫様が腰を振ってます、私の上でっ
PRINTFORMW 「今の状態じゃ、無理に攻撃しても……」	PRINTFORMW 「今の状態じゃ、無理に攻撃しても……」
PRINTFORMW 「逃がして……わたしを逃してよぅ……」	PRINTFORMW 「逃がして……わたしを逃してよぅ……」
PRINTFORMW 「嫌……なかを穢されるのはイヤ……！」	PRINTFORMW 「嫌……なかを穢されるのはイヤ……！」
PRINTFORMDW 中にいるはずの鈴仙は、何も答えない。	PRINTFORMDW 中にいるはずの鈴仙は、何も答えない。
PRINTFORMDW そろそろあのお姫様の機嫌を損ねるぞ」	PRINTFORMDW そろそろあのお姫様の機嫌を損ねるぞ」
PRINTFORMW 　私のはじめて、どうでしたかぁ……？」	PRINTFORMW 　私のはじめて、どうでしたかぁ……？」
PRINTFORMW 「きゃっ！？　そ、そういえば今は……」	PRINTFORMW 「きゃっ！？　そ、そういえば今は……」
PRINTFORMW 「や……このままじゃ、意識、まで……」	PRINTFORMW 「や……このままじゃ、意識、まで……」
PRINTFORMW 「こ、これくらい眼で追えるんだから！」	PRINTFORMW 「こ、これくらい眼で追えるんだから！」
PRINTFORMW 「ま……魔眼なら、対応出来ます……！」	PRINTFORMW 「ま……魔眼なら、対応出来ます……！」
PRINTFORM 「きもちよすぎてぇ……もう、動けない……	PRINTFORM 「きもちよすぎてぇ……もう、動けない……
PRINTFORMW 「意識がこっちに向いてない……今よ！」	PRINTFORMW 「意識がこっちに向いてない……今よ！」
PRINTFORMW 「こんな戦いを続けてたら、いつか……」	PRINTFORMW 「こんな戦いを続けてたら、いつか……」
PRINTFORMW 「逃げ切れたけど……このままじゃ……」	PRINTFORMW 「逃げ切れたけど……このままじゃ……」
PRINTFORMW 「てゐは……今なら、動けない……よね」	PRINTFORMW 「てゐは……今なら、動けない……よね」
PRINTFORMW 「そそそそそその笑顔はなんでしょうか」	PRINTFORMW 「そそそそそその笑顔はなんでしょうか」
PRINTFORMW 「や、やっぱり……怒ってます、よね？」	PRINTFORMW 「や、やっぱり……怒ってます、よね？」
PRINTFORMW 「輝夜さま、あれから何かありました？」	PRINTFORMW 「輝夜さま、あれから何かありました？」
PRINTFORMW 「ごめんなさい……何度も見捨てて……」	PRINTFORMW 「ごめんなさい……何度も見捨てて……」
PRINTFORMW 「じゃ、じゃあその調子で頑張ってね！」	PRINTFORMW 「じゃ、じゃあその調子で頑張ってね！」
PRINTFORMW 「薬が欲しい……何もかも治せるような」	PRINTFORMW 「薬が欲しい……何もかも治せるような」
PRINTFORMW 「私の瞳って、貴方たちに効いてるの？」	PRINTFORMW 「私の瞳って、貴方たちに効いてるの？」
PRINTFORMW 「これってやっぱり、罰、なのかな……」	PRINTFORMW 「これってやっぱり、罰、なのかな……」
PRINTFORMW 「私が見聞きしたのは、こんな感じです」	PRINTFORMW 「私が見聞きしたのは、こんな感じです」
PRINTFORMW 「私の眼に映ってきたことは、以上です」	PRINTFORMW 「私の眼に映ってきたことは、以上です」
PRINTFORMW 「え、えっと、その……ごめんなさい！」	PRINTFORMW 「え、えっと、その……ごめんなさい！」
PRINTFORMW 「何か裏があったり……しない、よね？」	PRINTFORMW 「何か裏があったり……しない、よね？」
PRINTFORMW 「このままじゃ、私が幻覚を見そう……」	PRINTFORMW 「このままじゃ、私が幻覚を見そう……」
PRINTFORMW 「変なものが見つかりませんように……」	PRINTFORMW 「変なものが見つかりませんように……」
PRINTFORMW 「やっぱり、穢れのない飲み物が一番ね」	PRINTFORMW 「やっぱり、穢れのない飲み物が一番ね」
PRINTFORMW 「あの色……絶対、何か変なの入ってる」	PRINTFORMW 「あの色……絶対、何か変なの入ってる」
PRINTFORMW 「どうりで何か波長が変だと思った……」	PRINTFORMW 「どうりで何か波長が変だと思った……」
PRINTFORM 「私じゃ、この草を保存して持ち歩けない…	PRINTFORM 「私じゃ、この草を保存して持ち歩けない…
PRINTFORMW 「やめっ……ぼにゅー、ぼにゅーがぁ♪」	PRINTFORMW 「やめっ……ぼにゅー、ぼにゅーがぁ♪」
PRINTFORMW 「はやく、いなくなってください……！」	PRINTFORMW 「はやく、いなくなってください……！」
DATAFORM 「かあさまのめを、ばかにしないでください」	DATAFORM 「かあさまのめを、ばかにしないでください」
DATAFORM 「かあさまのめならとめるのはかんたんです」	DATAFORM 「かあさまのめならとめるのはかんたんです」
PRINTFORMW 「今の状況じゃ、これくらいしか……」	PRINTFORMW 「今の状況じゃ、これくらいしか……」
PRINTFORMW 「消えて！　全部、いなくなってっ！」	PRINTFORMW 「消えて！　全部、いなくなってっ！」
PRINTFORMW 「撃つまでに治ってくれないかな……」	PRINTFORMW 「撃つまでに治ってくれないかな……」
PRINTFORMW 「ドカーンと大穴開けちゃいますよ！」	PRINTFORMW 「ドカーンと大穴開けちゃいますよ！」
PRINTFORMW 「す、するなら後でしましょう……！」	PRINTFORMW 「す、するなら後でしましょう……！」
PRINTFORMW 「あ……や、やっと、満足、して……」	PRINTFORMW 「あ……や、やっと、満足、して……」
PRINTFORM 　ひめさまのお顔が、こんなに近くに……	PRINTFORM 　ひめさまのお顔が、こんなに近くに……
PRINTFORMDW こうして、鈴仙は日常生活に戻った。	PRINTFORMDW こうして、鈴仙は日常生活に戻った。
PRINTFORMW 「……いたい……なに……なんな……？	PRINTFORMW 「……いたい……なに……なんな……？
PRINTFORMW 「ご……ごめん、なさい……んぅ……」	PRINTFORMW 「ご……ごめん、なさい……んぅ……」
PRINTFORM %ARGS:0%は【処女】を捧げた… 	PRINTFORM %ARGS:0%は【処女】を捧げた… 
PRINTFORMW 　次は、中に入れて下さいねぇ……♪」	PRINTFORMW 　次は、中に入れて下さいねぇ……♪」
PRINTFORMW 「魔眼なら、私だってあるんだから！」	PRINTFORMW 「魔眼なら、私だってあるんだから！」
PRINTFORMW 「……いじめないで……むにゃむにゃ」	PRINTFORMW 「……いじめないで……むにゃむにゃ」
PRINTFORMW 「眼に頼れなくても、これくらいはね」	PRINTFORMW 「眼に頼れなくても、これくらいはね」
PRINTFORMW 「……貴方、ドッペルゲンガーでしょ」	PRINTFORMW 「……貴方、ドッペルゲンガーでしょ」
PRINTFORMW 「……ごめんね。助ける余力はないの」	PRINTFORMW 「……ごめんね。助ける余力はないの」
PRINTFORMW 「湿気が多いせいで、耳の管理が……」	PRINTFORMW 「湿気が多いせいで、耳の管理が……」
PRINTFORMW 「ここには普通の動物はいないのかな」	PRINTFORMW 「ここには普通の動物はいないのかな」
PRINTFORMW 「輝夜様まで見捨てたら、私は……！」	PRINTFORMW 「輝夜様まで見捨てたら、私は……！」
PRINTFORMW 「これから、よろしくお願いしますね」	PRINTFORMW 「これから、よろしくお願いしますね」
PRINTFORMW 「勝手に蘇ったりは……しないよね？」	PRINTFORMW 「勝手に蘇ったりは……しないよね？」
PRINTFORMW 「あ、あぁ……お腹、出てきてる……」	PRINTFORMW 「あ、あぁ……お腹、出てきてる……」
PRINTFORMW 「もう、だめ……視界が、歪んで……」	PRINTFORMW 「もう、だめ……視界が、歪んで……」
PRINTFORMW 「走らなきゃ……こんな体調でも……」	PRINTFORMW 「走らなきゃ……こんな体調でも……」
PRINTFORMW 「うん、これなら周囲がよく見えるわ」	PRINTFORMW 「うん、これなら周囲がよく見えるわ」
PRINTFORMW 「煮沸できるような装備はないし……」	PRINTFORMW 「煮沸できるような装備はないし……」
PRINTFORMW 「ひっ！　なに、なんなのこれぇ！？」	PRINTFORMW 「ひっ！　なに、なんなのこれぇ！？」
PRINTFORMW 「むねぇ……すべすべ、してぇ……♪」	PRINTFORMW 「むねぇ……すべすべ、してぇ……♪」
PRINTFORML 「むねぇ……すべすべ、してぇ……♪」	PRINTFORML 「むねぇ……すべすべ、してぇ……♪」
DATAFORM 「みなさんのくるわせかたは、しってます」	DATAFORM 「みなさんのくるわせかたは、しってます」
PRINTFORMW 「これならちかづいてもあんぜんです」	PRINTFORMW 「これならちかづいてもあんぜんです」
PRINTFORMW 「こんな相手に近寄りたくない……」	PRINTFORMW 「こんな相手に近寄りたくない……」
PRINTFORMW 「アーマーピアシング、ファイア！」	PRINTFORMW 「アーマーピアシング、ファイア！」
PRINTFORMW 「……軽く当てるだけでいいよね？」	PRINTFORMW 「……軽く当てるだけでいいよね？」
PRINTFORM 「えへへ、全部だしちゃだめですよ……	PRINTFORM 「えへへ、全部だしちゃだめですよ……
PRINTFORMD 多少罪悪感が浮かんだものの、鈴仙は	PRINTFORMD 多少罪悪感が浮かんだものの、鈴仙は
PRINTFORMDW 「おい、起きてんの？　バカ鈴仙」	PRINTFORMDW 「おい、起きてんの？　バカ鈴仙」
PRINTFORMW 「これだけ用意してれば、大丈夫よ」	PRINTFORMW 「これだけ用意してれば、大丈夫よ」
PRINTFORM 「ぅ……んっ……はぁあっ、あはっ……	PRINTFORM 「ぅ……んっ……はぁあっ、あはっ……
PRINTFORMW 「やめ……て……来ない……で……」	PRINTFORMW 「やめ……て……来ない……で……」
PRINTFORMW 「あ……あっ、あっ、あぁっ……♪」	PRINTFORMW 「あ……あっ、あっ、あぁっ……♪」
PRINTFORM 　出されちゃいけないのにっ、のにぃっ	PRINTFORM 　出されちゃいけないのにっ、のにぃっ
PRINTFORMW 「よ、よかった。逃げ切れたみたい」	PRINTFORMW 「よ、よかった。逃げ切れたみたい」
PRINTFORMW 「あれ、貴方もここにいたんですか」	PRINTFORMW 「あれ、貴方もここにいたんですか」
PRINTFORMW 「急いで、ここから離れなきゃ……」	PRINTFORMW 「急いで、ここから離れなきゃ……」
PRINTFORMW 「いやー、そのー、ご、ごめん……」	PRINTFORMW 「いやー、そのー、ご、ごめん……」
PRINTFORML 「落とし穴とか仕掛けたりしないの？	PRINTFORML 「落とし穴とか仕掛けたりしないの？
PRINTFORMW 「私が見聞きしたのは、こんな感じ」	PRINTFORMW 「私が見聞きしたのは、こんな感じ」
PRINTFORMW 「これから、よろしくお願いするわ」	PRINTFORMW 「これから、よろしくお願いするわ」
PRINTFORMW 「や、やれるだけ……やってみます」	PRINTFORMW 「や、やれるだけ……やってみます」
PRINTFORMW 「師匠に助けなんているんですか？」	PRINTFORMW 「師匠に助けなんているんですか？」
PRINTFORMW 「ご、ごめん……今の私じゃ無理！」	PRINTFORMW 「ご、ごめん……今の私じゃ無理！」
PRINTFORMW （はっ……まさか私、乗せられた？）	PRINTFORMW （はっ……まさか私、乗せられた？）
PRINTFORMW 「や、優しく……して下さい、ね？」	PRINTFORMW 「や、優しく……して下さい、ね？」
PRINTFORMW 「あ、あぁ……お腹、出てきて……」	PRINTFORMW 「あ、あぁ……お腹、出てきて……」
PRINTFORMW 「不安だけど、ちゃんと眠らないと」	PRINTFORMW 「不安だけど、ちゃんと眠らないと」
PRINTFORMW 「それじゃ、見張りはお任せします」	PRINTFORMW 「それじゃ、見張りはお任せします」
PRINTFORMW 「消毒はこまめにしておかなくちゃ」	PRINTFORMW 「消毒はこまめにしておかなくちゃ」
PRINTFORMW （敵を見つけたらすぐ逃げよう……）	PRINTFORMW （敵を見つけたらすぐ逃げよう……）
PRINTFORMW 「……うっかり何か踏んじゃいそう」	PRINTFORMW 「……うっかり何か踏んじゃいそう」
PRINTFORMW （止めても聞く人じゃないよね……）	PRINTFORMW （止めても聞く人じゃないよね……）
PRINTFORMW 「いやぁ！　もう落とし穴いやぁ！」	PRINTFORMW 「いやぁ！　もう落とし穴いやぁ！」
PRINTFORMW 師匠はなんとかできないんですか？」	PRINTFORMW 師匠はなんとかできないんですか？」
PRINTFORMW 師匠ならできるのかもしれないけど」	PRINTFORMW 師匠ならできるのかもしれないけど」
PRINTFORMW 「や、やっと……これで、もう……」	PRINTFORMW 「や、やっと……これで、もう……」
PRINTFORMW 「ねらいをつけて……ねらいを……」	PRINTFORMW 「ねらいをつけて……ねらいを……」
PRINTFORMW 「やめて……やめて、ください……」	PRINTFORMW 「やめて……やめて、ください……」
PRINTFORMW 　せーえき、はいってきてます……」	PRINTFORMW 　せーえき、はいってきてます……」
PRINTFORMW 「ぅ……ぁ……なにか、へんで……」	PRINTFORMW 「ぅ……ぁ……なにか、へんで……」
PRINTFORMW 「た、たすけて……助けてぇ……」	PRINTFORMW 「た、たすけて……助けてぇ……」
PRINTFORMW 「こんなのしか撃てないの……？」	PRINTFORMW 「こんなのしか撃てないの……？」
PRINTFORMW 「本当にこれで勝てるのかな……」	PRINTFORMW 「本当にこれで勝てるのかな……」
PRINTFORMW 「なんとかして助けなきゃ……！」	PRINTFORMW 「なんとかして助けなきゃ……！」
PRINTFORMW 「狂気の瞳、効いてるのかしら？」	PRINTFORMW 「狂気の瞳、効いてるのかしら？」
PRINTFORMW 「早く吹き飛ばさなくちゃ……！」	PRINTFORMW 「早く吹き飛ばさなくちゃ……！」
PRINTFORMW 「あ、当てたらすぐ逃げなきゃ！」	PRINTFORMW 「あ、当てたらすぐ逃げなきゃ！」
PRINTFORMW 「離れたい……離れたいけど……」	PRINTFORMW 「離れたい……離れたいけど……」
PRINTFORMW （軽く突いたらすぐ離れよう……）	PRINTFORMW （軽く突いたらすぐ離れよう……）
PRINTFORMW 「これなら、逃げやすくもなるし」	PRINTFORMW 「これなら、逃げやすくもなるし」
PRINTFORMW 「……そっか。そうだったんだぁ」	PRINTFORMW 「……そっか。そうだったんだぁ」
PRINTFORMDW やれやれ、と肩をすくめるてゐ。	PRINTFORMDW やれやれ、と肩をすくめるてゐ。
PRINTFORMW 「こないで……責めないでぇ……」	PRINTFORMW 「こないで……責めないでぇ……」
PRINTFORMW 「か、体中に触られてるぅ……！」	PRINTFORMW 「か、体中に触られてるぅ……！」
PRINTFORM 「んふっ……いっぱい、出てます……	PRINTFORM 「んふっ……いっぱい、出てます……
PRINTFORMW 「こ、これじゃ、見えない……！」	PRINTFORMW 「こ、これじゃ、見えない……！」
PRINTFORMW 「服……邪魔なんですかぁ……？」	PRINTFORMW 「服……邪魔なんですかぁ……？」
PRINTFORMW 「強そうだけど、頑張らなきゃ！」	PRINTFORMW 「強そうだけど、頑張らなきゃ！」
PRINTFORMW 「…………あれ？　わたし……？」	PRINTFORMW 「…………あれ？　わたし……？」
PRINTFORMDW 鈴仙は全力で現実逃避している…	PRINTFORMDW 鈴仙は全力で現実逃避している…
PRINTFORMW 「……はぁ、何やってるんだろう」	PRINTFORMW 「……はぁ、何やってるんだろう」
PRINTFORMW 「少しだけど、眼が効いた……！」	PRINTFORMW 「少しだけど、眼が効いた……！」
PRINTFORMW （見てるだけで……興奮……する）	PRINTFORMW （見てるだけで……興奮……する）
PRINTFORMW 「あれからどうでしたか、師匠？」	PRINTFORMW 「あれからどうでしたか、師匠？」
PRINTFORMW 「な、何かあったり、しました？」	PRINTFORMW 「な、何かあったり、しました？」
PRINTFORMW 「じゃ、じゃあ……頑張ってね？」	PRINTFORMW 「じゃ、じゃあ……頑張ってね？」
PRINTFORMW 「……お願い。しばらく、助けて」	PRINTFORMW 「……お願い。しばらく、助けて」
PRINTFORMW 「や、やれるだけ……やってみる」	PRINTFORMW 「や、やれるだけ……やってみる」
PRINTFORMW 「え、えっと、その……ごめん！」	PRINTFORMW 「え、えっと、その……ごめん！」
PRINTFORMW 「あ、あの……何し、て……！？」	PRINTFORMW 「あ、あの……何し、て……！？」
PRINTFORMW 「これで大丈夫です、輝夜さま！」	PRINTFORMW 「これで大丈夫です、輝夜さま！」
PRINTFORM 「あ……はいぃ、わかりましたぁ……	PRINTFORM 「あ……はいぃ、わかりましたぁ……
PRINTFORMW 「この症状……まさか、そんなの」	PRINTFORMW 「この症状……まさか、そんなの」
PRINTFORMW 「もう、疲れた……帰りたい……」	PRINTFORMW 「もう、疲れた……帰りたい……」
PRINTFORMW 「だ、大丈夫かな、これ……！？」	PRINTFORMW 「だ、大丈夫かな、これ……！？」
PRINTFORMW 「……ん……すぅ……っ、は！？」	PRINTFORMW 「……ん……すぅ……っ、は！？」
PRINTFORMW 「いやぁ……またこ、れなの……」	PRINTFORMW 「いやぁ……またこ、れなの……」
PRINTFORMW 「……よかった、何もないみたい」	PRINTFORMW 「……よかった、何もないみたい」
PRINTFORMW 「……あー、大変でしたね、師匠」	PRINTFORMW 「……あー、大変でしたね、師匠」
PRINTFORMW 「あぁ……取れちゃったのね……」	PRINTFORMW 「あぁ……取れちゃったのね……」
PRINTFORM 　もっと動いて、もっと射精させてぇ	PRINTFORM 　もっと動いて、もっと射精させてぇ
PRINTFORMW 「やめてください……やめて……」	PRINTFORMW 「やめてください……やめて……」
PRINTFORMW 「ちかよりたく……ないですけど」	PRINTFORMW 「ちかよりたく……ないですけど」
PRINTFORMW 「ごめんなさい、おまかせします」	PRINTFORMW 「ごめんなさい、おまかせします」
DATAFORM 「かあさま、いま、たすけます……！」	DATAFORM 「かあさま、いま、たすけます……！」
DATAFORM 「どこをちゅういしてるかよめました」	DATAFORM 「どこをちゅういしてるかよめました」
PRINTFORMW 「は、早く……早くしなきゃ！」	PRINTFORMW 「は、早く……早くしなきゃ！」
PRINTFORMW 「こないで……来ないでぇっ！」	PRINTFORMW 「こないで……来ないでぇっ！」
PRINTFORMW 「近づかれる前に撃たないと！」	PRINTFORMW 「近づかれる前に撃たないと！」
PRINTFORMW 「ホローポイント、シュート！」	PRINTFORMW 「ホローポイント、シュート！」
PRINTFORMW 「弾薬は有限……節約しないと」	PRINTFORMW 「弾薬は有限……節約しないと」
PRINTFORMW 「ひっ、何かべたべたする……」	PRINTFORMW 「ひっ、何かべたべたする……」
PRINTFORMW 「……なんか、汁がかかりそう」	PRINTFORMW 「……なんか、汁がかかりそう」
PRINTFORMW 「ちゃんと怯みますように……」	PRINTFORMW 「ちゃんと怯みますように……」
PRINTFORMW 「これ以上汚される前に……！」	PRINTFORMW 「これ以上汚される前に……！」
PRINTFORMW 「もうくっつかれるのは嫌っ！」	PRINTFORMW 「もうくっつかれるのは嫌っ！」
PRINTFORMW （現実から、逃げちゃおう……）	PRINTFORMW （現実から、逃げちゃおう……）
PRINTFORMW 「す、するなら後にして……！」	PRINTFORMW 「す、するなら後にして……！」
PRINTFORMW 　私ので悦んでくれてますぅ！」	PRINTFORMW 　私ので悦んでくれてますぅ！」
PRINTFORMD 「いつまで引き篭もってる気？　	PRINTFORMD 「いつまで引き篭もってる気？　
PRINTFORMW 「……幻覚……これは幻覚……」	PRINTFORMW 「……幻覚……これは幻覚……」
PRINTFORMW 「いたた……後で処置しないと」	PRINTFORMW 「いたた……後で処置しないと」
PRINTFORM 「はぁ……んぅうっ、あはぁっ……	PRINTFORM 「はぁ……んぅうっ、あはぁっ……
PRINTFORMW 「きゃっ！？　は、離れてっ！」	PRINTFORMW 「きゃっ！？　は、離れてっ！」
PRINTFORMW 「体、重くて……戦えない……」	PRINTFORMW 「体、重くて……戦えない……」
PRINTFORMW 「ひっ……み、見ないでぇっ！」	PRINTFORMW 「ひっ……み、見ないでぇっ！」
PRINTFORMW 「こ、こんなの無理だよ……！」	PRINTFORMW 「こ、こんなの無理だよ……！」
PRINTFORMW 「あっ……はぁぁぁぁっ……♪」	PRINTFORMW 「あっ……はぁぁぁぁっ……♪」
PRINTFORMW 「洗えば、まだ大丈夫かな……」	PRINTFORMW 「洗えば、まだ大丈夫かな……」
PRINTFORMW 「まだ月では訓練やってるの？」	PRINTFORMW 「まだ月では訓練やってるの？」
PRINTFORMW 「今回は騙したりしないでよ？」	PRINTFORMW 「今回は騙したりしないでよ？」
PRINTFORMW 「また暴れられても困るし……」	PRINTFORMW 「また暴れられても困るし……」
PRINTFORMW 「私が、責任を取らなきゃ……」	PRINTFORMW 「私が、責任を取らなきゃ……」
PRINTFORMW 「た、頼りにしてます……よ？」	PRINTFORMW 「た、頼りにしてます……よ？」
PRINTFORMW 「連携は取りやすい……かな？」	PRINTFORMW 「連携は取りやすい……かな？」
PRINTFORMW 「だれか、たすけ、てぇ……！」	PRINTFORMW 「だれか、たすけ、てぇ……！」
PRINTFORMW 「ちゃんと見張らなくちゃ……」	PRINTFORMW 「ちゃんと見張らなくちゃ……」
PRINTFORMW 「あぅ……目がかすんでる……」	PRINTFORMW 「あぅ……目がかすんでる……」
PRINTFORMW 「また暴れたりしないよね……」	PRINTFORMW 「また暴れたりしないよね……」
PRINTFORMW 「な、なに、こいつら……！？」	PRINTFORMW 「な、なに、こいつら……！？」
PRINTFORM 「あぁっ、出ちゃう、射精しちゃう	PRINTFORM 「あぁっ、出ちゃう、射精しちゃう
PRINTFORMW 「もうきえてくださいっ……！」	PRINTFORMW 「もうきえてくださいっ……！」
PRINTFORMW 「こないで……こないでぇっ！」	PRINTFORMW 「こないで……こないでぇっ！」
PRINTFORMW 「あてるまで、にげません……」	PRINTFORMW 「あてるまで、にげません……」
PRINTFORMW 「あてるだけでいいみたいです」	PRINTFORMW 「あてるだけでいいみたいです」
PRINTFORMW 「あなたがいたいのはそこです」	PRINTFORMW 「あなたがいたいのはそこです」
PRINTFORMW 「わたしなんて……どうせ……」	PRINTFORMW 「わたしなんて……どうせ……」
PRINTFORMW 「べたべた……いや、です……」	PRINTFORMW 「べたべた……いや、です……」
PRINTFORMW 「戦う……戦う……戦う……」	PRINTFORMW 「戦う……戦う……戦う……」
PRINTFORMW 「武器、早くしなきゃ……！」	PRINTFORMW 「武器、早くしなきゃ……！」
PRINTFORMW 「もう無理っ、離れるから！」	PRINTFORMW 「もう無理っ、離れるから！」
PRINTFORMW 「吐き出しなさい、このっ！」	PRINTFORMW 「吐き出しなさい、このっ！」
PRINTFORMW 「私、火力も十分あるわよ？」	PRINTFORMW 「私、火力も十分あるわよ？」
PRINTFORMW 「目標を真ん中に捉えて……」	PRINTFORMW 「目標を真ん中に捉えて……」
PRINTFORMW 「なか……穢さ、ないで……」	PRINTFORMW 「なか……穢さ、ないで……」
PRINTFORM 　師匠のナカが、締め付けてくる	PRINTFORM 　師匠のナカが、締め付けてくる
PRINTFORMD 仲間が迷宮の話をしに来ても、	PRINTFORMD 仲間が迷宮の話をしに来ても、
PRINTFORMD どんな目に遭ったか知らないが	PRINTFORMD どんな目に遭ったか知らないが
PRINTFORMW 「こ、こっち、見ないで……」	PRINTFORMW 「こ、こっち、見ないで……」
PRINTFORMW 「う、撃ち返さなくちゃ……」	PRINTFORMW 「う、撃ち返さなくちゃ……」
PRINTFORM 「もっと……射精、させてぇ……	PRINTFORM 「もっと……射精、させてぇ……
PRINTFORMW 「こ、このままじゃっ……！」	PRINTFORMW 「こ、このままじゃっ……！」
PRINTFORMW 「どうせ着てても、もう……」	PRINTFORMW 「どうせ着てても、もう……」
PRINTFORMW 「こんな状態で戦うの……？」	PRINTFORMW 「こんな状態で戦うの……？」
PRINTFORMW 「逃げたほうがいいかも……」	PRINTFORMW 「逃げたほうがいいかも……」
PRINTFORMW 「あぁ、てゐもいたのね……」	PRINTFORMW 「あぁ、てゐもいたのね……」
PRINTFORMW 「今更、私が何をしても……」	PRINTFORMW 「今更、私が何をしても……」
PRINTFORMW 　……解剖が必要？　うげぇ」	PRINTFORMW 　……解剖が必要？　うげぇ」
PRINTFORMW 「私が、責任を取ります……」	PRINTFORMW 「私が、責任を取ります……」
PRINTFORMW 「今回は真面目にやってよね」	PRINTFORMW 「今回は真面目にやってよね」
PRINTFORMW 「……普通はそう返すわよね」	PRINTFORMW 「……普通はそう返すわよね」
PRINTFORMW 「はい……わかりました……」	PRINTFORMW 「はい……わかりました……」
PRINTFORMW 「は、はい、わかりました！」	PRINTFORMW 「は、はい、わかりました！」
PRINTFORMW 「足を引っ張るわけには……」	PRINTFORMW 「足を引っ張るわけには……」
PRINTFORM 「そ……その目、私と、同じ……	PRINTFORM 「そ……その目、私と、同じ……
PRINTFORMW 「……お腹から……響いてる」	PRINTFORMW 「……お腹から……響いてる」
PRINTFORMW 「うぅ……気色悪いなぁ……」	PRINTFORMW 「うぅ……気色悪いなぁ……」
PRINTFORMW 「あう……頭がくらくらする」	PRINTFORMW 「あう……頭がくらくらする」
PRINTFORMW 「そーっと……そーっと……」	PRINTFORMW 「そーっと……そーっと……」
PRINTFORMW （ちょっとサボろうかな……）	PRINTFORMW （ちょっとサボろうかな……）
PRINTFORMW 「探す前に少し寝ようよ……」	PRINTFORMW 「探す前に少し寝ようよ……」
PRINTFORMW 「ね、粘っこいのが、肌に！」	PRINTFORMW 「ね、粘っこいのが、肌に！」
PRINTFORM 　私のがそんなにいいんですねっ	PRINTFORM 　私のがそんなにいいんですねっ
PRINTFORM 赤ちゃん溺れるくらい出しますぅ	PRINTFORM 赤ちゃん溺れるくらい出しますぅ
PRINTFORMW 「はやくたおしたいのに……」	PRINTFORMW 「はやくたおしたいのに……」
DATAFORM 「まっててください、かあさま！」	DATAFORM 「まっててください、かあさま！」
PRINTFORM 「は、い……わたしのこと、あっ	PRINTFORM 「は、い……わたしのこと、あっ
PRINTFORM 　すきに、つかってください……	PRINTFORM 　すきに、つかってください……
PRINTFORMW 「こ、こないでください……」	PRINTFORMW 「こ、こないでください……」
PRINTFORMW 「……あ、あぶなかったです」	PRINTFORMW 「……あ、あぶなかったです」
PRINTFORMW 「かあさまの、ために……！」	PRINTFORMW 「かあさまの、ために……！」
PRINTFORMW 「かあさま……たすけます！」	PRINTFORMW 「かあさま……たすけます！」
PRINTFORMW 「かあさまが、いうなら……」	PRINTFORMW 「かあさまが、いうなら……」
PRINTFORMW 「これで終わってってば！」	PRINTFORMW 「これで終わってってば！」
PRINTFORMW 「射線確認、撃ちこむわ！」	PRINTFORMW 「射線確認、撃ちこむわ！」
PRINTFORMW 「……近寄りたくないけど」	PRINTFORMW 「……近寄りたくないけど」
PRINTFORMW 「べとべとはもうやだぁ！」	PRINTFORMW 「べとべとはもうやだぁ！」
PRINTFORM 　せ、せめてぇ、自分でぇ……	PRINTFORM 　せ、せめてぇ、自分でぇ……
PRINTFORMW 「あ……た、助けないと！」	PRINTFORMW 「あ……た、助けないと！」
PRINTFORM 　仕返ししても、いい、よねっ	PRINTFORM 　仕返ししても、いい、よねっ
PRINTFORMW 「これで眼が使える……！」	PRINTFORMW 「これで眼が使える……！」
PRINTFORM 「はい……挿れてください……	PRINTFORM 「はい……挿れてください……
PRINTFORMW 「変なことしないでよ……」	PRINTFORMW 「変なことしないでよ……」
PRINTFORMW 「もし、当たってたら……」	PRINTFORMW 「もし、当たってたら……」
PRINTFORMW 「もう……出ないよぉ……」	PRINTFORMW 「もう……出ないよぉ……」
PRINTFORMW 「……いつ帰れるんだろう」	PRINTFORMW 「……いつ帰れるんだろう」
PRINTFORML （し、師匠が倒れてる……）	PRINTFORML （し、師匠が倒れてる……）
PRINTFORMW （本当は頼りたいけど……）	PRINTFORMW （本当は頼りたいけど……）
PRINTFORMW 「……師匠は私が助けます」	PRINTFORMW 「……師匠は私が助けます」
PRINTFORM 「こ、これが、私の、こど……	PRINTFORM 「こ、これが、私の、こど……
PRINTFORMW 「おやすみなさい……ぐぅ」	PRINTFORMW 「おやすみなさい……ぐぅ」
PRINTFORMW 「眠っても大丈夫かな……」	PRINTFORMW 「眠っても大丈夫かな……」
PRINTFORMW 「今のところ……異常なし」	PRINTFORMW 「今のところ……異常なし」
PRINTFORMW 「薬は薬でも劇薬かも……」	PRINTFORMW 「薬は薬でも劇薬かも……」
PRINTFORMW 「あうっ……頭が重く……」	PRINTFORMW 「あうっ……頭が重く……」
PRINTFORMW 　ねぇ……そう言って……」	PRINTFORMW 　ねぇ……そう言って……」
PRINTFORM 子供に飲ませてあげますからぁ	PRINTFORM 子供に飲ませてあげますからぁ
PRINTFORMW 「もしちかづかれたら……」	PRINTFORMW 「もしちかづかれたら……」
PRINTFORMW 「はなれてください……！」	PRINTFORMW 「はなれてください……！」
PRINTFORMW 「さわらないでほしいです」	PRINTFORMW 「さわらないでほしいです」
PRINTFORMW 「……ぃゃ……ぃゃぁ……」	PRINTFORMW 「……ぃゃ……ぃゃぁ……」
PRINTFORM 「あ……わたし、わた、し……	PRINTFORM 「あ……わたし、わた、し……
PRINTFORMW 「やぁ……いやぁ……！」	PRINTFORMW 「やぁ……いやぁ……！」
PRINTFORMW 「うぁぁぁぁぁぁっ！！」	PRINTFORMW 「うぁぁぁぁぁぁっ！！」
PRINTFORMW 「待ってて下さい……！」	PRINTFORMW 「待ってて下さい……！」
PRINTFORMW 「その人を離しなさい！」	PRINTFORMW 「その人を離しなさい！」
PRINTFORM 「あぁっ、師匠、ししょおっ	PRINTFORM 「あぁっ、師匠、ししょおっ
PRINTFORMD 今一緒にいる仲間を連れて	PRINTFORMD 今一緒にいる仲間を連れて
PRINTFORMDW 脱出することを選んだ。	PRINTFORMDW 脱出することを選んだ。
PRINTFORMW 「きゃっ……痛いっ！？」	PRINTFORMW 「きゃっ……痛いっ！？」
PRINTFORMW 「読みそこねたかな……」	PRINTFORMW 「読みそこねたかな……」
PRINTFORMW 「あ……はずれ、たんだ」	PRINTFORMW 「あ……はずれ、たんだ」
PRINTFORMW 「みんな、頑張って……」	PRINTFORMW 「みんな、頑張って……」
PRINTFORMW 「ふぅ、なんとかなった」	PRINTFORMW 「ふぅ、なんとかなった」
PRINTFORM 「うぁっ……あー、あー……	PRINTFORM 「うぁっ……あー、あー……
PRINTFORMW 「そ、そんな、師匠……」	PRINTFORMW 「そ、そんな、師匠……」
PRINTFORMW 「じゃあ、急いでるから」	PRINTFORMW 「じゃあ、急いでるから」
PRINTFORMW 「で、では失礼します！」	PRINTFORMW 「で、では失礼します！」
PRINTFORMW 「では、急いでますので」	PRINTFORMW 「では、急いでますので」
PRINTFORMW 「私は……最低だ……！」	PRINTFORMW 「私は……最低だ……！」
PRINTFORMW 「……置いていくよりは」	PRINTFORMW 「……置いていくよりは」
PRINTFORMW 「えぇっ、そんなぁ！？」	PRINTFORMW 「えぇっ、そんなぁ！？」
PRINTFORMW 「……何か企んでるの？」	PRINTFORMW 「……何か企んでるの？」
PRINTFORM 「ひっ、うっ、うぅんっ……	PRINTFORM 「ひっ、うっ、うぅんっ……
PRINTFORMDW 鈴仙の瞳はそれを見た。	PRINTFORMDW 鈴仙の瞳はそれを見た。
PRINTFORMW 「この――どきなさい！」	PRINTFORMW 「この――どきなさい！」
PRINTFORMDW ――普通の、存在なら。	PRINTFORMDW ――普通の、存在なら。
PRINTFORM 絶対に受精してもらいますぅ	PRINTFORM 絶対に受精してもらいますぅ
PRINTFORMW 「……どうせ、むりです」	PRINTFORMW 「……どうせ、むりです」
PRINTFORMW 「これしか……できない」	PRINTFORMW 「これしか……できない」
DATAFORM 「はなしてあげてください！」	DATAFORM 「はなしてあげてください！」
PRINTFORMW 「おっきなのいきます！」	PRINTFORMW 「おっきなのいきます！」
DATAFORM 「……ちかよりたくないです」	DATAFORM 「……ちかよりたくないです」
PRINTFORMW 「……やって……みます」	PRINTFORMW 「……やって……みます」
PRINTFORMW 「荒っぽいですけど！」	PRINTFORMW 「荒っぽいですけど！」
PRINTFORM 「では……失礼します……	PRINTFORM 「では……失礼します……
PRINTFORM 「やさしく、しますね……	PRINTFORM 「やさしく、しますね……
PRINTFORMW 「あ……終わり……？」	PRINTFORMW 「あ……終わり……？」
PRINTFORMD そりゃ私だって怖いけど	PRINTFORMD そりゃ私だって怖いけど
PRINTFORMW 「うぅ……いやぁ……」	PRINTFORMW 「うぅ……いやぁ……」
PRINTFORMW 「ふふ、ふふふふ……」	PRINTFORMW 「ふふ、ふふふふ……」
PRINTFORMW 「やっ、やめてぇ……」	PRINTFORMW 「やっ、やめてぇ……」
PRINTFORM 「せーえき、入ってくるぅ	PRINTFORM 「せーえき、入ってくるぅ
PRINTFORMW 「こんな玉兎まで……」	PRINTFORMW 「こんな玉兎まで……」
PRINTFORM 「そ……その目、また……	PRINTFORM 「そ……その目、また……
PRINTFORM 「んっ、ふあっ、あはぁっ	PRINTFORM 「んっ、ふあっ、あはぁっ
PRINTFORM 絶対に受精させますからぁ	PRINTFORM 絶対に受精させますからぁ
PRINTFORMW 「にげちゃだめだ……」	PRINTFORMW 「にげちゃだめだ……」
PRINTFORMW 「はやくしないと……」	PRINTFORMW 「はやくしないと……」
PRINTFORMW 「もう、いやです……」	PRINTFORMW 「もう、いやです……」
DATAFORM 「そこをみているんですね」	DATAFORM 「そこをみているんですね」
DATAFORM 「ちかづかないでください」	DATAFORM 「ちかづかないでください」
PRINTFORMW 「そこがまんなかです」	PRINTFORMW 「そこがまんなかです」
DATAFORM 「ちはださないでください」	DATAFORM 「ちはださないでください」
PRINTFORMW 「もんだいありません」	PRINTFORMW 「もんだいありません」
PRINTFORMW 「……死ねばいいよ」	PRINTFORMW 「……死ねばいいよ」
PRINTFORMW 「もう無理ですっ！」	PRINTFORMW 「もう無理ですっ！」
PRINTFORMW 「うっ……眼が……」	PRINTFORMW 「うっ……眼が……」
PRINTFORMW 「近づかないでよ！」	PRINTFORMW 「近づかないでよ！」
PRINTFORMW 「散弾でいきます！」	PRINTFORMW 「散弾でいきます！」
PRINTFORMW 「行くわよ、連射！」	PRINTFORMW 「行くわよ、連射！」
PRINTFORM 「うあっ、ひめ、さまぁ	PRINTFORM 「うあっ、ひめ、さまぁ
PRINTFORMW 「…………そう、だ」	PRINTFORMW 「…………そう、だ」
PRINTFORMW （……逃げたいなぁ）	PRINTFORMW （……逃げたいなぁ）
PRINTFORM 「こんなに、近くに……	PRINTFORM 「こんなに、近くに……
PRINTFORMW 「い、や……ぁ……」	PRINTFORMW 「い、や……ぁ……」
PRINTFORMW 「はぁ、はぁっ……」	PRINTFORMW 「はぁ、はぁっ……」
PRINTFORMW 「危なかったぁ……」	PRINTFORMW 「危なかったぁ……」
PRINTFORMW 「し、下着がぁ……」	PRINTFORMW 「し、下着がぁ……」
PRINTFORMW 「……そう、ですか」	PRINTFORMW 「……そう、ですか」
PRINTFORMW 「何かないかしら？」	PRINTFORMW 「何かないかしら？」
PRINTFORMW 「え、わ、わっ！？」	PRINTFORMW 「え、わ、わっ！？」
PRINTFORMW 「あ……また……♪」	PRINTFORMW 「あ……また……♪」
PRINTFORMW 　私も出ちゃいます、	PRINTFORMW 　私も出ちゃいます、
PRINTFORMW 「はやく、はやく！」	PRINTFORMW 「はやく、はやく！」
PRINTFORMW 「こんなのじゃ……」	PRINTFORMW 「こんなのじゃ……」
DATAFORM 「あなたにはみえません」	DATAFORM 「あなたにはみえません」
PRINTFORMW 「い……たいっ……」	PRINTFORMW 「い……たいっ……」
PRINTFORMW 「きもちわるい……」	PRINTFORMW 「きもちわるい……」
PRINTFORMW 「は、離れてよ！」	PRINTFORMW 「は、離れてよ！」
PRINTFORMW 「今、助けます！」	PRINTFORMW 「今、助けます！」
PRINTFORMW 「せーの、乱射！」	PRINTFORMW 「せーの、乱射！」
PRINTFORMW 「……これでよし」	PRINTFORMW 「……これでよし」
PRINTFORMW 「う、うるさい！」	PRINTFORMW 「う、うるさい！」
PRINTFORMW 「わ、わわっ……」	PRINTFORMW 「わ、わわっ……」
PRINTFORM 「あぁ……んんっ……	PRINTFORM 「あぁ……んんっ……
PRINTFORMW 「この人まで……」	PRINTFORMW 「この人まで……」
PRINTFORMW 「今の私じゃ……」	PRINTFORMW 「今の私じゃ……」
PRINTFORMW 「……ですよねー」	PRINTFORMW 「……ですよねー」
PRINTFORM 　これ、びや、く……	PRINTFORM 　これ、びや、く……
PRINTFORMW 「うぅ、耳が……」	PRINTFORMW 「うぅ、耳が……」
PRINTFORMW 「かあさま……！」	PRINTFORMW 「かあさま……！」
PRINTFORMW 「だめです……！」	PRINTFORMW 「だめです……！」
PRINTFORMW 「次弾、装填！」	PRINTFORMW 「次弾、装填！」
PRINTFORM 「んんっ……ちゅっ	PRINTFORM 「んんっ……ちゅっ
PRINTFORMW 「…………あぁ」	PRINTFORMW 「…………あぁ」
PRINTFORMW 「……来るわ！」	PRINTFORMW 「……来るわ！」
PRINTFORMW 「貴方は……！」	PRINTFORMW 「貴方は……！」
PRINTFORMW 「この薬なら！」	PRINTFORMW 「この薬なら！」
PRINTFORMW 「……気色悪い」	PRINTFORMW 「……気色悪い」
PRINTFORMW 「う……う……」	PRINTFORMW 「う……う……」
PRINTFORMW 「つっつきます」	PRINTFORMW 「つっつきます」
PRINTFORMW 「へーき、です」	PRINTFORMW 「へーき、です」
PRINTFORMW 「……わ、わっ」	PRINTFORMW 「……わ、わっ」
PRINTFORMW 「は、はい……」	PRINTFORMW 「は、はい……」
PRINTFORMW 「撃ちます！」	PRINTFORMW 「撃ちます！」
PRINTFORMW 「せーのっ！」	PRINTFORMW 「せーのっ！」
PRINTFORMW 「弾丸、装填」	PRINTFORMW 「弾丸、装填」
PRINTFORMW 「――放て！」	PRINTFORMW 「――放て！」
PRINTFORMW 「あぅっ……」	PRINTFORMW 「あぅっ……」
PRINTFORM 　師匠、ししょお	PRINTFORM 　師匠、ししょお
PRINTFORM 「んぅ、ふむぅっ	PRINTFORM 「んぅ、ふむぅっ
PRINTFORM -{ARG:2}	PRINTFORM -{ARG:2}
PRINTFORMW 「見えたっ！」	PRINTFORMW 「見えたっ！」
PRINTFORMW 「ごめん……」	PRINTFORMW 「ごめん……」
PRINTFORM 「あ……うぅ……	PRINTFORM 「あ……うぅ……
DATAFORM 「ぜんぶうちます」	DATAFORM 「ぜんぶうちます」
PRINTFORMW 「……ごくっ」	PRINTFORMW 「……ごくっ」
PRINTFORMW 「えいっ！」	PRINTFORMW 「えいっ！」
PRINTFORMW 「…………」	PRINTFORMW 「…………」
PRINTFORMW 「そこっ！」	PRINTFORMW 「そこっ！」
PRINTFORMW 「見えた！」	PRINTFORMW 「見えた！」
PRINTFORMW 「きゃっ！」	PRINTFORMW 「きゃっ！」
PRINTFORMW 「ひっ！？」	PRINTFORMW 「ひっ！？」
PRINTFORMW 「……そう」	PRINTFORMW 「……そう」
PRINTFORMW 「――狂え」	PRINTFORMW 「――狂え」
PRINTFORMDL ※注意事項	PRINTFORMDL ※注意事項
PRINTFORMW 「――うわ」	PRINTFORMW 「――うわ」
DATAFORM 「ばらばらです」	DATAFORM 「ばらばらです」
PRINTFORMW 「ひぃっ！」	PRINTFORMW 「ひぃっ！」
PRINTFORMW 「ふぅ……」	PRINTFORMW 「ふぅ……」
PRINTFORMW 「やぁっ！」	PRINTFORMW 「やぁっ！」
PRINTFORM 「んんっ……	PRINTFORM 「んんっ……
PRINTFORMDW …………	PRINTFORMDW …………
PRINTFORM 「あ……あっ	PRINTFORM 「あ……あっ
PRINTFORMW 「あ……」	PRINTFORMW 「あ……」
DATAFORM 「せーの……」	DATAFORM 「せーの……」
DATAFORM 「つぶします」	DATAFORM 「つぶします」
DATAFORM 「まけません」	DATAFORM 「まけません」
PRINTFORMDW ………	PRINTFORMDW ………
PRINTFORM 「あぁ……	PRINTFORM 「あぁ……
PRINTFORM 「んっ……	PRINTFORM 「んっ……
DATAFORM 「うちます」	DATAFORM 「うちます」
DATAFORM 「けします」	DATAFORM 「けします」
PRINTFORM 「んんっ	PRINTFORM 「んんっ
PRINTFORM 「あぁっ	PRINTFORM 「あぁっ
PRINTFORMDW ……	PRINTFORMDW ……
PRINTFORM (MP 	PRINTFORM (MP 
PRINTFORM 「あ……	PRINTFORM 「あ……
PRINTFORMW 　」	PRINTFORMW 　」
DATAFORM 「えぃ」	DATAFORM 「えぃ」
PRINTFORMW 」	PRINTFORMW 」
PRINTFORML 」	PRINTFORML 」
PRINTFORMDW 	PRINTFORMDW 
PRINTFORML )	PRINTFORML )
PRINTFORMW ）	PRINTFORMW ）
PRINTFORMDL 	PRINTFORMDL 
PRINTFORML 	PRINTFORML 
PRINTFORMW 	PRINTFORMW 
PRINTDATAW	PRINTDATAW
