//口上:

PRINTFORMDL \@ NO:(FLAG:10) != 30 ? %CALLNAME:(FLAG:10)% # %CALLNAME:(FLAG:11)% \@の傍に、仲間が駆けよるのを見ながら、妹紅はゆっくりと輝夜の傍に向かう	PRINTFORMDL \@ NO:(FLAG:10) != 30 ? %CALLNAME:(FLAG:10)% # %CALLNAME:(FLAG:11)% \@の傍に、仲間が駆けよるのを見ながら、妹紅はゆっくりと輝夜の傍に向かう
PRINTFORMDL %CALLNAME:(FLAG:10)%と%CALLNAME:(FLAG:11)%が、妹紅の左右に陣取って、酌から上げ膳据え膳までしてくるのだ	PRINTFORMDL %CALLNAME:(FLAG:10)%と%CALLNAME:(FLAG:11)%が、妹紅の左右に陣取って、酌から上げ膳据え膳までしてくるのだ
PRINTFORMDL ぐったりとした%CALLNAME:(FLAG:10)%と%CALLNAME:(FLAG:11)%の傍に寄りながら、妹紅は溜め息を吐く	PRINTFORMDL ぐったりとした%CALLNAME:(FLAG:10)%と%CALLNAME:(FLAG:11)%の傍に寄りながら、妹紅は溜め息を吐く
PRINTFORMDW その言葉に、庵に入り浸るようになった%CALLNAME:(FLAG:10)%と%CALLNAME:(FLAG:11)%が同時に頷く	PRINTFORMDW その言葉に、庵に入り浸るようになった%CALLNAME:(FLAG:10)%と%CALLNAME:(FLAG:11)%が同時に頷く
PRINTFORML 口に含ませても飲み込まない%CALLNAME:(ARG:3)%に、妹紅は口移しで飲み込ませた	PRINTFORML 口に含ませても飲み込まない%CALLNAME:(ARG:3)%に、妹紅は口移しで飲み込ませた
PRINTFORMDL 悔しげな輝夜の表情に気付かないふりをして、妹紅は尻穴を弄られる感触に悦楽の悲鳴を上げている	PRINTFORMDL 悔しげな輝夜の表情に気付かないふりをして、妹紅は尻穴を弄られる感触に悦楽の悲鳴を上げている
PRINTFORML 意識があるのに勿体ないけどと言いながら、%CALLNAME:(ARG:3)%は飲み込んだ	PRINTFORML 意識があるのに勿体ないけどと言いながら、%CALLNAME:(ARG:3)%は飲み込んだ
PRINTFORMDL びくびくと全身を震わせて、表情を甘く蕩けさせて、妹紅は更に秘豆にローターを押し付けた	PRINTFORMDL びくびくと全身を震わせて、表情を甘く蕩けさせて、妹紅は更に秘豆にローターを押し付けた
PRINTFORMDW 蕩けた瞳で口の端から唾液をこぼす妹紅は、呆然とする輝夜に抱き付き、そのまま押し倒す	PRINTFORMDW 蕩けた瞳で口の端から唾液をこぼす妹紅は、呆然とする輝夜に抱き付き、そのまま押し倒す
PRINTFORMDL 一拍おいて、全身を痙攣させた妹紅は、口の端から涎を垂らし、舌を突き出しながら達した	PRINTFORMDL 一拍おいて、全身を痙攣させた妹紅は、口の端から涎を垂らし、舌を突き出しながら達した
PRINTFORMDL 生気の無い二人の少女を傍らにおき、優しく語りかける妹紅を見かけるようになったという	PRINTFORMDL 生気の無い二人の少女を傍らにおき、優しく語りかける妹紅を見かけるようになったという
PRINTFORMDL 体を震わせて、胸から這い上がってくる刺激に、妹紅は眠りながらも快楽に頬を緩ませる	PRINTFORMDL 体を震わせて、胸から這い上がってくる刺激に、妹紅は眠りながらも快楽に頬を緩ませる
PRINTFORMDL クリトリスが締め上げられる感触に、妹紅は舌を突き出しながら頂きへと押し上げられた	PRINTFORMDL クリトリスが締め上げられる感触に、妹紅は舌を突き出しながら頂きへと押し上げられた
PRINTFORMDL 輝夜に見るなと懇願しようとした妹紅は、菊座から這い上がる刺激に悦楽の悲鳴を上げた	PRINTFORMDL 輝夜に見るなと懇願しようとした妹紅は、菊座から這い上がる刺激に悦楽の悲鳴を上げた
PRINTFORMDL 馴れていたはずなのに、今まで感じたことのないほど深い悔恨に、妹紅は苛まされていた	PRINTFORMDL 馴れていたはずなのに、今まで感じたことのないほど深い悔恨に、妹紅は苛まされていた
PRINTFORMDW そう囁く輝夜の腕は、まるで接着でもされたようにこちらの腕に絡みついて振り払えない	PRINTFORMDW そう囁く輝夜の腕は、まるで接着でもされたようにこちらの腕に絡みついて振り払えない
PRINTFORMW 「ん、お尻っお尻熱いのっ！　お願い、ちょうだいっ！　お尻に太いのちょうだいっ！」	PRINTFORMW 「ん、お尻っお尻熱いのっ！　お願い、ちょうだいっ！　お尻に太いのちょうだいっ！」
PRINTFORMW （いやだいやだいやだっ！　こんな慧音を傷つけるようなことなんていやなのにっ！！）	PRINTFORMW （いやだいやだいやだっ！　こんな慧音を傷つけるようなことなんていやなのにっ！！）
PRINTFORML 「ふふ、%ARGS:1%のおまんこきゅんきゅん締め付けてきてる、そんなに良い？」	PRINTFORML 「ふふ、%ARGS:1%のおまんこきゅんきゅん締め付けてきてる、そんなに良い？」
PRINTFORMDL 小さなうめき声を上げても眼を覚まさない妹紅に、輝夜がいらだった表情で睨んでくる	PRINTFORMDL 小さなうめき声を上げても眼を覚まさない妹紅に、輝夜がいらだった表情で睨んでくる
PRINTFORMDL 菊座をくにくにと弄られて、眠ったままの妹紅はそれでも腰をゆらして逃れようとする	PRINTFORMDL 菊座をくにくにと弄られて、眠ったままの妹紅はそれでも腰をゆらして逃れようとする
PRINTFORMDL 膣奧を叩かれる感触に、身を震わせる妹紅を、輝夜が怒りに身を震わせて見つめている	PRINTFORMDL 膣奧を叩かれる感触に、身を震わせる妹紅を、輝夜が怒りに身を震わせて見つめている
PRINTFORML 「っっ！？　中で震え……じょうだんっっ！？　ひぁあっっ！　出すなぁああっっ！！」	PRINTFORML 「っっ！？　中で震え……じょうだんっっ！？　ひぁあっっ！　出すなぁああっっ！！」
PRINTFORML 「中で大きくっ！？　やめ、やめろ、中になんて、あひっ！　ん、くぁあああっっ！！」	PRINTFORML 「中で大きくっ！？　やめ、やめろ、中になんて、あひっ！　ん、くぁあああっっ！！」
PRINTFORMDL ローターから乳首に押し付けられる快感と、自身の指が乳房から紡ぐ悦楽に妹紅は喘ぐ	PRINTFORMDL ローターから乳首に押し付けられる快感と、自身の指が乳房から紡ぐ悦楽に妹紅は喘ぐ
PRINTFORMDL 「蓬莱の薬」を焼き消す事が叶うなら、きっと蓬莱人をも焼き滅ぼすことが出来るはず	PRINTFORMDL 「蓬莱の薬」を焼き消す事が叶うなら、きっと蓬莱人をも焼き滅ぼすことが出来るはず
PRINTFORML 「……ていうか、あんた達も、わざわざこんなところに入り浸って、何が楽しいんだか」	PRINTFORML 「……ていうか、あんた達も、わざわざこんなところに入り浸って、何が楽しいんだか」
PRINTFORMDL 自ら乳房を突き出し、触手に喘がされる妹紅は、輝夜が視界に入らぬよう顔を背けた	PRINTFORMDL 自ら乳房を突き出し、触手に喘がされる妹紅は、輝夜が視界に入らぬよう顔を背けた
PRINTFORML 「あふっ！　んくっ！　この、胸ばっかり触るなっ！　くっ、見るなこのバカっ！！」	PRINTFORML 「あふっ！　んくっ！　この、胸ばっかり触るなっ！　くっ、見るなこのバカっ！！」
PRINTFORMDL それに貫かれる事を思ってか、輝夜がほほを朱に染めて、それをじっと見つめている	PRINTFORMDL それに貫かれる事を思ってか、輝夜がほほを朱に染めて、それをじっと見つめている
PRINTFORMDL 肩を震わせながらもあまり表情を変えない妹紅を、羨ましそうに輝夜が見つめてくる	PRINTFORMDL 肩を震わせながらもあまり表情を変えない妹紅を、羨ましそうに輝夜が見つめてくる
PRINTFORML 「ひんっ！？　や、お尻入ってっ！？　あふっ！　んくっっ！　止めろ、このっっ！」	PRINTFORML 「ひんっ！？　や、お尻入ってっ！？　あふっ！　んくっっ！　止めろ、このっっ！」
PRINTFORML 「っく！　中で、出す気！？　や、こんなもののなんていやぁああああっっっっ！！」	PRINTFORML 「っく！　中で、出す気！？　や、こんなもののなんていやぁああああっっっっ！！」
PRINTFORMDL 快楽に呑まれて、涎と愛液とを垂らしながら、妹紅はひたすらアナルを刺激している	PRINTFORMDL 快楽に呑まれて、涎と愛液とを垂らしながら、妹紅はひたすらアナルを刺激している
PRINTFORML 「違う、そこ違うのに！　なんで、こんな、ふぁあああああああああっっっっっ！！」	PRINTFORML 「違う、そこ違うのに！　なんで、こんな、ふぁあああああああああっっっっっ！！」
PRINTFORML 「あひんっ！　んくっっ！　だめ、だめだめだめ、イく、イッちゃうぅぅぅっっ！！」	PRINTFORML 「あひんっ！　んくっっ！　だめ、だめだめだめ、イく、イッちゃうぅぅぅっっ！！」
PRINTFORMW 『ふふ、ふ、……く、うっ……、ばかもこー、いつまでもねてるんじゃ、ない、わよ』	PRINTFORMW 『ふふ、ふ、……く、うっ……、ばかもこー、いつまでもねてるんじゃ、ない、わよ』
PRINTFORMDL 幼子のような声と言葉に文句をつけ、強引に腕を振り払おうとして、異常に気付いた	PRINTFORMDL 幼子のような声と言葉に文句をつけ、強引に腕を振り払おうとして、異常に気付いた
PRINTFORML 「あついの、お尻が熱くてしかたないの、お願い埋めて、ここに太いの入れてよぉ」	PRINTFORML 「あついの、お尻が熱くてしかたないの、お願い埋めて、ここに太いの入れてよぉ」
PRINTFORMDW 自らの菊座を指で弄りながら啼き声を上げる妹紅を、輝夜が辛そうに見つめてくる	PRINTFORMDW 自らの菊座を指で弄りながら啼き声を上げる妹紅を、輝夜が辛そうに見つめてくる
PRINTFORMW （そんな目で見ないで慧音。私の意志じゃない、こんな事したいわけじゃないっ！）	PRINTFORMW （そんな目で見ないで慧音。私の意志じゃない、こんな事したいわけじゃないっ！）
PRINTFORMW 「%ARGS:1%も一緒にきもちよくなろ、ほらおまんこ擦るの気持ちいいよね」	PRINTFORMW 「%ARGS:1%も一緒にきもちよくなろ、ほらおまんこ擦るの気持ちいいよね」
PRINTFORMDL 痛みに体を震わせ、それでも瞼を閉じている妹紅を横目に、輝夜が敵を睨み付ける	PRINTFORMDL 痛みに体を震わせ、それでも瞼を閉じている妹紅を横目に、輝夜が敵を睨み付ける
PRINTFORMDL ぐにゅむにゅと形を変えるほど激しく揉まれる感触に、眠る妹紅の頬が赤く色づく	PRINTFORMDL ぐにゅむにゅと形を変えるほど激しく揉まれる感触に、眠る妹紅の頬が赤く色づく
PRINTFORMDL 足先から生暖かく湿った感覚に飲み込まれ、眠る妹紅は苦悶の表情を浮かべている	PRINTFORMDL 足先から生暖かく湿った感覚に飲み込まれ、眠る妹紅は苦悶の表情を浮かべている
PRINTFORMDL 胎に直接粘ついた物が注ぎ込まれる感触に、眠る妹紅の口から甘い啼き声が洩れた	PRINTFORMDL 胎に直接粘ついた物が注ぎ込まれる感触に、眠る妹紅の口から甘い啼き声が洩れた
PRINTFORMDL 体内に限界まで注がれた物に、眠りながらも苦悶を浮かべ荒い息を吐き出している	PRINTFORMDL 体内に限界まで注がれた物に、眠りながらも苦悶を浮かべ荒い息を吐き出している
PRINTFORMDL クリに刺激を受ける度、淫夢に浸る妹紅は、痙攣しながら甘い啼き声を上げている	PRINTFORMDL クリに刺激を受ける度、淫夢に浸る妹紅は、痙攣しながら甘い啼き声を上げている
PRINTFORMDL 直腸を嬲られる感触に、涎を垂らしながら、きゅっと尻たぶを締めて妹紅は達する	PRINTFORMDL 直腸を嬲られる感触に、涎を垂らしながら、きゅっと尻たぶを締めて妹紅は達する
PRINTFORMDL 痛みに体を震わせ、それでも自ら動かない妹紅を、苛出しげな輝夜が見つめている	PRINTFORMDL 痛みに体を震わせ、それでも自ら動かない妹紅を、苛出しげな輝夜が見つめている
PRINTFORMDL 諦めきった表情の妹紅は、みずから尻たぶをひろげ、尻穴に触手を受け入れている	PRINTFORMDL 諦めきった表情の妹紅は、みずから尻たぶをひろげ、尻穴に触手を受け入れている
PRINTFORMDL ローターへ指を伸ばし、深く強く押し付けた妹紅は、舌を突き出して悲鳴を上げた	PRINTFORMDL ローターへ指を伸ばし、深く強く押し付けた妹紅は、舌を突き出して悲鳴を上げた
PRINTFORMDL 触手に竿から亀頭に至るまで、全てを同時に嬲られ、妹紅は涎をこぼし腰を揺らす	PRINTFORMDL 触手に竿から亀頭に至るまで、全てを同時に嬲られ、妹紅は涎をこぼし腰を揺らす
PRINTFORMDL 現状、この迷宮での経験がある重要な戦力の自分が、立ち止まるわけにはいかない	PRINTFORMDL 現状、この迷宮での経験がある重要な戦力の自分が、立ち止まるわけにはいかない
PRINTFORMDW ぽつりと呟き、彼女達を外に運ぶよう頼んで、妹紅は仲間達と迷宮の奧に向かった	PRINTFORMDW ぽつりと呟き、彼女達を外に運ぶよう頼んで、妹紅は仲間達と迷宮の奧に向かった
PRINTFORMDL 以前なら近寄ることさえ憚られたそこは、けれどなにものも止めようとはしなくて	PRINTFORMDL 以前なら近寄ることさえ憚られたそこは、けれどなにものも止めようとはしなくて
PRINTFORMDL 同じように晒された裸身――輝夜にただ服をはぎ取られただけだけど――の下腹部	PRINTFORMDL 同じように晒された裸身――輝夜にただ服をはぎ取られただけだけど――の下腹部
PRINTFORMDW くすくすと笑いながら自慰を始める妹紅に、輝夜は恥ずかしげに視線を逸らした	PRINTFORMDW くすくすと笑いながら自慰を始める妹紅に、輝夜は恥ずかしげに視線を逸らした
PRINTFORMDW 乳首を強調する様に胸に手を添える妹紅を、輝夜がにやりと笑って傍観している	PRINTFORMDW 乳首を強調する様に胸に手を添える妹紅を、輝夜がにやりと笑って傍観している
PRINTFORMDW 頬を朱に染めて体の力を抜く輝夜の秘処に、必死に自身のそれを押し付ける妹紅	PRINTFORMDW 頬を朱に染めて体の力を抜く輝夜の秘処に、必死に自身のそれを押し付ける妹紅
PRINTFORML （このっ！　離れろっ！　はなれろっ！！　なんで言うこと聞かないんだっ！！）	PRINTFORML （このっ！　離れろっ！　はなれろっ！！　なんで言うこと聞かないんだっ！！）
PRINTFORML 「%ARGS:1%もきもちいいよね、私のおちんちん。ほらもっと腰動かして」	PRINTFORML 「%ARGS:1%もきもちいいよね、私のおちんちん。ほらもっと腰動かして」
PRINTFORMDL 硬くしこった淫豆をこすられ、内ももを震わせながらも、妹紅は目を覚まさない	PRINTFORMDL 硬くしこった淫豆をこすられ、内ももを震わせながらも、妹紅は目を覚まさない
PRINTFORMDL くにゅくりゅと膣内をまさぐられ、眠りながらも不快そうな表情を浮かべている	PRINTFORMDL くにゅくりゅと膣内をまさぐられ、眠りながらも不快そうな表情を浮かべている
PRINTFORMDL 胸を揉みたくられて、悲鳴を上げながらも妹紅は輝夜の視界から逃れようとする	PRINTFORMDL 胸を揉みたくられて、悲鳴を上げながらも妹紅は輝夜の視界から逃れようとする
PRINTFORMDL そっと、肉莢からむき出した秘豆を軽く擦った瞬間、全身を大きく震わせる妹紅	PRINTFORMDL そっと、肉莢からむき出した秘豆を軽く擦った瞬間、全身を大きく震わせる妹紅
PRINTFORML 「んくっ！　きもちいいっっ！　胸の先っぽ、あふっっ！　ひぁあああっっ！！」	PRINTFORML 「んくっ！　きもちいいっっ！　胸の先っぽ、あふっっ！　ひぁあああっっ！！」
PRINTFORMDL そう思っていたのに、輝夜の帰りを待ちわびている己を、妹紅は一人あざ笑った	PRINTFORMDL そう思っていたのに、輝夜の帰りを待ちわびている己を、妹紅は一人あざ笑った
PRINTFORMDW ……最近、輝夜の視線に媚びが浮かぶけれど、慕情などあり得ないと思い込んだ	PRINTFORMDW ……最近、輝夜の視線に媚びが浮かぶけれど、慕情などあり得ないと思い込んだ
PRINTFORMW 「乳首、吸って、舐めて、噛んで、擦って……、慧音、お願い、けいねぇ……」	PRINTFORMW 「乳首、吸って、舐めて、噛んで、擦って……、慧音、お願い、けいねぇ……」
PRINTFORMW 「ちくび、あついの、ぴんぴんでかゆいのぉ、お願いもっと、もっとしてよぉ」	PRINTFORMW 「ちくび、あついの、ぴんぴんでかゆいのぉ、お願いもっと、もっとしてよぉ」
PRINTFORMDW 口の端から涎をこぼし、擬根を突き出す妹紅に、輝夜が生唾を飲み込んでいる	PRINTFORMDW 口の端から涎をこぼし、擬根を突き出す妹紅に、輝夜が生唾を飲み込んでいる
PRINTFORMDW 虚ろな瞳の妹紅が触手に唇を押し付けるのを、羨ましげに輝夜が見つめている	PRINTFORMDW 虚ろな瞳の妹紅が触手に唇を押し付けるのを、羨ましげに輝夜が見つめている
PRINTFORMW 「慧音すきなの、すきだからいいよね。おまんこ擦って、慧音もうごいてよぉ」	PRINTFORMW 「慧音すきなの、すきだからいいよね。おまんこ擦って、慧音もうごいてよぉ」
PRINTFORMW 「慧音、お願い慧音もきもちよくなって、おまんここすれて、気持ちいいよぉ」	PRINTFORMW 「慧音、お願い慧音もきもちよくなって、おまんここすれて、気持ちいいよぉ」
PRINTFORMDW 戸惑いに身を固くする慧音に、蕩けた瞳で囁きながら妹紅は腰を動かし始めた	PRINTFORMDW 戸惑いに身を固くする慧音に、蕩けた瞳で囁きながら妹紅は腰を動かし始めた
PRINTFORMDL 肌に跡が残る程の攻撃に、苦痛に表情を歪めるも、妹紅の眼は開こうとしない	PRINTFORMDL 肌に跡が残る程の攻撃に、苦痛に表情を歪めるも、妹紅の眼は開こうとしない
PRINTFORMDL ずるりと腸内を蹂躙される感触に、眠りながらも妹紅は尻穴をキュッと締めた	PRINTFORMDL ずるりと腸内を蹂躙される感触に、眠りながらも妹紅は尻穴をキュッと締めた
PRINTFORMDL ぬめりとしたものに呑まれる感触に、眠りながらも苦しそうな声を上げる妹紅	PRINTFORMDL ぬめりとしたものに呑まれる感触に、眠りながらも苦しそうな声を上げる妹紅
PRINTFORMDL 胎を使われている事で、悪夢を見ているらしい妹紅の口から悲鳴が零れている	PRINTFORMDL 胎を使われている事で、悪夢を見ているらしい妹紅の口から悲鳴が零れている
PRINTFORMDL びくんっと、大きく全身を痙攣させ、妹紅が腰を前後にカクカクと振っている	PRINTFORMDL びくんっと、大きく全身を痙攣させ、妹紅が腰を前後にカクカクと振っている
PRINTFORMDL 輝夜がもの問いたげな表情を向けてくるが、妹紅は諦めを浮かべ身動きしない	PRINTFORMDL 輝夜がもの問いたげな表情を向けてくるが、妹紅は諦めを浮かべ身動きしない
PRINTFORMDL だらしなく口を開き、妹紅は涎をこぼしながら秘豆への愛撫を受け入れている	PRINTFORMDL だらしなく口を開き、妹紅は涎をこぼしながら秘豆への愛撫を受け入れている
PRINTFORML 「っ！　あふっ！！　くっ、見るな、輝夜！　見ないでっ、ふあぁあっっ！！」	PRINTFORML 「っ！　あふっ！！　くっ、見るな、輝夜！　見ないでっ、ふあぁあっっ！！」
PRINTFORMDL 尻穴をいじくられ、快楽に染まりながらも、妹紅は輝夜から身を隠そうとする	PRINTFORMDL 尻穴をいじくられ、快楽に染まりながらも、妹紅は輝夜から身を隠そうとする
PRINTFORMDL 秘豆から駆け上がるあまりにも強い快感に、妹紅は涎を垂らしながら泣き叫ぶ	PRINTFORMDL 秘豆から駆け上がるあまりにも強い快感に、妹紅は涎を垂らしながら泣き叫ぶ
PRINTFORML 「くぅっっ！　この、そんなとこ、触るなっっ！　やめろ、やめ、あひんっ！」	PRINTFORML 「くぅっっ！　この、そんなとこ、触るなっっ！　やめろ、やめ、あひんっ！」
PRINTFORMDL 最奥に精を放たれ、びくりと肩を震わせた妹紅は、諦めの笑みを浮かべている	PRINTFORMDL 最奥に精を放たれ、びくりと肩を震わせた妹紅は、諦めの笑みを浮かべている
PRINTFORML 「ひんっ！？　や、熱い熱い熱いぃぃっっ！！　体熱くて、止められない！！」	PRINTFORML 「ひんっ！？　や、熱い熱い熱いぃぃっっ！！　体熱くて、止められない！！」
PRINTFORMDL 自分で出来ると言おうとした妹紅に、二人が泣き出しそうな眼で見つめてくる	PRINTFORMDL 自分で出来ると言おうとした妹紅に、二人が泣き出しそうな眼で見つめてくる
PRINTFORMDW 傾城の美姫を馬鹿にするなと文句を言いつつ、妹紅を睨んだ輝夜が服を着た	PRINTFORMDW 傾城の美姫を馬鹿にするなと文句を言いつつ、妹紅を睨んだ輝夜が服を着た
PRINTFORMDW にやりと笑いながら投げつける妹紅に、訝りながら輝夜がそれを飲み下した	PRINTFORMDW にやりと笑いながら投げつける妹紅に、訝りながら輝夜がそれを飲み下した
PRINTFORML 「ん、ふふ、そんなにみたいなら見せてあげる。ううん、一緒にしようよ？」	PRINTFORML 「ん、ふふ、そんなにみたいなら見せてあげる。ううん、一緒にしようよ？」
PRINTFORMW 「おっぱいさわって……、慧音でもいいの、お願い、おねがいだからぁ……」	PRINTFORMW 「おっぱいさわって……、慧音でもいいの、お願い、おねがいだからぁ……」
PRINTFORMDW 妹紅が有りもしない竹竿を握る姿勢に、輝夜が混乱した表情を浮かべている	PRINTFORMDW 妹紅が有りもしない竹竿を握る姿勢に、輝夜が混乱した表情を浮かべている
PRINTFORMDW おままごとのように見えない鍋を掻き回す妹紅を、輝夜は呆然と眺めている	PRINTFORMDW おままごとのように見えない鍋を掻き回す妹紅を、輝夜は呆然と眺めている
PRINTFORMDW 遠慮すると囁きながらも、輝夜は嬉しそうな笑みを浮かべ体から力を抜いた	PRINTFORMDW 遠慮すると囁きながらも、輝夜は嬉しそうな笑みを浮かべ体から力を抜いた
PRINTFORMDW 甘えるように囁きながら腰を振り始める妹紅に、慧音は僅かに身をよじった	PRINTFORMDW 甘えるように囁きながら腰を振り始める妹紅に、慧音は僅かに身をよじった
PRINTFORMDW 完全に蕩けきった表情を浮かべ腰を揺らす妹紅を、慧音はそっと抱き締めた	PRINTFORMDW 完全に蕩けきった表情を浮かべ腰を揺らす妹紅を、慧音はそっと抱き締めた
PRINTFORMDW 擬根に感じる膣腔の感覚に、笑みを浮かべた妹紅は輝夜に口づけを落とした	PRINTFORMDW 擬根に感じる膣腔の感覚に、笑みを浮かべた妹紅は輝夜に口づけを落とした
PRINTFORMDL 体中に巻き付いてくる触手に、眉を顰める妹紅の眠りは、まだ破れていない	PRINTFORMDL 体中に巻き付いてくる触手に、眉を顰める妹紅の眠りは、まだ破れていない
PRINTFORMDL びくびくと震える触手の感触に、瞼を閉ざした妹紅は全身を痙攣させている	PRINTFORMDL びくびくと震える触手の感触に、瞼を閉ざした妹紅は全身を痙攣させている
PRINTFORMDL 根元から頂きまで乳房を覆い尽くされ、蹂躙される妹紅はそのまま絶頂する	PRINTFORMDL 根元から頂きまで乳房を覆い尽くされ、蹂躙される妹紅はそのまま絶頂する
PRINTFORMDL 自ら感じるように乳房を突き出しながら、眠る妹紅は体を震わせ達している	PRINTFORMDL 自ら感じるように乳房を突き出しながら、眠る妹紅は体を震わせ達している
PRINTFORMDL 乳首を弄られ、渧泣を上げる妹紅に、輝夜が沈痛そうな表情を浮かべている	PRINTFORMDL 乳首を弄られ、渧泣を上げる妹紅に、輝夜が沈痛そうな表情を浮かべている
PRINTFORMDL 自ら肉莢を剥いて秘豆を晒す妹紅に、輝夜が噛み付きそうな表情を浮かべる	PRINTFORMDL 自ら肉莢を剥いて秘豆を晒す妹紅に、輝夜が噛み付きそうな表情を浮かべる
PRINTFORMDL そんな様子に気付いてないふりをして、妹紅は腰を振って秘豆を擦りつけた	PRINTFORMDL そんな様子に気付いてないふりをして、妹紅は腰を振って秘豆を擦りつけた
PRINTFORMDL 輝夜の怒りのこもった視線にも気付かず、ただひたすら妹紅は快楽に耽った	PRINTFORMDL 輝夜の怒りのこもった視線にも気付かず、ただひたすら妹紅は快楽に耽った
PRINTFORMDL 垣間見える妹紅の肌を見て、輝夜が綺麗と訳のわからないことを言っている	PRINTFORMDL 垣間見える妹紅の肌を見て、輝夜が綺麗と訳のわからないことを言っている
PRINTFORML 「ふぁっ！　ひんっ！　このっ！　先っぽばかりっ！　っ！　バカ見るな！」	PRINTFORML 「ふぁっ！　ひんっ！　このっ！　先っぽばかりっ！　っ！　バカ見るな！」
PRINTFORML 「や、お尻っ！？　んくっ！　なんでこんな、あひんっふぁぁあああっっ！！	PRINTFORML 「や、お尻っ！？　んくっ！　なんでこんな、あひんっふぁぁあああっっ！！
PRINTFORML 「やめろって！　私を食ったって不老不死になんて、なれないのにっっ！！」	PRINTFORML 「やめろって！　私を食ったって不老不死になんて、なれないのにっっ！！」
PRINTFORML 「く……、中きもち、いい……！？　こ、このっ！　離せはなれろっっ！！」	PRINTFORML 「く……、中きもち、いい……！？　こ、このっ！　離せはなれろっっ！！」
PRINTFORMDL 硬くいきりたつ乳首を軽く指で挟み、妹紅は虚ろな表情で身を震わせている	PRINTFORMDL 硬くいきりたつ乳首を軽く指で挟み、妹紅は虚ろな表情で身を震わせている
PRINTFORMDL つぷりと肛腔へと指を突き入れ、掻き回しながら妹紅は悦楽の悲鳴を上げた	PRINTFORMDL つぷりと肛腔へと指を突き入れ、掻き回しながら妹紅は悦楽の悲鳴を上げた
PRINTFORML 「ダメ！　ダメダメダメ！　お尻でなんてっ！　だめえええっっっっっ！！」	PRINTFORML 「ダメ！　ダメダメダメ！　お尻でなんてっ！　だめえええっっっっっ！！」
PRINTFORMDL びくびくと体を震わせ、菊座で絶頂した妹紅の頬を涙が一筋伝い落ちている	PRINTFORMDL びくびくと体を震わせ、菊座で絶頂した妹紅の頬を涙が一筋伝い落ちている
PRINTFORMW 「お前、蓬莱人なんだろ？　この程度のことで、なんで簡単に壊れるんだよ」	PRINTFORMW 「お前、蓬莱人なんだろ？　この程度のことで、なんで簡単に壊れるんだよ」
PRINTFORMDL 消えたままの迷宮、なれど幾度となく取り込まれていく、消えていく少女達	PRINTFORMDL 消えたままの迷宮、なれど幾度となく取り込まれていく、消えていく少女達
PRINTFORMDL そう言いたくても、反論は許さないと瞳で語る輝夜に、妹紅は視線を下ろす	PRINTFORMDL そう言いたくても、反論は許さないと瞳で語る輝夜に、妹紅は視線を下ろす
PRINTFORMDL その言葉に、二人がクスクス笑い、いきなり見せつけるようにキスを始める	PRINTFORMDL その言葉に、二人がクスクス笑い、いきなり見せつけるようにキスを始める
PRINTFORMDW 触手の攻めを躱そうとする妹紅に、輝夜が生ぬるい声援を投げかけてきた	PRINTFORMDW 触手の攻めを躱そうとする妹紅に、輝夜が生ぬるい声援を投げかけてきた
PRINTFORML 「んっ……乳首ピンピンになってるの、お願い吸って、こりこりしてよぉ」	PRINTFORML 「んっ……乳首ピンピンになってるの、お願い吸って、こりこりしてよぉ」
PRINTFORMDW 口の端から涎をこぼし腰を突き出す妹紅に、自分がしてあげると囁く輝夜	PRINTFORMDW 口の端から涎をこぼし腰を突き出す妹紅に、自分がしてあげると囁く輝夜
PRINTFORML 「はーはー、おまんこ切ないの、おねがい輝夜、一緒に気持ち良くなって」	PRINTFORML 「はーはー、おまんこ切ないの、おねがい輝夜、一緒に気持ち良くなって」
PRINTFORMDL 秘豆を擦り立てられて、眠りながらもかくかくと腰を前後に揺らし始めた	PRINTFORMDL 秘豆を擦り立てられて、眠りながらもかくかくと腰を前後に揺らし始めた
PRINTFORMDL ぐりゅんと、最奥を突き上げられて、妹紅は眠りながらも息を荒げている	PRINTFORMDL ぐりゅんと、最奥を突き上げられて、妹紅は眠りながらも息を荒げている
PRINTFORMDL 眠りながらも、尻を左右に振り、尻穴をぎゅっと締め付けて妹紅は達した	PRINTFORMDL 眠りながらも、尻を左右に振り、尻穴をぎゅっと締め付けて妹紅は達した
PRINTFORMDL そして、眠りながらも大きな声を上げて、妹紅は潮吹きしながら絶頂した	PRINTFORMDL そして、眠りながらも大きな声を上げて、妹紅は潮吹きしながら絶頂した
PRINTFORMDL うっとりとした表情で、妹紅は触手の間に擬根を突き込み腰を振っている	PRINTFORMDL うっとりとした表情で、妹紅は触手の間に擬根を突き込み腰を振っている
PRINTFORMDL だらしない表情で悦楽を貪る妹紅に、輝夜が哀しげな表情を浮かべている	PRINTFORMDL だらしない表情で悦楽を貪る妹紅に、輝夜が哀しげな表情を浮かべている
PRINTFORMDL 顔を赤らめて見つめてくる輝夜を、気にする余裕もなく渧泣を上げ続けた	PRINTFORMDL 顔を赤らめて見つめてくる輝夜を、気にする余裕もなく渧泣を上げ続けた
PRINTFORMDL 秘処の上へと手を伸ばし、くにくにと弄り始める妹紅に、表情は見えない	PRINTFORMDL 秘処の上へと手を伸ばし、くにくにと弄り始める妹紅に、表情は見えない
PRINTFORMDL ローターがクリトリスに触れると同時、妹紅は身も世もない悲鳴を上げた	PRINTFORMDL ローターがクリトリスに触れると同時、妹紅は身も世もない悲鳴を上げた
PRINTFORML 「んくっ、ふぁっ！　くっ、やめ、ろ。そこはダメっ！　んくぅっっ！！」	PRINTFORML 「んくっ、ふぁっ！　くっ、やめ、ろ。そこはダメっ！　んくぅっっ！！」
PRINTFORMDL もう一度頭を蹴って、それでもピクリとも動かない輝夜の隣に腰を下ろす	PRINTFORMDL もう一度頭を蹴って、それでもピクリとも動かない輝夜の隣に腰を下ろす
PRINTFORMDL どんどん寂しくなっていく幻想郷、もはや住人もさほどの数が居ない状況	PRINTFORMDL どんどん寂しくなっていく幻想郷、もはや住人もさほどの数が居ない状況
PRINTFORMDL 止められるほどのものは居なくなっていて、妹紅は小さく溜め息を吐いた	PRINTFORMDL 止められるほどのものは居なくなっていて、妹紅は小さく溜め息を吐いた
PRINTFORMDW 今更そのことを思い知らされて、けれど、もはやそれを救う術など無くて	PRINTFORMDW 今更そのことを思い知らされて、けれど、もはやそれを救う術など無くて
PRINTFORMDW 身を守る事を優先する妹紅を、輝夜は小馬鹿にした表情で見つめている	PRINTFORMDW 身を守る事を優先する妹紅を、輝夜は小馬鹿にした表情で見つめている
PRINTFORMDW 同じパーティーでしょとニヤニヤ笑う輝夜に、ただ溜め息だけをついた	PRINTFORMDW 同じパーティーでしょとニヤニヤ笑う輝夜に、ただ溜め息だけをついた
PRINTFORMDW 前に出ながら呟く妹紅に、深窓の姫君に無茶言わないでと苦笑する輝夜	PRINTFORMDW 前に出ながら呟く妹紅に、深窓の姫君に無茶言わないでと苦笑する輝夜
PRINTFORMDW 自分の事を棚に上げるなと文句を言いつつ、輝夜が身構えるのが見えた	PRINTFORMDW 自分の事を棚に上げるなと文句を言いつつ、輝夜が身構えるのが見えた
PRINTFORMDW 妹紅の手が僅かにのぞきまた、飲み込まれる光景に輝夜が顔色を変える	PRINTFORMDW 妹紅の手が僅かにのぞきまた、飲み込まれる光景に輝夜が顔色を変える
PRINTFORMDL 同じように触手に嬲られている輝夜が、諦念に染まった笑みを浮かべる	PRINTFORMDL 同じように触手に嬲られている輝夜が、諦念に染まった笑みを浮かべる
PRINTFORMDW ぴくぴくと体を震わせ何もしない妹紅に、輝夜が戸惑いを浮かべている	PRINTFORMDW ぴくぴくと体を震わせ何もしない妹紅に、輝夜が戸惑いを浮かべている
PRINTFORMDW 悦楽に身を任せ、身動きしない妹紅を、唇を噛んだ輝夜が見つめている	PRINTFORMDW 悦楽に身を任せ、身動きしない妹紅を、唇を噛んだ輝夜が見つめている
PRINTFORMDW 疲れた表情で何もしない妹紅に、輝夜が不思議そうな視線を向けてくる	PRINTFORMDW 疲れた表情で何もしない妹紅に、輝夜が不思議そうな視線を向けてくる
PRINTFORML 「慧音、慧音、慧音ぇ、全部、全部見せてあげるから、慧音も見せてよ」	PRINTFORML 「慧音、慧音、慧音ぇ、全部、全部見せてあげるから、慧音も見せてよ」
PRINTFORMW （慧音の……、って違うっ！　そんなこと言ってる場合じゃないのに！）	PRINTFORMW （慧音の……、って違うっ！　そんなこと言ってる場合じゃないのに！）
PRINTFORMDW 自ら尻たぶを割り開き、尻穴をさらけ出す妹紅に、頬を朱に染める輝夜	PRINTFORMDW 自ら尻たぶを割り開き、尻穴をさらけ出す妹紅に、頬を朱に染める輝夜
PRINTFORMDW 弱音を吐きながら、愛撫を待つ妹紅を、輝夜は羨ましげに見つめている	PRINTFORMDW 弱音を吐きながら、愛撫を待つ妹紅を、輝夜は羨ましげに見つめている
PRINTFORMW （天井しかない、天井しかないのに、なんでそんな風に思うんだっ！？）	PRINTFORMW （天井しかない、天井しかないのに、なんでそんな風に思うんだっ！？）
PRINTFORMDL くにくりと乳房の先端を刺激され、眠る妹紅の息が激しさを増していく	PRINTFORMDL くにくりと乳房の先端を刺激され、眠る妹紅の息が激しさを増していく
PRINTFORMDL 最も敏感な場所を攻められ、眠る妹紅の口から渧泣と涎がこぼれ落ちた	PRINTFORMDL 最も敏感な場所を攻められ、眠る妹紅の口から渧泣と涎がこぼれ落ちた
PRINTFORMDL 眠る妹紅は、肉の隘路を割り広げられる感覚に、軽く体を震わせている	PRINTFORMDL 眠る妹紅は、肉の隘路を割り広げられる感覚に、軽く体を震わせている
PRINTFORMDL 強烈な肛虐に、びくびくと全身を震わせ、妹紅は頂きに押し上げられた	PRINTFORMDL 強烈な肛虐に、びくびくと全身を震わせ、妹紅は頂きに押し上げられた
PRINTFORMDL 痛みを感じそうなほどの刺激に、涎と渧泣を漏らしながら妹紅はイッた	PRINTFORMDL 痛みを感じそうなほどの刺激に、涎と渧泣を漏らしながら妹紅はイッた
PRINTFORMDL 根元から先端まで絡みついた触手が動く度、妹紅は甘い啼き声を上げる	PRINTFORMDL 根元から先端まで絡みついた触手が動く度、妹紅は甘い啼き声を上げる
PRINTFORMDL 乳首を刺激され渧泣を上げる妹紅は、笑みを浮かべる輝夜を睨み付ける	PRINTFORMDL 乳首を刺激され渧泣を上げる妹紅は、笑みを浮かべる輝夜を睨み付ける
PRINTFORMDL 輝夜の目が、ずっぽりと触手をくわえ込んだ膣口に釘付けにされている	PRINTFORMDL 輝夜の目が、ずっぽりと触手をくわえ込んだ膣口に釘付けにされている
PRINTFORML 「あふ、んくっっ胸触るなぁっっ！　ひぁっっ！　や、先っぽやめ、て」	PRINTFORML 「あふ、んくっっ胸触るなぁっっ！　ひぁっっ！　や、先っぽやめ、て」
PRINTFORML 「や、やあ……おしり、……きもちい、い？　っっ！？　何してる！！」	PRINTFORML 「や、やあ……おしり、……きもちい、い？　っっ！？　何してる！！」
PRINTFORML 「ん、やぁ……そこ、や……んっ……、っ！？　くっ、ふざけないでよ」	PRINTFORML 「ん、やぁ……そこ、や……んっ……、っ！？　くっ、ふざけないでよ」
PRINTFORMDL 視線をあらぬ方にむけたまま、擬根をこしゅこしゅとこすりたてる妹紅	PRINTFORMDL 視線をあらぬ方にむけたまま、擬根をこしゅこしゅとこすりたてる妹紅
PRINTFORMDL 快楽に蕩けきった妹紅は、ひたすらオナホに擬根をツッコミ喘いでいる	PRINTFORMDL 快楽に蕩けきった妹紅は、ひたすらオナホに擬根をツッコミ喘いでいる
PRINTFORMDL クリトリスを擦る妹紅は、強すぎる快感に口の端から涎をこぼしている	PRINTFORMDL クリトリスを擦る妹紅は、強すぎる快感に口の端から涎をこぼしている
PRINTFORMDL 全力を込めて巻き上がる炎は、弾幕ごっこでやる程度の威力のないもの	PRINTFORMDL 全力を込めて巻き上がる炎は、弾幕ごっこでやる程度の威力のないもの
PRINTFORML 「お前は……、お前を殺すのは私だろ……、お前だって私を殺すんだろ」	PRINTFORML 「お前は……、お前を殺すのは私だろ……、お前だって私を殺すんだろ」
PRINTFORMDW 深い溜め息をついた妹紅は、それでも抱き付いてくる二人に身を任せる	PRINTFORMDW 深い溜め息をついた妹紅は、それでも抱き付いてくる二人に身を任せる
PRINTFORMDW 妹紅の言葉に、顔を赤くして文句を言いながら輝夜が服を手早く纏う	PRINTFORMDW 妹紅の言葉に、顔を赤くして文句を言いながら輝夜が服を手早く纏う
PRINTFORMDW 文句を言いながら体から力を抜く妹紅に、輝夜が笑みを浮かべている	PRINTFORMDW 文句を言いながら体から力を抜く妹紅に、輝夜が笑みを浮かべている
PRINTFORMW 「……えーと、あ、アレしないと……、えーと、アレ？　なんだっけ」	PRINTFORMW 「……えーと、あ、アレしないと……、えーと、アレ？　なんだっけ」
PRINTFORMDW 背後からのしかかり耳元で囁く妹紅に、輝夜は顔を真っ赤にしている	PRINTFORMDW 背後からのしかかり耳元で囁く妹紅に、輝夜は顔を真っ赤にしている
PRINTFORMW 「%ARGS:1%のおまんこ、おつゆ一杯だね、そんなに欲しい？」	PRINTFORMW 「%ARGS:1%のおまんこ、おつゆ一杯だね、そんなに欲しい？」
PRINTFORML （違うっ！　こんなこと、したくないっ！　したくないのにっっ！！）	PRINTFORML （違うっ！　こんなこと、したくないっ！　したくないのにっっ！！）
PRINTFORMDL 打撃を受けても眼を覚まさない妹紅に、輝夜が戸惑いを浮かべている	PRINTFORMDL 打撃を受けても眼を覚まさない妹紅に、輝夜が戸惑いを浮かべている
PRINTFORMDL 痛烈な打撃に、それでも深い眠りに身を委ねる妹紅は目を覚まさない	PRINTFORMDL 痛烈な打撃に、それでも深い眠りに身を委ねる妹紅は目を覚まさない
PRINTFORMDL 睨む輝夜から視線を逸らして、妹紅はみずからしりたぶを割り広げた	PRINTFORMDL 睨む輝夜から視線を逸らして、妹紅はみずからしりたぶを割り広げた
PRINTFORMDL 欠片も抗う意志を見せない妹紅に、触手が激しさをまして乳房を嬲る	PRINTFORMDL 欠片も抗う意志を見せない妹紅に、触手が激しさをまして乳房を嬲る
PRINTFORML 「あふんっ！　んきゅっ、や、こんなところで、気持ち良くなんてぇ」	PRINTFORML 「あふんっ！　んきゅっ、や、こんなところで、気持ち良くなんてぇ」
PRINTFORML 「ひぁんっ！　だめ、お尻やめてっ！　みな、ひんっっ！　んくっ！」	PRINTFORML 「ひぁんっ！　だめ、お尻やめてっ！　みな、ひんっっ！　んくっ！」
PRINTFORMDL こりっとした秘豆を指で擦り、妹紅は無表情のまま時折荒い息を吐く	PRINTFORMDL こりっとした秘豆を指で擦り、妹紅は無表情のまま時折荒い息を吐く
PRINTFORMDL 妹紅は悦楽に濁った瞳で、敏感な先端と柔らかな膨らみを揉みしだく	PRINTFORMDL 妹紅は悦楽に濁った瞳で、敏感な先端と柔らかな膨らみを揉みしだく
PRINTFORMDL 甘い啼き声を上げながら、全身を震わせ妹紅は快感に声を上げている	PRINTFORMDL 甘い啼き声を上げながら、全身を震わせ妹紅は快感に声を上げている
PRINTFORMDL 頬を緩ませ、ぎゅっとクリトリスをつまむ妹紅は全身を震わせている	PRINTFORMDL 頬を緩ませ、ぎゅっとクリトリスをつまむ妹紅は全身を震わせている
PRINTFORMDL 触手の作り出した穴に、自ら腰を振って妹紅は肉棒を突き込んでいく	PRINTFORMDL 触手の作り出した穴に、自ら腰を振って妹紅は肉棒を突き込んでいく
PRINTFORMDL さらに、妹紅の抵抗を阻むように、輝夜の手が秘処を撫で上げてきた	PRINTFORMDL さらに、妹紅の抵抗を阻むように、輝夜の手が秘処を撫で上げてきた
PRINTFORMDW かがみ込みただ身を守る妹紅を、いたわしげに輝夜が見つめている	PRINTFORMDW かがみ込みただ身を守る妹紅を、いたわしげに輝夜が見つめている
PRINTFORMDW そんな厭味に唇を尖らせて、口に含んだクスリを輝夜は飲み下した	PRINTFORMDW そんな厭味に唇を尖らせて、口に含んだクスリを輝夜は飲み下した
PRINTFORMDW 大丈夫かと目で問い掛けてくる慧音に、妹紅は辛さを隠して頷いた	PRINTFORMDW 大丈夫かと目で問い掛けてくる慧音に、妹紅は辛さを隠して頷いた
PRINTFORMW 「ん、気持ち良くなりたいな。一人でやるの、少しつまらないけど」	PRINTFORMW 「ん、気持ち良くなりたいな。一人でやるの、少しつまらないけど」
PRINTFORML 「輝夜、んっ……、輝夜がしてくれないから、やってるんだからね」	PRINTFORML 「輝夜、んっ……、輝夜がしてくれないから、やってるんだからね」
PRINTFORMDW 体を揺すり乳房を揺らす妹紅を、輝夜は不愉快そうに見つめている	PRINTFORMDW 体を揺すり乳房を揺らす妹紅を、輝夜は不愉快そうに見つめている
PRINTFORMDW 僅かに頬を染める妹紅に、輝夜が不機嫌そうな表情を浮かべている	PRINTFORMDW 僅かに頬を染める妹紅に、輝夜が不機嫌そうな表情を浮かべている
PRINTFORML 「ん、ふふ、こんなのが好きなんだ？　いいよ、もっとしてあげる」	PRINTFORML 「ん、ふふ、こんなのが好きなんだ？　いいよ、もっとしてあげる」
PRINTFORMDW 地面に生える触手を見ながらの妹紅の呟きに、輝夜が青ざめている	PRINTFORMDW 地面に生える触手を見ながらの妹紅の呟きに、輝夜が青ざめている
PRINTFORMW （いやだっ！　こんなの私のすることじゃないだろっ！　くそっ！）	PRINTFORMW （いやだっ！　こんなの私のすることじゃないだろっ！　くそっ！）
PRINTFORMDW 戸惑いで動けない輝夜に、固くそそり立った擬根を押し付ける妹紅	PRINTFORMDW 戸惑いで動けない輝夜に、固くそそり立った擬根を押し付ける妹紅
PRINTFORML 「ふふ、輝夜のおまんこ、気持ちいいよ。私のおちんちんはどう？」	PRINTFORML 「ふふ、輝夜のおまんこ、気持ちいいよ。私のおちんちんはどう？」
PRINTFORML 「慧音のおまんこ気持ちいいよ、私のおちんちんも気持ちいいよね」	PRINTFORML 「慧音のおまんこ気持ちいいよ、私のおちんちんも気持ちいいよね」
PRINTFORMDL 眠りに陥っている妹紅は、服が破かれていくことに気付いていない	PRINTFORMDL 眠りに陥っている妹紅は、服が破かれていくことに気付いていない
PRINTFORMDL 眠る妹紅は、激しい肛虐に身を震わせて、甘い吐息を漏らしている	PRINTFORMDL 眠る妹紅は、激しい肛虐に身を震わせて、甘い吐息を漏らしている
PRINTFORMDL ずちゅぬちゅと膣内を擦り立てられ、眠る妹紅の眉間に皺がよった	PRINTFORMDL ずちゅぬちゅと膣内を擦り立てられ、眠る妹紅の眉間に皺がよった
PRINTFORMDL 胎の中に入り込み、縦横に暴れる幼体に、眠る妹紅は苦悶している	PRINTFORMDL 胎の中に入り込み、縦横に暴れる幼体に、眠る妹紅は苦悶している
PRINTFORMDL 時折息をせわしくしながらも、妹紅は肛虐に目を覚ます様子はない	PRINTFORMDL 時折息をせわしくしながらも、妹紅は肛虐に目を覚ます様子はない
PRINTFORMDL 触手が蠢く度、ぴくぴくと太ももを震わせ、自ら腰を突き出す妹紅	PRINTFORMDL 触手が蠢く度、ぴくぴくと太ももを震わせ、自ら腰を突き出す妹紅
PRINTFORMDL 全く抵抗しない妹紅に、菊座を攻める触手が喜々として貫いてくる	PRINTFORMDL 全く抵抗しない妹紅に、菊座を攻める触手が喜々として貫いてくる
PRINTFORMDL 触手が激しく動く度、自ら腰を揺らし妹紅は悦楽の悲鳴を漏らした	PRINTFORMDL 触手が激しく動く度、自ら腰を揺らし妹紅は悦楽の悲鳴を漏らした
PRINTFORMDL 妹紅の弱々しい様子に、輝夜の罵詈雑言を装った励声が飛んでくる	PRINTFORMDL 妹紅の弱々しい様子に、輝夜の罵詈雑言を装った励声が飛んでくる
PRINTFORMDL 薄く笑みを浮かべる輝夜に気付いて、隙間から覗く柔肌を隠す妹紅	PRINTFORMDL 薄く笑みを浮かべる輝夜に気付いて、隙間から覗く柔肌を隠す妹紅
PRINTFORMDL 菊座から這い上がる悦楽を噛み締め、妹紅は輝夜から視線を逸らす	PRINTFORMDL 菊座から這い上がる悦楽を噛み締め、妹紅は輝夜から視線を逸らす
PRINTFORMDL 全く相手にされていない輝夜が、呆れたような表情を浮かべている	PRINTFORMDL 全く相手にされていない輝夜が、呆れたような表情を浮かべている
PRINTFORML 「……ん、お尻、むずむずする……っ！？　な、なんでこんなっ！」	PRINTFORML 「……ん、お尻、むずむずする……っ！？　な、なんでこんなっ！」
PRINTFORMDL 欲情に眼を潤ませて、むにむにと胸を揉みながら、瞳を蕩けさせた	PRINTFORMDL 欲情に眼を潤ませて、むにむにと胸を揉みながら、瞳を蕩けさせた
PRINTFORMDL 秘豆に与えられる振動に、靄がかかった瞳で悦楽の声を上げる妹紅	PRINTFORMDL 秘豆に与えられる振動に、靄がかかった瞳で悦楽の声を上げる妹紅
PRINTFORMDL 涎と先走りをだらだらとこぼしながら、喜悦の表情を浮かべる妹紅	PRINTFORMDL 涎と先走りをだらだらとこぼしながら、喜悦の表情を浮かべる妹紅
PRINTFORMDL 呟きながら、膣を抉るバイブの感触に、妹紅は僅かに頬を赤らめる	PRINTFORMDL 呟きながら、膣を抉るバイブの感触に、妹紅は僅かに頬を赤らめる
PRINTFORML 「っっ！？　や、お尻で！　お尻でイくっっ！！　イくぅっっ！！」	PRINTFORML 「っっ！？　や、お尻で！　お尻でイくっっ！！　イくぅっっ！！」
PRINTFORMDL 両の乳房を揉みしだかれ、うつろな表情の妹紅は体を震わせている	PRINTFORMDL 両の乳房を揉みしだかれ、うつろな表情の妹紅は体を震わせている
PRINTFORMDL クリトリスを嬲られる感覚に、妹紅の口の端から涎がこぼれ落ちる	PRINTFORMDL クリトリスを嬲られる感覚に、妹紅の口の端から涎がこぼれ落ちる
PRINTFORMDL もし、輝夜がするのであれば、使いを寄こして存分に吹聴させるか	PRINTFORMDL もし、輝夜がするのであれば、使いを寄こして存分に吹聴させるか
PRINTFORMDL 熱い物が頬を伝い落ちるのを感じながら、妹紅は輝夜を抱き締めた	PRINTFORMDL 熱い物が頬を伝い落ちるのを感じながら、妹紅は輝夜を抱き締めた
PRINTFORML 『ふふ、可愛いわ妹紅。こう言う楽しみ方も覚えてはどうかしら？』	PRINTFORML 『ふふ、可愛いわ妹紅。こう言う楽しみ方も覚えてはどうかしら？』
PRINTFORMDW そう言って渡されたものを、輝夜は小首を傾げながら飲み下した	PRINTFORMDW そう言って渡されたものを、輝夜は小首を傾げながら飲み下した
PRINTFORMDW 心配そうに横目で見つめてくる輝夜には、気付かないふりをした	PRINTFORMDW 心配そうに横目で見つめてくる輝夜には、気付かないふりをした
PRINTFORMDW こちらをちらりと見た慧音が、僅かにほっとした表情を浮かべた	PRINTFORMDW こちらをちらりと見た慧音が、僅かにほっとした表情を浮かべた
PRINTFORMDW びくびくと震えて引き込まれていく妹紅に、輝夜は顔を赤くする	PRINTFORMDW びくびくと震えて引き込まれていく妹紅に、輝夜は顔を赤くする
PRINTFORMW 「慧音のオナニーも、見せてよ。私のだって見せてあげるからさ」	PRINTFORMW 「慧音のオナニーも、見せてよ。私のだって見せてあげるからさ」
PRINTFORMW 「あはぁ、お尻気持ち良くしてぇ……、慧音でも、良いからさぁ」	PRINTFORMW 「あはぁ、お尻気持ち良くしてぇ……、慧音でも、良いからさぁ」
PRINTFORMDW 輝夜が不快そうに眉を顰めるのを尻目に、妹紅は乳房を強調する	PRINTFORMDW 輝夜が不快そうに眉を顰めるのを尻目に、妹紅は乳房を強調する
PRINTFORMDW 腰を振って、擬根を揺らす妹紅に、輝夜はただ顔を赤くしている	PRINTFORMDW 腰を振って、擬根を揺らす妹紅に、輝夜はただ顔を赤くしている
PRINTFORMDW イヤイヤ秘処を晒す妹紅に、なぜか輝夜が生唾を飲み込んでいる	PRINTFORMDW イヤイヤ秘処を晒す妹紅に、なぜか輝夜が生唾を飲み込んでいる
PRINTFORMDW そんな妹紅の呟きに、輝夜がいらだたしげな表情を浮かべている	PRINTFORMDW そんな妹紅の呟きに、輝夜がいらだたしげな表情を浮かべている
PRINTFORMDW 涙目で呟く妹紅を、気に入らないと言いたげな輝夜が睨んでいる	PRINTFORMDW 涙目で呟く妹紅を、気に入らないと言いたげな輝夜が睨んでいる
PRINTFORMW 「ん、可愛いね、こんなことで喜ぶなんて、あ、慧音も混ざる？」	PRINTFORMW 「ん、可愛いね、こんなことで喜ぶなんて、あ、慧音も混ざる？」
PRINTFORMW 「ふふ、ほら、こうすれば良いんだろう？　慧音も一緒にどう？」	PRINTFORMW 「ふふ、ほら、こうすれば良いんだろう？　慧音も一緒にどう？」
PRINTFORML 「そんな体をして誘ってるんだろ、ほらおちんちんいれてやるよ」	PRINTFORML 「そんな体をして誘ってるんだろ、ほらおちんちんいれてやるよ」
PRINTFORMW 「慧音、欲しいよ。慧音の全部、おねがいだから私にちょうだい」	PRINTFORMW 「慧音、欲しいよ。慧音の全部、おねがいだから私にちょうだい」
PRINTFORMDW 甘い声を上げ始める輝夜に、妹紅も舌を突き出しひたすら喘いだ	PRINTFORMDW 甘い声を上げ始める輝夜に、妹紅も舌を突き出しひたすら喘いだ
PRINTFORMDW 頬を朱に染め頷く輝夜に、妹紅は唇を押し付け腰を動かし始めた	PRINTFORMDW 頬を朱に染め頷く輝夜に、妹紅は唇を押し付け腰を動かし始めた
PRINTFORML 「慧音のおまんここすれるの気持ちいい。慧音も気持ちいいよね」	PRINTFORML 「慧音のおまんここすれるの気持ちいい。慧音も気持ちいいよね」
PRINTFORMDL 妹紅は眠ったまま、垣間見える素肌を隠そうと腕を動かしている	PRINTFORMDL 妹紅は眠ったまま、垣間見える素肌を隠そうと腕を動かしている
PRINTFORMDL 菊座を犯される感覚に、妹紅は眠りながら尻をきゅっとすぼめた	PRINTFORMDL 菊座を犯される感覚に、妹紅は眠りながら尻をきゅっとすぼめた
PRINTFORMDL 両の膨らみをこね回され、眠る妹紅の口元から甘い吐息が漏れる	PRINTFORMDL 両の膨らみをこね回され、眠る妹紅の口元から甘い吐息が漏れる
PRINTFORMDL 乳房の頂きを嬲られ、妹紅の口の端から悦楽を示す唾液が零れた	PRINTFORMDL 乳房の頂きを嬲られ、妹紅の口の端から悦楽を示す唾液が零れた
PRINTFORMDL くちゅくちゅと膣口を弄られる感触に、妹紅は眉根を寄せている	PRINTFORMDL くちゅくちゅと膣口を弄られる感触に、妹紅は眉根を寄せている
PRINTFORMDL 膣腔を抉られ不快感を表す妹紅に、輝夜が反撃しろと言い始めた	PRINTFORMDL 膣腔を抉られ不快感を表す妹紅に、輝夜が反撃しろと言い始めた
PRINTFORMDL 痛ましげな輝夜に気付かぬように、妹紅は肛虐に喜悦を浮かべる	PRINTFORMDL 痛ましげな輝夜に気付かぬように、妹紅は肛虐に喜悦を浮かべる
PRINTFORMDL ゴクリと生唾を飲み込み、輝夜がじっとその様子を見つめている	PRINTFORMDL ゴクリと生唾を飲み込み、輝夜がじっとその様子を見つめている
PRINTFORML 「ひんっ！　な、なんで、こんな、半端に優しい、んだよぉ……」	PRINTFORML 「ひんっ！　な、なんで、こんな、半端に優しい、んだよぉ……」
PRINTFORMDL ぼうっとした表情で、妹紅は静かに張り詰めた擬根を擦っている	PRINTFORMDL ぼうっとした表情で、妹紅は静かに張り詰めた擬根を擦っている
PRINTFORMDL 指でしゅにしゅにとアナルを、くすぐる度、妹紅は体を震わせる	PRINTFORMDL 指でしゅにしゅにとアナルを、くすぐる度、妹紅は体を震わせる
PRINTFORMDL くりっと、硬くしこる乳首をつまみ上げ、甘い啼き声を漏らした	PRINTFORMDL くりっと、硬くしこる乳首をつまみ上げ、甘い啼き声を漏らした
PRINTFORMDL ぬちゅぐちゅと抜き差ししながら、妹紅は快楽の吐息を漏らした	PRINTFORMDL ぬちゅぐちゅと抜き差ししながら、妹紅は快楽の吐息を漏らした
PRINTFORMDL 尻穴をほじくられる感覚に、全身を震わせて、妹紅は達している	PRINTFORMDL 尻穴をほじくられる感覚に、全身を震わせて、妹紅は達している
PRINTFORMW 『ふふ、今日は趣向を変えて、こういう事をしてみようと思うの』	PRINTFORMW 『ふふ、今日は趣向を変えて、こういう事をしてみようと思うの』
PRINTFORMDW おそらく、輝夜の力で体の周囲の時間を遅くでもされたのだろう	PRINTFORMDW おそらく、輝夜の力で体の周囲の時間を遅くでもされたのだろう
PRINTFORMDW その言葉に、にっこり笑って輝夜が罵詈雑言を投げつけてきた	PRINTFORMDW その言葉に、にっこり笑って輝夜が罵詈雑言を投げつけてきた
PRINTFORMW 「ん……、オナニー見たいの？　いいよ、見て。慧音も一緒に」	PRINTFORMW 「ん……、オナニー見たいの？　いいよ、見て。慧音も一緒に」
PRINTFORMDW 妹紅の淫猥な仕草を、顔を赤くした輝夜がじっと見つめている	PRINTFORMDW 妹紅の淫猥な仕草を、顔を赤くした輝夜がじっと見つめている
PRINTFORMW 「んっ、おっぱい、おっぱいさわって、おっぱいさわってよぉ」	PRINTFORMW 「んっ、おっぱい、おっぱいさわって、おっぱいさわってよぉ」
PRINTFORMW 「慧音はしなくて良いから。……んっ、乳首弄ってみろってば」	PRINTFORMW 「慧音はしなくて良いから。……んっ、乳首弄ってみろってば」
PRINTFORMDW 輝夜は蕩けた瞳で腰を揺らす妹紅を、羨ましげに見つめている	PRINTFORMDW 輝夜は蕩けた瞳で腰を揺らす妹紅を、羨ましげに見つめている
PRINTFORMW 「慧音に手を出すな……、私にだったら、何をしても良いから」	PRINTFORMW 「慧音に手を出すな……、私にだったら、何をしても良いから」
PRINTFORML 「んくっ……はぁ……ん……、おねがい、気持ち良くして……」	PRINTFORML 「んくっ……はぁ……ん……、おねがい、気持ち良くして……」
PRINTFORMDW 口元に笑みを浮かべる妹紅に、輝夜が僅かに涙を浮かべている	PRINTFORMDW 口元に笑みを浮かべる妹紅に、輝夜が僅かに涙を浮かべている
PRINTFORMDW うつろな表情で呟く妹紅を、輝夜が驚きの表情で見つめている	PRINTFORMDW うつろな表情で呟く妹紅を、輝夜が驚きの表情で見つめている
PRINTFORML （違う、今はそんな事してる場合じゃないのに、なんでこんな）	PRINTFORML （違う、今はそんな事してる場合じゃないのに、なんでこんな）
PRINTFORMW （何言ってるんだ、酒なんてのんでないのに！　慧音助けて！）	PRINTFORMW （何言ってるんだ、酒なんてのんでないのに！　慧音助けて！）
PRINTFORMDW 嬉しげに囁く妹紅に、慧音は困ったように笑みを浮かべている	PRINTFORMDW 嬉しげに囁く妹紅に、慧音は困ったように笑みを浮かべている
PRINTFORMDL クリを嬲られる感触に、内ももを痙攣させ快感を味わっている	PRINTFORMDL クリを嬲られる感触に、内ももを痙攣させ快感を味わっている
PRINTFORMDL 全身に絡んでくる触手に、それでも眠る妹紅は気付いていない	PRINTFORMDL 全身に絡んでくる触手に、それでも眠る妹紅は気付いていない
PRINTFORMDL 眠っている妹紅の手が、自然と己の敏感な場所へと伸びていく	PRINTFORMDL 眠っている妹紅の手が、自然と己の敏感な場所へと伸びていく
PRINTFORMDL ……自分がされることを想像してか、輝夜が頬を赤らめている	PRINTFORMDL ……自分がされることを想像してか、輝夜が頬を赤らめている
PRINTFORMDL 妹紅はみずから胸を突き出し、触手のなすがままになっている	PRINTFORMDL 妹紅はみずから胸を突き出し、触手のなすがままになっている
PRINTFORMDL その事に気付いたのか、触手の擬根を扱く動きが激しくなった	PRINTFORMDL その事に気付いたのか、触手の擬根を扱く動きが激しくなった
PRINTFORMDL 無表情で自ら陰唇を割り開き、妹紅は体内に触手を受け入れた	PRINTFORMDL 無表情で自ら陰唇を割り開き、妹紅は体内に触手を受け入れた
PRINTFORMDL 触手が膣内を抉る度、腰を振りながら妹紅は快楽に耽っている	PRINTFORMDL 触手が膣内を抉る度、腰を振りながら妹紅は快楽に耽っている
PRINTFORML 「ちっっ！　この、そんなとこ、嬲って、どうする気っっ！！」	PRINTFORML 「ちっっ！　この、そんなとこ、嬲って、どうする気っっ！！」
PRINTFORMDL 自身の唾液で濡らした指で、くむくむと自身の菊座を弄る妹紅	PRINTFORMDL 自身の唾液で濡らした指で、くむくむと自身の菊座を弄る妹紅
PRINTFORMDL ずぷんと、アヌスへと指を突き込み、妹紅は快楽を貪っている	PRINTFORMDL ずぷんと、アヌスへと指を突き込み、妹紅は快楽を貪っている
PRINTFORMDL 舌を突き出し涎をこぼしながら、妹紅が激しく腰を振っている	PRINTFORMDL 舌を突き出し涎をこぼしながら、妹紅が激しく腰を振っている
PRINTFORMDL 妹紅が握り締める擬根は、固く張り詰めびくびくと震えている	PRINTFORMDL 妹紅が握り締める擬根は、固く張り詰めびくびくと震えている
PRINTFORMDL 指を動かし続けて、妹紅はぬるま湯のような快楽に耽っている	PRINTFORMDL 指を動かし続けて、妹紅はぬるま湯のような快楽に耽っている
PRINTFORML 「なんで、私を逃がして、なのに、お前は……お前はっっ！！」	PRINTFORML 「なんで、私を逃がして、なのに、お前は……お前はっっ！！」
PRINTFORMDW けれど、本当なら蓬莱人である自分が残った方が良かったのに	PRINTFORMDW けれど、本当なら蓬莱人である自分が残った方が良かったのに
PRINTFORMDL そして、ただ互いの欲情を発散させるためだけの行為を始める	PRINTFORMDL そして、ただ互いの欲情を発散させるためだけの行為を始める
PRINTFORML 『ふふ、今日くらいはいいでしょ。あそこでの遊びを続けても』	PRINTFORML 『ふふ、今日くらいはいいでしょ。あそこでの遊びを続けても』
PRINTFORMDW ニヤニヤ笑う輝夜に言葉を投げつけ、妹紅は身を守っている	PRINTFORMDW ニヤニヤ笑う輝夜に言葉を投げつけ、妹紅は身を守っている
PRINTFORMDW 厭味を乗せた言葉に、くすりと笑いながら輝夜が受け取った	PRINTFORMDW 厭味を乗せた言葉に、くすりと笑いながら輝夜が受け取った
PRINTFORMDW 顔を赤くして文句を言いながら、輝夜がクスリを飲み込んだ	PRINTFORMDW 顔を赤くして文句を言いながら、輝夜がクスリを飲み込んだ
PRINTFORMDW イヤそうな表情の妹紅と裏腹に、輝夜が頬を朱に染めている	PRINTFORMDW イヤそうな表情の妹紅と裏腹に、輝夜が頬を朱に染めている
PRINTFORMDW 慧音の気遣わしげな目線に、なんとか笑みを浮かべて見せた	PRINTFORMDW 慧音の気遣わしげな目線に、なんとか笑みを浮かべて見せた
PRINTFORMDW 助けた方が良いかしらと、のんきな表情で輝夜が呟いている	PRINTFORMDW 助けた方が良いかしらと、のんきな表情で輝夜が呟いている
PRINTFORMDW 助けようと手を伸ばす慧音に、妹紅は慌てて首を横に振った	PRINTFORMDW 助けようと手を伸ばす慧音に、妹紅は慌てて首を横に振った
PRINTFORMDL もはや抗えない、それをさとって、妹紅は体から力を抜いた	PRINTFORMDL もはや抗えない、それをさとって、妹紅は体から力を抜いた
PRINTFORMW 生唾を飲み込む見つめる輝夜を無視して、妹紅は自慰を始める	PRINTFORMW 生唾を飲み込む見つめる輝夜を無視して、妹紅は自慰を始める
PRINTFORMW 「ああ、だれか気持ち良くしてよ。……ちぇっ、一人でやろ」	PRINTFORMW 「ああ、だれか気持ち良くしてよ。……ちぇっ、一人でやろ」
PRINTFORMDW 目を潤ませて呟く妹紅を、いらだたしげに輝夜が睨んでいる	PRINTFORMDW 目を潤ませて呟く妹紅を、いらだたしげに輝夜が睨んでいる
PRINTFORMW 「慧音には手を出すな……、私には何をしても構わないから」	PRINTFORMW 「慧音には手を出すな……、私には何をしても構わないから」
PRINTFORMW 「お願い気持ち良くして、慧音がしてくれてもいいから……」	PRINTFORMW 「お願い気持ち良くして、慧音がしてくれてもいいから……」
PRINTFORML 「慧音、一緒に御飯食べようか？　今日は筍御飯なんだけど」	PRINTFORML 「慧音、一緒に御飯食べようか？　今日は筍御飯なんだけど」
PRINTFORML 「ふふ、輝夜のおまんこ、気持ちいい。そっちもそうだよね」	PRINTFORML 「ふふ、輝夜のおまんこ、気持ちいい。そっちもそうだよね」
PRINTFORMDL 服が削られる衝撃に、眉を顰めつつも妹紅は眠り続けている	PRINTFORMDL 服が削られる衝撃に、眉を顰めつつも妹紅は眠り続けている
PRINTFORMDL 眠りに落ちている妹紅の体が、ゆっくりと飲み込まれていく	PRINTFORMDL 眠りに落ちている妹紅の体が、ゆっくりと飲み込まれていく
PRINTFORMDL 熱情に頬を緩ませ、眠る妹紅は激しく全身を痙攣させている	PRINTFORMDL 熱情に頬を緩ませ、眠る妹紅は激しく全身を痙攣させている
PRINTFORMDL 淫夢でも見ているのか、妹紅は眠りながら自らを慰め始めた	PRINTFORMDL 淫夢でも見ているのか、妹紅は眠りながら自らを慰め始めた
PRINTFORMDL 擬根に絡みつく触手に、妹紅は愛おしげに指を這わせている	PRINTFORMDL 擬根に絡みつく触手に、妹紅は愛おしげに指を這わせている
PRINTFORMDL 僅かに嗚咽の混じる妹紅の声に、輝夜が顔に怒りを浮かべた	PRINTFORMDL 僅かに嗚咽の混じる妹紅の声に、輝夜が顔に怒りを浮かべた
PRINTFORML 「この化け物っ！！　っ！？　お前もこっち見るなっっ！！」	PRINTFORML 「この化け物っ！！　っ！？　お前もこっち見るなっっ！！」
PRINTFORML 「っっ！？　食う気っ！？　この、やめろ、やめてって！！」	PRINTFORML 「っっ！？　食う気っ！？　この、やめろ、やめてって！！」
PRINTFORMDL 呆然とした様子の妹紅は、それでも自身の乳房を揉んでいる	PRINTFORMDL 呆然とした様子の妹紅は、それでも自身の乳房を揉んでいる
PRINTFORMDL 舌を突き出し涎と愛液をまき散らし、全身を痙攣させている	PRINTFORMDL 舌を突き出し涎と愛液をまき散らし、全身を痙攣させている
PRINTFORMDL 甘い啼き声を上げながら、妹紅は必死に擬根をしごいている	PRINTFORMDL 甘い啼き声を上げながら、妹紅は必死に擬根をしごいている
PRINTFORMDL 振動する張り型を秘処にくわえ込み、妹紅は眉を顰めている	PRINTFORMDL 振動する張り型を秘処にくわえ込み、妹紅は眉を顰めている
PRINTFORMDL 諦めに染まった妹紅は、自ら腰を揺らして秘豆を擦り付ける	PRINTFORMDL 諦めに染まった妹紅は、自ら腰を揺らして秘豆を擦り付ける
PRINTFORMDL 一瞬、輝夜の仕業かと思い、即座にそれはないなと否定する	PRINTFORMDL 一瞬、輝夜の仕業かと思い、即座にそれはないなと否定する
PRINTFORML 「なあ、なんでこんなところで、こんな風に寝てるんだよ？」	PRINTFORML 「なあ、なんでこんなところで、こんな風に寝てるんだよ？」
PRINTFORMDW ……一度などは、目の前で消えて、救うことが出来なかった	PRINTFORMDW ……一度などは、目の前で消えて、救うことが出来なかった
PRINTFORMDL 思わず腰を引こうとして、体が動かないことに気付かされる	PRINTFORMDL 思わず腰を引こうとして、体が動かないことに気付かされる
PRINTFORMDL それくらいしか言えない妹紅は、呆然と思考を停止していた	PRINTFORMDL それくらいしか言えない妹紅は、呆然と思考を停止していた
PRINTFORML 「永琳並みに冷静になったらどう？　ま、無理だろうけど」	PRINTFORML 「永琳並みに冷静になったらどう？　ま、無理だろうけど」
PRINTFORMDW そんなに都合良く行くわけ無いかと、苦笑を浮かべる妹紅	PRINTFORMDW そんなに都合良く行くわけ無いかと、苦笑を浮かべる妹紅
PRINTFORML 「ちっ！　足手まといのせいで逃げれなかったじゃないか」	PRINTFORML 「ちっ！　足手まといのせいで逃げれなかったじゃないか」
PRINTFORMDW トロいのはあんただと、言い返してくる輝夜を睨み付けた	PRINTFORMDW トロいのはあんただと、言い返してくる輝夜を睨み付けた
PRINTFORMDL 触手に蹂躙される慧音が、必死に逃げてくれと叫んでいる	PRINTFORMDL 触手に蹂躙される慧音が、必死に逃げてくれと叫んでいる
PRINTFORMDW 呼吸を整える妹紅を、輝夜がいらだたしげに見つめている	PRINTFORMDW 呼吸を整える妹紅を、輝夜がいらだたしげに見つめている
PRINTFORML （なんで、こんなこと……、輝夜なんて、嫌いなのに……）	PRINTFORML （なんで、こんなこと……、輝夜なんて、嫌いなのに……）
PRINTFORML （違うっ！　私は輝夜のことなんて何とも思ってないっ！）	PRINTFORML （違うっ！　私は輝夜のことなんて何とも思ってないっ！）
PRINTFORML 「はぁはぁ、おっぱい、触って。おねがい気持ち良くして」	PRINTFORML 「はぁはぁ、おっぱい、触って。おねがい気持ち良くして」
PRINTFORMW 「慧音は下がって。……ほら、胸でもなんでも好きにしろ」	PRINTFORMW 「慧音は下がって。……ほら、胸でもなんでも好きにしろ」
PRINTFORMDW 泣き叫び、腰を突き出す妹紅に、輝夜はただ顔を赤らめる	PRINTFORMDW 泣き叫び、腰を突き出す妹紅に、輝夜はただ顔を赤らめる
PRINTFORML 「はぁはぁ……、なんでも良いから、どうにでもして……」	PRINTFORML 「はぁはぁ……、なんでも良いから、どうにでもして……」
PRINTFORMW 「……気持ち良くして欲しいの、……慧音でもいいからさ」	PRINTFORMW 「……気持ち良くして欲しいの、……慧音でもいいからさ」
PRINTFORMDW 涙目で叫ぶ妹紅を、輝夜が笑みを浮かべて抱き締めてきた	PRINTFORMDW 涙目で叫ぶ妹紅を、輝夜が笑みを浮かべて抱き締めてきた
PRINTFORML 「輝夜、そんなに私とするの嬉しいんだ？　私も嬉しいよ」	PRINTFORML 「輝夜、そんなに私とするの嬉しいんだ？　私も嬉しいよ」
PRINTFORMDL 膣を抉り嬲られる感触に、妹紅は身を震わせながらイッた	PRINTFORMDL 膣を抉り嬲られる感触に、妹紅は身を震わせながらイッた
PRINTFORMDL 膣奥を叩かれる感覚に、妹紅は悦楽の悲鳴をあげて達した	PRINTFORMDL 膣奥を叩かれる感覚に、妹紅は悦楽の悲鳴をあげて達した
PRINTFORMDL 呆然とした表情を浮かべて、輝夜がその様を見つめている	PRINTFORMDL 呆然とした表情を浮かべて、輝夜がその様を見つめている
PRINTFORMDL 頬を緩ませ、自ら腰を振って触手に秘豆を擦り付ける妹紅	PRINTFORMDL 頬を緩ませ、自ら腰を振って触手に秘豆を擦り付ける妹紅
PRINTFORMDL 妹紅の叫びに、納得の表情を浮かべて、輝夜が頷いている	PRINTFORMDL 妹紅の叫びに、納得の表情を浮かべて、輝夜が頷いている
PRINTFORML 「くっ！　服を破くな、この気持ち悪い化け物がっっ！！」	PRINTFORML 「くっ！　服を破くな、この気持ち悪い化け物がっっ！！」
PRINTFORMDL 乳首に貼り付けたローターの振動に、思わず悲鳴を漏らす	PRINTFORMDL 乳首に貼り付けたローターの振動に、思わず悲鳴を漏らす
PRINTFORMDL そう呟きながら、妹紅の手は己の乳房を揉みしだき始める	PRINTFORMDL そう呟きながら、妹紅の手は己の乳房を揉みしだき始める
PRINTFORMDL 顔を真っ赤にして、妹紅はひたすら擬根を擦りたてている	PRINTFORMDL 顔を真っ赤にして、妹紅はひたすら擬根を擦りたてている
PRINTFORMDL 呂律がまわらない程の悦楽に、妹紅は身悶えし続けている	PRINTFORMDL 呂律がまわらない程の悦楽に、妹紅は身悶えし続けている
PRINTFORML 「んっっ！　イくっ！　これ、胸でなんて、あひっっ！！」	PRINTFORML 「んっっ！　イくっ！　これ、胸でなんて、あひっっ！！」
PRINTFORML 「くぁっ！　あふっ！　んぅっっ！　くっ、イくっっ！！」	PRINTFORML 「くぁっ！　あふっ！　んぅっっ！　くっ、イくっっ！！」
PRINTFORMDL ぎゅっと、つよく締め付けられて、痙攣しながら射精した	PRINTFORMDL ぎゅっと、つよく締め付けられて、痙攣しながら射精した
PRINTFORMDL その思いに一縷の望みを託して、妹紅は火口に身を投げた	PRINTFORMDL その思いに一縷の望みを託して、妹紅は火口に身を投げた
PRINTFORMDW 月光に裸身を晒す輝夜の姿に、妹紅は深々と溜め息を吐く	PRINTFORMDW 月光に裸身を晒す輝夜の姿に、妹紅は深々と溜め息を吐く
PRINTFORMDW 途端に嬉しそうに笑って、左右からしなだれかかってくる	PRINTFORMDW 途端に嬉しそうに笑って、左右からしなだれかかってくる
PRINTFORMDW 泣き言を呟き、身を丸める妹紅に輝夜が眉を顰めている	PRINTFORMDW 泣き言を呟き、身を丸める妹紅に輝夜が眉を顰めている
PRINTFORMDW 妹紅は思い切りイヤそうな顔をして、輝夜に投げつけた	PRINTFORMDW 妹紅は思い切りイヤそうな顔をして、輝夜に投げつけた
PRINTFORMDW 冗談は顔だけにしてと呟く輝夜を、思いきり睨み付けた	PRINTFORMDW 冗談は顔だけにしてと呟く輝夜を、思いきり睨み付けた
PRINTFORMDW 妹紅の様子に笑みを浮かべて、輝夜が触手へ目を向けた	PRINTFORMDW 妹紅の様子に笑みを浮かべて、輝夜が触手へ目を向けた
PRINTFORMDW もっと気合いを入れろと、輝夜が無責任にヤジを飛ばす	PRINTFORMDW もっと気合いを入れろと、輝夜が無責任にヤジを飛ばす
PRINTFORML 「どうせ、死なないんだ……、なら、好きにすればいい」	PRINTFORML 「どうせ、死なないんだ……、なら、好きにすればいい」
PRINTFORMDW もはや、抗う意志を見せない妹紅に、触手達が殺到する	PRINTFORMDW もはや、抗う意志を見せない妹紅に、触手達が殺到する
PRINTFORMW 呟きながら自慰を始める妹紅に、輝夜が顔を赤くしている	PRINTFORMW 呟きながら自慰を始める妹紅に、輝夜が顔を赤くしている
PRINTFORMW 「私のＨなところ、そんなに見たいんだ？　なら良いよ」	PRINTFORMW 「私のＨなところ、そんなに見たいんだ？　なら良いよ」
PRINTFORMW 「がまん、できないや。オナニーして、ガマンしないと」	PRINTFORMW 「がまん、できないや。オナニーして、ガマンしないと」
PRINTFORML 「ん、輝夜もしたいの？　それとも輝夜は私としたい？」	PRINTFORML 「ん、輝夜もしたいの？　それとも輝夜は私としたい？」
PRINTFORMDW 虚ろな目で笑いながら、妹紅は輝夜に自慰を見せつける	PRINTFORMDW 虚ろな目で笑いながら、妹紅は輝夜に自慰を見せつける
PRINTFORMDW 必死に身をよじる妹紅に、輝夜が生唾を飲み込んでいる	PRINTFORMDW 必死に身をよじる妹紅に、輝夜が生唾を飲み込んでいる
PRINTFORML 「ふんっ、こういうのはあっちの方が似合ってるのにな」	PRINTFORML 「ふんっ、こういうのはあっちの方が似合ってるのにな」
PRINTFORMDW じろりと輝夜を睨んだ妹紅は、渋々秘処をさらけ出した	PRINTFORMDW じろりと輝夜を睨んだ妹紅は、渋々秘処をさらけ出した
PRINTFORML 「お前が悪いんだ、こんなＨなおまんこしてるんだから」	PRINTFORML 「お前が悪いんだ、こんなＨなおまんこしてるんだから」
PRINTFORMDW 顔を真っ赤にする輝夜を押し倒し、秘処を擦り合わせた	PRINTFORMDW 顔を真っ赤にする輝夜を押し倒し、秘処を擦り合わせた
PRINTFORMDW 笑顔を浮かべる妹紅に、輝夜も嬉しげに笑みを浮かべた	PRINTFORMDW 笑顔を浮かべる妹紅に、輝夜も嬉しげに笑みを浮かべた
PRINTFORML （いやだいやだいやだっ！　輝夜となんてそんなのっ！）	PRINTFORML （いやだいやだいやだっ！　輝夜となんてそんなのっ！）
PRINTFORMDW 妹紅の言葉に、コクンと頷いて輝夜が腰を揺らし始めた	PRINTFORMDW 妹紅の言葉に、コクンと頷いて輝夜が腰を揺らし始めた
PRINTFORMDL 眠る妹紅は、手を伸ばして服の破れを隠そうとしている	PRINTFORMDL 眠る妹紅は、手を伸ばして服の破れを隠そうとしている
PRINTFORMDL 腰を左右に振りながら、妹紅は秘豆を必死に押し付ける	PRINTFORMDL 腰を左右に振りながら、妹紅は秘豆を必死に押し付ける
PRINTFORMDL 輝夜の心配そうな視線を受けて、妹紅は視線を逸らした	PRINTFORMDL 輝夜の心配そうな視線を受けて、妹紅は視線を逸らした
PRINTFORMDL 触手が擬態した男性器を嬲られ、舌を突き出し喘ぐ妹紅	PRINTFORMDL 触手が擬態した男性器を嬲られ、舌を突き出し喘ぐ妹紅
PRINTFORML 「や、絡みつく！？　やめ、んくっ！　このぉっっ！！」	PRINTFORML 「や、絡みつく！？　やめ、んくっ！　このぉっっ！！」
PRINTFORML 「……はぁはぁ……っく……は……ん……、く、こんな」	PRINTFORML 「……はぁはぁ……っく……は……ん……、く、こんな」
PRINTFORMDL 自身の秘処へ指を差し込み、妹紅は機械的に指を動かす	PRINTFORMDL 自身の秘処へ指を差し込み、妹紅は機械的に指を動かす
PRINTFORMDL 妹紅は虚空へ視線をむけ、膣腔を自身の指で犯していく	PRINTFORMDL 妹紅は虚空へ視線をむけ、膣腔を自身の指で犯していく
PRINTFORMDL 指を動かす妹紅は、ぴくぴくと体を小さく震わせている	PRINTFORMDL 指を動かす妹紅は、ぴくぴくと体を小さく震わせている
PRINTFORMDL きゅっと締め上げられて、妹紅は声も出さずに絶頂した	PRINTFORMDL きゅっと締め上げられて、妹紅は声も出さずに絶頂した
PRINTFORMDL うつろな表情で床に臥す輝夜……、その頭を軽く蹴った	PRINTFORMDL うつろな表情で床に臥す輝夜……、その頭を軽く蹴った
PRINTFORMDW それは、あの異変が、終わることなく続いているからで	PRINTFORMDW それは、あの異変が、終わることなく続いているからで
PRINTFORMDL あの迷宮の中では、まともな精神状態じゃなかっただけ	PRINTFORMDL あの迷宮の中では、まともな精神状態じゃなかっただけ
PRINTFORMDL 盛り上がりまくった宴会を終えて、庵へと向かう帰り道	PRINTFORMDL 盛り上がりまくった宴会を終えて、庵へと向かう帰り道
PRINTFORMW 「使いたくない……。けど、背に腹は代えられないか」	PRINTFORMW 「使いたくない……。けど、背に腹は代えられないか」
PRINTFORML 「いい気味だ、……壊れてなかったら、助けてやるよ」	PRINTFORML 「いい気味だ、……壊れてなかったら、助けてやるよ」
PRINTFORMDW 儚げに微笑む輝夜の姿が、煙に紛れて見えなくなった	PRINTFORMDW 儚げに微笑む輝夜の姿が、煙に紛れて見えなくなった
PRINTFORMDW 輝夜の心配そうな表情を無視して、妹紅は敵を睨んだ	PRINTFORMDW 輝夜の心配そうな表情を無視して、妹紅は敵を睨んだ
PRINTFORMDW 妹紅が解放されたことに、安堵の表情を浮かべる輝夜	PRINTFORMDW 妹紅が解放されたことに、安堵の表情を浮かべる輝夜
PRINTFORML 「ふぁ、んっ……だめ……ちから、が……んくぅ……」	PRINTFORML 「ふぁ、んっ……だめ……ちから、が……んくぅ……」
PRINTFORMW 「お尻に入れてぇ、熱くて、固いの、入れてよぉ……」	PRINTFORMW 「お尻に入れてぇ、熱くて、固いの、入れてよぉ……」
PRINTFORMDW 輝夜の戸惑いを無視して、妹紅は自ら尻を突き出した	PRINTFORMDW 輝夜の戸惑いを無視して、妹紅は自ら尻を突き出した
PRINTFORMW 「慧音は下がってて……、食えるもんなら食ってみろ」	PRINTFORMW 「慧音は下がってて……、食えるもんなら食ってみろ」
PRINTFORMDW 涙目で輝夜を睨み、妹紅は触手にその身を差し出した	PRINTFORMDW 涙目で輝夜を睨み、妹紅は触手にその身を差し出した
PRINTFORMW 「慧音は、下がってて。ほら、私は食べ甲斐があるぞ」	PRINTFORMW 「慧音は、下がってて。ほら、私は食べ甲斐があるぞ」
PRINTFORMDW 戸惑う輝夜の胸元に顔を埋め、甘えた声で妹紅が囁く	PRINTFORMDW 戸惑う輝夜の胸元に顔を埋め、甘えた声で妹紅が囁く
PRINTFORMDW 涙目で見つめる妹紅の姿に、輝夜も腰を動かし始めた	PRINTFORMDW 涙目で見つめる妹紅の姿に、輝夜も腰を動かし始めた
PRINTFORMW （っっ！　なんで、勝手に動くんだよこの体はっ！！）	PRINTFORMW （っっ！　なんで、勝手に動くんだよこの体はっ！！）
PRINTFORML 「慧音、一緒に気持ち良くなろ？　ほら擦ってあげる」	PRINTFORML 「慧音、一緒に気持ち良くなろ？　ほら擦ってあげる」
PRINTFORMW は「;」を左につけるか消すかしたほうがよいでしょう	PRINTFORMW は「;」を左につけるか消すかしたほうがよいでしょう
PRINTFORMDL 眠っている妹紅の顔から、苦悶の表情さえ消え去った	PRINTFORMDL 眠っている妹紅の顔から、苦悶の表情さえ消え去った
PRINTFORMDL 眠っている妹紅の胎は蹂躙され、幼体の苗床と化した	PRINTFORMDL 眠っている妹紅の胎は蹂躙され、幼体の苗床と化した
PRINTFORMDL 荒い息を吐く妹紅に、心配そうな輝夜が見つめてくる	PRINTFORMDL 荒い息を吐く妹紅に、心配そうな輝夜が見つめてくる
PRINTFORMDL 輝夜に見せつけるように、尻穴を貫かれる愉悦に浸る	PRINTFORMDL 輝夜に見せつけるように、尻穴を貫かれる愉悦に浸る
PRINTFORMDL 疑似男根を擦られる感触に、悦楽の悲鳴を上げる妹紅	PRINTFORMDL 疑似男根を擦られる感触に、悦楽の悲鳴を上げる妹紅
PRINTFORML 「んくっ！　あふっ！　ちっ！　鬱陶しいっっっ！！」	PRINTFORML 「んくっ！　あふっ！　ちっ！　鬱陶しいっっっ！！」
PRINTFORML 「あふっ！？　そこは、違うっ！　やめ、んぅっっ！」	PRINTFORML 「あふっ！？　そこは、違うっ！　やめ、んぅっっ！」
PRINTFORML 「は、んっ！　や、熱い、体、あつく、んきゅっ……」	PRINTFORML 「は、んっ！　や、熱い、体、あつく、んきゅっ……」
PRINTFORML 「……え？　なんえ、しかい、が、ゆが…………んぅ」	PRINTFORML 「……え？　なんえ、しかい、が、ゆが…………んぅ」
PRINTFORML 「……ぁ……、かて、な、い……もう、むり…………」	PRINTFORML 「……ぁ……、かて、な、い……もう、むり…………」
PRINTFORML 「むね、やだ……って、っ！？　こ、このぉっっ！！」	PRINTFORML 「むね、やだ……って、っ！？　こ、このぉっっ！！」
PRINTFORML 「……こんな、気持ち悪い物があるのに、寝れるかな」	PRINTFORML 「……こんな、気持ち悪い物があるのに、寝れるかな」
PRINTFORMDL 虚ろな瞳の妹紅は、自身の菊座に指を突き入れている	PRINTFORMDL 虚ろな瞳の妹紅は、自身の菊座に指を突き入れている
PRINTFORMDL ごしゅごしゅと自身の手で、肉竿をこすりたてる妹紅	PRINTFORMDL ごしゅごしゅと自身の手で、肉竿をこすりたてる妹紅
PRINTFORMDL バイブを動かす妹紅は、どことなく物足りなさそうだ	PRINTFORMDL バイブを動かす妹紅は、どことなく物足りなさそうだ
PRINTFORMDL ぽつぽつと呟きながら、妹紅は輝夜の肩に手を置いた	PRINTFORMDL ぽつぽつと呟きながら、妹紅は輝夜の肩に手を置いた
PRINTFORMDL 自身でも思わぬ程に、この幻想郷を愛していたらしい	PRINTFORMDL 自身でも思わぬ程に、この幻想郷を愛していたらしい
PRINTFORMW 『よく似合ってるわよ。今風の格好も結構似合うわね』	PRINTFORMW 『よく似合ってるわよ。今風の格好も結構似合うわね』
PRINTFORML 「はいはい、わかったよ、すればいいんだろうすれば」	PRINTFORML 「はいはい、わかったよ、すればいいんだろうすれば」
PRINTFORMDW そう呟く妹紅の口元には嬉しげな笑みが浮かんでいた	PRINTFORMDW そう呟く妹紅の口元には嬉しげな笑みが浮かんでいた
PRINTFORMDW 必死に身を守る妹紅に、輝夜が笑みを浮かべている	PRINTFORMDW 必死に身を守る妹紅に、輝夜が笑みを浮かべている
PRINTFORMDW 思い切り輝夜に怒鳴りながら、妹紅は守りを固めた	PRINTFORMDW 思い切り輝夜に怒鳴りながら、妹紅は守りを固めた
PRINTFORMDW いやいや投げ渡す妹紅に、笑顔で輝夜が礼を告げた	PRINTFORMDW いやいや投げ渡す妹紅に、笑顔で輝夜が礼を告げた
PRINTFORMDW でも私は愉快と返す輝夜に、妹紅は溜め息を吐いた	PRINTFORMDW でも私は愉快と返す輝夜に、妹紅は溜め息を吐いた
PRINTFORMDW 後退する妹紅に、ニヤニヤ笑う輝夜は何も答えない	PRINTFORMDW 後退する妹紅に、ニヤニヤ笑う輝夜は何も答えない
PRINTFORMDW 笑みを向けられた輝夜が、顔を赤くして俯いている	PRINTFORMDW 笑みを向けられた輝夜が、顔を赤くして俯いている
PRINTFORMW 「やめろっ！　っ！？　慧音、こっちみないでっ！」	PRINTFORMW 「やめろっ！　っ！？　慧音、こっちみないでっ！」
PRINTFORML 「ん、くぅ……、はぁ……ん、ここに、ちょうだい」	PRINTFORML 「ん、くぅ……、はぁ……ん、ここに、ちょうだい」
PRINTFORMW 「……ここにほしいの。……慧音にもしてほしいな」	PRINTFORMW 「……ここにほしいの。……慧音にもしてほしいな」
PRINTFORMW 「慧音のおまんこ、私のおちんちんとぴったりだよ」	PRINTFORMW 「慧音のおまんこ、私のおちんちんとぴったりだよ」
PRINTFORML 「慧音気持ちいいよね？　ふふ、私も気持ちいいよ」	PRINTFORML 「慧音気持ちいいよね？　ふふ、私も気持ちいいよ」
PRINTFORMDL 眠る妹紅の体に、ぎちぎちと触手が絡みついてくる	PRINTFORMDL 眠る妹紅の体に、ぎちぎちと触手が絡みついてくる
PRINTFORMDL 眠っている妹紅に、その攻撃から身を守る術はない	PRINTFORMDL 眠っている妹紅に、その攻撃から身を守る術はない
PRINTFORMDL 妹紅は自ら腰を振って、疑似男根を触手に突き込む	PRINTFORMDL 妹紅は自ら腰を振って、疑似男根を触手に突き込む
PRINTFORMDL 衣がはぎ取られるのを生気の無い瞳で見つめている	PRINTFORMDL 衣がはぎ取られるのを生気の無い瞳で見つめている
PRINTFORMDL それを察したのか、触手が激しく秘豆を嬲ってくる	PRINTFORMDL それを察したのか、触手が激しく秘豆を嬲ってくる
PRINTFORMDL 妹紅の言葉に、輝夜が楽しげな笑みを浮かべている	PRINTFORMDL 妹紅の言葉に、輝夜が楽しげな笑みを浮かべている
PRINTFORML 「違う、ちがうからぁ、みるな、輝夜見るなぁ……」	PRINTFORML 「違う、ちがうからぁ、みるな、輝夜見るなぁ……」
PRINTFORML 「ひんっ！　気持ち悪っ！　離せ、離してよっっ！」	PRINTFORML 「ひんっ！　気持ち悪っ！　離せ、離してよっっ！」
PRINTFORML 「このっ！　離せ、離せ離せ離せぇえっっっっ！！」	PRINTFORML 「このっ！　離せ、離せ離せ離せぇえっっっっ！！」
PRINTFORMDL 淫らに腰を揺らし、妹紅は肛門の悦楽を貪っている	PRINTFORMDL 淫らに腰を揺らし、妹紅は肛門の悦楽を貪っている
PRINTFORMDL 震えるバイブを抜き差しし、アヌスを刺激する妹紅	PRINTFORMDL 震えるバイブを抜き差しし、アヌスを刺激する妹紅
PRINTFORMDL 言葉とは裏腹に、妹紅の手の動きは速くなっていく	PRINTFORMDL 言葉とは裏腹に、妹紅の手の動きは速くなっていく
PRINTFORMDL ぬちゅりと、膣内を擦りながら妹紅は吐息を漏らす	PRINTFORMDL ぬちゅりと、膣内を擦りながら妹紅は吐息を漏らす
PRINTFORMDL その上、腕を組んでくるのが、意味不明で鬱陶しい	PRINTFORMDL その上、腕を組んでくるのが、意味不明で鬱陶しい
PRINTFORMDW 厭味を込めた言葉に、輝夜がニヤニヤ笑っている	PRINTFORMDW 厭味を込めた言葉に、輝夜がニヤニヤ笑っている
PRINTFORM 「はぁ……はぁ……、すこしでも、削って……やる」	PRINTFORM 「はぁ……はぁ……、すこしでも、削って……やる」
PRINTFORMDW それでこそ妹紅と曰う輝夜を、横目で睨み付けた	PRINTFORMDW それでこそ妹紅と曰う輝夜を、横目で睨み付けた
PRINTFORMW 「慧音も一緒にしようよ……、気持ちいいんだよ」	PRINTFORMW 「慧音も一緒にしようよ……、気持ちいいんだよ」
PRINTFORMW （お願い、見ないで慧音っ！　こんなの、いや！）	PRINTFORMW （お願い、見ないで慧音っ！　こんなの、いや！）
PRINTFORMW 「慧音でも触手でも良いよぉ、お尻弄ってぇ……」	PRINTFORMW 「慧音でも触手でも良いよぉ、お尻弄ってぇ……」
PRINTFORMDW 輝夜と触手の間に割って入り尻穴をさらけ出した	PRINTFORMDW 輝夜と触手の間に割って入り尻穴をさらけ出した
PRINTFORM 　おちんちん、こすってぇ……、気持ち良くしてよぉ	PRINTFORM 　おちんちん、こすってぇ……、気持ち良くしてよぉ
PRINTFORML 「ふふ、こんなキスされて喜ぶなんて、可愛いな」	PRINTFORML 「ふふ、こんなキスされて喜ぶなんて、可愛いな」
PRINTFORML 「はは、慧音も呑む？　美味しいんだよ、この酒」	PRINTFORML 「はは、慧音も呑む？　美味しいんだよ、この酒」
PRINTFORMW 「ふふ、私のおちんちんで気持ち良くしてあげる」	PRINTFORMW 「ふふ、私のおちんちんで気持ち良くしてあげる」
PRINTFORMW 「おまんこ熱いの、%ARGS:1%も一緒にね」	PRINTFORMW 「おまんこ熱いの、%ARGS:1%も一緒にね」
PRINTFORM 　おまんこおちんちんでぐぽぐぽしてあげるからさぁ	PRINTFORM 　おまんこおちんちんでぐぽぐぽしてあげるからさぁ
PRINTFORMDW 耳元で囁く妹紅に、輝夜が嬉しげな表情になった	PRINTFORMDW 耳元で囁く妹紅に、輝夜が嬉しげな表情になった
PRINTFORMDW 腰を押し付ける妹紅に、輝夜も腰を揺らし始める	PRINTFORMDW 腰を押し付ける妹紅に、輝夜も腰を揺らし始める
PRINTFORML （いやだっ！　こんなこと輝夜になんてっっ！！）	PRINTFORML （いやだっ！　こんなこと輝夜になんてっっ！！）
PRINTFORML 「んっ、気持ちいい？　そう、私も気持ちいいよ」	PRINTFORML 「んっ、気持ちいい？　そう、私も気持ちいいよ」
PRINTFORMDL 眠りに落ちたままの妹紅は、痛みに苦鳴を漏らす	PRINTFORMDL 眠りに落ちたままの妹紅は、痛みに苦鳴を漏らす
PRINTFORMDL 眠る妹紅は、頬を紅潮させ全身を痙攣させている	PRINTFORMDL 眠る妹紅は、頬を紅潮させ全身を痙攣させている
PRINTFORMDL 眠る妹紅の体は触手にがんじがらめにされている	PRINTFORMDL 眠る妹紅の体は触手にがんじがらめにされている
PRINTFORMDL 泣き叫ぶ妹紅は、自ら腰を振り快楽を貪っている	PRINTFORMDL 泣き叫ぶ妹紅は、自ら腰を振り快楽を貪っている
PRINTFORML 「ちっっ、巻き付けるな、このっ！　くぅっ！！」	PRINTFORML 「ちっっ、巻き付けるな、このっ！　くぅっ！！」
PRINTFORML 「こんなの……、どうしろって……いうのよ……」	PRINTFORML 「こんなの……、どうしろって……いうのよ……」
PRINTFORML 「く、ん……、はっ！　や、やめ、何してる！！」	PRINTFORML 「く、ん……、はっ！　や、やめ、何してる！！」
PRINTFORML 「くっ！　離せ！　離せってば！！　や、動けな」	PRINTFORML 「くっ！　離せ！　離せってば！！　や、動けな」
PRINTFORML 「ひぅっっ！　くっ！　食われて、堪るかっ！？」	PRINTFORML 「ひぅっっ！　くっ！　食われて、堪るかっ！？」
PRINTFORMDL ずっぽりと菊座にくわえ込んだバイブが動きめた	PRINTFORMDL ずっぽりと菊座にくわえ込んだバイブが動きめた
PRINTFORMDL 硬くしこった乳首を刺激され、妹紅は達している	PRINTFORMDL 硬くしこった乳首を刺激され、妹紅は達している
PRINTFORMDL 一拍おいて、全身を痙攣させながら妹紅は達した	PRINTFORMDL 一拍おいて、全身を痙攣させながら妹紅は達した
PRINTFORMDL 仲間達は、こちらをちらりと見た後、少し離れた	PRINTFORMDL 仲間達は、こちらをちらりと見た後、少し離れた
PRINTFORMDL ……あれから、永遠亭に新たな住人が増えていた	PRINTFORMDL ……あれから、永遠亭に新たな住人が増えていた
PRINTFORML 『あら、あの場所では散々嬲ってくれたじゃない』	PRINTFORML 『あら、あの場所では散々嬲ってくれたじゃない』
PRINTFORML 『ね、殺し合いはあとでちゃんとしてあげるから』	PRINTFORML 『ね、殺し合いはあとでちゃんとしてあげるから』
PRINTFORML 「ふぁんっっ！　ちょっ！　待てコラっっっ！！」	PRINTFORML 「ふぁんっっ！　ちょっ！　待てコラっっっ！！」
PRINTFORMDL 深々と溜め息を吐いて、妹紅は輝夜を睨み付け、	PRINTFORMDL 深々と溜め息を吐いて、妹紅は輝夜を睨み付け、
PRINTFORMDL どうやら、反論と抵抗の余地は欠片もないらしい	PRINTFORMDL どうやら、反論と抵抗の余地は欠片もないらしい
PRINTFORML 「仕方ないから使わせてやる、ありがたく思え」	PRINTFORML 「仕方ないから使わせてやる、ありがたく思え」
PRINTFORMDW 儚げに微笑む輝夜に、背中を向けて走り出した	PRINTFORMDW 儚げに微笑む輝夜に、背中を向けて走り出した
PRINTFORMW 「んっ、ふぁっ、堪らない。オナニーしたいな」	PRINTFORMW 「んっ、ふぁっ、堪らない。オナニーしたいな」
PRINTFORML 「ふふ、そんなに見たい？　いいよ、見てても」	PRINTFORML 「ふふ、そんなに見たい？　いいよ、見てても」
PRINTFORMW 「慧音も一緒にしよ、見せ合いっこしたいなぁ」	PRINTFORMW 「慧音も一緒にしよ、見せ合いっこしたいなぁ」
PRINTFORML 「はぁはぁ、熱いよ、気持ち良くなりたいよぉ」	PRINTFORML 「はぁはぁ、熱いよ、気持ち良くなりたいよぉ」
PRINTFORMW 「食えるものなら食ってみろ。慧音は下がって」	PRINTFORMW 「食えるものなら食ってみろ。慧音は下がって」
PRINTFORML 「……あーと、迷ってない人間は、いないかな」	PRINTFORML 「……あーと、迷ってない人間は、いないかな」
PRINTFORML 「ああ、そろそろ筍が出てくる時期だよな……」	PRINTFORML 「ああ、そろそろ筍が出てくる時期だよな……」
PRINTFORML 「はは、良い月が出てるな。月見酒も良いかも」	PRINTFORML 「はは、良い月が出てるな。月見酒も良いかも」
PRINTFORMDL 深く眠る妹紅は、完全に飲み込まれてしまった	PRINTFORMDL 深く眠る妹紅は、完全に飲み込まれてしまった
PRINTFORMDL 秘豆に吸い付かれ、妹紅が甘い啼き声を上げる	PRINTFORMDL 秘豆に吸い付かれ、妹紅が甘い啼き声を上げる
PRINTFORML 「やめろ、やめて！　この離して、離してよっ」	PRINTFORML 「やめろ、やめて！　この離して、離してよっ」
PRINTFORMDL 目尻に涙を溜める妹紅に、輝夜が顔色を変えた	PRINTFORMDL 目尻に涙を溜める妹紅に、輝夜が顔色を変えた
PRINTFORM 　お願いやめてやめてやめ、んあああああっっっっ	PRINTFORM 　お願いやめてやめてやめ、んあああああっっっっ
PRINTFORML 「この程度で、参ったり、しないんだからっ！」	PRINTFORML 「この程度で、参ったり、しないんだからっ！」
PRINTFORML 「く……こんな、ので、……くぅ……外に……」	PRINTFORML 「く……こんな、ので、……くぅ……外に……」
PRINTFORML 「ここらで、寝ておいた方がいいんじゃない？」	PRINTFORML 「ここらで、寝ておいた方がいいんじゃない？」
PRINTFORML 「これ、焼き払っても、多分無駄なんだろうね」	PRINTFORML 「これ、焼き払っても、多分無駄なんだろうね」
PRINTFORM 「……こんなに大きいの、入るなん、て……ふぁっ	PRINTFORM 「……こんなに大きいの、入るなん、て……ふぁっ
PRINTFORML 「はぁはぁ、んっ……あふ、んくっ……ふぁっ」	PRINTFORML 「はぁはぁ、んっ……あふ、んくっ……ふぁっ」
PRINTFORM 　でる、でちゃう、おちんちんでいっちゃうのぉっ	PRINTFORM 　でる、でちゃう、おちんちんでいっちゃうのぉっ
PRINTFORML 「あひっ！　んっ！　くぅ、イくぅ……っっ！」	PRINTFORML 「あひっ！　んっ！　くぅ、イくぅ……っっ！」
PRINTFORML 「……退屈しなくて済みそうだし、まあいいか」	PRINTFORML 「……退屈しなくて済みそうだし、まあいいか」
PRINTFORMDL そう言いながら、自身の陰唇を両手で開く輝夜	PRINTFORMDL そう言いながら、自身の陰唇を両手で開く輝夜
PRINTFORMDL 今日もまた、あの迷宮から帰ってきた者がいる	PRINTFORMDL 今日もまた、あの迷宮から帰ってきた者がいる
PRINTFORMDL ただ悔しくて、けれど、なすすべなど無くて、	PRINTFORMDL ただ悔しくて、けれど、なすすべなど無くて、
PRINTFORML 「ちっ、お前も煙にまかれりゃ良かったのに」	PRINTFORML 「ちっ、お前も煙にまかれりゃ良かったのに」
PRINTFORMDW 慧音は、妹紅が解放されたことに喜んでいる	PRINTFORMDW 慧音は、妹紅が解放されたことに喜んでいる
PRINTFORML 「弄りたいおまんこくちゅくちゅしたいっ！」	PRINTFORML 「弄りたいおまんこくちゅくちゅしたいっ！」
PRINTFORMW （やだっ！　いやなのに、なんで体がっ！？）	PRINTFORMW （やだっ！　いやなのに、なんで体がっ！？）
PRINTFORMW 「慧音は後に。……こっちの方が美味しいぞ」	PRINTFORMW 「慧音は後に。……こっちの方が美味しいぞ」
PRINTFORM おねがい、おねがい弄って、クリトリス弄ってぇ	PRINTFORM おねがい、おねがい弄って、クリトリス弄ってぇ
PRINTFORM 　いれさせておまんこにおちんちんいれさせてぇ	PRINTFORM 　いれさせておまんこにおちんちんいれさせてぇ
PRINTFORM 「かぐやのおまんこ、とろとろできもちいいよぉ	PRINTFORM 「かぐやのおまんこ、とろとろできもちいいよぉ
PRINTFORM 　おまんこくちゅくちゅしてきもちよくなろうよ	PRINTFORM 　おまんこくちゅくちゅしてきもちよくなろうよ
PRINTFORML 「%ARGS:1%は可愛くて気持ちいいよ」	PRINTFORML 「%ARGS:1%は可愛くて気持ちいいよ」
PRINTFORMW （違うっ！　そんなこと言いたくないっ！！）	PRINTFORMW （違うっ！　そんなこと言いたくないっ！！）
PRINTFORMDL 眠る妹紅の顔に、苦悶が色濃く浮かんでいる	PRINTFORMDL 眠る妹紅の顔に、苦悶が色濃く浮かんでいる
PRINTFORMDL 妹紅の手は、纏う物を探すように動いている	PRINTFORMDL 妹紅の手は、纏う物を探すように動いている
PRINTFORMDL 敏感なクリトリスを攻められ、泣き叫ぶ妹紅	PRINTFORMDL 敏感なクリトリスを攻められ、泣き叫ぶ妹紅
PRINTFORML 「このっ！　服なんて破いてどうする気っ！」	PRINTFORML 「このっ！　服なんて破いてどうする気っ！」
PRINTFORM 　やめ、つよ、た、たしゅ、んきゅぅぅっっっっ	PRINTFORM 　やめ、つよ、た、たしゅ、んきゅぅぅっっっっ
PRINTFORML 「っ！？　この、離せっ！　離してっっ！！」	PRINTFORML 「っ！？　この、離せっ！　離してっっ！！」
PRINTFORML 「煙幕っ！？　このっ！　見えなくてもっ！」	PRINTFORML 「煙幕っ！？　このっ！　見えなくてもっ！」
PRINTFORML 「けほけほっ……く、まだ、まだ行ける……」	PRINTFORML 「けほけほっ……く、まだ、まだ行ける……」
PRINTFORML 「……空気が、ねとついて、……気持ち悪い」	PRINTFORML 「……空気が、ねとついて、……気持ち悪い」
PRINTFORML 「ちっ、そんなところ、触ってくるなぁ……」	PRINTFORML 「ちっ、そんなところ、触ってくるなぁ……」
PRINTFORML 「いざというとき、寝ておかないとキツいよ」	PRINTFORML 「いざというとき、寝ておかないとキツいよ」
PRINTFORML 「そっちが寝たいときは、こっちが見るから」	PRINTFORML 「そっちが寝たいときは、こっちが見るから」
PRINTFORML 「……こんなところで寝て、大丈夫かな……」	PRINTFORML 「……こんなところで寝て、大丈夫かな……」
PRINTFORMDL くちぬちと膣口を白魚のような指で嬲る妹紅	PRINTFORMDL くちぬちと膣口を白魚のような指で嬲る妹紅
PRINTFORM 　や、でちゃうっ！　おちんちんでいっちゃうっ	PRINTFORM 　や、でちゃうっ！　おちんちんでいっちゃうっ
PRINTFORMDL ぽつりと呟き、妹紅は周囲に視線を向けた。	PRINTFORMDL ぽつりと呟き、妹紅は周囲に視線を向けた。
PRINTFORMDW 深々と、溜め息を吐くことしか出来なかった	PRINTFORMDW 深々と、溜め息を吐くことしか出来なかった
PRINTFORMDL 救いきれなかった、守ることが出来なかった	PRINTFORMDL 救いきれなかった、守ることが出来なかった
PRINTFORML 「手前ぇはこっちばっかりみるなっっ！！」	PRINTFORML 「手前ぇはこっちばっかりみるなっっ！！」
PRINTFORML 「お前が飲んでも、効果無いと思うけどな」	PRINTFORML 「お前が飲んでも、効果無いと思うけどな」
PRINTFORML 「トロいっ！　逃げ切れなかっただろっ！」	PRINTFORML 「トロいっ！　逃げ切れなかっただろっ！」
PRINTFORMDW 妹紅の様子に、慧音の口元が僅かに綻んだ	PRINTFORMDW 妹紅の様子に、慧音の口元が僅かに綻んだ
PRINTFORMW （っ！　な、なんで体勝手にこんなっ！？）	PRINTFORMW （っ！　な、なんで体勝手にこんなっ！？）
PRINTFORML 「くっ、や、やなのに、熱い、熱いよ……」	PRINTFORML 「くっ、や、やなのに、熱い、熱いよ……」
PRINTFORMW 「……何もしないから、気持ち良くしてよ」	PRINTFORMW 「……何もしないから、気持ち良くしてよ」
PRINTFORML 「ふふ、%ARGS:1%、気持ちいい？」	PRINTFORML 「ふふ、%ARGS:1%、気持ちいい？」
PRINTFORML 妹紅がエロくヤられまくる所が見たい人向け	PRINTFORML 妹紅がエロくヤられまくる所が見たい人向け
PRINTFORMDL それまで以上に、妹紅の体から力が抜けた	PRINTFORMDL それまで以上に、妹紅の体から力が抜けた
PRINTFORMDL 輝夜が痛ましげな表情で、唇を噛んでいる	PRINTFORMDL 輝夜が痛ましげな表情で、唇を噛んでいる
PRINTFORMDL 弱々しい妹紅の声音に、輝夜が訝っている	PRINTFORMDL 弱々しい妹紅の声音に、輝夜が訝っている
PRINTFORML 「いたいよ……、だれか、たすけてぇ……」	PRINTFORML 「いたいよ……、だれか、たすけてぇ……」
PRINTFORML 「この程度の痛み、どうってことないっ！」	PRINTFORML 「この程度の痛み、どうってことないっ！」
PRINTFORML 「くぅっ、このっ！　中で動くなぁっ！！」	PRINTFORML 「くぅっ、このっ！　中で動くなぁっ！！」
PRINTFORML 「くっ！　中、擦るなぁ……、このぉ……」	PRINTFORML 「くっ！　中、擦るなぁ……、このぉ……」
PRINTFORML 「くっ……、なんでこんな、ねむ、く……」	PRINTFORML 「くっ……、なんでこんな、ねむ、く……」
PRINTFORML 「くっ！　人の服をおもちゃみたいに！」		PRINTFORML 「くっ！　人の服をおもちゃみたいに！」	
PRINTFORML 「くっ！　このちょこまかと気持ち悪いっ」	PRINTFORML 「くっ！　このちょこまかと気持ち悪いっ」
PRINTFORML 「や、やめろっ！　この！　まだ奧に！？」	PRINTFORML 「や、やめろっ！　この！　まだ奧に！？」
PRINTFORML 「……ふぁ……ん。眠っておかないと……」	PRINTFORML 「……ふぁ……ん。眠っておかないと……」
PRINTFORMDL 感情の消えた表情で、アヌスを弄り始めた	PRINTFORMDL 感情の消えた表情で、アヌスを弄り始めた
PRINTFORM 「入れない、から……くすぐる、だけ、あんっ	PRINTFORM 「入れない、から……くすぐる、だけ、あんっ
PRINTFORM 　や、やら、しょこ、やぁあああああっっっっ	PRINTFORM 　や、やら、しょこ、やぁあああああっっっっ
PRINTFORMDL そして、腰をぶるりと震わせ、精を放った	PRINTFORMDL そして、腰をぶるりと震わせ、精を放った
PRINTFORMDL それ以上の言葉を続けることが出来なくて	PRINTFORMDL それ以上の言葉を続けることが出来なくて
PRINTFORMDL あの時、確かに妹紅は自分の意志で逃げた	PRINTFORMDL あの時、確かに妹紅は自分の意志で逃げた
PRINTFORMDW 口では文句を言いつつ、輝夜を抱き寄せる	PRINTFORMDW 口では文句を言いつつ、輝夜を抱き寄せる
PRINTFORMDL 自身の庵で新聞を見ながら、溜め息を吐く	PRINTFORMDL 自身の庵で新聞を見ながら、溜め息を吐く
PRINTFORML 「……この分だと、全員戻ってくるかもね」	PRINTFORML 「……この分だと、全員戻ってくるかもね」
PRINTFORML 『今日は妹紅ちゃんのおうちでおとまりー』	PRINTFORML 『今日は妹紅ちゃんのおうちでおとまりー』
PRINTFORML 「楽しげに見てる場合じゃないだろっ！」	PRINTFORML 「楽しげに見てる場合じゃないだろっ！」
PRINTFORMW 「守りは苦手だけど、言ってられないか」	PRINTFORMW 「守りは苦手だけど、言ってられないか」
PRINTFORML 「お前には勿体ないけどしょうがないな」	PRINTFORML 「お前には勿体ないけどしょうがないな」
PRINTFORMW 「ゴメン慧音……、必ず助けに来るから」	PRINTFORMW 「ゴメン慧音……、必ず助けに来るから」
PRINTFORMW 「さすがに、ちょっと退かないと不味い」	PRINTFORMW 「さすがに、ちょっと退かないと不味い」
PRINTFORM 「このていど、でも、こうかは、あるだろ」	PRINTFORM 「このていど、でも、こうかは、あるだろ」
PRINTFORML 「んぅっ……、力が、ぬけ、……あふっ」	PRINTFORML 「んぅっ……、力が、ぬけ、……あふっ」
PRINTFORMDW 妹紅の様子に、慧音は顔を赤くしている	PRINTFORMDW 妹紅の様子に、慧音は顔を赤くしている
PRINTFORMW 「ゴメン、慧音……、ちょっと動けない」	PRINTFORMW 「ゴメン、慧音……、ちょっと動けない」
PRINTFORMDW 妹紅の言葉に、輝夜が目を輝かせている	PRINTFORMDW 妹紅の言葉に、輝夜が目を輝かせている
PRINTFORML 「慧音、見て、私のＨな所全部見てよぉ」	PRINTFORML 「慧音、見て、私のＨな所全部見てよぉ」
PRINTFORMW 「このっ！　やっ！　慧音見ないでっ！」	PRINTFORMW 「このっ！　やっ！　慧音見ないでっ！」
PRINTFORML 「おねがい、ここずぼずぼしてよぉ……」	PRINTFORML 「おねがい、ここずぼずぼしてよぉ……」
PRINTFORMW 「……望んでない、仕方が無いんだ……」	PRINTFORMW 「……望んでない、仕方が無いんだ……」
PRINTFORMW 「慧音、お願い下がって、お願いだから」	PRINTFORMW 「慧音、お願い下がって、お願いだから」
PRINTFORM 　けいねとおまんこくちゅくちゅさせたいの	PRINTFORM 　けいねとおまんこくちゅくちゅさせたいの
PRINTFORMW （ゴメン慧音ゴメン慧音ゴメン慧音……）	PRINTFORMW （ゴメン慧音ゴメン慧音ゴメン慧音……）
PRINTFORMW （くそっ！　こんなの、したくないのに）	PRINTFORMW （くそっ！　こんなの、したくないのに）
PRINTFORMW はその行の左にある「;」を消しましょう	PRINTFORMW はその行の左にある「;」を消しましょう
PRINTFORMDL 膣口を擦り立てられ、妹紅は達している	PRINTFORMDL 膣口を擦り立てられ、妹紅は達している
PRINTFORMDL 服がはじけ飛んでも、身じろぎもしない	PRINTFORMDL 服がはじけ飛んでも、身じろぎもしない
PRINTFORMDL 肌が晒されようと妹紅は全く反応しない	PRINTFORMDL 肌が晒されようと妹紅は全く反応しない
PRINTFORML 「ちっ！　これくらい、馴れてるっ！！」	PRINTFORML 「ちっ！　これくらい、馴れてるっ！！」
PRINTFORML 「痛っ！　でもこの程度、馴れてるっ！」	PRINTFORML 「痛っ！　でもこの程度、馴れてるっ！」
PRINTFORML 「痛いくらいが、どうだって言うのよ！」	PRINTFORML 「痛いくらいが、どうだって言うのよ！」
PRINTFORML 「……はぁ……はぁ…………ん…………」	PRINTFORML 「……はぁ……はぁ…………ん…………」
PRINTFORML 「くぅっ……、体が……でも、まだまだ」	PRINTFORML 「くぅっ……、体が……でも、まだまだ」
PRINTFORML 「……まだ、この程度で、負けたり……」	PRINTFORML 「……まだ、この程度で、負けたり……」
PRINTFORML 「いやぁっっ！　中で動くなぁっっ！！」	PRINTFORML 「いやぁっっ！　中で動くなぁっっ！！」
PRINTFORML 「ぐっ……、この……、はな、して……」	PRINTFORML 「ぐっ……、この……、はな、して……」
PRINTFORML 「……あふ、そろそろ眠っておこうかな」	PRINTFORML 「……あふ、そろそろ眠っておこうかな」
PRINTFORMDL 本人が現れてちょっかいをかけてくる筈	PRINTFORMDL 本人が現れてちょっかいをかけてくる筈
PRINTFORMW 「動けさえすれば、多少の怪我は……」	PRINTFORMW 「動けさえすれば、多少の怪我は……」
PRINTFORMW 「大丈夫、慧音。これで、少しは楽に」	PRINTFORMW 「大丈夫、慧音。これで、少しは楽に」
PRINTFORML 「私が出てやるんだ、ありがたく思え」	PRINTFORML 「私が出てやるんだ、ありがたく思え」
PRINTFORML 「ちっ、今度はお前が出れば良いだろ」	PRINTFORML 「ちっ、今度はお前が出れば良いだろ」
PRINTFORMDW 慧音が心配そうな表情で見つめてくる	PRINTFORMDW 慧音が心配そうな表情で見つめてくる
PRINTFORML 「はっ……はっ……、あつ……ぅ……」	PRINTFORML 「はっ……はっ……、あつ……ぅ……」
PRINTFORML 「ん……ふぁ……んくぅ……やぁ……」	PRINTFORML 「ん……ふぁ……んくぅ……やぁ……」
PRINTFORMW 「……だい、じょうぶ……けい、ね？」	PRINTFORMW 「……だい、じょうぶ……けい、ね？」
PRINTFORMW 「はぁはぁ……熱い、体が、熱い……」	PRINTFORMW 「はぁはぁ……熱い、体が、熱い……」
PRINTFORM 　おちんちん、きもちよくしてほしいよぉ	PRINTFORM 　おちんちん、きもちよくしてほしいよぉ
PRINTFORMW 「これで、良い？　私だけで良いだろ」	PRINTFORMW 「これで、良い？　私だけで良いだろ」
PRINTFORML 「はぁはぁ……ん、ここにいれて……」	PRINTFORML 「はぁはぁ……ん、ここにいれて……」
PRINTFORMW 「慧音、今日は寺子屋はどうしたの？」	PRINTFORMW 「慧音、今日は寺子屋はどうしたの？」
PRINTFORMW 「あ、慧音。一緒に筍でも採らない？」	PRINTFORMW 「あ、慧音。一緒に筍でも採らない？」
PRINTFORML （何もないのに、何してるんだ、私は）	PRINTFORML （何もないのに、何してるんだ、私は）
PRINTFORM 　おなかのおくまであいしてあげるからぁ	PRINTFORM 　おなかのおくまであいしてあげるからぁ
PRINTFORM 　%ARGS:1%もきもちよくなろうよ	PRINTFORM 　%ARGS:1%もきもちよくなろうよ
PRINTFORM 　%ARGS:1%も、きもち、いいよね	PRINTFORM 　%ARGS:1%も、きもち、いいよね
PRINTFORML 「くっ、この程度で、負けるかっっ！」	PRINTFORML 「くっ、この程度で、負けるかっっ！」
PRINTFORM 　やあ、お尻弄られるの、きもちいいっっ	PRINTFORM 　やあ、お尻弄られるの、きもちいいっっ
PRINTFORML 「やっっ！？　力が、抜けるっっ！！」	PRINTFORML 「やっっ！？　力が、抜けるっっ！！」
PRINTFORML 「きゃっ！　っ！！　このぉっっ！！」	PRINTFORML 「きゃっ！　っ！！　このぉっっ！！」
PRINTFORML 「ひっ！？　な、何か入って来る！？」	PRINTFORML 「ひっ！？　な、何か入って来る！？」
PRINTFORML 「くっ……、着替えさえ、あれば……」	PRINTFORML 「くっ……、着替えさえ、あれば……」
PRINTFORML 「こんな格好……、いやなの、に……」	PRINTFORML 「こんな格好……、いやなの、に……」
PRINTFORML 「……私の事は良いから、行って……」	PRINTFORML 「……私の事は良いから、行って……」
PRINTFORML 「……ん、はぁ……、中で、震えてる」	PRINTFORML 「……ん、はぁ……、中で、震えてる」
PRINTFORML 「は、んっ！　ふぅ、ふぅ……んくっ」	PRINTFORML 「は、んっ！　ふぅ、ふぅ……んくっ」
PRINTFORM 「やっ！　おちんちんっ、おちんちんっっ	PRINTFORM 「やっ！　おちんちんっ、おちんちんっっ
PRINTFORMDL 妹紅は一人妖怪の山の頂に立っていた	PRINTFORMDL 妹紅は一人妖怪の山の頂に立っていた
PRINTFORMDL 「てかまあ、なんでこうなるんだ？」	PRINTFORMDL 「てかまあ、なんでこうなるんだ？」
PRINTFORMDL 手に残っていた炎の残滓を振り払い、	PRINTFORMDL 手に残っていた炎の残滓を振り払い、
PRINTFORMDL にやりと笑った妹紅は迷宮を後にした	PRINTFORMDL にやりと笑った妹紅は迷宮を後にした
PRINTFORMDL 感情のない表情で、妹紅は歩き出した	PRINTFORMDL 感情のない表情で、妹紅は歩き出した
PRINTFORML 「今だけは、死なれちゃ困るからな」	PRINTFORML 「今だけは、死なれちゃ困るからな」
PRINTFORML 「お前の裸なんて見たくないからな」	PRINTFORML 「お前の裸なんて見たくないからな」
PRINTFORMW 「ん……、ちょっとは落ち着いたな」	PRINTFORMW 「ん……、ちょっとは落ち着いたな」
PRINTFORMW 「慧音、これで少しでも落ち着いて」	PRINTFORMW 「慧音、これで少しでも落ち着いて」
PRINTFORMW 「慧音、はい。これで大丈夫だから」	PRINTFORMW 「慧音、はい。これで大丈夫だから」
PRINTFORMW 「道具に頼るのは趣味じゃ無いけど」	PRINTFORMW 「道具に頼るのは趣味じゃ無いけど」
PRINTFORML 「なんでお前もついてきてるんだよ」	PRINTFORML 「なんでお前もついてきてるんだよ」
PRINTFORMW 「ゴメン慧音、ちょっと下がらせて」	PRINTFORMW 「ゴメン慧音、ちょっと下がらせて」
PRINTFORM 「あつまれ……はやく、はや、く……」	PRINTFORM 「あつまれ……はやく、はや、く……」
PRINTFORMW 「このっ！　離せっ！　離してっ！」	PRINTFORMW 「このっ！　離せっ！　離してっ！」
PRINTFORML 「くそっ！　離せっ離せってばっ！」	PRINTFORML 「くそっ！　離せっ離せってばっ！」
PRINTFORMW 「ふぅふぅ……んぅ……ふぁっ……」	PRINTFORMW 「ふぅふぅ……んぅ……ふぁっ……」
PRINTFORMW 「……ん、ここ熱くて切ないな……」	PRINTFORMW 「……ん、ここ熱くて切ないな……」
PRINTFORMW 「このっ！　気持ち悪いんだよっ！」	PRINTFORMW 「このっ！　気持ち悪いんだよっ！」
PRINTFORMW 「ん……、しょうがない、んだから」	PRINTFORMW 「ん……、しょうがない、んだから」
PRINTFORMW 「ここに、きて……、慧音も、して」	PRINTFORMW 「ここに、きて……、慧音も、して」
PRINTFORML 「……はぁ。ほら、好きに使いなよ」	PRINTFORML 「……はぁ。ほら、好きに使いなよ」
PRINTFORMW 「ん……、気持ち良くして、お願い」	PRINTFORMW 「ん……、気持ち良くして、お願い」
PRINTFORML 「……なんで、私がこんな目に……」	PRINTFORML 「……なんで、私がこんな目に……」
PRINTFORMW 「あー、筍のあく抜きしないと……」	PRINTFORMW 「あー、筍のあく抜きしないと……」
PRINTFORM 　かぐやもきもちよくしてあげるからぁ	PRINTFORM 　かぐやもきもちよくしてあげるからぁ
PRINTFORM 「かぐやぁ、おまんこくちゅくちゅしよ	PRINTFORM 「かぐやぁ、おまんこくちゅくちゅしよ
PRINTFORM 「%ARGS:1%も、きもちいいよね	PRINTFORM 「%ARGS:1%も、きもちいいよね
PRINTFORML PTプレイ不向き、ねちょメイン口上	PRINTFORML PTプレイ不向き、ねちょメイン口上
PRINTFORMDL 妹紅の睡顔は、苦痛に青ざめている	PRINTFORMDL 妹紅の睡顔は、苦痛に青ざめている
PRINTFORML 「んくっ、あふっ……もう、やだぁ」	PRINTFORML 「んくっ、あふっ……もう、やだぁ」
PRINTFORML 「痛っ！！　だから、どうしたっ！」	PRINTFORML 「痛っ！！　だから、どうしたっ！」
PRINTFORMDL 輝夜が感心した表情を浮かべている	PRINTFORMDL 輝夜が感心した表情を浮かべている
PRINTFORML 「それじゃ、この辺で寝ておこうか」	PRINTFORML 「それじゃ、この辺で寝ておこうか」
PRINTFORML 「んぅ、気持ちいい……、でも……」	PRINTFORML 「んぅ、気持ちいい……、でも……」
PRINTFORM 「やめてっ！　おちんちんよわいのっっ	PRINTFORM 「やめてっ！　おちんちんよわいのっっ
PRINTFORMDL 膣腔を抉られ、妹紅は身を震わせた	PRINTFORMDL 膣腔を抉られ、妹紅は身を震わせた
PRINTFORMDL 膣内を擦り立てられ、妹紅は達した	PRINTFORMDL 膣内を擦り立てられ、妹紅は達した
PRINTFORML 「……なんで、私を逃がしたんだよ」	PRINTFORML 「……なんで、私を逃がしたんだよ」
PRINTFORMDL 深夜、迷いの竹林に訪れる者達は、	PRINTFORMDL 深夜、迷いの竹林に訪れる者達は、
PRINTFORML 「……で、どこまでついてくる気？」	PRINTFORML 「……で、どこまでついてくる気？」
PRINTFORMW 「はぁはぁ……、腕一本捨てるか」	PRINTFORMW 「はぁはぁ……、腕一本捨てるか」
PRINTFORMW 「慧音、大丈夫？　これ使って！」	PRINTFORMW 「慧音、大丈夫？　これ使って！」
PRINTFORML 「ほらよ、その貧相な体覆っとけ」	PRINTFORML 「ほらよ、その貧相な体覆っとけ」
PRINTFORMW 「ちっ！　慧音に手を出すなっ！」	PRINTFORMW 「ちっ！　慧音に手を出すなっ！」
PRINTFORM 「ん、くっ……やられて、たまるか」	PRINTFORM 「ん、くっ……やられて、たまるか」
PRINTFORML 「ちっ！　まだ、離れないかっ！」	PRINTFORML 「ちっ！　まだ、離れないかっ！」
PRINTFORMW 「はぁはぁ……んく……はぁ……」	PRINTFORMW 「はぁはぁ……んく……はぁ……」
PRINTFORML 「お前の方が、向いてるだろ……」	PRINTFORML 「お前の方が、向いてるだろ……」
PRINTFORM 　おねがい、こすって！　ださせてぇ	PRINTFORM 　おねがい、こすって！　ださせてぇ
PRINTFORML 「ん、ふふ、今日も良い天気だな」	PRINTFORML 「ん、ふふ、今日も良い天気だな」
PRINTFORM 　おまんこせつないの、せつないのぉ	PRINTFORM 　おまんこせつないの、せつないのぉ
PRINTFORML 「いたいよ、だれか、たすけてぇ」	PRINTFORML 「いたいよ、だれか、たすけてぇ」
PRINTFORML 「これくらい、馴れてるのに……」	PRINTFORML 「これくらい、馴れてるのに……」
PRINTFORML 「砂煙！？　くっ、前が見えない」	PRINTFORML 「砂煙！？　くっ、前が見えない」
PRINTFORML 「なにこれ、力が……ぬける……」	PRINTFORML 「なにこれ、力が……ぬける……」
PRINTFORML 「この、化け物の分際でっっ！！」	PRINTFORML 「この、化け物の分際でっっ！！」
PRINTFORML 「ぐっ！　や、中で暴れてる！？」	PRINTFORML 「ぐっ！　や、中で暴れてる！？」
PRINTFORML 「やんっ！　胸に、触るなっっ！」	PRINTFORML 「やんっ！　胸に、触るなっっ！」
PRINTFORM 　ふぁあっっ！！　おかしくなるっっ	PRINTFORM 　ふぁあっっ！！　おかしくなるっっ
PRINTFORM 「だめなのぉ、おかしくなるのぉ……	PRINTFORM 「だめなのぉ、おかしくなるのぉ……
PRINTFORML 「んっ、ふぁっ……、はぁ、んく」	PRINTFORML 「んっ、ふぁっ……、はぁ、んく」
PRINTFORML 「ちっ、ややこしそうな場所だな」	PRINTFORML 「ちっ、ややこしそうな場所だな」
PRINTFORMDL そう呟いて、妹紅は一歩を刻んだ	PRINTFORMDL そう呟いて、妹紅は一歩を刻んだ
PRINTFORMDL そして、強引に上体を起こさせる	PRINTFORMDL そして、強引に上体を起こさせる
PRINTFORMDL ……あの異変から数十年が経って	PRINTFORMDL ……あの異変から数十年が経って
PRINTFORMDW それでもまだ輝夜が帰ってこない	PRINTFORMDW それでもまだ輝夜が帰ってこない
PRINTFORMDL その苛立ちに妹紅は舌打ちを残す	PRINTFORMDL その苛立ちに妹紅は舌打ちを残す
PRINTFORMDL ぽつりと呟いた妹紅は眼を閉じる	PRINTFORMDL ぽつりと呟いた妹紅は眼を閉じる
PRINTFORMDL 不尽の煙を上げる火口を見下ろす	PRINTFORMDL 不尽の煙を上げる火口を見下ろす
PRINTFORML 「くそっ、勝手に笑ってろバカ」	PRINTFORML 「くそっ、勝手に笑ってろバカ」
PRINTFORML 「体力さえあれば、この程度で」	PRINTFORML 「体力さえあれば、この程度で」
PRINTFORMW 「慧音、大丈夫、気がついた？」	PRINTFORMW 「慧音、大丈夫、気がついた？」
PRINTFORM 「燃え尽きろぉおおっっっ！！！」	PRINTFORM 「燃え尽きろぉおおっっっ！！！」
PRINTFORML 「すぅ……はぁ……、すぅ……」	PRINTFORML 「すぅ……はぁ……、すぅ……」
PRINTFORMW 「慧音……、少し、待って……」	PRINTFORMW 「慧音……、少し、待って……」
PRINTFORMW 「くっ！　触らせて堪るかっ！」	PRINTFORMW 「くっ！　触らせて堪るかっ！」
PRINTFORML 「……お前じゃ、無理だもんな」	PRINTFORML 「……お前じゃ、無理だもんな」
PRINTFORM あついの、クリトリス熱いからぁっ	PRINTFORM あついの、クリトリス熱いからぁっ
PRINTFORML 「みるな、輝夜、みないで……」	PRINTFORML 「みるな、輝夜、みないで……」
PRINTFORMW 「私さえ、がまん、すれば……」	PRINTFORMW 「私さえ、がまん、すれば……」
PRINTFORMW 「んぅ……、ここに、欲しいの」	PRINTFORMW 「んぅ……、ここに、欲しいの」
PRINTFORMW 「……はぁ……、好きにしなよ」	PRINTFORMW 「……はぁ……、好きにしなよ」
PRINTFORML 「……ん、釣りでもしようかな」	PRINTFORML 「……ん、釣りでもしようかな」
PRINTFORM 　バカになる、お尻バカになるよぉ	PRINTFORM 　バカになる、お尻バカになるよぉ
PRINTFORML 　クリだめおちんちんだめぇっっ	PRINTFORML 　クリだめおちんちんだめぇっっ
PRINTFORM 「や、ん、ふぁっ、んきゅ、あひっ	PRINTFORM 「や、ん、ふぁっ、んきゅ、あひっ
PRINTFORML 「ここまでくれば、大丈夫だね」	PRINTFORML 「ここまでくれば、大丈夫だね」
PRINTFORML 「……っ……、も……か……な」	PRINTFORML 「……っ……、も……か……な」
PRINTFORML 「ごめん……、助け、られない」	PRINTFORML 「ごめん……、助け、られない」
PRINTFORML 「絶対、助けに、来るから……」	PRINTFORML 「絶対、助けに、来るから……」
PRINTFORML 「眠って置いた方が、いいよね」	PRINTFORML 「眠って置いた方が、いいよね」
PRINTFORM 　んっ、や、指、きもち、いい……	PRINTFORM 　んっ、や、指、きもち、いい……
PRINTFORM 「だめ、こんなの、だめなのにぃっ	PRINTFORM 「だめ、こんなの、だめなのにぃっ
PRINTFORM 　だめこれっ、ひぁあああっっっっ	PRINTFORM 　だめこれっ、ひぁあああっっっっ
PRINTFORML 「はぁ……、んくっ……ん、ふ」	PRINTFORML 「はぁ……、んくっ……ん、ふ」
PRINTFORM やあ、イく、イッちゃうのぉっっっ	PRINTFORM やあ、イく、イッちゃうのぉっっっ
PRINTFORMDL 輝夜が居なくて、せいせいする	PRINTFORMDL 輝夜が居なくて、せいせいする
PRINTFORMDL その異変が終わりを告げて後、	PRINTFORMDL その異変が終わりを告げて後、
PRINTFORML 「全く、不毛にも程があるよね」	PRINTFORML 「全く、不毛にも程があるよね」
PRINTFORML 「……よろしくおねがいします」	PRINTFORML 「……よろしくおねがいします」
PRINTFORMDL のろのろと、妹紅は立ち上がる	PRINTFORMDL のろのろと、妹紅は立ち上がる
PRINTFORMW 「少し、気を落ち着けないと」	PRINTFORMW 「少し、気を落ち着けないと」
PRINTFORMW 「一旦体勢を立て直さないと」	PRINTFORMW 「一旦体勢を立て直さないと」
PRINTFORML 「手前ぇも前に出たらどうだ」	PRINTFORML 「手前ぇも前に出たらどうだ」
PRINTFORMW 「悪い慧音、少し下がるから」	PRINTFORMW 「悪い慧音、少し下がるから」
PRINTFORMW 「くっ、あと少しだったのに」	PRINTFORMW 「くっ、あと少しだったのに」
PRINTFORM 「もえつきろ……、おねがいっ」	PRINTFORM 「もえつきろ……、おねがいっ」
PRINTFORML 「やめ、そこはやめろぉっ！」	PRINTFORML 「やめ、そこはやめろぉっ！」
PRINTFORML 「……好きに、すれば良いよ」	PRINTFORML 「……好きに、すれば良いよ」
PRINTFORML 「……私さえ、ガマンすれば」	PRINTFORML 「……私さえ、ガマンすれば」
PRINTFORM 「んっ！　おねがい、おねがいぃ	PRINTFORM 「んっ！　おねがい、おねがいぃ
PRINTFORM 　おちんちん、きもちよくしてぇ	PRINTFORM 　おちんちん、きもちよくしてぇ
PRINTFORM 　慧音、……お願い出させてよぉ	PRINTFORM 　慧音、……お願い出させてよぉ
PRINTFORMW 「おねがい、慧音は下がって」	PRINTFORMW 「おねがい、慧音は下がって」
PRINTFORMW 「どうせ、気持ち良くないし」	PRINTFORMW 「どうせ、気持ち良くないし」
PRINTFORML 「……今度は、お前がやれよ」	PRINTFORML 「……今度は、お前がやれよ」
PRINTFORMW 「ふふ、どう、気持ちいい？」	PRINTFORMW 「ふふ、どう、気持ちいい？」
PRINTFORMW 「可愛いね、ホント、可愛い」	PRINTFORMW 「可愛いね、ホント、可愛い」
PRINTFORM 「かぐやぁ、いいことしようよぉ	PRINTFORM 「かぐやぁ、いいことしようよぉ
PRINTFORM 　いいよね、いつもどおりしても	PRINTFORM 　いいよね、いつもどおりしても
PRINTFORM 「ねえかぐやも、きもちいいよね	PRINTFORM 「ねえかぐやも、きもちいいよね
PRINTFORM 　気持ちいい、気持ちいいの……	PRINTFORM 　気持ちいい、気持ちいいの……
PRINTFORML 「くっ！　この化け物っっ！」	PRINTFORML 「くっ！　この化け物っっ！」
PRINTFORML 「私の肌は高く付くからな！」	PRINTFORML 「私の肌は高く付くからな！」
PRINTFORML 「この、そこはやめてってば」	PRINTFORML 「この、そこはやめてってば」
PRINTFORM 　や、そこ、きゅって、ひゃふっ	PRINTFORM 　や、そこ、きゅって、ひゃふっ
PRINTFORML 「くぅ、こんな、こんなこと」	PRINTFORML 「くぅ、こんな、こんなこと」
PRINTFORML 「くっ……、早く、逃げなよ」	PRINTFORML 「くっ……、早く、逃げなよ」
PRINTFORM 、……んくっ、こんな、あふ……	PRINTFORM 、……んくっ、こんな、あふ……
PRINTFORM 　こんなの、おかしくなるぅっっ	PRINTFORM 　こんなの、おかしくなるぅっっ
PRINTFORM 　そこ、だめ、だめなのにぃっっ	PRINTFORM 　そこ、だめ、だめなのにぃっっ
PRINTFORMDL 妹紅は輝夜の隣にあり続けた	PRINTFORMDL 妹紅は輝夜の隣にあり続けた
PRINTFORMDL 仲間達が、奧に向かって行く	PRINTFORMDL 仲間達が、奧に向かって行く
PRINTFORMDW 男のモノが、形を為していた	PRINTFORMDW 男のモノが、形を為していた
PRINTFORMW 「……っ、もう、いや……」	PRINTFORMW 「……っ、もう、いや……」
PRINTFORMW 「くっ、今は守りに入るか」	PRINTFORMW 「くっ、今は守りに入るか」
PRINTFORML 「お前に渡すのは癪だけど」	PRINTFORML 「お前に渡すのは癪だけど」
PRINTFORMW 「とりあえず羽織っとこう」	PRINTFORMW 「とりあえず羽織っとこう」
PRINTFORMW 「慧音、よかったら使って」	PRINTFORMW 「慧音、よかったら使って」
PRINTFORMW 「こんなの、要らないのに」	PRINTFORMW 「こんなの、要らないのに」
PRINTFORMW 「ちっ、逃げれなかったか」	PRINTFORMW 「ちっ、逃げれなかったか」
PRINTFORM 「まとめて、もえつきろ……」	PRINTFORM 「まとめて、もえつきろ……」
PRINTFORM 「ぜんぶもやして、やる……」	PRINTFORM 「ぜんぶもやして、やる……」
PRINTFORM 「ぜんぶ、こわれろ……っ！」	PRINTFORM 「ぜんぶ、こわれろ……っ！」
PRINTFORM 「さっさとしねぇえっっ！！」	PRINTFORM 「さっさとしねぇえっっ！！」
PRINTFORM 「まとめて燃やしてやるっ！」	PRINTFORM 「まとめて燃やしてやるっ！」
PRINTFORM 「こういうのも得意なんでね」	PRINTFORM 「こういうのも得意なんでね」
PRINTFORML 「さっさと離れろっっ！！」	PRINTFORML 「さっさと離れろっっ！！」
PRINTFORMW 「……慧……音？　……ん」	PRINTFORMW 「……慧……音？　……ん」
PRINTFORML 「くぅ……、この離せっ！」	PRINTFORML 「くぅ……、この離せっ！」
PRINTFORMW 「くっ、なんでこんな……」	PRINTFORMW 「くっ、なんでこんな……」
PRINTFORM 　おねがいっ！　ここ弄ってっ	PRINTFORM 　おねがいっ！　ここ弄ってっ
PRINTFORMW 「……ここに、ちょうだい」	PRINTFORMW 「……ここに、ちょうだい」
PRINTFORML 「ん、今日も良い感じだな」	PRINTFORML 「ん、今日も良い感じだな」
PRINTFORM 「けいね、ほらきもちいいよね	PRINTFORM 「けいね、ほらきもちいいよね
PRINTFORM 　いっしょに、きもちよくなろ	PRINTFORM 　いっしょに、きもちよくなろ
PRINTFORMW （っ！　なんでこんなっ！）	PRINTFORMW （っ！　なんでこんなっ！）
PRINTFORML 「んっ、やめ、ろって、ば」	PRINTFORML 「んっ、やめ、ろって、ば」
PRINTFORML 「……ごめん、無理言って」	PRINTFORML 「……ごめん、無理言って」
PRINTFORML 「勝手ばかり言って悪いね」	PRINTFORML 「勝手ばかり言って悪いね」
PRINTFORM おもちゃで、なんて……ふぁっ	PRINTFORM おもちゃで、なんて……ふぁっ
PRINTFORM 　お尻になんて……ふぁっ……	PRINTFORM 　お尻になんて……ふぁっ……
PRINTFORM 　や、だめ、だめ、なのに……	PRINTFORM 　や、だめ、だめ、なのに……
PRINTFORM 「……がまん、できないよ……	PRINTFORM 「……がまん、できないよ……
PRINTFORM 「や、ぶるぶる震えて、んくっ	PRINTFORM 「や、ぶるぶる震えて、んくっ
PRINTFORM 「だめ、んっ、あふっ、ふぁっ	PRINTFORM 「だめ、んっ、あふっ、ふぁっ
PRINTFORM 「……はぁ、こ、んな……んっ	PRINTFORM 「……はぁ、こ、んな……んっ
PRINTFORM 　だめぇ、おちんちんだめぇっ	PRINTFORM 　だめぇ、おちんちんだめぇっ
PRINTFORMDL 壊れた少女を救うためにと	PRINTFORMDL 壊れた少女を救うためにと
PRINTFORML 「やめて、こんなのもう」	PRINTFORML 「やめて、こんなのもう」
PRINTFORMW 「少しでも回復しないと」	PRINTFORMW 「少しでも回復しないと」
PRINTFORML 「輝夜、良いものやるよ」	PRINTFORML 「輝夜、良いものやるよ」
PRINTFORMW 「大丈夫？　もう平気？」	PRINTFORMW 「大丈夫？　もう平気？」
PRINTFORM 「まとめて、つぶれろ……」	PRINTFORM 「まとめて、つぶれろ……」
PRINTFORM 「本気なんて、必要ないね」	PRINTFORM 「本気なんて、必要ないね」
PRINTFORM 「これで、終われぇっ！！」	PRINTFORM 「これで、終われぇっ！！」
PRINTFORM 「集まれ……、集まれ……」	PRINTFORM 「集まれ……、集まれ……」
PRINTFORM 「焼却してやるっっっ！！」	PRINTFORM 「焼却してやるっっっ！！」
PRINTFORM 「消えろ消えろ消えろっ！」	PRINTFORM 「消えろ消えろ消えろっ！」
PRINTFORM 「これで動けないだろっ！」	PRINTFORM 「これで動けないだろっ！」
PRINTFORML 「……はぁはぁ……くっ」	PRINTFORML 「……はぁはぁ……くっ」
PRINTFORMW 「……いや、なのに……」	PRINTFORMW 「……いや、なのに……」
PRINTFORM 　慧音にも、してほしいのぉ	PRINTFORM 　慧音にも、してほしいのぉ
PRINTFORM 「んぅ、おちんちん、あつい	PRINTFORM 「んぅ、おちんちん、あつい
PRINTFORMW 「……ふぅ、勝手にしろ」	PRINTFORMW 「……ふぅ、勝手にしろ」
PRINTFORML 「くぅ、この、程度でぇ」	PRINTFORML 「くぅ、この、程度でぇ」
PRINTFORM 　よわいの、よわいかりゃぁ	PRINTFORM 　よわいの、よわいかりゃぁ
PRINTFORML 「くっ、入り口、擦るな」	PRINTFORML 「くっ、入り口、擦るな」
PRINTFORML 　んく、我慢、しないと」	PRINTFORML 　んく、我慢、しないと」
PRINTFORM 　ひんっ！　乳首気持ちいい	PRINTFORM 　ひんっ！　乳首気持ちいい
PRINTFORM 　してる場合じゃ、ないのに	PRINTFORM 　してる場合じゃ、ないのに
PRINTFORM 　あたま、バカになっちゃう	PRINTFORM 　あたま、バカになっちゃう
PRINTFORM 「おちんちん、おちんちんっ	PRINTFORM 「おちんちん、おちんちんっ
PRINTFORM 「んきゅっ、やぁ、きゅんっ	PRINTFORM 「んきゅっ、やぁ、きゅんっ
PRINTFORM 　おかしきゅ、にゃりゅ……	PRINTFORM 　おかしきゅ、にゃりゅ……
PRINTFORML 「気持ち、いい……かな」	PRINTFORML 「気持ち、いい……かな」
PRINTFORML 「ん、これ、いい、かも」	PRINTFORML 「ん、これ、いい、かも」
PRINTFORMDW 自身の罪を贖うためにと	PRINTFORMDW 自身の罪を贖うためにと
PRINTFORMW 『妹紅、ほら月が綺麗よ』	PRINTFORMW 『妹紅、ほら月が綺麗よ』
PRINTFORMDL 永遠亭の中にある一部屋	PRINTFORMDL 永遠亭の中にある一部屋
PRINTFORMDL 「はー、呑んだ呑んだ」	PRINTFORMDL 「はー、呑んだ呑んだ」
PRINTFORMW 「ここは一旦下がるか」	PRINTFORMW 「ここは一旦下がるか」
PRINTFORM 「はぁはぁ……、はっ！」	PRINTFORM 「はぁはぁ……、はっ！」
PRINTFORM 「……離れろぉっっ！！」	PRINTFORM 「……離れろぉっっ！！」
PRINTFORM 「消え失せろぉっっ！！」	PRINTFORM 「消え失せろぉっっ！！」
PRINTFORM 「これで、終われぇっ！」	PRINTFORM 「これで、終われぇっ！」
PRINTFORM 「足下がお留守だよっ！」	PRINTFORM 「足下がお留守だよっ！」
PRINTFORMW 「喰われて堪るかっ！」	PRINTFORMW 「喰われて堪るかっ！」
PRINTFORM 「んっっ！！　や、熱いの	PRINTFORM 「んっっ！！　や、熱いの
PRINTFORM 　おちんちん、熱いのぉっ	PRINTFORM 　おちんちん、熱いのぉっ
PRINTFORML 「輝夜、輝夜輝夜っ！」	PRINTFORML 「輝夜、輝夜輝夜っ！」
PRINTFORM 「もうがまんできないから	PRINTFORM 「もうがまんできないから
PRINTFORM 　わたしも、きもちいいよ	PRINTFORM 　わたしも、きもちいいよ
PRINTFORM 　かぐやもＨすきだもんね	PRINTFORM 　かぐやもＨすきだもんね
PRINTFORM 　、指が、かって、に……	PRINTFORM 　、指が、かって、に……
PRINTFORM 　なのに、だめ、なのに、	PRINTFORM 　なのに、だめ、なのに、
PRINTFORML 「痛ぅ……このぉ……」	PRINTFORML 「痛ぅ……このぉ……」
PRINTFORM 　ふぁああああんっっっっ	PRINTFORM 　ふぁああああんっっっっ
PRINTFORM こんにゃのおかしくなりゅ	PRINTFORM こんにゃのおかしくなりゅ
PRINTFORM 　や、そこいやぁああっっ	PRINTFORM 　や、そこいやぁああっっ
PRINTFORM 　あひんっ、やっ、んくっ	PRINTFORM 　あひんっ、やっ、んくっ
PRINTFORM 　んくっ、あふっ、ふぁっ	PRINTFORM 　んくっ、あふっ、ふぁっ
PRINTFORM 「やっ！　腰、腰が勝手に	PRINTFORM 「やっ！　腰、腰が勝手に
PRINTFORM 　んにゃああああっっっっ	PRINTFORM 　んにゃああああっっっっ
PRINTFORMDW なぜか輝夜が隣にいる	PRINTFORMDW なぜか輝夜が隣にいる
PRINTFORMW 「やめろ、気持ち悪い」	PRINTFORMW 「やめろ、気持ち悪い」
PRINTFORML 「今日だけ、だからね」	PRINTFORML 「今日だけ、だからね」
PRINTFORMW 「もう、やめて……」	PRINTFORMW 「もう、やめて……」
PRINTFORMW 「一気に飲まないと」	PRINTFORMW 「一気に飲まないと」
PRINTFORMW 「慧音早くこれを！」	PRINTFORMW 「慧音早くこれを！」
PRINTFORMW 「早く着替えないと」	PRINTFORMW 「早く着替えないと」
PRINTFORMW 「はい、代わりの服」	PRINTFORMW 「はい、代わりの服」
PRINTFORMW 「これでも飲んでろ」	PRINTFORMW 「これでも飲んでろ」
PRINTFORMW 「これで、なんとか」	PRINTFORMW 「これで、なんとか」
PRINTFORMW 「慧音。これ使って」	PRINTFORMW 「慧音。これ使って」
PRINTFORML 「あー、気持ち悪い」	PRINTFORML 「あー、気持ち悪い」
PRINTFORMW 「早く行こう、慧音」	PRINTFORMW 「早く行こう、慧音」
PRINTFORMW 「慧音は下がってて」	PRINTFORMW 「慧音は下がってて」
PRINTFORMW 「私が前に出るから」	PRINTFORMW 「私が前に出るから」
PRINTFORM 「くぅ……、そこっ！」	PRINTFORM 「くぅ……、そこっ！」
PRINTFORM 「いたぶってやるよ！」	PRINTFORM 「いたぶってやるよ！」
PRINTFORM 「まとめて消えろっ！」	PRINTFORM 「まとめて消えろっ！」
PRINTFORM 「連打でも食らえっ！」	PRINTFORM 「連打でも食らえっ！」
PRINTFORM 「まとめて食らえっ！」	PRINTFORM 「まとめて食らえっ！」
PRINTFORM 「さっさと死ねぇっ！」	PRINTFORM 「さっさと死ねぇっ！」
PRINTFORML 「つっ……くぅ……」	PRINTFORML 「つっ……くぅ……」
PRINTFORM 　あついよ、あついよぉ	PRINTFORM 　あついよ、あついよぉ
PRINTFORM 「はぁはぁ、あついのぉ	PRINTFORM 「はぁはぁ、あついのぉ
PRINTFORM 「弄って、お願い弄って	PRINTFORM 「弄って、お願い弄って
PRINTFORMW 「……好きにしなよ」	PRINTFORMW 「……好きにしなよ」
PRINTFORM だからもっと、もっとぉ	PRINTFORM だからもっと、もっとぉ
PRINTFORM 　かぐやもうごいてよぉ	PRINTFORM 　かぐやもうごいてよぉ
PRINTFORML 「ぁ…………ん……」	PRINTFORML 「ぁ…………ん……」
PRINTFORML 「もう、いやぁ……」	PRINTFORML 「もう、いやぁ……」
PRINTFORML 「っ！　このっっ！」	PRINTFORML 「っ！　このっっ！」
PRINTFORM 　そ、そこきもちいいっ	PRINTFORM 　そ、そこきもちいいっ
PRINTFORM 　だめなのに、こんなの	PRINTFORM 　だめなのに、こんなの
PRINTFORM 　ひ、ひぁっや、やらぁ	PRINTFORM 　ひ、ひぁっや、やらぁ
PRINTFORM 　んくぅ、ふぁっひんっ	PRINTFORM 　んくぅ、ふぁっひんっ
PRINTFORM 　こんなの、こんなのぉ	PRINTFORM 　こんなの、こんなのぉ
PRINTFORM 「だめ、そこだめぇっっ	PRINTFORM 「だめ、そこだめぇっっ
PRINTFORM 　や、くる、きちゃうっ	PRINTFORM 　や、くる、きちゃうっ
PRINTFORMW 「おい、何してる？」	PRINTFORMW 「おい、何してる？」
PRINTFORMDL ……訳がわからない	PRINTFORMDL ……訳がわからない
PRINTFORML 「へへっ、燃えたろ」	PRINTFORML 「へへっ、燃えたろ」
PRINTFORML 「ホントに不愉快」	PRINTFORML 「ホントに不愉快」
PRINTFORMW 「燃やしてやるよ」	PRINTFORMW 「燃やしてやるよ」
PRINTFORML 「何笑ってやがる」	PRINTFORML 「何笑ってやがる」
PRINTFORMW 「慧音は先にっ！」	PRINTFORMW 「慧音は先にっ！」
PRINTFORM 「これでも食らえ！」	PRINTFORM 「これでも食らえ！」
PRINTFORM 「さっさと死ねっ！」	PRINTFORM 「さっさと死ねっ！」
PRINTFORM 「すぅ……はぁ……」	PRINTFORM 「すぅ……はぁ……」
PRINTFORM 「逃げ場はないぞっ」	PRINTFORM 「逃げ場はないぞっ」
PRINTFORM 「死ね死ね死ねっ！」	PRINTFORM 「死ね死ね死ねっ！」
PRINTFORM 「こういうのはどう」	PRINTFORM 「こういうのはどう」
PRINTFORM 「さっさと食らえっ」	PRINTFORM 「さっさと食らえっ」
PRINTFORM 　おちんちんあついの	PRINTFORM 　おちんちんあついの
PRINTFORM 　慧音ぇ、あついよぉ	PRINTFORM 　慧音ぇ、あついよぉ
PRINTFORM 　きもちよくなろうよ	PRINTFORM 　きもちよくなろうよ
PRINTFORM 「ん、あふ、熱い……	PRINTFORM 「ん、あふ、熱い……
PRINTFORM 　指とめられない……	PRINTFORM 　指とめられない……
PRINTFORM 　かぐやぁ、みるなぁ	PRINTFORM 　かぐやぁ、みるなぁ
PRINTFORM 　そこ、しょこぉっっ	PRINTFORM 　そこ、しょこぉっっ
PRINTFORM 「や、そこ弱いのっっ	PRINTFORM 「や、そこ弱いのっっ
PRINTFORML 「っ！　こんな！」	PRINTFORML 「っ！　こんな！」
PRINTFORM 　さ、さわらないでっ	PRINTFORM 　さ、さわらないでっ
PRINTFORM 「ん……お尻広がって	PRINTFORM 「ん……お尻広がって
PRINTFORM 　これ、すご、い……	PRINTFORM 　これ、すご、い……
PRINTFORM 　んくっ、あふっんっ	PRINTFORM 　んくっ、あふっんっ
PRINTFORM 　もっと、もっとっっ	PRINTFORM 　もっと、もっとっっ
PRINTFORM 　こんなこと、んくっ	PRINTFORM 　こんなこと、んくっ
PRINTFORM 　ん……あふ、んくっ	PRINTFORM 　ん……あふ、んくっ
PRINTFORM 「ぶるぶるだめぇっっ	PRINTFORM 「ぶるぶるだめぇっっ
PRINTFORM 　気持ちいいのぉ……	PRINTFORM 　気持ちいいのぉ……
PRINTFORM 　ひぁあああっっっっ	PRINTFORM 　ひぁあああっっっっ
PRINTFORM 　これだめええっっっ	PRINTFORM 　これだめええっっっ
PRINTFORMDW なのに、どうして	PRINTFORMDW なのに、どうして
PRINTFORMDL ……誰も救えない	PRINTFORMDL ……誰も救えない
PRINTFORML 「もう、いい……」	PRINTFORML 「もう、いい……」
PRINTFORMW 「ごめん、慧音」	PRINTFORMW 「ごめん、慧音」
PRINTFORMW 「これがあれば」	PRINTFORMW 「これがあれば」
PRINTFORMW 「慧音、行こう」	PRINTFORMW 「慧音、行こう」
PRINTFORM 「弱いので十分だ」	PRINTFORM 「弱いので十分だ」
PRINTFORM 「そらそらそらっ」	PRINTFORM 「そらそらそらっ」
PRINTFORM 「逃がすもんかっ」	PRINTFORM 「逃がすもんかっ」
PRINTFORM 「そこぉっっ！！」	PRINTFORM 「そこぉっっ！！」
PRINTFORM 「死ねぇっっ！！」	PRINTFORM 「死ねぇっっ！！」
PRINTFORML 「……は、はは」	PRINTFORML 「……は、はは」
PRINTFORM ガマン、でき、ない	PRINTFORM ガマン、でき、ない
PRINTFORM 　すきだよ、けいね	PRINTFORM 　すきだよ、けいね
PRINTFORM 　おかして、あげる	PRINTFORM 　おかして、あげる
PRINTFORM 　だから、うごいて	PRINTFORM 　だから、うごいて
PRINTFORM 「%ARGS:1%	PRINTFORM 「%ARGS:1%
PRINTFORML 「ぁ……っ――」	PRINTFORML 「ぁ……っ――」
PRINTFORM 　だめ、なのに……	PRINTFORM 　だめ、なのに……
PRINTFORM 　や、やだ、やらっ	PRINTFORM 　や、やだ、やらっ
PRINTFORM 　ひあああっっっっ	PRINTFORM 　ひあああっっっっ
PRINTFORM 　や、どこ触ってっ	PRINTFORM 　や、どこ触ってっ
PRINTFORM 　や、やめあひんっ	PRINTFORM 　や、やめあひんっ
PRINTFORM 「や、そこ、だめっ	PRINTFORM 「や、そこ、だめっ
PRINTFORM 　や、しび、れるぅ	PRINTFORM 　や、しび、れるぅ
PRINTFORM 「んっんっんぅ……	PRINTFORM 「んっんっんぅ……
PRINTFORM 　あふんっ！　んく	PRINTFORM 　あふんっ！　んく
PRINTFORM 　ひぁぁあああっっ	PRINTFORM 　ひぁぁあああっっ
PRINTFORM 　……きもち、いい	PRINTFORM 　……きもち、いい
PRINTFORM 　やめ、ないと……	PRINTFORM 　やめ、ないと……
PRINTFORM 　きもちいいのぉっ	PRINTFORM 　きもちいいのぉっ
PRINTFORM 　こわれりゅぅっっ	PRINTFORM 　こわれりゅぅっっ
PRINTFORM 　バカになりそうっ	PRINTFORM 　バカになりそうっ
PRINTFORM 　精液でちゃうのっ	PRINTFORM 　精液でちゃうのっ
PRINTFORM 　ふぁっ、んきゅっ	PRINTFORM 　ふぁっ、んきゅっ
PRINTFORML 「なんで、だよ」	PRINTFORML 「なんで、だよ」
PRINTFORML 「最期まで……」	PRINTFORML 「最期まで……」
PRINTFORMDW ぽつりと呟いた	PRINTFORMDW ぽつりと呟いた
﻿PRINTFORML 「もういやぁ」	PRINTFORML 「もういやぁ」
PRINTFORMW 「悪い、慧音」	PRINTFORMW 「悪い、慧音」
PRINTFORMW 「悪かったね」	PRINTFORMW 「悪かったね」
PRINTFORMW 「……ごめん」	PRINTFORMW 「……ごめん」
PRINTFORMW 「下がってて」	PRINTFORMW 「下がってて」
PRINTFORMW 「私に任せて」	PRINTFORMW 「私に任せて」
PRINTFORMW 「やってやる」	PRINTFORMW 「やってやる」
PRINTFORM 「切れ、ろっ！」	PRINTFORM 「切れ、ろっ！」
PRINTFORM 「くらえ……っ」	PRINTFORM 「くらえ……っ」
PRINTFORM 「鬱陶しいっ！」	PRINTFORM 「鬱陶しいっ！」
PRINTFORM 「躱せるかい？」	PRINTFORM 「躱せるかい？」
PRINTFORM 「これでどうっ」	PRINTFORM 「これでどうっ」
PRINTFORM 「だいすきだから	PRINTFORM 「だいすきだから
PRINTFORM 　だいすきだよぉ	PRINTFORM 　だいすきだよぉ
PRINTFORML 「……痛……」	PRINTFORML 「……痛……」
PRINTFORML 「――ぅ――」	PRINTFORML 「――ぅ――」
PRINTFORM 　……熱い、体、	PRINTFORM 　……熱い、体、
PRINTFORM 　あつ、いよ……	PRINTFORM 　あつ、いよ……
PRINTFORM 「だめだから……	PRINTFORM 「だめだから……
PRINTFORM 「あふ、んぅ……	PRINTFORM 「あふ、んぅ……
PRINTFORM 「重、い……」	PRINTFORM 「重、い……」
PRINTFORM 「くぅっ……」	PRINTFORM 「くぅっ……」
PRINTFORM 「消えろっ！」	PRINTFORM 「消えろっ！」
PRINTFORM 　お願いしてぇ	PRINTFORM 　お願いしてぇ
PRINTFORM だから、もっと	PRINTFORM だから、もっと
PRINTFORML 「…………」	PRINTFORML 「…………」
PRINTFORML 「――――」	PRINTFORML 「――――」
PRINTFORM 「……はぁはぁ	PRINTFORM 「……はぁはぁ
PRINTFORM 　おしりこわれ	PRINTFORM 　おしりこわれ
PRINTFORM 「ひあああっっ	PRINTFORM 「ひあああっっ
PRINTFORM 　ふぁあっっっ	PRINTFORM 　ふぁあっっっ
PRINTFORM 　やめてってば	PRINTFORM 　やめてってば
PRINTFORM 　ひん、んくっ	PRINTFORM 　ひん、んくっ
PRINTFORM 　んく、ふぁっ	PRINTFORM 　んく、ふぁっ
PRINTFORM 　あんっ、あふ	PRINTFORM 　あんっ、あふ
PRINTFORM 　これ、だめぇ	PRINTFORM 　これ、だめぇ
PRINTFORM 　こんなのぉっ	PRINTFORM 　こんなのぉっ
PRINTFORM 　気持ちいいよ	PRINTFORM 　気持ちいいよ
PRINTFORM 　あふんっ……	PRINTFORM 　あふんっ……
PRINTFORM 　きもちいいよ	PRINTFORM 　きもちいいよ
PRINTFORM 「気持ちいいっ	PRINTFORM 「気持ちいいっ
PRINTFORM 　そこ、しょこ	PRINTFORM 　そこ、しょこ
PRINTFORML 「……はっ」	PRINTFORML 「……はっ」
PRINTFORMDL ただ懸命に	PRINTFORMDL ただ懸命に
PRINTFORMDL ただ必死に	PRINTFORMDL ただ必死に
PRINTFORML 『そうよね』	PRINTFORML 『そうよね』
PRINTFORML 「……はぁ」	PRINTFORML 「……はぁ」
PRINTFORMW 「あのさぁ」	PRINTFORMW 「あのさぁ」
PRINTFORML 「はぁ……」	PRINTFORML 「はぁ……」
PRINTFORMW 「使って」	PRINTFORMW 「使って」
PRINTFORMW 「ごめん」	PRINTFORMW 「ごめん」
PRINTFORMW 「大丈夫」	PRINTFORMW 「大丈夫」
PRINTFORMW 「お疲れ」	PRINTFORMW 「お疲れ」
PRINTFORMW 「悪いね」	PRINTFORMW 「悪いね」
PRINTFORM 「はー、はー	PRINTFORM 「はー、はー
PRINTFORM 　あついよぉ	PRINTFORM 　あついよぉ
PRINTFORM 「おねがいぃ	PRINTFORM 「おねがいぃ
PRINTFORM 　はぁ、んぅ	PRINTFORM 　はぁ、んぅ
PRINTFORM 　そうだよね	PRINTFORM 　そうだよね
PRINTFORM 　だからしよ	PRINTFORM 　だからしよ
PRINTFORM 「ふぁんっっ	PRINTFORM 「ふぁんっっ
PRINTFORM 「んきゅっっ	PRINTFORM 「んきゅっっ
PRINTFORM 　こわれりゅ	PRINTFORM 　こわれりゅ
PRINTFORM 「くぅんっっ	PRINTFORM 「くぅんっっ
PRINTFORM 　ふぁんっっ	PRINTFORM 　ふぁんっっ
PRINTFORML 「んきゅっ	PRINTFORML 「んきゅっ
PRINTFORML 　やああっ	PRINTFORML 　やああっ
PRINTFORM 　やめてぇっ	PRINTFORM 　やめてぇっ
PRINTFORM 「あひんっっ	PRINTFORM 「あひんっっ
PRINTFORM 「ひゃふっっ	PRINTFORM 「ひゃふっっ
PRINTFORM 「ふぁっ……	PRINTFORM 「ふぁっ……
PRINTFORM 　何か上って	PRINTFORM 　何か上って
PRINTFORM 　ひゅあっっ	PRINTFORM 　ひゅあっっ
PRINTFORM 　んきゅっっ	PRINTFORM 　んきゅっっ
PRINTFORM 「や、だめぇ	PRINTFORM 「や、だめぇ
PRINTFORM 「よすぎるの	PRINTFORM 「よすぎるの
PRINTFORM 　でちゃうっ	PRINTFORM 　でちゃうっ
PRINTFORM 「んきゅぅっ	PRINTFORM 「んきゅぅっ
PRINTFORM 　ひゃふぅっ	PRINTFORM 　ひゃふぅっ
PRINTFORM 「だめなのぉ	PRINTFORM 「だめなのぉ
PRINTFORML 「輝夜？」	PRINTFORML 「輝夜？」
PRINTFORMW 「はい」	PRINTFORMW 「はい」
PRINTFORM 「このぉ」	PRINTFORM 「このぉ」
PRINTFORM 「しねっ」	PRINTFORM 「しねっ」
PRINTFORM 「はぁっ」	PRINTFORM 「はぁっ」
PRINTFORM 「はぁはぁ	PRINTFORM 「はぁはぁ
PRINTFORM 「んきゅっ	PRINTFORM 「んきゅっ
PRINTFORM 「あついの	PRINTFORM 「あついの
PRINTFORM 　かぐやっ	PRINTFORM 　かぐやっ
PRINTFORM 　かぐやぁ	PRINTFORM 　かぐやぁ
PRINTFORM 「けいねぇ	PRINTFORM 「けいねぇ
PRINTFORM 「はーはー	PRINTFORM 「はーはー
PRINTFORM 「けいねっ	PRINTFORM 「けいねっ
PRINTFORM 　けいねぇ	PRINTFORM 　けいねぇ
PRINTFORM 「はふ、ん	PRINTFORM 「はふ、ん
PRINTFORM 「あふんっ	PRINTFORM 「あふんっ
PRINTFORM 　だめぇっ	PRINTFORM 　だめぇっ
PRINTFORM 「やあっっ	PRINTFORM 「やあっっ
PRINTFORM 　んくっっ	PRINTFORM 　んくっっ
PRINTFORM 　ひんっっ	PRINTFORM 　ひんっっ
PRINTFORM 「ひぅっっ	PRINTFORM 「ひぅっっ
PRINTFORM 　あひっっ	PRINTFORM 　あひっっ
PRINTFORM 「ひんっっ	PRINTFORM 「ひんっっ
PRINTFORM 　ふぁんっ	PRINTFORM 　ふぁんっ
PRINTFORM 「んくっっ	PRINTFORM 「んくっっ
PRINTFORM 「や、来る	PRINTFORM 「や、来る
PRINTFORM 　ひうっっ	PRINTFORM 　ひうっっ
PRINTFORM 　んぅっっ	PRINTFORM 　んぅっっ
PRINTFORM 「んきゅぅ	PRINTFORM 「んきゅぅ
PRINTFORM 　ひぃんっ	PRINTFORM 　ひぃんっ
PRINTFORM 「これだめ	PRINTFORM 「これだめ
PRINTFORM 　これだめ	PRINTFORM 　これだめ
PRINTFORM 　こわれる	PRINTFORM 　こわれる
PRINTFORM 　んきゅっ	PRINTFORM 　んきゅっ
PRINTFORML 「ちっ」	PRINTFORML 「ちっ」
PRINTFORML 「……」	PRINTFORML 「……」
PRINTFORM 「くっ」	PRINTFORM 「くっ」
PRINTFORM 「ひんっ	PRINTFORM 「ひんっ
PRINTFORM 　慧音っ	PRINTFORM 　慧音っ
PRINTFORM 「かぐや	PRINTFORM 「かぐや
PRINTFORM もっとぉ	PRINTFORM もっとぉ
PRINTFORM 「けいね	PRINTFORM 「けいね
PRINTFORM 　ひあっ	PRINTFORM 　ひあっ
PRINTFORM 　んくっ	PRINTFORM 　んくっ
PRINTFORM 「ひぁっ	PRINTFORM 「ひぁっ
PRINTFORM 「ふあん	PRINTFORM 「ふあん
PRINTFORM 　ひんっ	PRINTFORM 　ひんっ
PRINTFORM 　ひうっ	PRINTFORM 　ひうっ
PRINTFORM 　やんっ	PRINTFORM 　やんっ
PRINTFORM 　ひぁっ	PRINTFORM 　ひぁっ
PRINTFORM 　あんっ	PRINTFORM 　あんっ
PRINTFORM 　あふっ	PRINTFORM 　あふっ
PRINTFORM 「あふっ	PRINTFORM 「あふっ
PRINTFORM 「……ん	PRINTFORM 「……ん
PRINTFORM 　ふぁっ	PRINTFORM 　ふぁっ
PRINTFORM 　あたま	PRINTFORM 　あたま
PRINTFORM 　おかし	PRINTFORM 　おかし
PRINTFORM 「あは	PRINTFORM 「あは
PRINTFORM 「だめ	PRINTFORM 「だめ
PRINTFORM 「やあ	PRINTFORM 「やあ
PRINTFORMW 「」	PRINTFORMW 「」
PRINTFORML 」	PRINTFORML 」
PRINTFORMW 」	PRINTFORMW 」
PRINTFORM 　ね	PRINTFORM 　ね
PRINTFORMDL 	PRINTFORMDL 
PRINTFORMW 　	PRINTFORMW 　
PRINTFORMW 「	PRINTFORMW 「
PRINTFORMW 	PRINTFORMW 
PRINTFORM 」	PRINTFORM 」
PRINTFORML 	PRINTFORML 
PRINTL 	PRINTL 
