//口上:

PRINTFORMW 歯がみする%ARGS:0%に、%CALLNAME:(FLAG:10)%と%CALLNAME:(FLAG:11)%が覚悟を決めたように話しかける	PRINTFORMW 歯がみする%ARGS:0%に、%CALLNAME:(FLAG:10)%と%CALLNAME:(FLAG:11)%が覚悟を決めたように話しかける
PRINTFORMW 必死の抵抗も空しく、%CALLNAME:(FLAG:10)%と%CALLNAME:(FLAG:11)%は敵に拘束され、激しい凌辱を受けている	PRINTFORMW 必死の抵抗も空しく、%CALLNAME:(FLAG:10)%と%CALLNAME:(FLAG:11)%は敵に拘束され、激しい凌辱を受けている
PRINTFORMDL すぐに前へと向き直ったが背中を焦がすような乾いたぎこちない笑顔の静葉の視線に耐えられず%CALLNAME:1%は思わず駆け出した！	PRINTFORMDL すぐに前へと向き直ったが背中を焦がすような乾いたぎこちない笑顔の静葉の視線に耐えられず%CALLNAME:1%は思わず駆け出した！
PRINTFORMW 「今までの3倍…いや10倍の効率で木々を塗ることができている！？私は…私はこのままで秋の神ではなく幻想郷の神になってしまうかも♪」	PRINTFORMW 「今までの3倍…いや10倍の効率で木々を塗ることができている！？私は…私はこのままで秋の神ではなく幻想郷の神になってしまうかも♪」
PRINTFORMDW	%CALLNAME:(FLAG:10)%と%CALLNAME:(FLAG:11)%の腕は途中から枝分かれし無数の触手となり	PRINTFORMDW	%CALLNAME:(FLAG:10)%と%CALLNAME:(FLAG:11)%の腕は途中から枝分かれし無数の触手となり
PRINTFORMDW	涙ながらに首を横にふり謝る静葉に%CALLNAME:(FLAG:10)%が『謝れば私達を見捨てた事が許されるの？』と尋ねる	PRINTFORMDW	涙ながらに首を横にふり謝る静葉に%CALLNAME:(FLAG:10)%が『謝れば私達を見捨てた事が許されるの？』と尋ねる
PRINTFORMDW	冷たい水で乾いてベタベタな口をゆすいでいると、コップの中の水が白濁液なことに気づき、慌てて吐き出しそしてトイレに駆け込んだ	PRINTFORMDW	冷たい水で乾いてベタベタな口をゆすいでいると、コップの中の水が白濁液なことに気づき、慌てて吐き出しそしてトイレに駆け込んだ
PRINTFORMDW 静葉の望みを知ってか知らずか、彼女の背後に生物の口のような穴が開き、無数の触手が静葉の細い体目掛けて伸びていく…！	PRINTFORMDW 静葉の望みを知ってか知らずか、彼女の背後に生物の口のような穴が開き、無数の触手が静葉の細い体目掛けて伸びていく…！
PRINTFORMDW こうして静葉と触手達は話し合いを繰り返し「迷宮の中を秋にして外にでなければいい」という結論にたどり着いたのであった	PRINTFORMDW こうして静葉と触手達は話し合いを繰り返し「迷宮の中を秋にして外にでなければいい」という結論にたどり着いたのであった
PRINTFORMDL %CALLNAME:1%がちらりと後ろへ視線をやるとぐったりとした静葉が少しの抵抗もせずに触手に陵辱されていた……	PRINTFORMDL %CALLNAME:1%がちらりと後ろへ視線をやるとぐったりとした静葉が少しの抵抗もせずに触手に陵辱されていた……
PRINTFORML 「ﾐﾉﾙｺﾁｬﾝﾐﾉﾙｺﾁｬﾝﾐﾉﾙｺﾁｬﾝﾐﾉﾙｺﾁｬﾝﾐﾉﾙｺﾁｬﾝﾐﾉﾙｺﾁｬﾝﾐﾉﾙｺﾁｬﾝﾐﾉﾙｺﾁｬﾝ」	PRINTFORML 「ﾐﾉﾙｺﾁｬﾝﾐﾉﾙｺﾁｬﾝﾐﾉﾙｺﾁｬﾝﾐﾉﾙｺﾁｬﾝﾐﾉﾙｺﾁｬﾝﾐﾉﾙｺﾁｬﾝﾐﾉﾙｺﾁｬﾝﾐﾉﾙｺﾁｬﾝ」
PRINTFORMDW 『どひゃああ…ホント酷い目にあったわー…』と疲れ切った聞きなれた懐かしい声に静葉は玄関へとバタバタとかけていった	PRINTFORMDW 『どひゃああ…ホント酷い目にあったわー…』と疲れ切った聞きなれた懐かしい声に静葉は玄関へとバタバタとかけていった
PRINTFORMDW 静葉が玄関で大の字になっている穣子を思わず怒鳴りつけると『思い出したくもないようなところ』と穣子は口をとがらせた	PRINTFORMDW 静葉が玄関で大の字になっている穣子を思わず怒鳴りつけると『思い出したくもないようなところ』と穣子は口をとがらせた
PRINTFORMDL 全身の穴を押し広げられる快感と不快感に静葉は全身をビクビクと痙攣させながらも処女だけは守ろうと下半身を庇っている	PRINTFORMDL 全身の穴を押し広げられる快感と不快感に静葉は全身をビクビクと痙攣させながらも処女だけは守ろうと下半身を庇っている
PRINTFORMDL 力なく横たわっている%CALLNAME:(ARG:1)%の手を%CALLNAME:TARGET%はそっととった…	PRINTFORMDL 力なく横たわっている%CALLNAME:(ARG:1)%の手を%CALLNAME:TARGET%はそっととった…
PRINTFORMDL 身も心もボロボロで自分で歩くことも出来ない%CALLNAME:TARGET%を守りながら探索を続けるのは難しい…	PRINTFORMDL 身も心もボロボロで自分で歩くことも出来ない%CALLNAME:TARGET%を守りながら探索を続けるのは難しい…
PRINTFORMDW	謝ることしかでいない静葉の濡れていないワレメに%CALLNAME:(FLAG:11)%の男性器が押し付けられる	PRINTFORMDW	謝ることしかでいない静葉の濡れていないワレメに%CALLNAME:(FLAG:11)%の男性器が押し付けられる
PRINTFORMDL 抵抗を試みようとした静葉の四肢からは力が感じられず、肉壁と触手に嬲られ華奢な背中を時折のけぞらせるだけだった…	PRINTFORMDL 抵抗を試みようとした静葉の四肢からは力が感じられず、肉壁と触手に嬲られ華奢な背中を時折のけぞらせるだけだった…
PRINTFORML 子宮へと生暖かい感触が満ちていく感覚から逃れようと身を捩るたびにワレメから外れた触手が静葉の身体へ精を吐きかけた	PRINTFORML 子宮へと生暖かい感触が満ちていく感覚から逃れようと身を捩るたびにワレメから外れた触手が静葉の身体へ精を吐きかけた
PRINTFORMDW ベッドに腰掛け泣き出しそうな顔で立ち上がろうとしていた穣子は静葉の姿をみて安心したのか穏やかな笑みを浮かべた	PRINTFORMDW ベッドに腰掛け泣き出しそうな顔で立ち上がろうとしていた穣子は静葉の姿をみて安心したのか穏やかな笑みを浮かべた
PRINTFORML やりたい放題の秋モードは最悪触手宮の世界観をぶち壊す危険性しかないので使用の際には『自己責任』でお願いします。	PRINTFORML やりたい放題の秋モードは最悪触手宮の世界観をぶち壊す危険性しかないので使用の際には『自己責任』でお願いします。
PRINTFORMDW 秋の幻想郷、仲睦まじく木々を色づかせる親子の神様が今年も人々の目を楽しませようと妖怪の山を飛びまわっていた	PRINTFORMDW 秋の幻想郷、仲睦まじく木々を色づかせる親子の神様が今年も人々の目を楽しませようと妖怪の山を飛びまわっていた
PRINTFORMDW 巨大な触手の柱と一体化しつつある静葉の元に娘の一人が激しい陵辱を受け腹部が異常に膨らんだ妖精を連れてきた	PRINTFORMDW 巨大な触手の柱と一体化しつつある静葉の元に娘の一人が激しい陵辱を受け腹部が異常に膨らんだ妖精を連れてきた
PRINTFORMDW	%CALLNAME:(FLAG:11)%は悲しげな表情で口を開く『あなたが謝れば私達は生き返るの？』と…	PRINTFORMDW	%CALLNAME:(FLAG:11)%は悲しげな表情で口を開く『あなたが謝れば私達は生き返るの？』と…
PRINTFORMDW 静葉がボロボロ穣子の目の前で泣き始めると穣子はむくりと起き上がりどうしたらいいか分からずおろろとし始めた	PRINTFORMDW 静葉がボロボロ穣子の目の前で泣き始めると穣子はむくりと起き上がりどうしたらいいか分からずおろろとし始めた
PRINTFORMDW 床にも天井にもそして静葉がもたれかかっている壁にも触手が生えている不気味な洞窟にいつの間にか移動していた	PRINTFORMDW 床にも天井にもそして静葉がもたれかかっている壁にも触手が生えている不気味な洞窟にいつの間にか移動していた
PRINTFORMDW 髪もボサボサデで顔もずっと洗っていないのか涙の跡でぐちゃぐちゃな穣子が目いっぱいに涙を溜め込んで現れた	PRINTFORMDW 髪もボサボサデで顔もずっと洗っていないのか涙の跡でぐちゃぐちゃな穣子が目いっぱいに涙を溜め込んで現れた
PRINTFORMDW これからされるであろう事を嫌がりさらに静葉は抵抗を激しくするが広げられた足はがっちりと固定されている…	PRINTFORMDW これからされるであろう事を嫌がりさらに静葉は抵抗を激しくするが広げられた足はがっちりと固定されている…
PRINTFORMDW 虚ろな瞳でその行為と受け入れ終わると別の魔物が栄養価の高い蜜を分泌する触手を静葉の口に優しく挿し入れる	PRINTFORMDW 虚ろな瞳でその行為と受け入れ終わると別の魔物が栄養価の高い蜜を分泌する触手を静葉の口に優しく挿し入れる
PRINTFORMDW ただ、いつ穣子が帰ってきても大丈夫なように部屋も服も清潔な状態にし、まだ使える遺品も大切にしまってある	PRINTFORMDW ただ、いつ穣子が帰ってきても大丈夫なように部屋も服も清潔な状態にし、まだ使える遺品も大切にしまってある
PRINTFORMDW 二人は、心行くまで泣きあった後、お互いの酷くなった顔を笑いあい、そして手を繋いで二人で顔を洗いにいった	PRINTFORMDW 二人は、心行くまで泣きあった後、お互いの酷くなった顔を笑いあい、そして手を繋いで二人で顔を洗いにいった
PRINTFORMDW 何を思ったか静葉は青々とした木々に今までのような紅葉の赤や黄色ではなく金色で片っ端から塗りたくっていた	PRINTFORMDW 何を思ったか静葉は青々とした木々に今までのような紅葉の赤や黄色ではなく金色で片っ端から塗りたくっていた
PRINTFORMW そのことに気付いた%ARGS:0%は、必ず助けを呼んでくるからと言い残し、出口へと向かって駆け出した……	PRINTFORMW そのことに気付いた%ARGS:0%は、必ず助けを呼んでくるからと言い残し、出口へと向かって駆け出した……
PRINTFORMDW あちこちをぶつけながら悲鳴を上げて地底へと転がり落ちていく間に意識を失った静葉が意識を取り戻した時には	PRINTFORMDW あちこちをぶつけながら悲鳴を上げて地底へと転がり落ちていく間に意識を失った静葉が意識を取り戻した時には
PRINTFORMDW 羞恥心と本能がこれから起こる事を誰かに見られてはいけないと囁き静葉は人の目の届き辛い茂みへと向かった	PRINTFORMDW 羞恥心と本能がこれから起こる事を誰かに見られてはいけないと囁き静葉は人の目の届き辛い茂みへと向かった
PRINTFORMDW 静葉は洞穴…いや迷宮が巨大化するたびに最も安全な再奥に運び込まれ触手達に何不自由なく世話をされていた	PRINTFORMDW 静葉は洞穴…いや迷宮が巨大化するたびに最も安全な再奥に運び込まれ触手達に何不自由なく世話をされていた
PRINTFORMW ──今ならこの魔物は私たちの事しか見えていないはずだから、%ARGS:0%だけなら逃げられるはずだ──	PRINTFORMW ──今ならこの魔物は私たちの事しか見えていないはずだから、%ARGS:0%だけなら逃げられるはずだ──
PRINTFORML (まさかとは思うけど…いやそんな秋の神である私を捨て駒にして逃げ出すなんて罰当たりな事するわけが……)	PRINTFORML (まさかとは思うけど…いやそんな秋の神である私を捨て駒にして逃げ出すなんて罰当たりな事するわけが……)
PRINTFORMDL 喉奥まで犯される息苦しさに静葉はスライムを掴もうと何度も手を動かすがスライムの中へ指が沈むだけだった	PRINTFORMDL 喉奥まで犯される息苦しさに静葉はスライムを掴もうと何度も手を動かすがスライムの中へ指が沈むだけだった
PRINTFORMDL 必死に体液の侵入を拒もうと身を捩るが身体はがっちりと固定されていて挿入を防ぐ以上のことはできなかった	PRINTFORMDL 必死に体液の侵入を拒もうと身を捩るが身体はがっちりと固定されていて挿入を防ぐ以上のことはできなかった
PRINTFORMDL 唇を貪られ口内へと唾液とともに送られる媚薬に全身の感覚を溶かされ静葉はとろんとした目でなすがままだ…	PRINTFORMDL 唇を貪られ口内へと唾液とともに送られる媚薬に全身の感覚を溶かされ静葉はとろんとした目でなすがままだ…
PRINTFORMDL %CALLNAME:(ARG:2)%が申し訳なさそうな視線を静葉に向けたかと思うとくるりと踵を返した	PRINTFORMDL %CALLNAME:(ARG:2)%が申し訳なさそうな視線を静葉に向けたかと思うとくるりと踵を返した
PRINTFORMDW 静葉の声が届かなかったのか『いないの…？』と泣だしそうな声で言うので慌てて穣子の部屋へと向かう静葉	PRINTFORMDW 静葉の声が届かなかったのか『いないの…？』と泣だしそうな声で言うので慌てて穣子の部屋へと向かう静葉
PRINTFORMDW 不意に穣子表情がぐしゃりと歪みその場にぺたんと座り込み泣き始めた『お姉ちゃんが無事でよかった…』と	PRINTFORMDW 不意に穣子表情がぐしゃりと歪みその場にぺたんと座り込み泣き始めた『お姉ちゃんが無事でよかった…』と
PRINTFORMDW ついに胸からは母乳が滲み、勘違いでは済まされないほど大きく張った腹を前にしても静葉は何も出来ない…	PRINTFORMDW ついに胸からは母乳が滲み、勘違いでは済まされないほど大きく張った腹を前にしても静葉は何も出来ない…
PRINTFORMDW 翌年の秋、どういうわけか様々な触手達と共に木々を色づける静葉の姿が目撃されたとかされていないとか…	PRINTFORMDW 翌年の秋、どういうわけか様々な触手達と共に木々を色づける静葉の姿が目撃されたとかされていないとか…
PRINTFORMDW そして紆余曲折を経てなぜか迷宮を一年中秋が楽しめるレジャー施設として改装することとなったのであった	PRINTFORMDW そして紆余曲折を経てなぜか迷宮を一年中秋が楽しめるレジャー施設として改装することとなったのであった
PRINTFORML 秋の異常なテンションの壊れた秋姉妹も好き、穣子の一歩後ろでニコニコ静かにしている静葉お姉ちゃんも好き	PRINTFORML 秋の異常なテンションの壊れた秋姉妹も好き、穣子の一歩後ろでニコニコ静かにしている静葉お姉ちゃんも好き
PRINTFORMDW 心身共に疲れがたまってきていた静葉は木陰に座り込み、滲んだ涙を人差し指で拭うと小さなため息をついた	PRINTFORMDW 心身共に疲れがたまってきていた静葉は木陰に座り込み、滲んだ涙を人差し指で拭うと小さなため息をついた
PRINTFORMDL 追い詰められた静葉は声も震え、冷や汗と粘液でベタベタな挙句、台詞も意味のわからないものとなっていた	PRINTFORMDL 追い詰められた静葉は声も震え、冷や汗と粘液でベタベタな挙句、台詞も意味のわからないものとなっていた
PRINTFORMW 「聞いてる！？うわなんかやばそうな液体がぎゃあなんかいかにもアレな感じの触手が！？助けてーーー！！」	PRINTFORMW 「聞いてる！？うわなんかやばそうな液体がぎゃあなんかいかにもアレな感じの触手が！？助けてーーー！！」
PRINTFORML 「今ッ！最高潮に秋の力でパワーが漲る最強の神とも言える私を頼りにしたくなる気持ちはよーくわかるわ…」	PRINTFORML 「今ッ！最高潮に秋の力でパワーが漲る最強の神とも言える私を頼りにしたくなる気持ちはよーくわかるわ…」
PRINTFORMDL 必死に秘所を両手で覆うがスライムの体は指の隙間をズルズルとすり抜け処女膜の隙間から体内へと入り込む	PRINTFORMDL 必死に秘所を両手で覆うがスライムの体は指の隙間をズルズルとすり抜け処女膜の隙間から体内へと入り込む
PRINTFORMDL %CALLNAME:TARGET%は安心して気が抜けたのかその場に座り込むとめそめそ泣きはじめた。	PRINTFORMDL %CALLNAME:TARGET%は安心して気が抜けたのかその場に座り込むとめそめそ泣きはじめた。
PRINTFORMDL そう判断した%CALLNAME:1%は%CALLNAME:TARGET%をおいていくことにした……	PRINTFORMDL そう判断した%CALLNAME:1%は%CALLNAME:TARGET%をおいていくことにした……
PRINTFORMDW 人里で色々あってなかなか帰れなかった穣子がぐったりとして家に帰ると既に家はもぬけの殻だったそうだ	PRINTFORMDW 人里で色々あってなかなか帰れなかった穣子がぐったりとして家に帰ると既に家はもぬけの殻だったそうだ
PRINTFORMDW なんでも生き残った魔物を退治している時にバイオプラントの中に捕らえられている穣子を発見したらしい	PRINTFORMDW なんでも生き残った魔物を退治している時にバイオプラントの中に捕らえられている穣子を発見したらしい
PRINTFORMDW 頭痛がしそうなやたら高い秋姉妹のテンションに妖怪の山の人妖は秋の訪れをイヤでも感じるのであった…	PRINTFORMDW 頭痛がしそうなやたら高い秋姉妹のテンションに妖怪の山の人妖は秋の訪れをイヤでも感じるのであった…
PRINTFORMDW 『抵抗しても無駄よ。あたし、いっぱい妖精や妖怪を吸収しておかあさんの5倍くらいつよくなったもん』	PRINTFORMDW 『抵抗しても無駄よ。あたし、いっぱい妖精や妖怪を吸収しておかあさんの5倍くらいつよくなったもん』
PRINTFORMDW 秋のイベントをことごとく台無しにしただけでなく、秋の神である妹すらも毒牙にかけたであろう異変…！	PRINTFORMDW 秋のイベントをことごとく台無しにしただけでなく、秋の神である妹すらも毒牙にかけたであろう異変…！
PRINTFORML 「まちなさい！秋パワーで神罰を下すわよ！？助けなさい！助けてください！もみじ一年分あげるから！！」	PRINTFORML 「まちなさい！秋パワーで神罰を下すわよ！？助けなさい！助けてください！もみじ一年分あげるから！！」
PRINTFORMDL 半狂乱でもがく静葉の膣口から卵管が引き抜かれるとポロポロと産み付けられた卵のいくつかが零れ落ちた	PRINTFORMDL 半狂乱でもがく静葉の膣口から卵管が引き抜かれるとポロポロと産み付けられた卵のいくつかが零れ落ちた
PRINTFORMDL 膣口で暴れる触手を押える静葉の小さな手に伝わる精液がほどばしり脈打つ感触に引きつった悲鳴を上げた	PRINTFORMDL 膣口で暴れる触手を押える静葉の小さな手に伝わる精液がほどばしり脈打つ感触に引きつった悲鳴を上げた
PRINTFORMDL ポンプから押し出されているかのような勢いで吐き出される精液が処女膜の隙間から子宮へと注がれていく	PRINTFORMDL ポンプから押し出されているかのような勢いで吐き出される精液が処女膜の隙間から子宮へと注がれていく
PRINTFORMDL 静葉は肉壁から次々と生える触手に絡みつかれ、と噴き出す気味の悪い粘液を浴びながら抵抗を諦める……	PRINTFORMDL 静葉は肉壁から次々と生える触手に絡みつかれ、と噴き出す気味の悪い粘液を浴びながら抵抗を諦める……
PRINTFORMDL 呑み込まれている静葉を置いて逃げることを決めた穣子は何度も静葉が呑まれている方を振り返っている…	PRINTFORMDL 呑み込まれている静葉を置いて逃げることを決めた穣子は何度も静葉が呑まれている方を振り返っている…
PRINTFORMDL %CALLNAME:TARGET%は泣きながらも必死に絡みついた触手を掴み引き剥がそうとしている	PRINTFORMDL %CALLNAME:TARGET%は泣きながらも必死に絡みついた触手を掴み引き剥がそうとしている
PRINTFORMDL %CALLNAME:TARGET%は肉壁に包まれた状態でどうしたらいいか分からずおろおろしている	PRINTFORMDL %CALLNAME:TARGET%は肉壁に包まれた状態でどうしたらいいか分からずおろおろしている
PRINTFORMDL 静葉は自分の胸をぺたぺたと触り、セットに入っていた迫力のある下着に目をやり自嘲気味に短く笑った	PRINTFORMDL 静葉は自分の胸をぺたぺたと触り、セットに入っていた迫力のある下着に目をやり自嘲気味に短く笑った
PRINTFORMDW 『お姉ちゃんも他の人みたいに帰ってこないかと思ったら…』と穣子は今にも泣き出しそうな顔で言うと	PRINTFORMDW 『お姉ちゃんも他の人みたいに帰ってこないかと思ったら…』と穣子は今にも泣き出しそうな顔で言うと
PRINTFORMDW ニヤニヤと笑いが止まらないそんな静葉を背中から呼び止める声に彼女は慌ててブレーキをかけ振り向き	PRINTFORMDW ニヤニヤと笑いが止まらないそんな静葉を背中から呼び止める声に彼女は慌ててブレーキをかけ振り向き
PRINTFORMDW 出産によりドロドロの性器は驚くほどすんなりと触手を受け入れ挿入された触手が蠢き静葉の心を砕いた	PRINTFORMDW 出産によりドロドロの性器は驚くほどすんなりと触手を受け入れ挿入された触手が蠢き静葉の心を砕いた
PRINTFORMDW 動かなくなった静葉に満足した魔物は静葉の体を触手で抱きしめるように包み込むと大きく身を震わせた	PRINTFORMDW 動かなくなった静葉に満足した魔物は静葉の体を触手で抱きしめるように包み込むと大きく身を震わせた
PRINTFORMDW 一つ、二つ、三つ、四つ……何十分とかけて数え切れないほどの何かを子宮内に直接送り込まれた静葉は	PRINTFORMDW 一つ、二つ、三つ、四つ……何十分とかけて数え切れないほどの何かを子宮内に直接送り込まれた静葉は
PRINTFORMDW 赤ん坊のように静葉がそれをちゅぱちゅぱと吸い終わると、触手がヨダレと蜜を丁寧に拭い去っていく…	PRINTFORMDW 赤ん坊のように静葉がそれをちゅぱちゅぱと吸い終わると、触手がヨダレと蜜を丁寧に拭い去っていく…
PRINTFORMDW 最近、神隠しが増えているという噂を耳にはしていたが神そのものである穣子がであったとは考え辛い…	PRINTFORMDW 最近、神隠しが増えているという噂を耳にはしていたが神そのものである穣子がであったとは考え辛い…
PRINTFORML 「まちなさい！秋パワーで神罰を下すわよ！？助けなさい！助けてください！紅葉一年分あげるから！！」	PRINTFORML 「まちなさい！秋パワーで神罰を下すわよ！？助けなさい！助けてください！紅葉一年分あげるから！！」
PRINTFORML 「だからといってまるでこいつうるさい邪魔くさいいっそ囮にしてしまえみたいな扱いは許されないわ！」	PRINTFORML 「だからといってまるでこいつうるさい邪魔くさいいっそ囮にしてしまえみたいな扱いは許されないわ！」
PRINTFORMDL 汚濁液と共に吐き出された静葉はよろめきながらも%SAVESTR:(ARG:4)%から逃げ出した	PRINTFORMDL 汚濁液と共に吐き出された静葉はよろめきながらも%SAVESTR:(ARG:4)%から逃げ出した
PRINTFORMDL 静葉は肉壁から次々と生える触手に絡みつかれ、噴き出す気味の悪い粘液を浴びながら抵抗を諦めた……	PRINTFORMDL 静葉は肉壁から次々と生える触手に絡みつかれ、噴き出す気味の悪い粘液を浴びながら抵抗を諦めた……
PRINTFORMDL %CALLNAME:TARGET%は思い切り振り回した武器に引っ張られバランスを崩してしまった	PRINTFORMDL %CALLNAME:TARGET%は思い切り振り回した武器に引っ張られバランスを崩してしまった
PRINTFORML 「……知ってるよ、私はこの迷宮の魔物がお父さんだもん。おかあさんがどんな気持ちで私を産んだか…」	PRINTFORML 「……知ってるよ、私はこの迷宮の魔物がお父さんだもん。おかあさんがどんな気持ちで私を産んだか…」
PRINTFORMDW 静葉の声に反応して家の奥からバタバタガラガラと大きなものが動く音、何かが崩れ壊れる音が響いた	PRINTFORMDW 静葉の声に反応して家の奥からバタバタガラガラと大きなものが動く音、何かが崩れ壊れる音が響いた
PRINTFORMDW 声を出せないように口に触手をねじ込まれ崖に出来た小さな洞穴へと静葉を引きずり込もうとする魔物	PRINTFORMDW 声を出せないように口に触手をねじ込まれ崖に出来た小さな洞穴へと静葉を引きずり込もうとする魔物
PRINTFORMDW そして、さらに膣内へと侵入した触手の先端から伸びた細い何かが子宮口を通り直接子宮へと入り込む	PRINTFORMDW そして、さらに膣内へと侵入した触手の先端から伸びた細い何かが子宮口を通り直接子宮へと入り込む
PRINTFORMDW それは本当に眠っているのか、それとも自分の体を取り込んでいる触手の柱に乗っ取られているのか…	PRINTFORMDW それは本当に眠っているのか、それとも自分の体を取り込んでいる触手の柱に乗っ取られているのか…
PRINTFORMDW これから数日後、常緑樹すらも巻き込みありとあらゆる木々が金色になった黄金異変といわれる異変は	PRINTFORMDW これから数日後、常緑樹すらも巻き込みありとあらゆる木々が金色になった黄金異変といわれる異変は
PRINTFORMDW クイーンの力を吸収し、一年中秋に近い気候で仕事をする静葉から神らしさはさらに減ってしまったが	PRINTFORMDW クイーンの力を吸収し、一年中秋に近い気候で仕事をする静葉から神らしさはさらに減ってしまったが
PRINTFORMDW こんなところを穣子に見られてしまったら『お姉ちゃんは心配性ね』なんて笑われてしまうだろうか？	PRINTFORMDW こんなところを穣子に見られてしまったら『お姉ちゃんは心配性ね』なんて笑われてしまうだろうか？
PRINTFORML 「さすがにそこまでは思ってないとは私も分かってはいるけれどそう勘違いされてもしかたないわよ？」	PRINTFORML 「さすがにそこまでは思ってないとは私も分かってはいるけれどそう勘違いされてもしかたないわよ？」
PRINTFORMDL 暗い体内で抵抗することも出来ず静葉は胎内へ卵を産み付けられる感覚に耐えることしかできなかった	PRINTFORMDL 暗い体内で抵抗することも出来ず静葉は胎内へ卵を産み付けられる感覚に耐えることしかできなかった
PRINTFORMDL 静葉はゾッとして暴れるが静葉の全身を咥えこむ肉壁は彼女の全身を完全に包み込み抵抗を許さない。	PRINTFORMDL 静葉はゾッとして暴れるが静葉の全身を咥えこむ肉壁は彼女の全身を完全に包み込み抵抗を許さない。
PRINTFORMDL %CALLNAME:TARGET%は時々甘い声を漏らす以外、反応をみせずまるで人形のようだ…	PRINTFORMDL %CALLNAME:TARGET%は時々甘い声を漏らす以外、反応をみせずまるで人形のようだ…
PRINTFORMDW その塊が子宮口を犯す細い触手の中も通り子宮口を強引に押し広げ静葉の下腹部に激痛を引き起こす	PRINTFORMDW その塊が子宮口を犯す細い触手の中も通り子宮口を強引に押し広げ静葉の下腹部に激痛を引き起こす
PRINTFORMDW	胃の中身が空っぽになったところでフラフラと洗面所へ戻り、コップの中身を洗おうとしたところで	PRINTFORMDW	胃の中身が空っぽになったところでフラフラと洗面所へ戻り、コップの中身を洗おうとしたところで
PRINTFORMDW	事情を話すと妖怪の山の天狗の力で迷宮と神隠し、そして迷宮の入り口の情報は数分で山中に広がり	PRINTFORMDW	事情を話すと妖怪の山の天狗の力で迷宮と神隠し、そして迷宮の入り口の情報は数分で山中に広がり
PRINTFORMDW	まだ迷宮を脱出して1時間もたっていない…穣子の無事を祈りながら静葉もまた迷宮へと足を運んだ	PRINTFORMDW	まだ迷宮を脱出して1時間もたっていない…穣子の無事を祈りながら静葉もまた迷宮へと足を運んだ
PRINTFORMDW 必死に全ての葉っぱを涙目で塗りなおす静葉の姿は文々新聞の一面をかざったとかかざらないとか…	PRINTFORMDW 必死に全ての葉っぱを涙目で塗りなおす静葉の姿は文々新聞の一面をかざったとかかざらないとか…
PRINTFORML 「っておおおい！私はここよー！みんな大好き秋のお姉さんはお腹の中で助けをまってるのよー！？」	PRINTFORML 「っておおおい！私はここよー！みんな大好き秋のお姉さんはお腹の中で助けをまってるのよー！？」
PRINTFORML 「さあ！風流に紅葉を散らしてあげるわ！今ならこのお湯全てを埋め尽くすほどに紅葉をだしても！」	PRINTFORML 「さあ！風流に紅葉を散らしてあげるわ！今ならこのお湯全てを埋め尽くすほどに紅葉をだしても！」
PRINTFORMDL 静葉が這い出したのか、それとも%SAVESTR:(ARG:4)%の肉壁の自然な動きなのか…	PRINTFORMDL 静葉が這い出したのか、それとも%SAVESTR:(ARG:4)%の肉壁の自然な動きなのか…
PRINTFORMDL 静葉の弱っていく抵抗をあざ笑うかの用にぬめる肉壁は静葉の体をどんどん奥深くへ引きずり込む…	PRINTFORMDL 静葉の弱っていく抵抗をあざ笑うかの用にぬめる肉壁は静葉の体をどんどん奥深くへ引きずり込む…
PRINTFORMDL 本来自分が管理し秋色に染めるはずの植物に陵辱される悔しさに静葉はボロボロと大粒の涙を流した	PRINTFORMDL 本来自分が管理し秋色に染めるはずの植物に陵辱される悔しさに静葉はボロボロと大粒の涙を流した
PRINTFORMDL そんなわけがないと頭で分かっていても、従うしかない自分が悔しくて穣子は俯き、下唇を噛んだ。	PRINTFORMDL そんなわけがないと頭で分かっていても、従うしかない自分が悔しくて穣子は俯き、下唇を噛んだ。
PRINTFORML 「でも、しばらくは別々に行動しましょう。お姉ちゃん、穣子ちゃんを嫌いになんてなりたくないの」	PRINTFORML 「でも、しばらくは別々に行動しましょう。お姉ちゃん、穣子ちゃんを嫌いになんてなりたくないの」
PRINTFORMDL 腹の中で時折這い回る何かに対する恐怖の為か%CALLNAME:TARGET%は元気がない…	PRINTFORMDL 腹の中で時折這い回る何かに対する恐怖の為か%CALLNAME:TARGET%は元気がない…
PRINTFORMDW 静葉が玄関を開くと中から「放っておいて…」と覇気のない声がかけられ、静葉ははっとし叫んだ	PRINTFORMDW 静葉が玄関を開くと中から「放っておいて…」と覇気のない声がかけられ、静葉ははっとし叫んだ
PRINTFORMW 「本当にごめんね、でもお姉ちゃんだって穣子ちゃんが帰ってこなくてすごく心配したんだから…」	PRINTFORMW 「本当にごめんね、でもお姉ちゃんだって穣子ちゃんが帰ってこなくてすごく心配したんだから…」
PRINTFORMDW どうやら苗床として触手の母体とされていた穣子がクイーンの消滅と同時に解放されたようだった	PRINTFORMDW どうやら苗床として触手の母体とされていた穣子がクイーンの消滅と同時に解放されたようだった
PRINTFORMDW 激しい痛みと嫌悪感に悲鳴をあげ耐えることしか出来ない静葉の体から触手の幼体が産まれ落ちた	PRINTFORMDW 激しい痛みと嫌悪感に悲鳴をあげ耐えることしか出来ない静葉の体から触手の幼体が産まれ落ちた
PRINTFORMDW 洞穴に入ると静葉の母乳で急速に成長した触手の魔物は既に静葉と同じ程度の大きさになっていた	PRINTFORMDW 洞穴に入ると静葉の母乳で急速に成長した触手の魔物は既に静葉と同じ程度の大きさになっていた
PRINTFORMDW 一体どれほどの時間が立ったのだろうか？もう何匹の魔物を産み、何人の娘を産んだのだろうか…	PRINTFORMDW 一体どれほどの時間が立ったのだろうか？もう何匹の魔物を産み、何人の娘を産んだのだろうか…
PRINTFORMDW 静葉がボロボロと大粒の涙を流し穣子に飛びつこうとするが、その静葉の頬を穣子の両手が挟んだ	PRINTFORMDW 静葉がボロボロと大粒の涙を流し穣子に飛びつこうとするが、その静葉の頬を穣子の両手が挟んだ
PRINTFORMDW それは美しい紅葉を手向けることだけだと思った静葉はいつもにまして丁寧に葉を色づけていった	PRINTFORMDW それは美しい紅葉を手向けることだけだと思った静葉はいつもにまして丁寧に葉を色づけていった
PRINTFORMDW その娘は静葉の母乳を吸うと生まれたばかりだというのに立ち上がり獲物を求めて外へと出て行く	PRINTFORMDW その娘は静葉の母乳を吸うと生まれたばかりだというのに立ち上がり獲物を求めて外へと出て行く
PRINTFORMDW 突然、背後から声をかけられビクリと身を震わせた静葉が振り返るとそこには小さな女の子がいた	PRINTFORMDW 突然、背後から声をかけられビクリと身を震わせた静葉が振り返るとそこには小さな女の子がいた
PRINTFORMDW 目を白黒させ立ちすくむ静葉に女の子は近づき、ぎゅーっと甘えるように抱きつき、押し倒された	PRINTFORMDW 目を白黒させ立ちすくむ静葉に女の子は近づき、ぎゅーっと甘えるように抱きつき、押し倒された
PRINTFORMW ((…何を考えているの私！秋だからといってやって許されること、許されないことがあるわ！))	PRINTFORMW ((…何を考えているの私！秋だからといってやって許されること、許されないことがあるわ！))
PRINTFORMW 「ではお客様、お荷物をこちらに。お疲れのようですしまずはお風呂にご案内いたしましょうか？」	PRINTFORMW 「ではお客様、お荷物をこちらに。お疲れのようですしまずはお風呂にご案内いたしましょうか？」
PRINTFORMW それでも必死に訴えかける二人を前に、ついに%ARGS:0%は自分だけ外に向かう事を決心する	PRINTFORMW それでも必死に訴えかける二人を前に、ついに%ARGS:0%は自分だけ外に向かう事を決心する
PRINTFORML 通常モードでは穣子が一緒に閉じ込められているといないとでエンディング、一部口上が変化します	PRINTFORML 通常モードでは穣子が一緒に閉じ込められているといないとでエンディング、一部口上が変化します
PRINTFORMDL ぎくりとして思わず後ろを振り返った%CALLNAME:1%と静葉の視線が一瞬だけあった。	PRINTFORMDL ぎくりとして思わず後ろを振り返った%CALLNAME:1%と静葉の視線が一瞬だけあった。
PRINTFORMDL 静葉の目の前には穣子が帽子につけていたブドウの飾りの粒がバラバラになって散らばっていた…	PRINTFORMDL 静葉の目の前には穣子が帽子につけていたブドウの飾りの粒がバラバラになって散らばっていた…
PRINTFORMDL 口からただ甘い声を漏らすだけの静葉の身体は抵抗など出来ずゆっくりと肉の中へと沈んでいく…	PRINTFORMDL 口からただ甘い声を漏らすだけの静葉の身体は抵抗など出来ずゆっくりと肉の中へと沈んでいく…
PRINTFORMDL 静葉は%SAVESTR:(ARG:4)%が自分を嬲る為にわざと自分を解放したように感じた	PRINTFORMDL 静葉は%SAVESTR:(ARG:4)%が自分を嬲る為にわざと自分を解放したように感じた
PRINTFORMDL 唇を貪られ口内へと唾液とともに送られる媚薬に全身の感覚を溶かされながらも挿入だけは防いだ	PRINTFORMDL 唇を貪られ口内へと唾液とともに送られる媚薬に全身の感覚を溶かされながらも挿入だけは防いだ
PRINTFORMDL 数十秒以上続く子宮を内側から舐められるような感触に静葉の絶叫は次第に弱々しくなっていった	PRINTFORMDL 数十秒以上続く子宮を内側から舐められるような感触に静葉の絶叫は次第に弱々しくなっていった
PRINTFORML 「穣子ちゃん…お姉ちゃんはね。穣子ちゃんだけでもいいから無事に帰って欲しいって思ってるわ」	PRINTFORML 「穣子ちゃん…お姉ちゃんはね。穣子ちゃんだけでもいいから無事に帰って欲しいって思ってるわ」
PRINTFORMDW だが、心の傷は深く静葉と同じベッドでないと寝ることもできず、夜中にもよくうなされている	PRINTFORMDW だが、心の傷は深く静葉と同じベッドでないと寝ることもできず、夜中にもよくうなされている
PRINTFORMDW	『私だって死にたくなかった』『羨ましい』『憎い』『快楽と』『苦痛と』『恥辱と』『苦痛』	PRINTFORMDW	『私だって死にたくなかった』『羨ましい』『憎い』『快楽と』『苦痛と』『恥辱と』『苦痛』
PRINTFORMDW もう穣子の分の料理を作ってしまうことも、何かの拍子に穣子の名前を呼んでしまうこともない	PRINTFORMDW もう穣子の分の料理を作ってしまうことも、何かの拍子に穣子の名前を呼んでしまうこともない
PRINTFORMDW 迷宮での厳しいサバイバル計画を通しすっかり実力と自信をつけた彼女に初めての秋が訪れた…	PRINTFORMDW 迷宮での厳しいサバイバル計画を通しすっかり実力と自信をつけた彼女に初めての秋が訪れた…
PRINTFORMW 背後から聞こえてくる二人の悲鳴に、%ARGS:0%は泣くのを堪えながら出口へと走った……	PRINTFORMW 背後から聞こえてくる二人の悲鳴に、%ARGS:0%は泣くのを堪えながら出口へと走った……
PRINTFORMDW その姿は否が応でも人々の目を引き、目立つつもりがなくとも目立ってしまうことだろう…ッ！	PRINTFORMDW その姿は否が応でも人々の目を引き、目立つつもりがなくとも目立ってしまうことだろう…ッ！
PRINTFORMDW 風の心地よいこんなにも素晴らしい季節だというのに、人妖の興味は秋には少しも向いていない	PRINTFORMDW 風の心地よいこんなにも素晴らしい季節だというのに、人妖の興味は秋には少しも向いていない
PRINTFORML 「こんなよくわかんない生き物の子供ができたら信仰激減で私の神生が終焉しちゃうかもぉ！？」	PRINTFORML 「こんなよくわかんない生き物の子供ができたら信仰激減で私の神生が終焉しちゃうかもぉ！？」
PRINTFORMDL 呑み込まれている静葉の救出を諦めた%CALLNAME:1%はこの場を離れることにした…	PRINTFORMDL 呑み込まれている静葉の救出を諦めた%CALLNAME:1%はこの場を離れることにした…
PRINTFORMDL 目を覚ましたらめんどくさそうだと思いながらも%CALLNAME:1%は静葉の手を取った	PRINTFORMDL 目を覚ましたらめんどくさそうだと思いながらも%CALLNAME:1%は静葉の手を取った
PRINTFORML 「…しばらく頭ひやしてなさい。お姉ちゃんは一人で行くからね！熱い秋がそこにあるから！！」	PRINTFORML 「…しばらく頭ひやしてなさい。お姉ちゃんは一人で行くからね！熱い秋がそこにあるから！！」
PRINTFORMDL 咽るように汚濁液を撒き散らす%SAVESTR:(ARG:4)%から静葉も吐き出された…	PRINTFORMDL 咽るように汚濁液を撒き散らす%SAVESTR:(ARG:4)%から静葉も吐き出された…
PRINTFORMDL 射精の勢いはすさまじく、挿入されていないにも関わらず静葉の子宮へと不快感が満ちていく…	PRINTFORMDL 射精の勢いはすさまじく、挿入されていないにも関わらず静葉の子宮へと不快感が満ちていく…
PRINTFORMDL 暗いワームの体内でもみくちゃにされながらもはっきりとわかる異物感に静葉は叫び声をあげた	PRINTFORMDL 暗いワームの体内でもみくちゃにされながらもはっきりとわかる異物感に静葉は叫び声をあげた
PRINTFORMDL 静葉は必死に触手を抜こうともがくが吸盤の付いた太い触手は少しも静葉の自由を許さなかった	PRINTFORMDL 静葉は必死に触手を抜こうともがくが吸盤の付いた太い触手は少しも静葉の自由を許さなかった
PRINTFORML 「ごめんなさい…貴方がこの世に産まれてくることをお母さんは素直に喜んであげられないの…」	PRINTFORML 「ごめんなさい…貴方がこの世に産まれてくることをお母さんは素直に喜んであげられないの…」
PRINTFORMDL %CALLNAME:TARGET%は真っ青になって下腹部で脈動する触手を見つめている…	PRINTFORMDL %CALLNAME:TARGET%は真っ青になって下腹部で脈動する触手を見つめている…
PRINTFORMDL %CALLNAME:TARGET%は体にかかった白濁液を気持ち悪そうに見つめている……	PRINTFORMDL %CALLNAME:TARGET%は体にかかった白濁液を気持ち悪そうに見つめている……
PRINTFORMDL 時折腹部を押える%CALLNAME:TARGET%は今にも泣き出しそうな顔をしている。	PRINTFORMDL 時折腹部を押える%CALLNAME:TARGET%は今にも泣き出しそうな顔をしている。
PRINTFORMDW その日の宴会は、いつもにまして仲良く盃を交し合い笑いあいじゃれあう秋姉妹の姿があった	PRINTFORMDW その日の宴会は、いつもにまして仲良く盃を交し合い笑いあいじゃれあう秋姉妹の姿があった
PRINTFORMDW クイーンを倒し静葉は仇を討った事を穣子に伝える為、彼女の遺品があった場所へと向かった	PRINTFORMDW クイーンを倒し静葉は仇を討った事を穣子に伝える為、彼女の遺品があった場所へと向かった
PRINTFORMDW そこにあったバイオプラントの触手は溶けたアイスのようにドロドロに溶け生臭い臭いを放ち	PRINTFORMDW そこにあったバイオプラントの触手は溶けたアイスのようにドロドロに溶け生臭い臭いを放ち
PRINTFORMDW クイーンを倒した静葉が出口を探していると閉じ込められていた少女の一人に声をかけられた	PRINTFORMDW クイーンを倒した静葉が出口を探していると閉じ込められていた少女の一人に声をかけられた
PRINTFORMDW 静葉は子宮口を犯され、子宮を直接陵辱される異常な腹部の感覚に言葉を失い抵抗を諦めた…	PRINTFORMDW 静葉は子宮口を犯され、子宮を直接陵辱される異常な腹部の感覚に言葉を失い抵抗を諦めた…
PRINTFORMDW 先日、子宮に産み付けられたものが魔物の卵であったことを最悪の理由で知ることになった…	PRINTFORMDW 先日、子宮に産み付けられたものが魔物の卵であったことを最悪の理由で知ることになった…
PRINTFORMDW 静葉が虚ろな瞳を娘に向けると娘は嬉しそうに微笑み妖精を引きずりどこかへと去っていく…	PRINTFORMDW 静葉が虚ろな瞳を娘に向けると娘は嬉しそうに微笑み妖精を引きずりどこかへと去っていく…
PRINTFORMDW	『同じ目に』『お前も孕め』『壊れろ』『私達の苦しみを知れ』『なぜあんたが生き残った』	PRINTFORMDW	『同じ目に』『お前も孕め』『壊れろ』『私達の苦しみを知れ』『なぜあんたが生き残った』
PRINTFORMDW 出現する場所にまったく法則性がなく果たして自分がいた迷宮と同じかどうかも分からない…	PRINTFORMDW 出現する場所にまったく法則性がなく果たして自分がいた迷宮と同じかどうかも分からない…
PRINTFORMDW まだこんな風に考えてしまうのにそんなことをしてしまったらきっと悲しくなるだけだから…	PRINTFORMDW まだこんな風に考えてしまうのにそんなことをしてしまったらきっと悲しくなるだけだから…
PRINTFORMDW 静葉は出産の疲れと異形の生物を出産したショックでそれを呆然と見送る事しかできなかった	PRINTFORMDW 静葉は出産の疲れと異形の生物を出産したショックでそれを呆然と見送る事しかできなかった
PRINTFORMDW そう考えた静葉は山頂の二柱の神に力を借りようと妖怪の山の奥地へと足をむけたのであった	PRINTFORMDW そう考えた静葉は山頂の二柱の神に力を借りようと妖怪の山の奥地へと足をむけたのであった
PRINTFORMDW 壁の触手が静葉の尻をいやらしく撫で回し始めたので静葉は大きな悲鳴をあげて立ち上がった	PRINTFORMDW 壁の触手が静葉の尻をいやらしく撫で回し始めたので静葉は大きな悲鳴をあげて立ち上がった
PRINTFORMDW 静葉は大きく何度か深呼吸をすると落ち着いて自分のおかれた状況をゆっくりと考えはじめた	PRINTFORMDW 静葉は大きく何度か深呼吸をすると落ち着いて自分のおかれた状況をゆっくりと考えはじめた
PRINTFORMDL それならばと静葉はこの不快な肉の中から這い出そうと体をよじると肉壁が全身を揉みしだく	PRINTFORMDL それならばと静葉はこの不快な肉の中から這い出そうと体をよじると肉壁が全身を揉みしだく
PRINTFORMDL 必死に秘所を両手で覆うがスライムの体は指の隙間をズルズルとすり抜けて体内へと入り込む	PRINTFORMDL 必死に秘所を両手で覆うがスライムの体は指の隙間をズルズルとすり抜けて体内へと入り込む
PRINTFORMDL 何度も何度も振り返る穣子に静葉は快感と不快感で声が漏れそうになるのを必死に堪えながら	PRINTFORMDL 何度も何度も振り返る穣子に静葉は快感と不快感で声が漏れそうになるのを必死に堪えながら
PRINTFORMDL %CALLNAME:(ARG:1)%の顔が悲しげに曇ったことに静葉は気づかなかった…	PRINTFORMDL %CALLNAME:(ARG:1)%の顔が悲しげに曇ったことに静葉は気づかなかった…
PRINTFORMDL %CALLNAME:TARGET%は涙に濡れた瞳で必死に訴え、下半身を守っている……	PRINTFORMDL %CALLNAME:TARGET%は涙に濡れた瞳で必死に訴え、下半身を守っている……
PRINTFORMDL 時折手足の先をピクリと痙攣させる以外に%CALLNAME:TARGET%は動かない…	PRINTFORMDL 時折手足の先をピクリと痙攣させる以外に%CALLNAME:TARGET%は動かない…
PRINTFORMDW 汚れるのも気にせず静葉は粘液の水溜りにひざまづき、妹の体を肉塊の中から引きずり出す	PRINTFORMDW 汚れるのも気にせず静葉は粘液の水溜りにひざまづき、妹の体を肉塊の中から引きずり出す
PRINTFORMDW 生命力を吸われ続け心身共に酷く衰弱してはいるがまだ生きてはいる妹を静葉は抱え上げる	PRINTFORMDW 生命力を吸われ続け心身共に酷く衰弱してはいるがまだ生きてはいる妹を静葉は抱え上げる
PRINTFORMDW 『お姉ちゃん…どこ…？』と不安げな声に気づいた静葉は料理を中断し手をエプロンで拭う	PRINTFORMDW 『お姉ちゃん…どこ…？』と不安げな声に気づいた静葉は料理を中断し手をエプロンで拭う
PRINTFORMDW それが終わると別の魔物がブラシのような触手で静葉の肌を、そして髪を綺麗に磨いていく	PRINTFORMDW それが終わると別の魔物がブラシのような触手で静葉の肌を、そして髪を綺麗に磨いていく
PRINTFORMDW 穣子は『お姉ちゃんは心配性ね』と照れ笑いを浮かべると姉にそっとハンカチを差し出した	PRINTFORMDW 穣子は『お姉ちゃんは心配性ね』と照れ笑いを浮かべると姉にそっとハンカチを差し出した
PRINTFORMDW そして静葉とは対照的に怒りに目を燃え上がらせながら出口はずっと前に見つけていたこと	PRINTFORMDW そして静葉とは対照的に怒りに目を燃え上がらせながら出口はずっと前に見つけていたこと
PRINTFORMDW その事実を前に静葉が出来ることはそれが勘違いであることを祈って震えることだけだった	PRINTFORMDW その事実を前に静葉が出来ることはそれが勘違いであることを祈って震えることだけだった
PRINTFORMDL 静葉はもうどんなに暴れても解けそうにないほど触手が巻きついた体を見てため息をついた	PRINTFORMDL 静葉はもうどんなに暴れても解けそうにないほど触手が巻きついた体を見てため息をついた
PRINTFORMDL 力なく横たわっている%CALLNAME:(ARG:1)%の手を静葉はそっととった…	PRINTFORMDL 力なく横たわっている%CALLNAME:(ARG:1)%の手を静葉はそっととった…
PRINTFORMDL 身も心もボロボロで自分で歩くことも出来ない静葉を守りながら探索を続けるのは難しい…	PRINTFORMDL 身も心もボロボロで自分で歩くことも出来ない静葉を守りながら探索を続けるのは難しい…
PRINTFORML 「ごめんね…お姉ちゃん、穣子ちゃんを助けられなかった…ダメなお姉ちゃんでごめんね…」	PRINTFORML 「ごめんね…お姉ちゃん、穣子ちゃんを助けられなかった…ダメなお姉ちゃんでごめんね…」
PRINTFORML 「ごめんね…ごめんね……ごめん…なさい……お姉ちゃんの事…いっぱい責めていいから…」	PRINTFORML 「ごめんね…ごめんね……ごめん…なさい……お姉ちゃんの事…いっぱい責めていいから…」
PRINTFORMDL %CALLNAME:TARGET%は手足を使って弱々しいながらも肉壁を攻撃している	PRINTFORMDL %CALLNAME:TARGET%は手足を使って弱々しいながらも肉壁を攻撃している
PRINTFORMDL %CALLNAME:TARGET%は太ももを這い上がる触手の気配に慌てて前を隠した	PRINTFORMDL %CALLNAME:TARGET%は太ももを這い上がる触手の気配に慌てて前を隠した
PRINTFORMDL 腹部を押えた%CALLNAME:TARGET%は声もださずただ涙を流し続けている…	PRINTFORMDL 腹部を押えた%CALLNAME:TARGET%は声もださずただ涙を流し続けている…
PRINTFORML 「あんまり派手に動くと見えちゃいそう…でも、派手に動かざるを得ないのよね…はぁ…」	PRINTFORML 「あんまり派手に動くと見えちゃいそう…でも、派手に動かざるを得ないのよね…はぁ…」
PRINTFORMDW あの異変から数ヶ月、秋が近づき静葉たちもにわかに忙しく、そして騒がしくなりだした	PRINTFORMDW あの異変から数ヶ月、秋が近づき静葉たちもにわかに忙しく、そして騒がしくなりだした
PRINTFORMDW 二人で叫び8月31日のカレンダーをビリビリに破き妙なテンションで窓から投げ捨てる	PRINTFORMDW 二人で叫び8月31日のカレンダーをビリビリに破き妙なテンションで窓から投げ捨てる
PRINTFORMDW 最悪の結末も何度か考えたがそのたびに静葉は首を振ってその考えを吹き飛ばしていた…	PRINTFORMDW 最悪の結末も何度か考えたがそのたびに静葉は首を振ってその考えを吹き飛ばしていた…
PRINTFORMDW 遺品は迷宮に残してしまった穣子の安否を生存者に尋ねまわっていた時に見つけたものだ	PRINTFORMDW 遺品は迷宮に残してしまった穣子の安否を生存者に尋ねまわっていた時に見つけたものだ
PRINTFORMDW 『迷宮の床に落ちていた』そしてこう続けながら静葉の手に穣子の遺品を渡したのだった	PRINTFORMDW 『迷宮の床に落ちていた』そしてこう続けながら静葉の手に穣子の遺品を渡したのだった
PRINTFORMDW 穣子に穂子が声をかけると穣子はむっとして『おばちゃんって言うな！』と口を尖らせる	PRINTFORMDW 穣子に穂子が声をかけると穣子はむっとして『おばちゃんって言うな！』と口を尖らせる
PRINTFORMDW 幻想郷最後の触手の生き残りは過去の異変の事など少しも知らず幸せな毎日を送っていた	PRINTFORMDW 幻想郷最後の触手の生き残りは過去の異変の事など少しも知らず幸せな毎日を送っていた
PRINTFORMDW 静葉はその場に膝をつくとそのまま動かなくなり冬、冬、冬とうわ言のように呟き続けた	PRINTFORMDW 静葉はその場に膝をつくとそのまま動かなくなり冬、冬、冬とうわ言のように呟き続けた
PRINTFORMDW 触手の変わりに秋の味覚が育ち、温泉が沸き、リビングバインからは紅葉や銀杏が生えた	PRINTFORMDW 触手の変わりに秋の味覚が育ち、温泉が沸き、リビングバインからは紅葉や銀杏が生えた
PRINTFORMDW 本人達が幸せそうなので特に誰も気に止めずこの施設をありがたく利用するのであった…	PRINTFORMDW 本人達が幸せそうなので特に誰も気に止めずこの施設をありがたく利用するのであった…
PRINTFORMW ──今なら敵はあの二人に夢中になっている　　自分だけなら逃げられるのではないか──	PRINTFORMW ──今なら敵はあの二人に夢中になっている　　自分だけなら逃げられるのではないか──
PRINTFORML 「そこ弄られると気持ちよすぎておかしくなっちゃう♪なんて…いやマジやめてください」	PRINTFORML 「そこ弄られると気持ちよすぎておかしくなっちゃう♪なんて…いやマジやめてください」
PRINTFORMDL そう判断した%CALLNAME:1%は静かになるし静葉をおいていくことにした……	PRINTFORMDL そう判断した%CALLNAME:1%は静かになるし静葉をおいていくことにした……
PRINTFORML 「私は私の秋パワーを必要とする秋の足りない奴らに秋パワーをわけてくるわ！またね！」	PRINTFORML 「私は私の秋パワーを必要とする秋の足りない奴らに秋パワーをわけてくるわ！またね！」
PRINTFORMDL 暴れる静葉の手足は柔らかい肉に沈みすべり脱出への取っ掛かりなど少しもできなかった	PRINTFORMDL 暴れる静葉の手足は柔らかい肉に沈みすべり脱出への取っ掛かりなど少しもできなかった
PRINTFORMDL 白濁液に混じって数匹の寄生し損ねた幼体が静葉の股間から零れ落ち床をのた打ち回った	PRINTFORMDL 白濁液に混じって数匹の寄生し損ねた幼体が静葉の股間から零れ落ち床をのた打ち回った
PRINTFORMDL 白濁液に混じって寄生し損ねた数匹の幼体が静葉の股間から零れ落ち床をのた打ち回った	PRINTFORMDL 白濁液に混じって寄生し損ねた数匹の幼体が静葉の股間から零れ落ち床をのた打ち回った
PRINTFORMDL そんな静葉に押し付けられた肉壁の向こうから少しずつ遠のいていく足音が耳に入った…	PRINTFORMDL そんな静葉に押し付けられた肉壁の向こうから少しずつ遠のいていく足音が耳に入った…
PRINTFORMDL %CALLNAME:TARGET%は安堵とまだ残る恐怖とで肩で激しく息をしている	PRINTFORMDL %CALLNAME:TARGET%は安堵とまだ残る恐怖とで肩で激しく息をしている
PRINTFORMDL 着替えセットの中身は隠すべき場所が隠れる程度しか布面積のないキワドイ水着だった	PRINTFORMDL 着替えセットの中身は隠すべき場所が隠れる程度しか布面積のないキワドイ水着だった
PRINTFORMW 「お風呂でさっぱり汚れも気持ちもさっぱりさせて一緒にいっぱい飲みにいきましょ！」	PRINTFORMW 「お風呂でさっぱり汚れも気持ちもさっぱりさせて一緒にいっぱい飲みにいきましょ！」
PRINTFORMDW まだ息はあるが心身共に酷く衰弱している妹を受け取ると静葉はボロボロと涙を流した	PRINTFORMDW まだ息はあるが心身共に酷く衰弱している妹を受け取ると静葉はボロボロと涙を流した
PRINTFORMDW だが、少女の天敵として進化を果たした魔物を相手に静葉の力など役にはたたなかった	PRINTFORMDW だが、少女の天敵として進化を果たした魔物を相手に静葉の力など役にはたたなかった
PRINTFORMDW もしそれぞれの迷宮が別の迷宮ならば穣子を見た者が一人としていない事も納得がいく	PRINTFORMDW もしそれぞれの迷宮が別の迷宮ならば穣子を見た者が一人としていない事も納得がいく
PRINTFORMDW 『どうして？なんで抵抗するの？あたしはおかあさんと一緒に暮らしたいだけだよ？』	PRINTFORMDW 『どうして？なんで抵抗するの？あたしはおかあさんと一緒に暮らしたいだけだよ？』
PRINTFORMW ((四季は巡るもの。四季の一つを司る神がその摂理を捻じ曲げるだなんて言語道断))	PRINTFORMW ((四季は巡るもの。四季の一つを司る神がその摂理を捻じ曲げるだなんて言語道断))
PRINTFORML 「秋静はが宣言するわ！次でかならずこのふざけた呪縛から解き放たれる秋の到来を！」	PRINTFORML 「秋静はが宣言するわ！次でかならずこのふざけた呪縛から解き放たれる秋の到来を！」
PRINTFORML 「ちょ、ちょっと秋とはいえこの状況はちょっとお姉ちゃん大ピンチ的なアレよアレ！」	PRINTFORML 「ちょ、ちょっと秋とはいえこの状況はちょっとお姉ちゃん大ピンチ的なアレよアレ！」
PRINTFORML 「私が様子を見てくるわ。あなたはここで待っていて。私が帰るまで動いちゃダメよ？」	PRINTFORML 「私が様子を見てくるわ。あなたはここで待っていて。私が帰るまで動いちゃダメよ？」
PRINTFORMDL 捕らえられた静葉を置いて逃げることができず必死に戦っている穣子に静葉が叫んだ。	PRINTFORMDL 捕らえられた静葉を置いて逃げることができず必死に戦っている穣子に静葉が叫んだ。
PRINTFORML 「私、葉っぱだけじゃなくて女の子の顔を絶望色に塗るのも得意なんですよ、ふふっ♪」	PRINTFORML 「私、葉っぱだけじゃなくて女の子の顔を絶望色に塗るのも得意なんですよ、ふふっ♪」
PRINTFORML 「……いいわ！お姉ちゃん、もう穣子ちゃんのことなんて知らないんだから！ばかっ！」	PRINTFORML 「……いいわ！お姉ちゃん、もう穣子ちゃんのことなんて知らないんだから！ばかっ！」
PRINTFORMDL %CALLNAME:TARGET%は小さく悲鳴を漏らすが何も抵抗をしなかった…	PRINTFORMDL %CALLNAME:TARGET%は小さく悲鳴を漏らすが何も抵抗をしなかった…
PRINTFORMDL %CALLNAME:TARGET%は膨らみきった腹をなでながら呆然としている…	PRINTFORMDL %CALLNAME:TARGET%は膨らみきった腹をなでながら呆然としている…
PRINTFORMDL %CALLNAME:TARGET%は普段出さないような叫び声をあげて暴れている	PRINTFORMDL %CALLNAME:TARGET%は普段出さないような叫び声をあげて暴れている
PRINTFORMDL 着替えセットの中身はガーターベルトやベビードールといったセクシーな下着だった	PRINTFORMDL 着替えセットの中身はガーターベルトやベビードールといったセクシーな下着だった
PRINTFORMDW それも夜だと言うのに灯りのついていない家を前にしては仕方ないことかもしれない	PRINTFORMDW それも夜だと言うのに灯りのついていない家を前にしては仕方ないことかもしれない
PRINTFORMW (そもそも穣子ちゃんがちゃんと帰ってくればこんな事にはならなかったのだけど…)	PRINTFORMW (そもそも穣子ちゃんがちゃんと帰ってくればこんな事にはならなかったのだけど…)
PRINTFORMDW 見ているほうが恥ずかしくなるようなその光景は秋よりも春を感じさせるのであった	PRINTFORMDW 見ているほうが恥ずかしくなるようなその光景は秋よりも春を感じさせるのであった
PRINTFORMDW そんな穣子のベッドの脇の椅子に腰掛け、彼女の手を静葉は優しく両手で包み込んだ	PRINTFORMDW そんな穣子のベッドの脇の椅子に腰掛け、彼女の手を静葉は優しく両手で包み込んだ
PRINTFORMDW 静葉の胎内で成長していた生物が静葉の産道を押し広げ外へ這い出そうと暴れ始めた	PRINTFORMDW 静葉の胎内で成長していた生物が静葉の産道を押し広げ外へ這い出そうと暴れ始めた
PRINTFORMDW 迷宮の出入り口はある時は太陽の畑、ある時は人里付近、またある時は迷いの竹林…	PRINTFORMDW 迷宮の出入り口はある時は太陽の畑、ある時は人里付近、またある時は迷いの竹林…
PRINTFORMDW 静葉が迷宮を脱出し心身共々ボロボロのまま家路につくと驚いた顔の穣子が出迎えた	PRINTFORMDW 静葉が迷宮を脱出し心身共々ボロボロのまま家路につくと驚いた顔の穣子が出迎えた
PRINTFORMDW 『お姉ちゃん！？』と穣子が驚いた声をあげバタバタと静葉のほうへと向かっていく	PRINTFORMDW 『お姉ちゃん！？』と穣子が驚いた声をあげバタバタと静葉のほうへと向かっていく
PRINTFORMDW 穣子は出口をみつけたものの静葉を見たという人が居たために静葉を探していたこと	PRINTFORMDW 穣子は出口をみつけたものの静葉を見たという人が居たために静葉を探していたこと
PRINTFORMDW 急速に膨らんでいく腹部をなんとかしようにも外出などとてもできそうにはなかった	PRINTFORMDW 急速に膨らんでいく腹部をなんとかしようにも外出などとてもできそうにはなかった
PRINTFORMDW 悲鳴をきいた穣子が静葉の部屋に入るなり、その異常な光景に凍り付いてしまった…	PRINTFORMDW 悲鳴をきいた穣子が静葉の部屋に入るなり、その異常な光景に凍り付いてしまった…
PRINTFORMDW だが、穣子が我に帰った時には生まれたての触手が穣子に飛び掛っていたのだった…	PRINTFORMDW だが、穣子が我に帰った時には生まれたての触手が穣子に飛び掛っていたのだった…
PRINTFORMW 苦楽を共にしてきた二人を見捨てられないと、%ARGS:0%はその提案を否定する	PRINTFORMW 苦楽を共にしてきた二人を見捨てられないと、%ARGS:0%はその提案を否定する
PRINTFORMDW 人々は明日は自分や自分の大切な人が被害に遭うかもしれないと家で震えているのだ	PRINTFORMDW 人々は明日は自分や自分の大切な人が被害に遭うかもしれないと家で震えているのだ
PRINTFORMDW 眠い…まるで何かに強制的に眠らせられているかのように凶悪な眠気がやってくる…	PRINTFORMDW 眠い…まるで何かに強制的に眠らせられているかのように凶悪な眠気がやってくる…
PRINTFORML 「どいつもこいつも食欲の秋食欲の秋…紅葉の美しさに気づかぬ愚か者共ばかり……」	PRINTFORML 「どいつもこいつも食欲の秋食欲の秋…紅葉の美しさに気づかぬ愚か者共ばかり……」
PRINTFORMDW 申し訳なさそうな視線をちらりと一瞬だけ向けた仲間達が何も言わずに走り出した。	PRINTFORMDW 申し訳なさそうな視線をちらりと一瞬だけ向けた仲間達が何も言わずに走り出した。
PRINTFORML 「ふぁ、こんな場所にいるストレスだったのかしら？秋度が足りないわねやっぱり！」	PRINTFORML 「ふぁ、こんな場所にいるストレスだったのかしら？秋度が足りないわねやっぱり！」
PRINTFORML 「ここはどこ！？ええいどうでもいい！まずは探索よ！秋度を見つけ出すのだああ！」	PRINTFORML 「ここはどこ！？ええいどうでもいい！まずは探索よ！秋度を見つけ出すのだああ！」
PRINTFORMDL %SAVESTR:(ARG:4)%の口から静葉はなんとか手足の力で這い出した	PRINTFORMDL %SAVESTR:(ARG:4)%の口から静葉はなんとか手足の力で這い出した
PRINTFORMDL 力を込めようと強く握られていた手も今はだらりと垂れ下がり快楽に痙攣している…	PRINTFORMDL 力を込めようと強く握られていた手も今はだらりと垂れ下がり快楽に痙攣している…
PRINTFORMDL 引き抜かれた触手の先端から見せ付けるように滴り落ちた白濁液が静葉の肌を汚した	PRINTFORMDL 引き抜かれた触手の先端から見せ付けるように滴り落ちた白濁液が静葉の肌を汚した
PRINTFORMDL 静葉よりも先に状況を理解した触手が不幸な獲物をしゃぶりつくそうと殺到する…！	PRINTFORMDL 静葉よりも先に状況を理解した触手が不幸な獲物をしゃぶりつくそうと殺到する…！
PRINTFORML 「こんな場所だけど出会えたのも何かの縁、外に出れたら一緒に紅葉狩りしましょう」	PRINTFORML 「こんな場所だけど出会えたのも何かの縁、外に出れたら一緒に紅葉狩りしましょう」
PRINTFORML 「ですので同行してくれたことには少なからず感謝をしていないわけではないですよ」	PRINTFORML 「ですので同行してくれたことには少なからず感謝をしていないわけではないですよ」
PRINTFORML 「ごめんね…ごめんね……ごめん…なさい……お姉ちゃん…なにもできなかった……」	PRINTFORML 「ごめんね…ごめんね……ごめん…なさい……お姉ちゃん…なにもできなかった……」
PRINTFORMDL 初めてを死守しようと%CALLNAME:TARGET%は必死に抵抗している！	PRINTFORMDL 初めてを死守しようと%CALLNAME:TARGET%は必死に抵抗している！
PRINTFORMDL %CALLNAME:TARGET%は恐怖のあまり声もだせず唇を震わせている…	PRINTFORMDL %CALLNAME:TARGET%は恐怖のあまり声もだせず唇を震わせている…
PRINTFORMDL %CALLNAME:TARGET%は弱々しくありがとうと唇を震わせている……	PRINTFORMDL %CALLNAME:TARGET%は弱々しくありがとうと唇を震わせている……
PRINTFORMDL 着替えセットの中身は可愛らしいデザインの子供服一式、そしてランドセルだった	PRINTFORMDL 着替えセットの中身は可愛らしいデザインの子供服一式、そしてランドセルだった
PRINTFORMDW 幼体は精根尽きた静葉の胸から母乳を吸い尽くすと静葉の体を触手で拘束し始めた	PRINTFORMDW 幼体は精根尽きた静葉の胸から母乳を吸い尽くすと静葉の体を触手で拘束し始めた
PRINTFORMDW	秋になれば動物も妖怪も作物の恵を受けようと自然と集まり時には宴会も開かれる	PRINTFORMDW	秋になれば動物も妖怪も作物の恵を受けようと自然と集まり時には宴会も開かれる
PRINTFORMDW 家に帰ると静葉が神隠しにあっていてとても心配したことを涙ながらに訴えてきた	PRINTFORMDW 家に帰ると静葉が神隠しにあっていてとても心配したことを涙ながらに訴えてきた
PRINTFORMDW 静葉は穣子をギュッと抱きしめるとあやすように頭をぽんぽんと叩くように撫でた	PRINTFORMDW 静葉は穣子をギュッと抱きしめるとあやすように頭をぽんぽんと叩くように撫でた
PRINTFORMDW しばらくの間、抱き合っていた二人だが穣子が『お姉ちゃん臭い』と口を尖らせる	PRINTFORMDW しばらくの間、抱き合っていた二人だが穣子が『お姉ちゃん臭い』と口を尖らせる
PRINTFORMDW 母親が自分に何かしてくれそうだと本能的に感じ取った娘はこくりと小さく頷いた	PRINTFORMDW 母親が自分に何かしてくれそうだと本能的に感じ取った娘はこくりと小さく頷いた
PRINTFORMDW 子供とはいえ親は迷宮に居た魔物…とんでもないことをしていてもおかしくはない	PRINTFORMDW 子供とはいえ親は迷宮に居た魔物…とんでもないことをしていてもおかしくはない
PRINTFORMDW 神である静葉を僅か一匹の眷属だけでも圧倒できる想像を絶する力の権化クイーン	PRINTFORMDW 神である静葉を僅か一匹の眷属だけでも圧倒できる想像を絶する力の権化クイーン
PRINTFORML また、通常モードではビクビクおどおどしている泣き虫のお姉ちゃんを楽しめます。	PRINTFORML また、通常モードではビクビクおどおどしている泣き虫のお姉ちゃんを楽しめます。
PRINTFORMDW …静葉は覚悟を決めたようにぐっと拳を握るとこの洞窟を探索することを決心した	PRINTFORMDW …静葉は覚悟を決めたようにぐっと拳を握るとこの洞窟を探索することを決心した
PRINTFORML 「フォオオオオオオオオオオオオオオオリンブラアアアアアアアアアァァァァ！！」	PRINTFORML 「フォオオオオオオオオオオオオオオオリンブラアアアアアアアアアァァァァ！！」
PRINTFORML 「これで穣子ちゃんもおばちゃんねー…って言ってる場合じゃないわよねこれ！？」	PRINTFORML 「これで穣子ちゃんもおばちゃんねー…って言ってる場合じゃないわよねこれ！？」
PRINTFORML 「ライバルといえどもその手のオトナ行為はちょっとノーサンキューっていうか…」	PRINTFORML 「ライバルといえどもその手のオトナ行為はちょっとノーサンキューっていうか…」
PRINTFORML 「そのひまわりは何かしら！？もう秋よ！そんなもの捨てて楓の木をもちなさい！」	PRINTFORML 「そのひまわりは何かしら！？もう秋よ！そんなもの捨てて楓の木をもちなさい！」
PRINTFORML 「ひまわりをもっていられるのも今のうちよ？すぐに秋の植物を持たせてやるわ…」	PRINTFORML 「ひまわりをもっていられるのも今のうちよ？すぐに秋の植物を持たせてやるわ…」
PRINTFORML 「さあ！秋について！素晴らしい秋について！特に紅葉について語りましょうか！」	PRINTFORML 「さあ！秋について！素晴らしい秋について！特に紅葉について語りましょうか！」
PRINTFORML 「秋パワーを吸収したこの究極の力ですべてをフュージョンしつくしてやるわ！！」	PRINTFORML 「秋パワーを吸収したこの究極の力ですべてをフュージョンしつくしてやるわ！！」
PRINTFORML 「秋の本能なのかしら…あいたたたた…なんとなくもうすぐ産まれるって分かるわ」	PRINTFORML 「秋の本能なのかしら…あいたたたた…なんとなくもうすぐ産まれるって分かるわ」
PRINTFORMDL ぼーっとした瞳で快楽に震える静葉の肉体は触手に求められるがままとなっている	PRINTFORMDL ぼーっとした瞳で快楽に震える静葉の肉体は触手に求められるがままとなっている
PRINTFORMDL 数本の触手から逃れたもののまだ静葉の身体はがっちりと触手に絡め獲られている	PRINTFORMDL 数本の触手から逃れたもののまだ静葉の身体はがっちりと触手に絡め獲られている
PRINTFORMDL 抵抗する静葉の手足に次々と絡みつく触手を前に静葉の手足から力が抜けていった	PRINTFORMDL 抵抗する静葉の手足に次々と絡みつく触手を前に静葉の手足から力が抜けていった
PRINTFORMDL スライムのプールの中で膣へと侵入していく白濁した塊を止めようと静葉は暴れた	PRINTFORMDL スライムのプールの中で膣へと侵入していく白濁した塊を止めようと静葉は暴れた
PRINTFORMDL 全身の穴を押し広げられる快感と不快感に静葉は全身をビクビクと痙攣させている	PRINTFORMDL 全身の穴を押し広げられる快感と不快感に静葉は全身をビクビクと痙攣させている
PRINTFORMDL 静葉は穣子の姿が見えなくなるまで、安心させるかのようにずっと笑顔だった……	PRINTFORMDL 静葉は穣子の姿が見えなくなるまで、安心させるかのようにずっと笑顔だった……
PRINTFORMDL %CALLNAME:(ARG:1)%に尋ねたが穣子の行方はわからなかった…	PRINTFORMDL %CALLNAME:(ARG:1)%に尋ねたが穣子の行方はわからなかった…
PRINTFORML (隠れていれば…きっと誰かが助けにきてくれる……わけないわよね･･･ぐすっ)	PRINTFORML (隠れていれば…きっと誰かが助けにきてくれる……わけないわよね･･･ぐすっ)
PRINTFORMDL %CALLNAME:TARGET%は泣きながらも必死に這い出そうともがいた	PRINTFORMDL %CALLNAME:TARGET%は泣きながらも必死に這い出そうともがいた
PRINTFORMDL %CALLNAME:TARGET%は怯えた瞳で迫る巨大な口を見つめている…	PRINTFORMDL %CALLNAME:TARGET%は怯えた瞳で迫る巨大な口を見つめている…
PRINTFORMDL %CALLNAME:TARGET%は静かに、だが強い調子でそう言い残した。	PRINTFORMDL %CALLNAME:TARGET%は静かに、だが強い調子でそう言い残した。
PRINTFORMDW 穣子は腕を力なく持ち上げると震える指で静葉の涙をそっと拭い、気を失った…	PRINTFORMDW 穣子は腕を力なく持ち上げると震える指で静葉の涙をそっと拭い、気を失った…
PRINTFORMDW 静葉が外に出ると、先に脱出していた穣子が満面の笑顔で静葉に飛びついてきた	PRINTFORMDW 静葉が外に出ると、先に脱出していた穣子が満面の笑顔で静葉に飛びついてきた
PRINTFORMDW 何とか迷宮の外へ脱出することに成功した静葉は助けを求めがむしゃらに走った	PRINTFORMDW 何とか迷宮の外へ脱出することに成功した静葉は助けを求めがむしゃらに走った
PRINTFORMDW	天狗はもちろん、河童、妖怪、神…妖怪の山の有志達が異変解決の為に集結した	PRINTFORMDW	天狗はもちろん、河童、妖怪、神…妖怪の山の有志達が異変解決の為に集結した
PRINTFORMDW	立ち尽くす静葉に天狗は重々しく口を開く『これしか見つけられていない』と…	PRINTFORMDW	立ち尽くす静葉に天狗は重々しく口を開く『これしか見つけられていない』と…
PRINTFORMDW 穣子はムスッとした表情だが、静葉の体をぎゅっと抱きしめて離そうとはしない	PRINTFORMDW 穣子はムスッとした表情だが、静葉の体をぎゅっと抱きしめて離そうとはしない
PRINTFORMW 「穣子ちゃん！準備はOK！？道具は！？テンションは！？秋よ！始まるわ！！」	PRINTFORMW 「穣子ちゃん！準備はOK！？道具は！？テンションは！？秋よ！始まるわ！！」
PRINTFORMDW 生存者の何人かが穣子を見た気がすると言うものの穣子はまだもどってこない…	PRINTFORMDW 生存者の何人かが穣子を見た気がすると言うものの穣子はまだもどってこない…
PRINTFORMDW 『あんな状況だったから使えるものは使わないと自分の身が危なかったんだ』と	PRINTFORMDW 『あんな状況だったから使えるものは使わないと自分の身が危なかったんだ』と
PRINTFORMDW 悪夢の終わりに対する安心感か？心身の傷の為に自分の事で手一杯だったのか？	PRINTFORMDW 悪夢の終わりに対する安心感か？心身の傷の為に自分の事で手一杯だったのか？
PRINTFORMDW たとえこのまま外に出たとしても迷宮に入ってかなりの時間がたっているのだ。	PRINTFORMDW たとえこのまま外に出たとしても迷宮に入ってかなりの時間がたっているのだ。
PRINTFORMDW 静葉は大股でずかずかと歩きながら静葉は怒りに任せて酔っ払いのように怒鳴る	PRINTFORMDW 静葉は大股でずかずかと歩きながら静葉は怒りに任せて酔っ払いのように怒鳴る
PRINTFORMDW はっと慌てて目を覚ました静葉の目の前には見たこともない世界が広がっていた	PRINTFORMDW はっと慌てて目を覚ました静葉の目の前には見たこともない世界が広がっていた
PRINTFORML 「秋パワー充填完了！天狗に攻撃すらさせない秋過ぎる弾幕をくらうがいいわ！」	PRINTFORML 「秋パワー充填完了！天狗に攻撃すらさせない秋過ぎる弾幕をくらうがいいわ！」
PRINTFORML 「ちょ、ちょ、ちょ、ちょっと！そそそそそそれはさすがにダダダダダメだよ！」	PRINTFORML 「ちょ、ちょ、ちょ、ちょっと！そそそそそそれはさすがにダダダダダメだよ！」
PRINTFORMDL ツタが小気味いい乾いた音と共に何度もリズミカルに静葉の頬を往復ビンタした	PRINTFORMDL ツタが小気味いい乾いた音と共に何度もリズミカルに静葉の頬を往復ビンタした
PRINTFORML 「…ちょっとお姉ちゃんカチンときてなくもないわけじゃなかったりするかなー」	PRINTFORML 「…ちょっとお姉ちゃんカチンときてなくもないわけじゃなかったりするかなー」
PRINTFORMDL 触手越しに伝わってくるゴロリとした何かが進入する感触に静葉は言葉を失った	PRINTFORMDL 触手越しに伝わってくるゴロリとした何かが進入する感触に静葉は言葉を失った
PRINTFORMDL 蠢く触手の幼体が静葉の子宮口を押し広げる痛みに静葉は思わず叫び声をあげた	PRINTFORMDL 蠢く触手の幼体が静葉の子宮口を押し広げる痛みに静葉は思わず叫び声をあげた
PRINTFORMDL 射精の度に結合部から子宮に入りきらなかった粘つく精液が噴出し内腿を汚した	PRINTFORMDL 射精の度に結合部から子宮に入りきらなかった粘つく精液が噴出し内腿を汚した
PRINTFORMDL 静葉は膣内に射精されると抵抗を諦め、虚ろな瞳で陵辱が終わるを待っていた…	PRINTFORMDL 静葉は膣内に射精されると抵抗を諦め、虚ろな瞳で陵辱が終わるを待っていた…
PRINTFORMDL 突かれていると錯覚するほど強い勢いで吐き出される精液が子宮の奥を叩くたび	PRINTFORMDL 突かれていると錯覚するほど強い勢いで吐き出される精液が子宮の奥を叩くたび
PRINTFORMDL 穣子はこの迷宮には居ないので自分の身を守ることを優先するように諭された…	PRINTFORMDL 穣子はこの迷宮には居ないので自分の身を守ることを優先するように諭された…
PRINTFORMDL %CALLNAME:(ARG:1)%は迷宮の中で穣子らしき人をみたらしい	PRINTFORMDL %CALLNAME:(ARG:1)%は迷宮の中で穣子らしき人をみたらしい
PRINTFORML 「待ち伏せなんて卑怯な気もするけど…そんなこと言ってる場合じゃないわよね」	PRINTFORML 「待ち伏せなんて卑怯な気もするけど…そんなこと言ってる場合じゃないわよね」
PRINTFORML 「だからこれからもお姉ちゃんを利用してでも助かろうなんて事をするなら……」	PRINTFORML 「だからこれからもお姉ちゃんを利用してでも助かろうなんて事をするなら……」
PRINTFORMDL %CALLNAME:TARGET%はブンブンと首を横に必死に振っている。	PRINTFORMDL %CALLNAME:TARGET%はブンブンと首を横に必死に振っている。
PRINTFORMDW %CALLNAME:TARGET%は下腹部の圧迫感に思わず涙を滲ませた…	PRINTFORMDW %CALLNAME:TARGET%は下腹部の圧迫感に思わず涙を滲ませた…
PRINTFORMDL %CALLNAME:TARGET%はふらつく足取りで必死に逃げ出した……	PRINTFORMDL %CALLNAME:TARGET%はふらつく足取りで必死に逃げ出した……
PRINTFORML 「こんな場所にいるからかしら…ちょっと布地が頼りないのが気になっちゃう」	PRINTFORML 「こんな場所にいるからかしら…ちょっと布地が頼りないのが気になっちゃう」
PRINTFORMDW そしてお風呂に入って汚れを落としてさっぱりする為に一旦自宅へと向かった	PRINTFORMDW そしてお風呂に入って汚れを落としてさっぱりする為に一旦自宅へと向かった
PRINTFORMDW 玄関の前に立つ頃にはすっかり晴れやかだった表情は暗く悲しげになっていた	PRINTFORMDW 玄関の前に立つ頃にはすっかり晴れやかだった表情は暗く悲しげになっていた
PRINTFORMDW 体を摺り寄せ甘える酔った妹を酔った姉は抱きしめたり撫でたり膝枕したり…	PRINTFORMDW 体を摺り寄せ甘える酔った妹を酔った姉は抱きしめたり撫でたり膝枕したり…
PRINTFORMDW 中心部に満たされていたらしい得体の知れない粘つく液体が床を満たしていた	PRINTFORMDW 中心部に満たされていたらしい得体の知れない粘つく液体が床を満たしていた
PRINTFORMDW 数日後、魔物に汚染されあの迷宮のように触手が生えた壁に捕えられた静葉は	PRINTFORMDW 数日後、魔物に汚染されあの迷宮のように触手が生えた壁に捕えられた静葉は
PRINTFORMDW その年の紅葉はそれから何年も語り継がれるような見事な紅葉だったという…	PRINTFORMDW その年の紅葉はそれから何年も語り継がれるような見事な紅葉だったという…
PRINTFORMDW はっとした静葉は悲鳴をあげ娘を引き剥がそうと暴れる静葉の頬を平手が弾く	PRINTFORMDW はっとした静葉は悲鳴をあげ娘を引き剥がそうと暴れる静葉の頬を平手が弾く
PRINTFORML 「私はただ立っているだけでも秋の力でガードできるのよ！さあっ来なさい！」	PRINTFORML 「私はただ立っているだけでも秋の力でガードできるのよ！さあっ来なさい！」
PRINTFORML 「せめて外に！ね、責任とらせに家まで押しかけられたくはないでしょ？ね？」	PRINTFORML 「せめて外に！ね、責任とらせに家まで押しかけられたくはないでしょ？ね？」
PRINTFORMDL 静葉はダラダラと冷や汗を流しながら下腹部で脈動する触手を見つめている…	PRINTFORMDL 静葉はダラダラと冷や汗を流しながら下腹部で脈動する触手を見つめている…
PRINTFORML 「さあさあ秋パワーで傷んだ服を修理っと、紅葉いっぱいくっつけるわよー！」	PRINTFORML 「さあさあ秋パワーで傷んだ服を修理っと、紅葉いっぱいくっつけるわよー！」
PRINTFORML 「ここは二手にわかれましょう！大丈夫！秋の加護は離れていてもあるのよ！」	PRINTFORML 「ここは二手にわかれましょう！大丈夫！秋の加護は離れていてもあるのよ！」
PRINTFORML 「どうしてあなたがいるかわからないけれど今は秋よ秋！残念だったわね！！」	PRINTFORML 「どうしてあなたがいるかわからないけれど今は秋よ秋！残念だったわね！！」
PRINTFORML 「ふっふっふ、秋パワー溢れる私のマシンガントークについてこれるかしら？」	PRINTFORML 「ふっふっふ、秋パワー溢れる私のマシンガントークについてこれるかしら？」
PRINTFORMDL 膣口に押し付けられた触手からとめどなく白濁液が噴出し静葉の膣を汚した…	PRINTFORMDL 膣口に押し付けられた触手からとめどなく白濁液が噴出し静葉の膣を汚した…
PRINTFORMDL 射精の度に膣へ侵入できなかった精液が静葉の全身を白く染め上げていった…	PRINTFORMDL 射精の度に膣へ侵入できなかった精液が静葉の全身を白く染め上げていった…
PRINTFORMDL 子宮へと粘つく特濃の精液を注ぎ込まれる度に静葉の腹部がにわかに膨らむ…	PRINTFORMDL 子宮へと粘つく特濃の精液を注ぎ込まれる度に静葉の腹部がにわかに膨らむ…
PRINTFORMDL 体内と体外を同時に汚され静葉は体を庇うことを諦めなすがままとなっている	PRINTFORMDL 体内と体外を同時に汚され静葉は体を庇うことを諦めなすがままとなっている
PRINTFORMDL それだけ叫んだ静葉だが、すぐに諦めたのかそれっきり言葉を発しなかった。	PRINTFORMDL それだけ叫んだ静葉だが、すぐに諦めたのかそれっきり言葉を発しなかった。
PRINTFORML (どうして…ううん、今は素直に穣子ちゃんが生きていたことを喜びましょ！)	PRINTFORML (どうして…ううん、今は素直に穣子ちゃんが生きていたことを喜びましょ！)
PRINTFORML 「穣子ちゃんが神隠しにあってしまって…きっとここのいると思うのだけど…」	PRINTFORML 「穣子ちゃんが神隠しにあってしまって…きっとここのいると思うのだけど…」
PRINTFORML 「心配してくれてありがとう。そう…穣子ちゃんはいないのね…よかった……」	PRINTFORML 「心配してくれてありがとう。そう…穣子ちゃんはいないのね…よかった……」
PRINTFORML 「……不安じゃないといえば嘘になっちゃうけれどそのほうがいいというなら」	PRINTFORML 「……不安じゃないといえば嘘になっちゃうけれどそのほうがいいというなら」
PRINTFORML 「ごめんなさい。これ以上貴方について行っても危険なだけとしか思えません」	PRINTFORML 「ごめんなさい。これ以上貴方について行っても危険なだけとしか思えません」
PRINTFORMDL %CALLNAME:TARGET%は怯えながら弱々しい弾幕を放っている	PRINTFORMDL %CALLNAME:TARGET%は怯えながら弱々しい弾幕を放っている
PRINTFORMDL %CALLNAME:TARGET%は呆然と自分の下腹部を見つめている…	PRINTFORMDL %CALLNAME:TARGET%は呆然と自分の下腹部を見つめている…
PRINTFORMDL %CALLNAME:TARGET%は濁った瞳でふらふらと立ち上がった…	PRINTFORMDL %CALLNAME:TARGET%は濁った瞳でふらふらと立ち上がった…
PRINTFORMDW そう考えをめぐらせ続けるも答えが出ないまま穣子が力尽きた部屋へとつく	PRINTFORMDW そう考えをめぐらせ続けるも答えが出ないまま穣子が力尽きた部屋へとつく
PRINTFORMDW このまま捕まると危険だと感じた静葉も力を振り絞り暴れ叫ぼうと抵抗する	PRINTFORMDW このまま捕まると危険だと感じた静葉も力を振り絞り暴れ叫ぼうと抵抗する
PRINTFORMDW	捕らわれた者達だけでなく突入した者達からも多くの犠牲者をだしたものの	PRINTFORMDW	捕らわれた者達だけでなく突入した者達からも多くの犠牲者をだしたものの
PRINTFORMDW 生還者が現れる度に穣子の安否を聞き、出入り口のあった場所を尋ねていた	PRINTFORMDW 生還者が現れる度に穣子の安否を聞き、出入り口のあった場所を尋ねていた
PRINTFORMDW それはこっちの台詞だとボロボロの服を身に着けた静葉に食って掛かる穣子	PRINTFORMDW それはこっちの台詞だとボロボロの服を身に着けた静葉に食って掛かる穣子
PRINTFORMDW 捕らわれた者達だけでなく突入した者達からも多くの犠牲者をだしたものの	PRINTFORMDW 捕らわれた者達だけでなく突入した者達からも多くの犠牲者をだしたものの
PRINTFORMDW 静葉がその事について問い詰めると生存者はバツが悪そうにこう答えたのだ	PRINTFORMDW 静葉がその事について問い詰めると生存者はバツが悪そうにこう答えたのだ
PRINTFORMDW 静葉は虚ろな瞳でフラフラと立ち上がると再び迷宮の中へと帰っていった…	PRINTFORMDW 静葉は虚ろな瞳でフラフラと立ち上がると再び迷宮の中へと帰っていった…
PRINTFORMDW なんにせよ、誰一人として静葉が外にいないことには気づかなかったのだ。	PRINTFORMDW なんにせよ、誰一人として静葉が外にいないことには気づかなかったのだ。
PRINTFORMDW エプロンを着けたオーナー静葉自らが温かい笑顔で客を触手宮に招きいれた	PRINTFORMDW エプロンを着けたオーナー静葉自らが温かい笑顔で客を触手宮に招きいれた
PRINTFORMDW 静葉は触手達と共に外へ繰り出そうとしたのだがそう上手くはいかなかった	PRINTFORMDW 静葉は触手達と共に外へ繰り出そうとしたのだがそう上手くはいかなかった
PRINTFORMW 出口を見つけたものの、そこを守る魔物は強く、自分達ではどうしようもない	PRINTFORMW 出口を見つけたものの、そこを守る魔物は強く、自分達ではどうしようもない
PRINTFORML 「言うなれば…そうッ！超強気な幸せもの！スーパーゴッド静葉よッッッ！」	PRINTFORML 「言うなれば…そうッ！超強気な幸せもの！スーパーゴッド静葉よッッッ！」
PRINTFORML 「そういや昔、枯らそうとしたツタ植物に絡みつかれたこともあったわね…」	PRINTFORML 「そういや昔、枯らそうとしたツタ植物に絡みつかれたこともあったわね…」
PRINTFORML 「私が強くなりすぎたのかしら？ライバルの貴方の攻撃もあまり痛くないわ」	PRINTFORML 「私が強くなりすぎたのかしら？ライバルの貴方の攻撃もあまり痛くないわ」
PRINTFORML 「弱ってると思ったかしら？これは演戯よ！だからもう狙わないでください」	PRINTFORML 「弱ってると思ったかしら？これは演戯よ！だからもう狙わないでください」
PRINTFORML 「静けさと終焉を司る私にかかれば静かに部屋を移動するなんて朝飯前よ！」	PRINTFORML 「静けさと終焉を司る私にかかれば静かに部屋を移動するなんて朝飯前よ！」
PRINTFORML 「ほら！ほらほらほら！もっと紅葉を！もっと秋を！ひゃっはああああ！！」	PRINTFORML 「ほら！ほらほらほら！もっと紅葉を！もっと秋を！ひゃっはああああ！！」
PRINTFORML 「いいのいいの、私の秋パワーが強力すぎて一緒にいると辛いんでしょう？」	PRINTFORML 「いいのいいの、私の秋パワーが強力すぎて一緒にいると辛いんでしょう？」
PRINTFORMDL 少し這い出したところで静葉の身体を肉壁が包んでいる事にはかわらない…	PRINTFORMDL 少し這い出したところで静葉の身体を肉壁が包んでいる事にはかわらない…
PRINTFORMDL 静葉は挿入を防いだにも関わらず膣内を汚され、妊娠の恐怖に震えている…	PRINTFORMDL 静葉は挿入を防いだにも関わらず膣内を汚され、妊娠の恐怖に震えている…
PRINTFORMDL いつまでも止まらない射精に静葉は言葉にならないうめき声をあげている…	PRINTFORMDL いつまでも止まらない射精に静葉は言葉にならないうめき声をあげている…
PRINTFORMDL 静葉は吐き出される新鮮な精液で手を汚しながらも挿入を拒み抵抗している	PRINTFORMDL 静葉は吐き出される新鮮な精液で手を汚しながらも挿入を拒み抵抗している
PRINTFORMDL 静葉は安心して気が抜けたのかその場に座り込むとめそめそ泣きはじめた。	PRINTFORMDL 静葉は安心して気が抜けたのかその場に座り込むとめそめそ泣きはじめた。
PRINTFORMDL 穣子の姿が見えなくなったところで静葉は溜め込んでいた涙を溢れさせた…	PRINTFORMDL 穣子の姿が見えなくなったところで静葉は溜め込んでいた涙を溢れさせた…
PRINTFORMDL 静葉は自身が助からないと悟ったのか少しも抵抗をしている様子がない……	PRINTFORMDL 静葉は自身が助からないと悟ったのか少しも抵抗をしている様子がない……
PRINTFORMDL そう判断した%CALLNAME:1%は静葉をおいていくことにした……	PRINTFORMDL そう判断した%CALLNAME:1%は静葉をおいていくことにした……
PRINTFORML 「けれども貴方は私の事を便利な囮程度にしか思ってはいないのでしょう？」	PRINTFORML 「けれども貴方は私の事を便利な囮程度にしか思ってはいないのでしょう？」
PRINTFORML 「これに…はぁ…はぁ…こりたら…二度と変な気はおこさないでください！」	PRINTFORML 「これに…はぁ…はぁ…こりたら…二度と変な気はおこさないでください！」
PRINTFORMDL %CALLNAME:TARGET%は泣きながら全身を痙攣させている…	PRINTFORMDL %CALLNAME:TARGET%は泣きながら全身を痙攣させている…
PRINTFORMDL %CALLNAME:TARGET%は深刻な表情で部屋を探索している。	PRINTFORMDL %CALLNAME:TARGET%は深刻な表情で部屋を探索している。
PRINTFORMDW 神隠しが多いこと、自分が家を出てからかなりの時間が立っていたこと…	PRINTFORMDW 神隠しが多いこと、自分が家を出てからかなりの時間が立っていたこと…
PRINTFORMDW 静葉はその中心に見慣れた姿が裸で倒れている事に気づき、悲鳴をあげた	PRINTFORMDW 静葉はその中心に見慣れた姿が裸で倒れている事に気づき、悲鳴をあげた
PRINTFORMDW	迷宮の主を倒した為に幻想郷はまたいつものように平和を取り戻していた	PRINTFORMDW	迷宮の主を倒した為に幻想郷はまたいつものように平和を取り戻していた
PRINTFORMDW 静葉は今なお帰らない穣子を助ける為に迷宮の出入り口を探し続けていた	PRINTFORMDW 静葉は今なお帰らない穣子を助ける為に迷宮の出入り口を探し続けていた
PRINTFORMDW 静葉は今にも泣き出しそうな穣子の肩に安心させるように優しく手置いた	PRINTFORMDW 静葉は今にも泣き出しそうな穣子の肩に安心させるように優しく手置いた
PRINTFORMW 「心配かけてごめんね、大丈夫。もうお姉ちゃんはどこにも行かないから」	PRINTFORMW 「心配かけてごめんね、大丈夫。もうお姉ちゃんはどこにも行かないから」
PRINTFORMDW 迷宮の主を倒した為に幻想郷はまたいつものように平和を取り戻していた	PRINTFORMDW 迷宮の主を倒した為に幻想郷はまたいつものように平和を取り戻していた
PRINTFORMDW 静葉は慌てて玄関へとかけていくと穣子がむすっとした表情で立っていた	PRINTFORMDW 静葉は慌てて玄関へとかけていくと穣子がむすっとした表情で立っていた
PRINTFORMDW 人々が異変のことを忘れ始めてもなお、静葉の心には深い傷が残っていた	PRINTFORMDW 人々が異変のことを忘れ始めてもなお、静葉の心には深い傷が残っていた
PRINTFORMDW 頬を何度も打たれ痛みと恐怖に啜り泣く静葉に娘は無邪気な笑顔を向けた	PRINTFORMDW 頬を何度も打たれ痛みと恐怖に啜り泣く静葉に娘は無邪気な笑顔を向けた
PRINTFORMW 「さあ出てきなさい神隠しの正体！この私がギャフンといわせてやるわ！」	PRINTFORMW 「さあ出てきなさい神隠しの正体！この私がギャフンといわせてやるわ！」
PRINTFORML 「今の私はたとえ巫女の弾幕を喰らおうとも立っていられる気がするわ！」	PRINTFORML 「今の私はたとえ巫女の弾幕を喰らおうとも立っていられる気がするわ！」
PRINTFORML 「ぜーぜー…この脚で…私は……ぜーぜー･･･ええい！めんどくさい！」	PRINTFORML 「ぜーぜー…この脚で…私は……ぜーぜー･･･ええい！めんどくさい！」
PRINTFORML 「私の秋パワーが欲しいのは分かるけど、神以外にはあつかえないわよ？」	PRINTFORML 「私の秋パワーが欲しいのは分かるけど、神以外にはあつかえないわよ？」
PRINTFORML 「それでこそ我がライバルぅぅうう%UNICODE(0x2665)%」	PRINTFORML 「それでこそ我がライバルぅぅうう%UNICODE(0x2665)%」
PRINTFORML 「ライバルと友情はともかく愛情って出すなぁ！やめろー！ぎゃーーー！」	PRINTFORML 「ライバルと友情はともかく愛情って出すなぁ！やめろー！ぎゃーーー！」
PRINTFORML 「うぐぐぐぐぐ…こんなにされたらちょっとやそっとじゃ直せないわね…」	PRINTFORML 「うぐぐぐぐぐ…こんなにされたらちょっとやそっとじゃ直せないわね…」
PRINTFORML 「貴様の葉という葉を全て鮮やかな朱に染め上げ秋の礎としてやるわ！！」	PRINTFORML 「貴様の葉という葉を全て鮮やかな朱に染め上げ秋の礎としてやるわ！！」
PRINTFORML 「そんな品のない紅は秋の赤ではないわ！許せない！秋に対する侮辱よ！」	PRINTFORML 「そんな品のない紅は秋の赤ではないわ！許せない！秋に対する侮辱よ！」
PRINTFORML 「今の私は気分がいいわ！冬の化身相手でも引かぬこびぬ省みぬぅぅ！！」	PRINTFORML 「今の私は気分がいいわ！冬の化身相手でも引かぬこびぬ省みぬぅぅ！！」
PRINTFORMW 「うう…やっぱり秋とはいえさすがに…お姉ちゃんこれはショックだわ…」	PRINTFORMW 「うう…やっぱり秋とはいえさすがに…お姉ちゃんこれはショックだわ…」
PRINTFORML 「反省したらまた少し力を貸してあげなくもないわよ？それまでさようなら	PRINTFORML 「反省したらまた少し力を貸してあげなくもないわよ？それまでさようなら
PRINTFORML 「外に出たら秋が終わっていたりして……い、いや！そんなはずないわ！」	PRINTFORML 「外に出たら秋が終わっていたりして……い、いや！そんなはずないわ！」
PRINTFORMDL 静葉は泣きながらも必死に絡みついた触手を掴み引き剥がそうとしている	PRINTFORMDL 静葉は泣きながらも必死に絡みついた触手を掴み引き剥がそうとしている
PRINTFORMDL 静葉が暴れた拍子に肉壁が大きくうねったかと思うと静葉を吐き出した！	PRINTFORMDL 静葉が暴れた拍子に肉壁が大きくうねったかと思うと静葉を吐き出した！
PRINTFORMDL 身体をねじり手足を無様に振り回しなんとか静葉は数本の触手から逃れた	PRINTFORMDL 身体をねじり手足を無様に振り回しなんとか静葉は数本の触手から逃れた
PRINTFORML 子宮いっぱいに生暖かい感触が満ちてもなお続く射精に静葉はなすがままだ	PRINTFORML 子宮いっぱいに生暖かい感触が満ちてもなお続く射精に静葉はなすがままだ
PRINTFORMDL 静葉は肉壁に包まれた状態でどうしたらいいか分からずおろおろしている	PRINTFORMDL 静葉は肉壁に包まれた状態でどうしたらいいか分からずおろおろしている
PRINTFORMDL 静葉は精一杯の大声を出すが、それっきりぐったりと全身の力を抜いた…	PRINTFORMDL 静葉は精一杯の大声を出すが、それっきりぐったりと全身の力を抜いた…
PRINTFORMDL ついさっき危険な状態の穣子を見かけたので急いだほうがいいと言われた	PRINTFORMDL ついさっき危険な状態の穣子を見かけたので急いだほうがいいと言われた
PRINTFORMDL %CALLNAME:TARGET%は肩を抱き震えて座り込んでいる…	PRINTFORMDL %CALLNAME:TARGET%は肩を抱き震えて座り込んでいる…
PRINTFORMDL %CALLNAME:TARGET%は胸を守ろうと必死に身をよじった	PRINTFORMDL %CALLNAME:TARGET%は胸を守ろうと必死に身をよじった
PRINTFORMDL %CALLNAME:TARGET%は下唇を噛んで声を押し殺している	PRINTFORMDL %CALLNAME:TARGET%は下唇を噛んで声を押し殺している
PRINTFORMDL 声を出しかけた%CALLNAME:TARGET%は慌てて口を押えた	PRINTFORMDL 声を出しかけた%CALLNAME:TARGET%は慌てて口を押えた
PRINTFORML 「…私が幻想郷の秋を司る神の末裔だということを忘れてはいませんか？」	PRINTFORML 「…私が幻想郷の秋を司る神の末裔だということを忘れてはいませんか？」
PRINTFORML (この際、どうしてそんなものがあるかは気にしないでおきましょう…)	PRINTFORML (この際、どうしてそんなものがあるかは気にしないでおきましょう…)
PRINTFORMDL 静葉はしばらく下着を難しい表情で睨んでいたが覚悟を決めて着始めた	PRINTFORMDL 静葉はしばらく下着を難しい表情で睨んでいたが覚悟を決めて着始めた
PRINTFORML 「水遊びでもないのに水着を着るのは見世物みたいでちょっと抵抗が…」	PRINTFORML 「水遊びでもないのに水着を着るのは見世物みたいでちょっと抵抗が…」
PRINTFORMDW 小さな洞穴はどんどん彫り進められ、今は地中奥深くまで広がっていた	PRINTFORMDW 小さな洞穴はどんどん彫り進められ、今は地中奥深くまで広がっていた
PRINTFORMDW 静葉は自分の体調不良の理由を穣子に告げることが結局できなかった…	PRINTFORMDW 静葉は自分の体調不良の理由を穣子に告げることが結局できなかった…
PRINTFORMDW 快感と疲労とで体を動かすのにやっとな静葉はなんとか声を張り上げた	PRINTFORMDW 快感と疲労とで体を動かすのにやっとな静葉はなんとか声を張り上げた
PRINTFORMDW そう息巻き彷徨う静葉だが結局、娘を見つけることは出来ないでいた…	PRINTFORMDW そう息巻き彷徨う静葉だが結局、娘を見つけることは出来ないでいた…
PRINTFORMDW とっくに雪と寒さに閉ざされた冬になっていたとしてもおかしくはない	PRINTFORMDW とっくに雪と寒さに閉ざされた冬になっていたとしてもおかしくはない
PRINTFORMDW 慌てて信仰をあつめるために秋の山を紅葉で満たしたのはまた別のお話	PRINTFORMDW 慌てて信仰をあつめるために秋の山を紅葉で満たしたのはまた別のお話
PRINTFORMW ──私達が囮になっている間に、なんとか脱出し助けを呼んで欲しい──	PRINTFORMW ──私達が囮になっている間に、なんとか脱出し助けを呼んで欲しい──
PRINTFORMDL 秋に毒された異常なテンションが静葉の性格すらも捻じ曲げてしまう！	PRINTFORMDL 秋に毒された異常なテンションが静葉の性格すらも捻じ曲げてしまう！
PRINTFORML 「この武器をもった私は最強よ！ほんとなんて強力な武器なのかしら！」	PRINTFORML 「この武器をもった私は最強よ！ほんとなんて強力な武器なのかしら！」
PRINTFORML 「ふっふっふ！一発逆転の必殺技はピンチまでとっておくものなのよ！」	PRINTFORML 「ふっふっふ！一発逆転の必殺技はピンチまでとっておくものなのよ！」
PRINTFORML 「お、おのれ！私の秋パワーで異物なんて消化吸収しつくしてやるわ！」	PRINTFORML 「お、おのれ！私の秋パワーで異物なんて消化吸収しつくしてやるわ！」
PRINTFORML 「さ、服が残ってる人がいたら秋パワーで直すわよー！超直すわよー！」	PRINTFORML 「さ、服が残ってる人がいたら秋パワーで直すわよー！超直すわよー！」
PRINTFORML 「ああ…もう……秋じゃなかったらショックで三日は寝込んでたわよ…」	PRINTFORML 「ああ…もう……秋じゃなかったらショックで三日は寝込んでたわよ…」
PRINTFORML 「温泉の秋！健康の秋！さあ汗を精一杯ながして秋を堪能するのよー！」	PRINTFORML 「温泉の秋！健康の秋！さあ汗を精一杯ながして秋を堪能するのよー！」
PRINTFORMDL 静葉は思い切り振り回した武器に引っ張られバランスを崩してしまった	PRINTFORMDL 静葉は思い切り振り回した武器に引っ張られバランスを崩してしまった
PRINTFORMDL 静葉は自分の服が破けていく様をまるで他人事のように見つめている…	PRINTFORMDL 静葉は自分の服が破けていく様をまるで他人事のように見つめている…
PRINTFORML 「あ…あぁ……お腹が…ふくらんで…そんな…だって相手は化物で……」	PRINTFORML 「あ…あぁ……お腹が…ふくらんで…そんな…だって相手は化物で……」
PRINTFORML 「一人じゃあぶないわよ！？お願い！お姉ちゃんの言うことを聞いて！」	PRINTFORML 「一人じゃあぶないわよ！？お願い！お姉ちゃんの言うことを聞いて！」
PRINTFORML 「まずは落ち着いて…うん、落ち着いて探索して状況を確認しましょう」	PRINTFORML 「まずは落ち着いて…うん、落ち着いて探索して状況を確認しましょう」
PRINTFORMDL %CALLNAME:TARGET%は静かに啜り泣き続けている……	PRINTFORMDL %CALLNAME:TARGET%は静かに啜り泣き続けている……
PRINTFORMDL %CALLNAME:TARGET%は光のない瞳でなすがままだ……	PRINTFORMDL %CALLNAME:TARGET%は光のない瞳でなすがままだ……
PRINTFORMDL %CALLNAME:TARGET%は苦しそうなうめき声を漏らした	PRINTFORMDL %CALLNAME:TARGET%は苦しそうなうめき声を漏らした
PRINTFORMDL %CALLNAME:TARGET%は幸せそうに湯船に浸かっている	PRINTFORMDL %CALLNAME:TARGET%は幸せそうに湯船に浸かっている
PRINTFORMDL %CALLNAME:TARGET%は濁った瞳から涙を流している…	PRINTFORMDL %CALLNAME:TARGET%は濁った瞳から涙を流している…
PRINTFORML 「子供っぽいデザイン…だなんてワガママ言ってられないし着ましょ」	PRINTFORML 「子供っぽいデザイン…だなんてワガママ言ってられないし着ましょ」
PRINTFORMDL 着替えセットの中身はスモッグやバッジといった幼稚園の制服だった	PRINTFORMDL 着替えセットの中身はスモッグやバッジといった幼稚園の制服だった
PRINTFORML 「こういうのはもっと…なんていうか…体に自信がある人のほうが…」	PRINTFORML 「こういうのはもっと…なんていうか…体に自信がある人のほうが…」
PRINTFORMDW そのままその場に座り込んで大声で子供のようにわんわん泣き始めた	PRINTFORMDW そのままその場に座り込んで大声で子供のようにわんわん泣き始めた
PRINTFORMDW 虚ろな瞳が静葉の瞳とあうと、穣子は唇を何か言いたげに震わせた…	PRINTFORMDW 虚ろな瞳が静葉の瞳とあうと、穣子は唇を何か言いたげに震わせた…
PRINTFORMDW 静葉は泣きながら少しでも早く穣子の治療の為にと出口へと向かった	PRINTFORMDW 静葉は泣きながら少しでも早く穣子の治療の為にと出口へと向かった
PRINTFORMW 「どうして…こんなになるまで見つけてあげられなかったのかしら…」	PRINTFORMW 「どうして…こんなになるまで見つけてあげられなかったのかしら…」
PRINTFORMDW 秋が深くなる頃、穣子は自力で歩ける程度には回復することができた	PRINTFORMDW 秋が深くなる頃、穣子は自力で歩ける程度には回復することができた
PRINTFORMDW まだベッドの上で過ごす時間のほうが長いが経過は順調で笑顔も増え	PRINTFORMDW まだベッドの上で過ごす時間のほうが長いが経過は順調で笑顔も増え
PRINTFORMDW 静葉は穣子と無事に脱出するとお互いに抱き合い、無事を喜び合った	PRINTFORMDW 静葉は穣子と無事に脱出するとお互いに抱き合い、無事を喜び合った
PRINTFORMDW だが数分も走ると腹部の激しい痛みに耐えかね足を止めることになる	PRINTFORMDW だが数分も走ると腹部の激しい痛みに耐えかね足を止めることになる
PRINTFORMDW 異形の魔物は未だにもがく静葉にのしかかると足を強引に押し広げる	PRINTFORMDW 異形の魔物は未だにもがく静葉にのしかかると足を強引に押し広げる
PRINTFORMDW	その天狗の手には綺麗に洗われた穣子が身に着けていた帽子があった	PRINTFORMDW	その天狗の手には綺麗に洗われた穣子が身に着けていた帽子があった
PRINTFORMDW	昨日あったこと、最近の噂話、他にもあれやこれやたわいのない話…	PRINTFORMDW	昨日あったこと、最近の噂話、他にもあれやこれやたわいのない話…
PRINTFORMDW	この場所はあの事件依頼、様々な秋の味覚が育つ天然の農地となった	PRINTFORMDW	この場所はあの事件依頼、様々な秋の味覚が育つ天然の農地となった
PRINTFORMDW 彼女はあれこれと言葉を探して口をしばらくパクパクとさせていたが	PRINTFORMDW 彼女はあれこれと言葉を探して口をしばらくパクパクとさせていたが
PRINTFORMDW 腹部が膨らんでいる原因は恐らく迷宮で射精されたことが原因だろう	PRINTFORMDW 腹部が膨らんでいる原因は恐らく迷宮で射精されたことが原因だろう
PRINTFORMDW まだ言葉が分からないのか不思議そうな顔で静葉へと近づいてくる娘	PRINTFORMDW まだ言葉が分からないのか不思議そうな顔で静葉へと近づいてくる娘
PRINTFORMDW 体調も回復した静葉は娘を野放しに出来ないと山中を探してまわった	PRINTFORMDW 体調も回復した静葉は娘を野放しに出来ないと山中を探してまわった
PRINTFORMDW 肌を切り裂くような猛吹雪…今年はどうやら特に寒さが厳しいようだ	PRINTFORMDW 肌を切り裂くような猛吹雪…今年はどうやら特に寒さが厳しいようだ
PRINTFORML 「私が可愛いから独り占めしたい気持ちはわかるけど、だ・め・よ？」	PRINTFORML 「私が可愛いから独り占めしたい気持ちはわかるけど、だ・め・よ？」
PRINTFORML 「痛いっ！ちょっと、ちょっとタイム！ドクターストッぷべらっ！？」	PRINTFORML 「痛いっ！ちょっと、ちょっとタイム！ドクターストッぷべらっ！？」
PRINTFORML 「いやああああああ！今からでもいいから抜いてやめて離してーー！」	PRINTFORML 「いやああああああ！今からでもいいから抜いてやめて離してーー！」
PRINTFORML 「コーラで洗えば大丈夫…コーラで洗えば大丈夫……うん、大丈夫！」	PRINTFORML 「コーラで洗えば大丈夫…コーラで洗えば大丈夫……うん、大丈夫！」
PRINTFORMDL 妙に賑やかなモンスターの腹部を見る限りまだ元気はあるのだろう…	PRINTFORMDL 妙に賑やかなモンスターの腹部を見る限りまだ元気はあるのだろう…
PRINTFORMDL そう突如叫び立ち上がった静葉だがすぐにバタリと倒れてしまった…	PRINTFORMDL そう突如叫び立ち上がった静葉だがすぐにバタリと倒れてしまった…
PRINTFORML 「変な粘液が…私から分泌されたメープルシロップ？なわけないわね」	PRINTFORML 「変な粘液が…私から分泌されたメープルシロップ？なわけないわね」
PRINTFORMDL 快楽に屈服した静葉の手足からは少しも抵抗の意思は感じられない…	PRINTFORMDL 快楽に屈服した静葉の手足からは少しも抵抗の意思は感じられない…
PRINTFORMDL 触手の数本が離れた拍子に静葉は他の触手も振りほどき距離をとった	PRINTFORMDL 触手の数本が離れた拍子に静葉は他の触手も振りほどき距離をとった
PRINTFORMDL どちらにせよ静葉が捕らえられたままということには変わりはない…	PRINTFORMDL どちらにせよ静葉が捕らえられたままということには変わりはない…
PRINTFORMDL 静葉は未だに絡みついている触手を絶望的な眼差しで見つめている…	PRINTFORMDL 静葉は未だに絡みついている触手を絶望的な眼差しで見つめている…
PRINTFORMDL 静葉は膣へと流れ込む粘液の気持ち悪さにひたすら悲鳴をあげている	PRINTFORMDL 静葉は膣へと流れ込む粘液の気持ち悪さにひたすら悲鳴をあげている
PRINTFORMDL 生まれたままの姿になってなお静葉は抵抗の意思を見せようとしない	PRINTFORMDL 生まれたままの姿になってなお静葉は抵抗の意思を見せようとしない
PRINTFORMDL 静葉は大きな悲鳴をあげると一糸纏わぬ身体を庇ってしゃがみこんだ	PRINTFORMDL 静葉は大きな悲鳴をあげると一糸纏わぬ身体を庇ってしゃがみこんだ
PRINTFORMDL 静葉は時々甘い声を漏らす以外、反応をみせずまるで人形のようだ…	PRINTFORMDL 静葉は時々甘い声を漏らす以外、反応をみせずまるで人形のようだ…
PRINTFORML 「んーっ…家に帰ったら穣子ちゃんとのんびりお風呂に入りたいわね」	PRINTFORML 「んーっ…家に帰ったら穣子ちゃんとのんびりお風呂に入りたいわね」
PRINTFORML 「さっきまでここにいたんでしょう？…あなたを見た人がいたのよ？」	PRINTFORML 「さっきまでここにいたんでしょう？…あなたを見た人がいたのよ？」
PRINTFORML 「ごめんね…お姉ちゃん、穣子ちゃんの側にいてあげるべきだった…」	PRINTFORML 「ごめんね…お姉ちゃん、穣子ちゃんの側にいてあげるべきだった…」
PRINTFORML 「私みたいに弱い神様の娘じゃ…どうしょうもないのね……ぐすっ…」	PRINTFORML 「私みたいに弱い神様の娘じゃ…どうしょうもないのね……ぐすっ…」
PRINTFORMDL %CALLNAME:TARGET%は顔を真っ赤にして耐えている	PRINTFORMDL %CALLNAME:TARGET%は顔を真っ赤にして耐えている
PRINTFORML 「ほんのーとりせいの折り合いをきちんとつけなきゃダメなんだって」	PRINTFORML 「ほんのーとりせいの折り合いをきちんとつけなきゃダメなんだって」
PRINTFORML 「あ…あぁ……お腹が…ふくらんで…そんな…私まだ子供なのに……」	PRINTFORML 「あ…あぁ……お腹が…ふくらんで…そんな…私まだ子供なのに……」
PRINTFORML 「わたし…おかあさんと一緒に外の世界･･･見てみたかったのに…」	PRINTFORML 「わたし…おかあさんと一緒に外の世界･･･見てみたかったのに…」
PRINTFORMDL 着替えセットの中身はブカブカな服と派手なブカブカな下着だった	PRINTFORMDL 着替えセットの中身はブカブカな服と派手なブカブカな下着だった
PRINTFORML 「ぅぅぅ…恥ずかしい…おへその辺りに心なしか視線を感じるわ…」	PRINTFORML 「ぅぅぅ…恥ずかしい…おへその辺りに心なしか視線を感じるわ…」
PRINTFORML 「ん～…ちょっとスカート丈が…なんて言ってる場合じゃないわね」	PRINTFORML 「ん～…ちょっとスカート丈が…なんて言ってる場合じゃないわね」
PRINTFORMDW 迷宮に穣子がいた形跡はなかったので恐らく無事ではあるのだが…	PRINTFORMDW 迷宮に穣子がいた形跡はなかったので恐らく無事ではあるのだが…
PRINTFORMDW 困り笑顔でそう口にした静葉に穣子はバカと叫びながら飛びついた	PRINTFORMDW 困り笑顔でそう口にした静葉に穣子はバカと叫びながら飛びついた
PRINTFORMW 「寂しかったでしょう？怖かったでしょう？心細かったでしょう？」	PRINTFORMW 「寂しかったでしょう？怖かったでしょう？心細かったでしょう？」
PRINTFORMDW 景色はいつの間にかすっかり秋めいていて二人は仕事の話しだとか	PRINTFORMDW 景色はいつの間にかすっかり秋めいていて二人は仕事の話しだとか
PRINTFORMDW 心なしかずっしりとした自分の腹部を虚ろな表情でみつめていた…	PRINTFORMDW 心なしかずっしりとした自分の腹部を虚ろな表情でみつめていた…
PRINTFORMDW 静葉の胎内に魔物が全身を震わせ大量の白濁液を触手が吐き出した	PRINTFORMDW 静葉の胎内に魔物が全身を震わせ大量の白濁液を触手が吐き出した
PRINTFORMW 「私が幻想郷を支配したら穣子ちゃんに幻想郷の半分をあげるわ！」	PRINTFORMW 「私が幻想郷を支配したら穣子ちゃんに幻想郷の半分をあげるわ！」
PRINTFORMDW 今、季節は秋。美しい紅葉、美味しい作物、そしてやっぱり紅葉…	PRINTFORMDW 今、季節は秋。美しい紅葉、美味しい作物、そしてやっぱり紅葉…
PRINTFORMW (いっそ、今すぐ目の前に私を笑いに出て来てくれればいいのに…)	PRINTFORMW (いっそ、今すぐ目の前に私を笑いに出て来てくれればいいのに…)
PRINTFORMDW 眠い…そういえば昨日の夕方辺りからずっと寝ていなかったっけか	PRINTFORMDW 眠い…そういえば昨日の夕方辺りからずっと寝ていなかったっけか
PRINTFORML 「秋の溢れるパワーが可能にしたこのッ！隙のない完全な防御ッ！」	PRINTFORML 「秋の溢れるパワーが可能にしたこのッ！隙のない完全な防御ッ！」
PRINTFORML 「ふふふふふ！この脚で私は何万という枯葉を散らしてきたのよ！」	PRINTFORML 「ふふふふふ！この脚で私は何万という枯葉を散らしてきたのよ！」
PRINTFORML 「私の美しい侘しく寂しい胸に興奮する気持ちはわかるけどダメよ」	PRINTFORML 「私の美しい侘しく寂しい胸に興奮する気持ちはわかるけどダメよ」
PRINTFORML 「ちょっとちょっと秋パワーがあってもこれはほらそのえーっと…」	PRINTFORML 「ちょっとちょっと秋パワーがあってもこれはほらそのえーっと…」
PRINTFORML 「お姉ちゃんだってそうぽんぽん赤ちゃんは作らせないんだから！」	PRINTFORML 「お姉ちゃんだってそうぽんぽん赤ちゃんは作らせないんだから！」
PRINTFORML 「秋パワーの塊が腹部に広がっていくのを…ち、ちがうわコレ！？」	PRINTFORML 「秋パワーの塊が腹部に広がっていくのを…ち、ちがうわコレ！？」
PRINTFORML 「秋の私を捉えるだなんてあのやたらつよい紅白の巫女くらいよ！」	PRINTFORML 「秋の私を捉えるだなんてあのやたらつよい紅白の巫女くらいよ！」
PRINTFORMDW 触手はうるさいと言わんばかりに静葉の口に自身をねじ込ませた。	PRINTFORMDW 触手はうるさいと言わんばかりに静葉の口に自身をねじ込ませた。
PRINTFORMDL 完全に燃え尽きて力尽きた静葉を守りながら探索は出来そうにない	PRINTFORMDL 完全に燃え尽きて力尽きた静葉を守りながら探索は出来そうにない
PRINTFORML 「もう少し私に力があれば化物どもも真っ赤にぬれるのだけどねー」	PRINTFORML 「もう少し私に力があれば化物どもも真っ赤にぬれるのだけどねー」
PRINTFORMDL 蠢く触手の幼体が静葉の処女膜の隙間から次々と潜り込んでいった	PRINTFORMDL 蠢く触手の幼体が静葉の処女膜の隙間から次々と潜り込んでいった
PRINTFORML 「ま、待っててね穣子ちゃん！お姉ちゃんがすぐに助けてあげる！」	PRINTFORML 「ま、待っててね穣子ちゃん！お姉ちゃんがすぐに助けてあげる！」
PRINTFORMDL 腹の中で時折這い回る何かに対する恐怖の為か静葉は元気がない…	PRINTFORMDL 腹の中で時折這い回る何かに対する恐怖の為か静葉は元気がない…
PRINTFORML 「…私が幻想郷の秋を司る神だということを忘れてはいませんか？」	PRINTFORML 「…私が幻想郷の秋を司る神だということを忘れてはいませんか？」
PRINTFORML 「ですが、私への扱いは余りにも礼節に欠けるとは思いませんか？」	PRINTFORML 「ですが、私への扱いは余りにも礼節に欠けるとは思いませんか？」
PRINTFORMDL %CALLNAME:TARGET%は身を硬くして震えている…	PRINTFORMDL %CALLNAME:TARGET%は身を硬くして震えている…
PRINTFORMDL %CALLNAME:TARGET%は必死におしりを庇っている	PRINTFORMDL %CALLNAME:TARGET%は必死におしりを庇っている
PRINTFORML （ごめんなさい…あなたを守りながらなんて私じゃできないわ……）	PRINTFORML （ごめんなさい…あなたを守りながらなんて私じゃできないわ……）
PRINTFORML 「…私は戦闘は得意でないし、この迷宮の魔物の血も流れています」	PRINTFORML 「…私は戦闘は得意でないし、この迷宮の魔物の血も流れています」
PRINTFORML 「たしか外の世界の子供用の鞄だったかしら？…意外と重いのね」	PRINTFORML 「たしか外の世界の子供用の鞄だったかしら？…意外と重いのね」
PRINTFORML 「この状況だし仕方ないわよね、この格好も不可抗力よ、ふふっ」	PRINTFORML 「この状況だし仕方ないわよね、この格好も不可抗力よ、ふふっ」
PRINTFORML 「可愛いのに…どうせまたすぐに裸にされちゃうのでしょうね…」	PRINTFORML 「可愛いのに…どうせまたすぐに裸にされちゃうのでしょうね…」
PRINTFORMDW しかし静葉の不安は家に近づくに連れて段々と大きくなってゆき	PRINTFORMDW しかし静葉の不安は家に近づくに連れて段々と大きくなってゆき
PRINTFORMDW 全身から冷や汗が噴出し、めまいで立っている事できなくなる…	PRINTFORMDW 全身から冷や汗が噴出し、めまいで立っている事できなくなる…
PRINTFORMDW	静葉も心に深い傷を負ったものの今は穣子と静かに暮らしている	PRINTFORMDW	静葉も心に深い傷を負ったものの今は穣子と静かに暮らしている
PRINTFORMDW	その股間からはどういうわけか力強く脈打つ男性器が生えている	PRINTFORMDW	その股間からはどういうわけか力強く脈打つ男性器が生えている
PRINTFORMDW	『生きていることを』『生き残ったことを』『後悔させてやる』	PRINTFORMDW	『生きていることを』『生き残ったことを』『後悔させてやる』
PRINTFORMDW	慌てて迷宮へと駆け込もうとする静葉を一人の天狗が呼び止めた	PRINTFORMDW	慌てて迷宮へと駆け込もうとする静葉を一人の天狗が呼び止めた
PRINTFORMDW 静葉も心に深い傷を負ったものの今は穣子と静かに暮らしている	PRINTFORMDW 静葉も心に深い傷を負ったものの今は穣子と静かに暮らしている
PRINTFORMW (だがこの力があれば一年中秋に出来る可能性がある。違うか？)	PRINTFORMW (だがこの力があれば一年中秋に出来る可能性がある。違うか？)
PRINTFORMDW 力を手に入れ調子に乗った静葉は手始めに触手宮を秋で支配した	PRINTFORMDW 力を手に入れ調子に乗った静葉は手始めに触手宮を秋で支配した
PRINTFORMDW 神らしさがなくなりすぎ、自身の存在すらも危うくなった彼女が	PRINTFORMDW 神らしさがなくなりすぎ、自身の存在すらも危うくなった彼女が
PRINTFORMDL [0] もちろん秋姉妹のテンションが荒ぶり狂気に満ちる秋！	PRINTFORMDL [0] もちろん秋姉妹のテンションが荒ぶり狂気に満ちる秋！
PRINTFORMDW それも人、妖怪、神と無差別に女性ばかりを狙って発生するのだ	PRINTFORMDW それも人、妖怪、神と無差別に女性ばかりを狙って発生するのだ
PRINTFORMW 「こうなったらこの私自らが殴りこみ異変を解決してやるわ！！」	PRINTFORMW 「こうなったらこの私自らが殴りこみ異変を解決してやるわ！！」
PRINTFORMDW あたり一面に不気味な触手が蠢く迷宮の一室にいたのであった…	PRINTFORMDW あたり一面に不気味な触手が蠢く迷宮の一室にいたのであった…
PRINTFORML 「諦めているように見えるかしら？それなら貴方は秋ド素人よ！」	PRINTFORML 「諦めているように見えるかしら？それなら貴方は秋ド素人よ！」
PRINTFORMDL そもそも巫女に攻撃されることが神として間違っている気がする	PRINTFORMDL そもそも巫女に攻撃されることが神として間違っている気がする
PRINTFORML 「完璧な間合いね。秋の力が戦略的に働いているのを感じるわ！」	PRINTFORML 「完璧な間合いね。秋の力が戦略的に働いているのを感じるわ！」
PRINTFORML 「私の弾幕以上の威力があるだなんて道具もバカにならないわね」	PRINTFORML 「私の弾幕以上の威力があるだなんて道具もバカにならないわね」
PRINTFORML 「そろそろ誰かが助けに来てくれるころかしら？なんて……はぁ」	PRINTFORML 「そろそろ誰かが助けに来てくれるころかしら？なんて……はぁ」
PRINTFORML 「この程度で私のライバルを名乗ろうとは３００億万秋早いわ！」	PRINTFORML 「この程度で私のライバルを名乗ろうとは３００億万秋早いわ！」
PRINTFORML 「ま、待ちなさい。話し合えば分かり合えることもあるはずよ…」	PRINTFORML 「ま、待ちなさい。話し合えば分かり合えることもあるはずよ…」
PRINTFORML 「落ちちゃう！落ちちゃう！！意識がつるべ落とししちゃうぅ！」	PRINTFORML 「落ちちゃう！落ちちゃう！！意識がつるべ落とししちゃうぅ！」
PRINTFORML 「芸術の秋らしくお姉ちゃんの美しい肢体にみとれていいのよ！」	PRINTFORML 「芸術の秋らしくお姉ちゃんの美しい肢体にみとれていいのよ！」
PRINTFORML 「春を告げるつもりかしら？残念だったわね！今は秋なのよ！！」	PRINTFORML 「春を告げるつもりかしら？残念だったわね！今は秋なのよ！！」
PRINTFORML 「う、うぅぅ…あやうく調子に乗りすぎて死ぬところだったわ…」	PRINTFORML 「う、うぅぅ…あやうく調子に乗りすぎて死ぬところだったわ…」
PRINTFORML 「まあお姉ちゃんの漲る秋の力に嫉妬する気持ちはわかるわよ？」	PRINTFORML 「まあお姉ちゃんの漲る秋の力に嫉妬する気持ちはわかるわよ？」
PRINTFORML 「でも、もう貴方とは行動する気なんてないから。それじゃあね」	PRINTFORML 「でも、もう貴方とは行動する気なんてないから。それじゃあね」
PRINTFORML 「もう怒ったわ！秋エスケープ！秋アディオス！ばーかばーか！」	PRINTFORML 「もう怒ったわ！秋エスケープ！秋アディオス！ばーかばーか！」
PRINTFORML 「ほらっ！お姉ちゃんと決めポーズして落ち着いて…おーーい？」	PRINTFORML 「ほらっ！お姉ちゃんと決めポーズして落ち着いて…おーーい？」
PRINTFORML 「ま、待って！一体私の秋の何が気に食わなかったというの！？」	PRINTFORML 「ま、待って！一体私の秋の何が気に食わなかったというの！？」
PRINTFORML 「私の美しい肢体をいつまでも晒しているわけにもいかないわね」	PRINTFORML 「私の美しい肢体をいつまでも晒しているわけにもいかないわね」
PRINTFORMDL するりとぬめる触手から抜け出せた静葉は這うように逃げ出した	PRINTFORMDL するりとぬめる触手から抜け出せた静葉は這うように逃げ出した
PRINTFORML 「私みたいに弱い神様じゃ…どうしょうもないのね……ぐすっ…」	PRINTFORML 「私みたいに弱い神様じゃ…どうしょうもないのね……ぐすっ…」
PRINTFORML 「ひっく…幻想郷の秋…どうなるのかしら……ごめんなさい……」	PRINTFORML 「ひっく…幻想郷の秋…どうなるのかしら……ごめんなさい……」
PRINTFORMDL 全身を汚され静葉は体を庇うことを諦めなすがままとなっている	PRINTFORMDL 全身を汚され静葉は体を庇うことを諦めなすがままとなっている
PRINTFORMDL 静葉は口をパクパクさせながら濁った瞳を出口へと向けている…	PRINTFORMDL 静葉は口をパクパクさせながら濁った瞳を出口へと向けている…
PRINTFORMDL 穣子は何度も後ろを振り返りながらも静葉を置いて逃げ出した。	PRINTFORMDL 穣子は何度も後ろを振り返りながらも静葉を置いて逃げ出した。
PRINTFORML （ごめんなさい…あなたを守りながらじゃとても戦えないの……）	PRINTFORML （ごめんなさい…あなたを守りながらじゃとても戦えないの……）
PRINTFORML 「穣子ちゃん気をつけてね。お姉ちゃんも気をつけるから、ね？」	PRINTFORML 「穣子ちゃん気をつけてね。お姉ちゃんも気をつけるから、ね？」
PRINTFORMDL これだけ探しても誰も見ていないのなら最初からいないのでは？	PRINTFORMDL これだけ探しても誰も見ていないのなら最初からいないのでは？
PRINTFORML 「ごめんなさい…あなたを守りながらじゃとても戦えないの……」	PRINTFORML 「ごめんなさい…あなたを守りながらじゃとても戦えないの……」
PRINTFORMDL 静葉は声も出せずに背中をのけぞらせ全身を激しく痙攣させた…	PRINTFORMDL 静葉は声も出せずに背中をのけぞらせ全身を激しく痙攣させた…
PRINTFORML (私、運動苦手だしきっと枝踏んづけたり転んだりするんだわ…)	PRINTFORML (私、運動苦手だしきっと枝踏んづけたり転んだりするんだわ…)
PRINTFORML 「何か…助けになるもの……そんな都合よくみつからないわよね」	PRINTFORML 「何か…助けになるもの……そんな都合よくみつからないわよね」
PRINTFORML 「稔子ちゃんを見ませんでしたか？ふふ…ねえ、教えてください」	PRINTFORML 「稔子ちゃんを見ませんでしたか？ふふ…ねえ、教えてください」
PRINTFORMDL %CALLNAME:TARGET%は必死な形相で暴れている	PRINTFORMDL %CALLNAME:TARGET%は必死な形相で暴れている
PRINTFORMDL %CALLNAME:TARGET%は呆然と立ち尽くしている	PRINTFORMDL %CALLNAME:TARGET%は呆然と立ち尽くしている
PRINTFORML 「おかあさん…私……ちゃんとしたおかあさんになれるのかな？」	PRINTFORML 「おかあさん…私……ちゃんとしたおかあさんになれるのかな？」
PRINTFORML 「おかあさんを見ませんでしたか？ふふ…ねえ、教えてください」	PRINTFORML 「おかあさんを見ませんでしたか？ふふ…ねえ、教えてください」
PRINTFORML 「……いいの。私が嫌いなら私はおかあさんの側から離れるから」	PRINTFORML 「……いいの。私が嫌いなら私はおかあさんの側から離れるから」
PRINTFORML 「もしかしてずっと前から私は目をつけられていたのかしら？」	PRINTFORML 「もしかしてずっと前から私は目をつけられていたのかしら？」
PRINTFORMDL 着替えセットの中身は少しサイズの小さい静葉の普段着だった	PRINTFORMDL 着替えセットの中身は少しサイズの小さい静葉の普段着だった
PRINTFORMDL 着替えセットの中身は静葉の名前の入ったスクール水着だった	PRINTFORMDL 着替えセットの中身は静葉の名前の入ったスクール水着だった
PRINTFORML 「恥ずかしくないと言えば嘘になるけど…裸よりは数倍マシね」	PRINTFORML 「恥ずかしくないと言えば嘘になるけど…裸よりは数倍マシね」
PRINTFORMDW 何もないけど不安でと口にする穣子の髪を静葉はそっとなでた	PRINTFORMDW 何もないけど不安でと口にする穣子の髪を静葉はそっとなでた
PRINTFORMDW ついに静葉は薄暗い狭い洞穴の奥へ引きずりこまれてしまった	PRINTFORMDW ついに静葉は薄暗い狭い洞穴の奥へ引きずりこまれてしまった
PRINTFORMDW	迷宮を脱出した静葉の情報もあり無事に解決した今回の異変…	PRINTFORMDW	迷宮を脱出した静葉の情報もあり無事に解決した今回の異変…
PRINTFORMDW	その自責の念なのか、二人の恨みなのかそれとも両方なのか…	PRINTFORMDW	その自責の念なのか、二人の恨みなのかそれとも両方なのか…
PRINTFORMDW	静葉よりも先に既に多くの有志が迷宮の中へと乗り込んでいた	PRINTFORMDW	静葉よりも先に既に多くの有志が迷宮の中へと乗り込んでいた
PRINTFORMDW	そして、何人かの少女達は既に助けられているようでもあった	PRINTFORMDW	そして、何人かの少女達は既に助けられているようでもあった
PRINTFORMDW 迷宮を脱出した静葉の情報もあり無事に解決した今回の異変…	PRINTFORMDW 迷宮を脱出した静葉の情報もあり無事に解決した今回の異変…
PRINTFORMDW 『やっと見つけた。おかあさんをお迎えする準備が出来たの』	PRINTFORMDW 『やっと見つけた。おかあさんをお迎えする準備が出来たの』
PRINTFORMDW 『そんな顔されると、興奮しちゃって自制できなくなりそう』	PRINTFORMDW 『そんな顔されると、興奮しちゃって自制できなくなりそう』
PRINTFORMDW だが、彼女が二柱の元へ向かったのは異変解決のためであった	PRINTFORMDW だが、彼女が二柱の元へ向かったのは異変解決のためであった
PRINTFORML 「覚えてなさい！次会う時までその命は預けておいてやるわ！」	PRINTFORML 「覚えてなさい！次会う時までその命は預けておいてやるわ！」
PRINTFORML 「だれがだじゅげでえ……調子乗ってずびばぜんでじだぁ……」	PRINTFORML 「だれがだじゅげでえ……調子乗ってずびばぜんでじだぁ……」
PRINTFORML 「ちょっとマニアックな場所を狙われてお姉ちゃんびっくりよ」	PRINTFORML 「ちょっとマニアックな場所を狙われてお姉ちゃんびっくりよ」
PRINTFORML 「完全にまいたわね。ん？後ろに気配が……ふう、気のせいか」	PRINTFORML 「完全にまいたわね。ん？後ろに気配が……ふう、気のせいか」
PRINTFORML 「私の前に緑の葉をつけて現れるとは…愚か！本当に愚か！！」	PRINTFORML 「私の前に緑の葉をつけて現れるとは…愚か！本当に愚か！！」
PRINTFORML 「あらあら、みんなそんなに距離をとって何をする気かしら？」	PRINTFORML 「あらあら、みんなそんなに距離をとって何をする気かしら？」
PRINTFORMDL 心底そう思いながら%CALLNAME:1%は逃げ出した。	PRINTFORMDL 心底そう思いながら%CALLNAME:1%は逃げ出した。
PRINTFORML 「穣子ちゃん！あなたもこの迷宮を秋色に染め上げましょう！」	PRINTFORML 「穣子ちゃん！あなたもこの迷宮を秋色に染め上げましょう！」
PRINTFORML 「ぜーぜー…動くのが辛いわけじゃぜーぜーぜー…ないわよ？」	PRINTFORML 「ぜーぜー…動くのが辛いわけじゃぜーぜーぜー…ないわよ？」
PRINTFORML まるで吹雪のようにどこからか真っ赤な紅葉が吹き付けてくる…	PRINTFORML まるで吹雪のようにどこからか真っ赤な紅葉が吹き付けてくる…
PRINTFORML 「よきかなよきかな。はぁ…幸せ…神様やっててよかったわー」	PRINTFORML 「よきかなよきかな。はぁ…幸せ…神様やっててよかったわー」
PRINTFORML 「この場で即、落ち葉に生き埋めになんて酷いことはしないわ」	PRINTFORML 「この場で即、落ち葉に生き埋めになんて酷いことはしないわ」
PRINTFORML 「また私は救えなかったの！？おのれ化物め！酷いことを！！」	PRINTFORML 「また私は救えなかったの！？おのれ化物め！酷いことを！！」
PRINTFORML 「全裸はさすがに抵抗あるわねえ、どこかに着替えないかしら」	PRINTFORML 「全裸はさすがに抵抗あるわねえ、どこかに着替えないかしら」
PRINTFORML 「紅葉をてぃくびとあそこに貼り付けて～♪･･･無理無理！」	PRINTFORML 「紅葉をてぃくびとあそこに貼り付けて～♪･･･無理無理！」
PRINTFORML 「神様に対してしていい扱いじゃないわよ？だから離して……」	PRINTFORML 「神様に対してしていい扱いじゃないわよ？だから離して……」
PRINTFORMDL 未だに身体を捕らえている触手を前に静葉は弱々しく呟いた…	PRINTFORMDL 未だに身体を捕らえている触手を前に静葉は弱々しく呟いた…
PRINTFORMDL 静葉は真っ青になって下腹部で脈動する触手を見つめている…	PRINTFORMDL 静葉は真っ青になって下腹部で脈動する触手を見つめている…
PRINTFORMDL 静葉は体にかかった白濁液を気持ち悪そうに見つめている……	PRINTFORMDL 静葉は体にかかった白濁液を気持ち悪そうに見つめている……
PRINTFORML 「ううん、それより今は…目の前の化物をなんとかしましょ！」	PRINTFORML 「ううん、それより今は…目の前の化物をなんとかしましょ！」
PRINTFORML 「あそこは危ないから穣子ちゃん近づいちゃダメよ。あとね…」	PRINTFORML 「あそこは危ないから穣子ちゃん近づいちゃダメよ。あとね…」
PRINTFORMDL 時折腹部を押える静葉は今にも泣き出しそうな顔をしている。	PRINTFORMDL 時折腹部を押える静葉は今にも泣き出しそうな顔をしている。
PRINTFORML (とにかく見つからないように…うう…見つかる気がするわ…)	PRINTFORML (とにかく見つからないように…うう…見つかる気がするわ…)
PRINTFORML 「こんなに汚れちゃったら洗ってもそう簡単にはおちないわね」	PRINTFORML 「こんなに汚れちゃったら洗ってもそう簡単にはおちないわね」
PRINTFORML 「せめて穣子ちゃんだけでも脱出してくれればいいのだけど…」	PRINTFORML 「せめて穣子ちゃんだけでも脱出してくれればいいのだけど…」
PRINTFORML 「もっと…早く…穣子ちゃんのことを見つけてあげられれば…」	PRINTFORML 「もっと…早く…穣子ちゃんのことを見つけてあげられれば…」
PRINTFORML 「そうすれば……身代わりにだってなれたかもしれないのに…」	PRINTFORML 「そうすれば……身代わりにだってなれたかもしれないのに…」
PRINTFORML 「少しずつこの環境が異常なんだなって感覚でわかってくるわ」	PRINTFORML 「少しずつこの環境が異常なんだなって感覚でわかってくるわ」
PRINTFORML 「ふぇぇ…裸よりはましとはいえピチピチで体のラインが…」	PRINTFORML 「ふぇぇ…裸よりはましとはいえピチピチで体のラインが…」
PRINTFORML 「ぅぅぅ…下着がスカスカだけど…着けないよりはマシよね」	PRINTFORML 「ぅぅぅ…下着がスカスカだけど…着けないよりはマシよね」
PRINTFORML 「やっと服を着れたけど…スカートがストーンといきそう…」	PRINTFORML 「やっと服を着れたけど…スカートがストーンといきそう…」
PRINTFORMDW そこには全裸で抱えあげられたボロボロの穣子の姿があった	PRINTFORMDW そこには全裸で抱えあげられたボロボロの穣子の姿があった
PRINTFORMW 「ごめんね…お姉ちゃん、全然気づいてあげられなかった…」	PRINTFORMW 「ごめんね…お姉ちゃん、全然気づいてあげられなかった…」
PRINTFORMW 「大丈夫よ、お姉ちゃんはずっと穣子ちゃんの側に居るから」	PRINTFORMW 「大丈夫よ、お姉ちゃんはずっと穣子ちゃんの側に居るから」
PRINTFORMDW 静葉は茂みの奥にあある崖にぐったりと背中を預けるや否や	PRINTFORMDW 静葉は茂みの奥にあある崖にぐったりと背中を預けるや否や
PRINTFORMDW 触手の中を何か硬い細長い塊が通るのを陰唇と膣口で感じる	PRINTFORMDW 触手の中を何か硬い細長い塊が通るのを陰唇と膣口で感じる
PRINTFORMW 『お母様、可愛い妖精を捕えたの！ねえ、褒めて！褒めて！』	PRINTFORMW 『お母様、可愛い妖精を捕えたの！ねえ、褒めて！褒めて！』
PRINTFORMDW その娘は何のために巣立ち、今は何をしているのだろうか？	PRINTFORMDW その娘は何のために巣立ち、今は何をしているのだろうか？
PRINTFORMDW	それが白濁液などではなくただの水だったことに気づく静葉	PRINTFORMDW	それが白濁液などではなくただの水だったことに気づく静葉
PRINTFORMDW だがしかし、もしも全て同じ迷宮だとしたら穣子はもう……	PRINTFORMDW だがしかし、もしも全て同じ迷宮だとしたら穣子はもう……
PRINTFORMDW 釣られて静葉も同じように座り込むと同じように泣き出した	PRINTFORMDW 釣られて静葉も同じように座り込むと同じように泣き出した
PRINTFORMDW そして、さらにその数日後、静葉は一人の娘を産み落とした	PRINTFORMDW そして、さらにその数日後、静葉は一人の娘を産み落とした
PRINTFORMDW そして数日後、ついに静葉から無数の異形の生物が誕生した	PRINTFORMDW そして数日後、ついに静葉から無数の異形の生物が誕生した
PRINTFORMDW というのも秋静葉は悲しんでいた。そして怒りに震えていた	PRINTFORMDW というのも秋静葉は悲しんでいた。そして怒りに震えていた
PRINTFORMDW 先ほども言った通り最近、幻想郷では神隠しが多発している	PRINTFORMDW 先ほども言った通り最近、幻想郷では神隠しが多発している
PRINTFORML 「そういうスポーツの秋がすきなのかしら？ふふっ…むにゃ」	PRINTFORML 「そういうスポーツの秋がすきなのかしら？ふふっ…むにゃ」
PRINTFORML 「運がよかったわね！運動会の時間だから帰ってあげるわ！」	PRINTFORML 「運がよかったわね！運動会の時間だから帰ってあげるわ！」
PRINTFORML 「ほらほら、吐き出すなら今のうちよ！ねえ？きいてる！？」	PRINTFORML 「ほらほら、吐き出すなら今のうちよ！ねえ？きいてる！？」
PRINTFORML 「きゃっ…ちょっとデリカシーにかけるんじゃないかしら？」	PRINTFORML 「きゃっ…ちょっとデリカシーにかけるんじゃないかしら？」
PRINTFORML 「ひゃっはー！なんびとたりとも今の私を止められないわ！」	PRINTFORML 「ひゃっはー！なんびとたりとも今の私を止められないわ！」
PRINTFORML 「ふふふっ、見られて恥ずかしい体はしてないつもりだけど」	PRINTFORML 「ふふふっ、見られて恥ずかしい体はしてないつもりだけど」
PRINTFORML 「秋ヌード！秋ヌード！いやなに言ってるの私きゃーーー！」	PRINTFORML 「秋ヌード！秋ヌード！いやなに言ってるの私きゃーーー！」
PRINTFORML 「私があなたを打ち倒し！本当の秋色にしてやる！絶対に！」	PRINTFORML 「私があなたを打ち倒し！本当の秋色にしてやる！絶対に！」
PRINTFORMDL 次に出会うときまでに秋パワーが持つことを願うばかりだ…	PRINTFORMDL 次に出会うときまでに秋パワーが持つことを願うばかりだ…
PRINTFORML 「あなたの敗因は一つ。私と出会ってしまったことだけよ！」	PRINTFORML 「あなたの敗因は一つ。私と出会ってしまったことだけよ！」
PRINTFORML 「ふふふ…この部屋に脚を踏み入れたその時が奴らの終焉よ」	PRINTFORML 「ふふふ…この部屋に脚を踏み入れたその時が奴らの終焉よ」
PRINTFORML 「もうちょっと着替えず粘れるかしら？全裸チキンレース♪」	PRINTFORML 「もうちょっと着替えず粘れるかしら？全裸チキンレース♪」
PRINTFORML 「はなしてっ･･･こーのー…おーねーがーいーー…ひゃっ」	PRINTFORML 「はなしてっ･･･こーのー…おーねーがーいーー…ひゃっ」
PRINTFORMDL 静葉は涙に濡れた瞳で必死に訴え、下半身を守っている……	PRINTFORMDL 静葉は涙に濡れた瞳で必死に訴え、下半身を守っている……
PRINTFORML 「神に対して…許されな……こんな…ぐすっ…こんなこと…」	PRINTFORML 「神に対して…許されな……こんな…ぐすっ…こんなこと…」
PRINTFORMDL 時折手足の先をピクリと痙攣させる以外に静葉は動かない…	PRINTFORMDL 時折手足の先をピクリと痙攣させる以外に静葉は動かない…
PRINTFORML 「ごめんなさい…私の力じゃどうすることもできないの……」	PRINTFORML 「ごめんなさい…私の力じゃどうすることもできないの……」
PRINTFORMDL 必死に戦う穣子は困惑した表情で静葉と触手へ顔を向けた。	PRINTFORMDL 必死に戦う穣子は困惑した表情で静葉と触手へ顔を向けた。
PRINTFORML 「お姉ちゃんは大丈夫だから！だから穣子ちゃんは逃げて！」	PRINTFORML 「お姉ちゃんは大丈夫だから！だから穣子ちゃんは逃げて！」
PRINTFORMW (そんなわけ…ないじゃない……私……見捨てられたのね…)	PRINTFORMW (そんなわけ…ないじゃない……私……見捨てられたのね…)
PRINTFORMDL もう助からない。そう思った静葉は触手に身をゆだねた……	PRINTFORMDL もう助からない。そう思った静葉は触手に身をゆだねた……
PRINTFORMDL 静葉は複雑な表情で「そうかもしれません」と呟くと俯いた	PRINTFORMDL 静葉は複雑な表情で「そうかもしれません」と呟くと俯いた
PRINTFORMDL 静葉はその場で崩れ落ちるように倒れると寝息を立て始めた	PRINTFORMDL 静葉はその場で崩れ落ちるように倒れると寝息を立て始めた
PRINTFORML (かける言葉が思いつかないわ…私…ダメなお姉ちゃんね…)	PRINTFORML (かける言葉が思いつかないわ…私…ダメなお姉ちゃんね…)
PRINTFORML 「それなのに…お姉ちゃんが…お姉ちゃんが遅かったから……	PRINTFORML 「それなのに…お姉ちゃんが…お姉ちゃんが遅かったから……
PRINTFORML 「どうして穣子ちゃんなの…？私じゃダメだったの･･･？」	PRINTFORML 「どうして穣子ちゃんなの…？私じゃダメだったの･･･？」
PRINTFORML 「早く逃げ出さないと…私もいつかここにいた人みたいに…」	PRINTFORML 「早く逃げ出さないと…私もいつかここにいた人みたいに…」
PRINTFORMDL 静葉は顔を両腕で隠しながら淡々と痛い痛いと訴え続けた…	PRINTFORMDL 静葉は顔を両腕で隠しながら淡々と痛い痛いと訴え続けた…
PRINTFORML 「う、うう…今の格好の方が下手したらマシな気がする…」	PRINTFORML 「う、うう…今の格好の方が下手したらマシな気がする…」
PRINTFORMDL 着替えセットの中身はふりふりひらひらのメイド服だった	PRINTFORMDL 着替えセットの中身はふりふりひらひらのメイド服だった
PRINTFORML 「こんなものまで用意されてる…弄ばれている気がするわ」	PRINTFORML 「こんなものまで用意されてる…弄ばれている気がするわ」
PRINTFORMDL 着替えセットの中身は可愛らしいパレオつきの水着だった	PRINTFORMDL 着替えセットの中身は可愛らしいパレオつきの水着だった
PRINTFORML 「この格好で歩き回るのは裸とはまた別の恥ずかしさが…」	PRINTFORML 「この格好で歩き回るのは裸とはまた別の恥ずかしさが…」
PRINTFORML 「水着なのにニーソックスってどういう組み合わせなの…」	PRINTFORML 「水着なのにニーソックスってどういう組み合わせなの…」
PRINTFORMDW 特に臭いはしなかったが、なんとなくべたつく気がする…	PRINTFORMDW 特に臭いはしなかったが、なんとなくべたつく気がする…
PRINTFORMDW クイーンを倒した静葉は穣子を探して迷宮内を駆け回った	PRINTFORMDW クイーンを倒した静葉は穣子を探して迷宮内を駆け回った
PRINTFORMDW	静葉の心の傷はまだまだ癒えるのに時間がかかりそうだ…	PRINTFORMDW	静葉の心の傷はまだまだ癒えるのに時間がかかりそうだ…
PRINTFORMDW	少しでも早く穣子助けるために静葉は必死に仲間を集めた	PRINTFORMDW	少しでも早く穣子助けるために静葉は必死に仲間を集めた
PRINTFORMDW	だがそれがまた静葉にはなんだかもの悲しい事に思えた…	PRINTFORMDW	だがそれがまた静葉にはなんだかもの悲しい事に思えた…
PRINTFORMDW 再会の喜びより先に全裸の静葉の有様に驚き言及する穣子	PRINTFORMDW 再会の喜びより先に全裸の静葉の有様に驚き言及する穣子
PRINTFORMDW 穣子は人里で色々あってなかなか帰るに帰れなかったこと	PRINTFORMDW 穣子は人里で色々あってなかなか帰るに帰れなかったこと
PRINTFORMDW 静葉は慌てて穣子から離れると申し訳なさそうに微笑んだ	PRINTFORMDW 静葉は慌てて穣子から離れると申し訳なさそうに微笑んだ
PRINTFORMDW 日めくりカレンダーを二人で掴みせーのでそれを引っ張る	PRINTFORMDW 日めくりカレンダーを二人で掴みせーのでそれを引っ張る
PRINTFORMDW ふと、そんなことを考えて静葉は寂しげにため息をついた	PRINTFORMDW ふと、そんなことを考えて静葉は寂しげにため息をついた
PRINTFORMDW 一人の生存者が穣子の持ち物を持っていることに気づいた	PRINTFORMDW 一人の生存者が穣子の持ち物を持っていることに気づいた
PRINTFORMDW 生まれたばかりの小さな娘は不安そうに母親へと向き直る	PRINTFORMDW 生まれたばかりの小さな娘は不安そうに母親へと向き直る
PRINTFORMW （穣子のような子をこれ以上増やすわけにはいかない…！）	PRINTFORMW （穣子のような子をこれ以上増やすわけにはいかない…！）
PRINTFORMDW その場に静葉がいない事になぜ誰も気づかなかったのか？	PRINTFORMDW その場に静葉がいない事になぜ誰も気づかなかったのか？
PRINTFORMDW そして、神を飲み込み神の力を得たという地底の烏の噂…	PRINTFORMDW そして、神を飲み込み神の力を得たという地底の烏の噂…
PRINTFORMDL 大して脚が上がっていないが多分かかと落としだろう……	PRINTFORMDL 大して脚が上がっていないが多分かかと落としだろう……
PRINTFORMDL 静葉は太ももを這い上がる触手の気配に慌てて前を隠した	PRINTFORMDL 静葉は太ももを這い上がる触手の気配に慌てて前を隠した
PRINTFORML 「押さえつければ勝てると思ったのかしら？ふふふふふ…」	PRINTFORML 「押さえつければ勝てると思ったのかしら？ふふふふふ…」
PRINTFORML 強烈なツタの一撃を腹部に喰らって静葉は豪快にふっとんだ	PRINTFORML 強烈なツタの一撃を腹部に喰らって静葉は豪快にふっとんだ
PRINTFORML 「ふははははは！この完璧なグレイズ！秋の私は無敵よ！」	PRINTFORML 「ふははははは！この完璧なグレイズ！秋の私は無敵よ！」
PRINTFORMDL 静葉は言葉にならない声をあげ全身を痙攣させている……	PRINTFORMDL 静葉は言葉にならない声をあげ全身を痙攣させている……
PRINTFORML 「ふぅ、これでうーんと羽を伸ばしてオナニーできるわ！」	PRINTFORML 「ふぅ、これでうーんと羽を伸ばしてオナニーできるわ！」
PRINTFORMDL スカーレットバインを前に静葉は怒りに打ち震えていた…	PRINTFORMDL スカーレットバインを前に静葉は怒りに打ち震えていた…
PRINTFORML 「…修理する服がないと流石に秋パワーがあってもむりね」	PRINTFORML 「…修理する服がないと流石に秋パワーがあってもむりね」
PRINTFORML 「やめて！私に酷いことするつもりでしょ！冬みたいに！」	PRINTFORML 「やめて！私に酷いことするつもりでしょ！冬みたいに！」
PRINTFORML 「秋なのにひと夏の思い出をつくらされるとこだったわ…」	PRINTFORML 「秋なのにひと夏の思い出をつくらされるとこだったわ…」
PRINTFORML 「ちょ、ちょっとどこ行くの！？一人じゃ危ないわよ！？」	PRINTFORML 「ちょ、ちょっとどこ行くの！？一人じゃ危ないわよ！？」
PRINTFORML 「着替えとっとと使ってパーフェクト秋静葉になりましょ」	PRINTFORML 「着替えとっとと使ってパーフェクト秋静葉になりましょ」
PRINTFORML 「ひゃっはぁあ！！理由はないけどテンション上がるー♪」	PRINTFORML 「ひゃっはぁあ！！理由はないけどテンション上がるー♪」
PRINTFORMDL 静葉は手足を使って弱々しいながらも肉壁を攻撃している	PRINTFORMDL 静葉は手足を使って弱々しいながらも肉壁を攻撃している
PRINTFORMDL 静葉は全身を汚される嫌悪感に声にならない悲鳴をあげた	PRINTFORMDL 静葉は全身を汚される嫌悪感に声にならない悲鳴をあげた
PRINTFORML 「こんな奴の…赤ちゃんなんて作るわけにいかないわ……」	PRINTFORML 「こんな奴の…赤ちゃんなんて作るわけにいかないわ……」
PRINTFORML (せめて…せめて穣子ちゃんだけでも無事にかえって……)	PRINTFORML (せめて…せめて穣子ちゃんだけでも無事にかえって……)
PRINTFORML 「…はぁ、さすがに今日はケンカする気なんてないわよ？」	PRINTFORML 「…はぁ、さすがに今日はケンカする気なんてないわよ？」
PRINTFORML 「穣子ちゃんもここにいるのね…教えてくれてありがとう」	PRINTFORML 「穣子ちゃんもここにいるのね…教えてくれてありがとう」
PRINTFORML 「以上が私の知っていることです。役に立つと嬉しいです」	PRINTFORML 「以上が私の知っていることです。役に立つと嬉しいです」
PRINTFORML 「穣子ちゃん、ごめんね。ちょっとだけここで待ってて…」	PRINTFORML 「穣子ちゃん、ごめんね。ちょっとだけここで待ってて…」
PRINTFORML 「早く服をきちゃいましょ…恥ずかしくて恥ずかしくて…」	PRINTFORML 「早く服をきちゃいましょ…恥ずかしくて恥ずかしくて…」
PRINTFORMDL 腹部を押えた静葉は声もださずただ涙を流し続けている…	PRINTFORMDL 腹部を押えた静葉は声もださずただ涙を流し続けている…
PRINTFORML 「あまり終焉の力をこんなことに使いたくはないけれど…」	PRINTFORML 「あまり終焉の力をこんなことに使いたくはないけれど…」
PRINTFORML 「ひっく…えっく……このままじゃいつか奪われちゃう…」	PRINTFORML 「ひっく…えっく……このままじゃいつか奪われちゃう…」
PRINTFORML 「怖いけど…穣子ちゃんがいるからお姉ちゃんは大丈夫よ」	PRINTFORML 「怖いけど…穣子ちゃんがいるからお姉ちゃんは大丈夫よ」
PRINTFORML 「お姉ちゃん…これから一人ぼっちでどうしたらいいの？」	PRINTFORML 「お姉ちゃん…これから一人ぼっちでどうしたらいいの？」
PRINTFORML 「いやっ……えっちなきもちな時に追いかけてこないで！」	PRINTFORML 「いやっ……えっちなきもちな時に追いかけてこないで！」
PRINTFORML 「おかあさん達がきたっていう外の世界、いってみたいの」	PRINTFORML 「おかあさん達がきたっていう外の世界、いってみたいの」
PRINTFORML 「半分仲間だけど邪魔するから…悪く思わないでください」	PRINTFORML 「半分仲間だけど邪魔するから…悪く思わないでください」
PRINTFORML 「おかあ…ひっく…おかあさああん！うわぁああああん！」	PRINTFORML 「おかあ…ひっく…おかあさああん！うわぁああああん！」
PRINTFORML 「もったいないけれど痛んでいる部分だけ着替えましょ」	PRINTFORML 「もったいないけれど痛んでいる部分だけ着替えましょ」
PRINTFORML (パンツも変えたいけど…歩いてる間にずり落ちそう…)	PRINTFORML (パンツも変えたいけど…歩いてる間にずり落ちそう…)
PRINTFORML 「やだっ…なんだか透けてるし裸より恥ずかしい気が…」	PRINTFORML 「やだっ…なんだか透けてるし裸より恥ずかしい気が…」
PRINTFORML 「か、考えすぎよね…裸に比べればどんな格好だって…」	PRINTFORML 「か、考えすぎよね…裸に比べればどんな格好だって…」
PRINTFORML 「水遊びに来たわけでもないのにこんな格好だなんて…」	PRINTFORML 「水遊びに来たわけでもないのにこんな格好だなんて…」
PRINTFORMDW …どうやら自分も人のことを言える立場ではないようだ	PRINTFORMDW …どうやら自分も人のことを言える立場ではないようだ
PRINTFORMW 「穣子ちゃん…お姉ちゃん……ちょっとだけ眠らせて…」	PRINTFORMW 「穣子ちゃん…お姉ちゃん……ちょっとだけ眠らせて…」
PRINTFORMDW	囮になり、静葉を助けた二人は結局、助からなかった…	PRINTFORMDW	囮になり、静葉を助けた二人は結局、助からなかった…
PRINTFORMDW	墓標のない墓地で静葉は毎日のように穣子に話しかけた	PRINTFORMDW	墓標のない墓地で静葉は毎日のように穣子に話しかけた
PRINTFORMDW けれども静葉を探すことが出来ず諦めて帰ってきたこと	PRINTFORMDW けれども静葉を探すことが出来ず諦めて帰ってきたこと
PRINTFORMDW 「…ダメよ、服を着ないと。それにとても汚れてるわ」	PRINTFORMDW 「…ダメよ、服を着ないと。それにとても汚れてるわ」
PRINTFORMDW 静葉が迷宮の外に顔を出すとそこは一面の雪景色だった	PRINTFORMDW 静葉が迷宮の外に顔を出すとそこは一面の雪景色だった
PRINTFORMW ((ダメよ！季節は秋秋秋秋と巡るから美しいのよ！))	PRINTFORMW ((ダメよ！季節は秋秋秋秋と巡るから美しいのよ！))
PRINTFORMW 確かに先程からあの魔物は殆どこちらに手を出してこない	PRINTFORMW 確かに先程からあの魔物は殆どこちらに手を出してこない
PRINTFORML じゃあ両方いれちゃおうなんて欲張った結果がこれだよ！	PRINTFORML じゃあ両方いれちゃおうなんて欲張った結果がこれだよ！
PRINTFORML 「くっ！ほどばしる秋パワーが自分でも抑えられない！」	PRINTFORML 「くっ！ほどばしる秋パワーが自分でも抑えられない！」
PRINTFORML 「わ、私を食べたら秋がこなくなるわよ！？いいの！？」	PRINTFORML 「わ、私を食べたら秋がこなくなるわよ！？いいの！？」
PRINTFORML 「実は諦めた振りしてチャンスを伺っていたんだけど…」	PRINTFORML 「実は諦めた振りしてチャンスを伺っていたんだけど…」
PRINTFORML 「責任とれないのに生はダメ、お姉ちゃんとの約束よ？」	PRINTFORML 「責任とれないのに生はダメ、お姉ちゃんとの約束よ？」
PRINTFORML 「食欲の秋なら仕方ないわね…ううん、よくないわよ！」	PRINTFORML 「食欲の秋なら仕方ないわね…ううん、よくないわよ！」
PRINTFORMDL 静葉は膝をガクガクさせながらふらふらと立ち上がった	PRINTFORMDL 静葉は膝をガクガクさせながらふらふらと立ち上がった
PRINTFORML 「くるくるくるぅ！秋がくるわぁ！……っーーーーー！」	PRINTFORML 「くるくるくるぅ！秋がくるわぁ！……っーーーーー！」
PRINTFORMDL 静葉はだらしなく顔をゆるませ甘えるような声をあげた	PRINTFORMDL 静葉はだらしなく顔をゆるませ甘えるような声をあげた
PRINTFORML 「これが秋にのみ許された回避法『秋ステップ』よっ！」	PRINTFORML 「これが秋にのみ許された回避法『秋ステップ』よっ！」
PRINTFORML 「秋パワーがなかったら妊娠してたかもしれないわ……」	PRINTFORML 「秋パワーがなかったら妊娠してたかもしれないわ……」
PRINTFORML 「うふふふふ、秋だとなんだかとっても気持ちいいわね」	PRINTFORML 「うふふふふ、秋だとなんだかとっても気持ちいいわね」
PRINTFORMDL 冬が…冬が…と虚ろな瞳で呟く静葉をほうっておけない	PRINTFORMDL 冬が…冬が…と虚ろな瞳で呟く静葉をほうっておけない
PRINTFORML 「……お姉ちゃんちょっと火遊びが過ぎちゃったかしら」	PRINTFORML 「……お姉ちゃんちょっと火遊びが過ぎちゃったかしら」
PRINTFORML 「こんな状態だからこそクールに秋らしく待ち伏せよ…」	PRINTFORML 「こんな状態だからこそクールに秋らしく待ち伏せよ…」
PRINTFORML 「のこのこやってきたところをこうガツンって寸法よ！」	PRINTFORML 「のこのこやってきたところをこうガツンって寸法よ！」
PRINTFORML 「うーん、もっとさくっと外に出れるとおもたのだけど」	PRINTFORML 「うーん、もっとさくっと外に出れるとおもたのだけど」
PRINTFORML 「私の秋パワーを吸い取ろうなんて罰当たりな化物ね！」	PRINTFORML 「私の秋パワーを吸い取ろうなんて罰当たりな化物ね！」
PRINTFORML 「あの…秋パワーあげるんで出て行ってくれませんか？」	PRINTFORML 「あの…秋パワーあげるんで出て行ってくれませんか？」
PRINTFORML 「ぎゃああ！なんかヤバイ！マジヤバイ！秋ヤバイ！！」	PRINTFORML 「ぎゃああ！なんかヤバイ！マジヤバイ！秋ヤバイ！！」
PRINTFORML 「やーだー！化物のままになんてなりたくないわよー！」	PRINTFORML 「やーだー！化物のままになんてなりたくないわよー！」
PRINTFORML 「メープルシロップでべたべたなら歓迎なんだけどねー」	PRINTFORML 「メープルシロップでべたべたなら歓迎なんだけどねー」
PRINTFORML 「汚れてる！？秋の私を怒らせるとは死にたいようね…」	PRINTFORML 「汚れてる！？秋の私を怒らせるとは死にたいようね…」
PRINTFORMDL 触手から逃れた拍子に静葉は思い切りしりもちをついた	PRINTFORMDL 触手から逃れた拍子に静葉は思い切りしりもちをついた
PRINTFORML 「こわれ…！こわれるっ！おなかこわれちゃうぅぅ…！」	PRINTFORML 「こわれ…！こわれるっ！おなかこわれちゃうぅぅ…！」
PRINTFORML 「はぁはぁ…なんとか最悪の事態は回避できたわね……」	PRINTFORML 「はぁはぁ…なんとか最悪の事態は回避できたわね……」
PRINTFORMDL 穣子は下唇を噛み、少し俯いた後、全力で駆け出した。	PRINTFORMDL 穣子は下唇を噛み、少し俯いた後、全力で駆け出した。
PRINTFORML (穣子ちゃん！？でもあれは間違いなく穣子ちゃんの…）	PRINTFORML (穣子ちゃん！？でもあれは間違いなく穣子ちゃんの…）
PRINTFORML 「きっと…情報があればお互いの為になると思うんです」	PRINTFORML 「きっと…情報があればお互いの為になると思うんです」
PRINTFORML 「こんなに服をありがたく感じる日がくるとは…はぁ…」	PRINTFORML 「こんなに服をありがたく感じる日がくるとは…はぁ…」
PRINTFORML 「ん～…まぁまぁ寝れたかしら。見張りの交代しましょ」	PRINTFORML 「ん～…まぁまぁ寝れたかしら。見張りの交代しましょ」
PRINTFORMDL 静葉は安堵とまだ残る恐怖とで肩で激しく息をしている	PRINTFORMDL 静葉は安堵とまだ残る恐怖とで肩で激しく息をしている
PRINTFORML 「服を見つけなくちゃ…恥ずかしくて死んじゃいそう…」	PRINTFORML 「服を見つけなくちゃ…恥ずかしくて死んじゃいそう…」
PRINTFORML 「せめて誰か強い人と一緒にいてくれればいいのだけど」	PRINTFORML 「せめて誰か強い人と一緒にいてくれればいいのだけど」
PRINTFORML 「私にこんなことしたら神様達が黙ってないんだから！」	PRINTFORML 「私にこんなことしたら神様達が黙ってないんだから！」
PRINTFORML 「これが私の知っていることです。役に立つと嬉しいわ」	PRINTFORML 「これが私の知っていることです。役に立つと嬉しいわ」
PRINTFORMDL 静葉は周囲の視線を気にしながらコソコソと着替えた	PRINTFORMDL 静葉は周囲の視線を気にしながらコソコソと着替えた
PRINTFORML (下着のサイズまで合っているなんて…少し怖いわ…)	PRINTFORML (下着のサイズまで合っているなんて…少し怖いわ…)
PRINTFORML 「ひらひらしてあまり給仕向けな服とは思えないわね」	PRINTFORML 「ひらひらしてあまり給仕向けな服とは思えないわね」
PRINTFORML 「うーん…これなら水着でもそこまで恥ずかしくは…」	PRINTFORML 「うーん…これなら水着でもそこまで恥ずかしくは…」
PRINTFORML 「もうあちこちビリビリにさけちゃってるじゃない…」	PRINTFORML 「もうあちこちビリビリにさけちゃってるじゃない…」
PRINTFORMDW 力尽きた彼女の為に出来ることは何かないだろうか？	PRINTFORMDW 力尽きた彼女の為に出来ることは何かないだろうか？
PRINTFORMDW そしてその平和な会話のありがたさを噛み締めていた	PRINTFORMDW そしてその平和な会話のありがたさを噛み締めていた
PRINTFORMDW 静葉の服を全て剥ぎ取ろうと服と肌との間を暴れ周り	PRINTFORMDW 静葉の服を全て剥ぎ取ろうと服と肌との間を暴れ周り
PRINTFORMDW そう願いながら静葉の意識は静かに消えていった……	PRINTFORMDW そう願いながら静葉の意識は静かに消えていった……
PRINTFORMDW もしかしたらふらっと穣子が帰って来るかもしれない	PRINTFORMDW もしかしたらふらっと穣子が帰って来るかもしれない
PRINTFORMDW けれども静葉を探してずっと迷宮を彷徨っていたこと	PRINTFORMDW けれども静葉を探してずっと迷宮を彷徨っていたこと
PRINTFORMDW 穣子と静葉はお互いに抱き合い、そして微笑みあった	PRINTFORMDW 穣子と静葉はお互いに抱き合い、そして微笑みあった
PRINTFORMDW 静葉は、真剣な表情でクイーンの亡骸を見つめていた	PRINTFORMDW 静葉は、真剣な表情でクイーンの亡骸を見つめていた
PRINTFORMDW 触手達がこう言ったのだ『迷宮の外に出たくない』と	PRINTFORMDW 触手達がこう言ったのだ『迷宮の外に出たくない』と
PRINTFORMW そんな中で、%ARGS:0%はふとある事に気付いた	PRINTFORMW そんな中で、%ARGS:0%はふとある事に気付いた
PRINTFORML 「この謎の迷宮には何よりも秋らしさが足りないッ！」	PRINTFORML 「この謎の迷宮には何よりも秋らしさが足りないッ！」
PRINTFORMW 「ならば神として私がすべきことはひとぉぉぉつ！！」	PRINTFORMW 「ならば神として私がすべきことはひとぉぉぉつ！！」
PRINTFORMDW これは明らかな秋に対する挑戦であり冒涜であった！	PRINTFORMDW これは明らかな秋に対する挑戦であり冒涜であった！
PRINTFORMDW 静葉が吼えると同時に、応えるように地面が消えた…	PRINTFORMDW 静葉が吼えると同時に、応えるように地面が消えた…
PRINTFORML 「そろそろ誰かが助けてくれないかなーって…えへへ」	PRINTFORML 「そろそろ誰かが助けてくれないかなーって…えへへ」
PRINTFORMDL ほとんど飛んでいない飛び膝蹴りが繰り出される……	PRINTFORMDL ほとんど飛んでいない飛び膝蹴りが繰り出される……
PRINTFORMDL 無駄な自信と共に初心者にも優しい弾幕が放たれた！	PRINTFORMDL 無駄な自信と共に初心者にも優しい弾幕が放たれた！
PRINTFORML 「ククククク…乱れ秋月花を使わざるを得ないわね！」	PRINTFORML 「ククククク…乱れ秋月花を使わざるを得ないわね！」
PRINTFORML 「今の私なら武器だってバンバン使える気がするわ！」	PRINTFORML 「今の私なら武器だってバンバン使える気がするわ！」
PRINTFORML 「うそです！出してください！ほんとお願いします！」	PRINTFORML 「うそです！出してください！ほんとお願いします！」
PRINTFORML 「神はかっこよく脱出するのが相場ってものなのよ！」	PRINTFORML 「神はかっこよく脱出するのが相場ってものなのよ！」
PRINTFORML 「ふふふ、動きを封じれば勝てると思ったのかしら？」	PRINTFORML 「ふふふ、動きを封じれば勝てると思ったのかしら？」
PRINTFORML 「わ、私は秋のテンションにやれれてなんて事を……」	PRINTFORML 「わ、私は秋のテンションにやれれてなんて事を……」
PRINTFORML 「あはぁ…さすがね……私が認めただけはあるわ……」	PRINTFORML 「あはぁ…さすがね……私が認めただけはあるわ……」
PRINTFORML 「ぎゃあああああ！？だからやめてってばあああ！！」	PRINTFORML 「ぎゃあああああ！？だからやめてってばあああ！！」
PRINTFORML 「ねえ、よかったら秋告げ精になるきはないかしら？」	PRINTFORML 「ねえ、よかったら秋告げ精になるきはないかしら？」
PRINTFORML 「さあ！紅葉を支配する紅蓮の力をみせてあげる！！」	PRINTFORML 「さあ！紅葉を支配する紅蓮の力をみせてあげる！！」
PRINTFORML 「だけど、そんなことしてる場合じゃないでしょう？」	PRINTFORML 「だけど、そんなことしてる場合じゃないでしょう？」
PRINTFORML 「ほらほらビークールビークール…み、穣子ちゃん？」	PRINTFORML 「ほらほらビークールビークール…み、穣子ちゃん？」
PRINTFORML 「ちょ、ちょっと？無視は酷いんじゃないかしらー？」	PRINTFORML 「ちょ、ちょっと？無視は酷いんじゃないかしらー？」
PRINTFORML 「ふっ…去るものは追わない。別れもまた秋の一部…」	PRINTFORML 「ふっ…去るものは追わない。別れもまた秋の一部…」
PRINTFORML 「そろそろ着替え（オータムチェンジ）をすべきよね」	PRINTFORML 「そろそろ着替え（オータムチェンジ）をすべきよね」
PRINTFORML 「もう…たすからないのかしら……ふぇ…ふぇぇぇ…」	PRINTFORML 「もう…たすからないのかしら……ふぇ…ふぇぇぇ…」
PRINTFORMDL 静葉は四肢に力をいれ少しずつ少しずつ這い上がった	PRINTFORMDL 静葉は四肢に力をいれ少しずつ少しずつ這い上がった
PRINTFORMDL 静葉は小さく悲鳴を漏らすが何も抵抗をしなかった…	PRINTFORMDL 静葉は小さく悲鳴を漏らすが何も抵抗をしなかった…
PRINTFORMDL 近くで穣子の持ち物が落ちていたことを教えてくれた	PRINTFORMDL 近くで穣子の持ち物が落ちていたことを教えてくれた
PRINTFORML 「睡魔が襲ってきても…なんだかお腹が気になって…」	PRINTFORML 「睡魔が襲ってきても…なんだかお腹が気になって…」
PRINTFORMDL 静葉は膨らみきった腹をなでながら呆然としている…	PRINTFORMDL 静葉は膨らみきった腹をなでながら呆然としている…
PRINTFORMDL 静葉は普段出さないような叫び声をあげて暴れている	PRINTFORMDL 静葉は普段出さないような叫び声をあげて暴れている
PRINTFORML 「あ…穣子ちゃん…お姉ちゃんそんなつもりじゃ……」	PRINTFORML 「あ…穣子ちゃん…お姉ちゃんそんなつもりじゃ……」
PRINTFORML 「穣子ちゃん…ごめんね、もう少しだけ我慢してね…」	PRINTFORML 「穣子ちゃん…ごめんね、もう少しだけ我慢してね…」
PRINTFORMDL 静葉は口元をおさえ目を見開きガクガクと震えだした	PRINTFORMDL 静葉は口元をおさえ目を見開きガクガクと震えだした
PRINTFORML 「お姉ちゃんがもっと早く神隠しにあっていれば……」	PRINTFORML 「お姉ちゃんがもっと早く神隠しにあっていれば……」
PRINTFORML (やだッ……こんなえっちな気分の時に触られたら…)	PRINTFORML (やだッ……こんなえっちな気分の時に触られたら…)
PRINTFORML 「私、おかあさんみたいにお姉ちゃんのほうがいいな」	PRINTFORML 「私、おかあさんみたいにお姉ちゃんのほうがいいな」
PRINTFORML 「ビリッといってまた裸なんてなりませんように…」	PRINTFORML 「ビリッといってまた裸なんてなりませんように…」
PRINTFORML (ううん、背に腹は変えられないわ。我慢よ静葉…)	PRINTFORML (ううん、背に腹は変えられないわ。我慢よ静葉…)
PRINTFORML 「…胸の大きい方向けのセクシーな下着つきですか」	PRINTFORML 「…胸の大きい方向けのセクシーな下着つきですか」
PRINTFORML 「はぁ…せめて下着は大人用のものがよかったわ…」	PRINTFORML 「はぁ…せめて下着は大人用のものがよかったわ…」
PRINTFORML 「あら、かわいい服♪吸血鬼のとこの家来の制服ね」	PRINTFORML 「あら、かわいい服♪吸血鬼のとこの家来の制服ね」
PRINTFORML 「うう…こんな格好じゃ私の神様としての威厳が…」	PRINTFORML 「うう…こんな格好じゃ私の神様としての威厳が…」
PRINTFORML 「服を着れる嬉しさがどこかにいってしまうわね…」	PRINTFORML 「服を着れる嬉しさがどこかにいってしまうわね…」
PRINTFORML 「下着、上着、全部揃ってる服ってとても嬉しいわ」	PRINTFORML 「下着、上着、全部揃ってる服ってとても嬉しいわ」
PRINTFORML 「うふふ…ここから一気にやぶけてしまいそうね…」	PRINTFORML 「うふふ…ここから一気にやぶけてしまいそうね…」
PRINTFORML 「あんな水着でもないよりはマシだったわ…くすん」	PRINTFORML 「あんな水着でもないよりはマシだったわ…くすん」
PRINTFORMDW	だが、静葉は今触手によって四肢を拘束されていた	PRINTFORMDW	だが、静葉は今触手によって四肢を拘束されていた
PRINTFORMDW しばらくすると何も言わずに静葉の服をもってきた	PRINTFORMDW しばらくすると何も言わずに静葉の服をもってきた
PRINTFORMW 「そうだ、久しぶりに一緒にお風呂にはいりましょ」	PRINTFORMW 「そうだ、久しぶりに一緒にお風呂にはいりましょ」
PRINTFORMDW 『目を覚ましたらあたしが作った新しい家だから』	PRINTFORMDW 『目を覚ましたらあたしが作った新しい家だから』
PRINTFORMDW 秋の終焉を…冬の到来を阻止できるかもしれない…	PRINTFORMDW 秋の終焉を…冬の到来を阻止できるかもしれない…
PRINTFORMDW これなら幻想郷中を秋色に一年中染め上げられる！	PRINTFORMDW これなら幻想郷中を秋色に一年中染め上げられる！
PRINTFORMDL 静葉は超強気な幸せ者として触手宮に君臨したッ！	PRINTFORMDL 静葉は超強気な幸せ者として触手宮に君臨したッ！
PRINTFORMDW 心配のし過ぎかもしれないと自分でも分かっている	PRINTFORMDW 心配のし過ぎかもしれないと自分でも分かっている
PRINTFORML 「秋パワーが溜まったらまた相手をしてあげるわ！」	PRINTFORML 「秋パワーが溜まったらまた相手をしてあげるわ！」
PRINTFORML 「うおおーー！！くああーー！！ざけんなーーっ！」	PRINTFORML 「うおおーー！！くああーー！！ざけんなーーっ！」
PRINTFORML 「この程度の攻撃で秋が終わると思ったかしら！？」	PRINTFORML 「この程度の攻撃で秋が終わると思ったかしら！？」
PRINTFORML 「お姉ちゃんこのままじゃどうかしちゃいそう…♪」	PRINTFORML 「お姉ちゃんこのままじゃどうかしちゃいそう…♪」
PRINTFORML 「秋の私に攻撃をあてようだなんて甘すぎるわね！」	PRINTFORML 「秋の私に攻撃をあてようだなんて甘すぎるわね！」
PRINTFORML 「とりあえず乳首に紅葉を張っておけばなんとか…」	PRINTFORML 「とりあえず乳首に紅葉を張っておけばなんとか…」
PRINTFORML 「この程度の穴、秋裁縫上手の前ではただの穴よ！」	PRINTFORML 「この程度の穴、秋裁縫上手の前ではただの穴よ！」
PRINTFORML 「まあ、あなたなら私がいなくても大丈夫でしょう」	PRINTFORML 「まあ、あなたなら私がいなくても大丈夫でしょう」
PRINTFORML 「ふふふ、こう見えても昔から物探しは得意なのよ」	PRINTFORML 「ふふふ、こう見えても昔から物探しは得意なのよ」
PRINTFORML 「穣子ちゃーん？どうしたのそんなこわーい顔して」	PRINTFORML 「穣子ちゃーん？どうしたのそんなこわーい顔して」
PRINTFORMDL 穣子は目に涙を蓄えながらビシッとポーズを決めた	PRINTFORMDL 穣子は目に涙を蓄えながらビシッとポーズを決めた
PRINTFORML 「ふっふっふ、私を拉致った事を後悔させてやるわ」	PRINTFORML 「ふっふっふ、私を拉致った事を後悔させてやるわ」
PRINTFORML 「離して…離して…もう…ひっく……壊れちゃう…」	PRINTFORML 「離して…離して…もう…ひっく……壊れちゃう…」
PRINTFORMDL 弱々しく呟く吐き出された静葉は憔悴しきっている	PRINTFORMDL 弱々しく呟く吐き出された静葉は憔悴しきっている
PRINTFORMDL 静葉の啜り泣く声はどんどん弱々しくなっていく…	PRINTFORMDL 静葉の啜り泣く声はどんどん弱々しくなっていく…
PRINTFORMDL 初めてを死守しようと静葉は必死に抵抗している！	PRINTFORMDL 初めてを死守しようと静葉は必死に抵抗している！
PRINTFORMDL 静葉は恐怖のあまり声もだせず唇を震わせている…	PRINTFORMDL 静葉は恐怖のあまり声もだせず唇を震わせている…
PRINTFORML (このまま…陵辱されて……もう…助からない……)	PRINTFORML (このまま…陵辱されて……もう…助からない……)
PRINTFORML 「はぁっ…はぁっ…もう……追ってこないわよね？」	PRINTFORML 「はぁっ…はぁっ…もう……追ってこないわよね？」
PRINTFORML 「穣子ちゃん！お姉ちゃん助けをよんでくるから！」	PRINTFORML 「穣子ちゃん！お姉ちゃん助けをよんでくるから！」
PRINTFORML 「そう、穣子もここに…ありがとう、教えてくれて」	PRINTFORML 「そう、穣子もここに…ありがとう、教えてくれて」
PRINTFORMDL 静葉は弱々しくありがとうと唇を震わせている……	PRINTFORMDL 静葉は弱々しくありがとうと唇を震わせている……
PRINTFORML 「お互いに無事に逃げられるように頑張りましょう」	PRINTFORML 「お互いに無事に逃げられるように頑張りましょう」
PRINTFORML 「睡魔が襲ってきても…なんだかお腹が気になる…」	PRINTFORML 「睡魔が襲ってきても…なんだかお腹が気になる…」
PRINTFORML 「なんとなくわかるの…もう間に合わないって……」	PRINTFORML 「なんとなくわかるの…もう間に合わないって……」
PRINTFORML 「どうして…どうして初めてが……化物なんかに…」	PRINTFORML 「どうして…どうして初めてが……化物なんかに…」
PRINTFORML 「……数刻後にはまた汚れてしまうのよね、きっと」	PRINTFORML 「……数刻後にはまた汚れてしまうのよね、きっと」
PRINTFORML 「……穣子ちゃんも必死なのは分かってあげたいわ」	PRINTFORML 「……穣子ちゃんも必死なのは分かってあげたいわ」
PRINTFORML 「…ごめんなさい。少し気遣いがたりなかったです」	PRINTFORML 「…ごめんなさい。少し気遣いがたりなかったです」
PRINTFORML 「着替えるべきかまだ取っておくべきか…うーん…」	PRINTFORML 「着替えるべきかまだ取っておくべきか…うーん…」
PRINTFORML 「急いで服を見つけるからもう少しだけ我慢してね」	PRINTFORML 「急いで服を見つけるからもう少しだけ我慢してね」
PRINTFORML 「ふぅ…お姉ちゃん、ちょっとだけ休んでもいい？」	PRINTFORML 「ふぅ…お姉ちゃん、ちょっとだけ休んでもいい？」
PRINTFORML 「えーとね、おばちゃ……睨まないで…怖いよぉ…」	PRINTFORML 「えーとね、おばちゃ……睨まないで…怖いよぉ…」
PRINTFORML 「半分は魔物でも…ねむ…ふぁぁああ…おやすみ…」	PRINTFORML 「半分は魔物でも…ねむ…ふぁぁああ…おやすみ…」
PRINTFORML 「んーっ…そとの世界の露天風呂、いってみたいな」	PRINTFORML 「んーっ…そとの世界の露天風呂、いってみたいな」
PRINTFORML 「んー、手も足も触手も…あ、触手はしまいます…」	PRINTFORML 「んー、手も足も触手も…あ、触手はしまいます…」
PRINTFORML 「おかあさん…おかあさんは……私の事嫌いなの？」	PRINTFORML 「おかあさん…おかあさんは……私の事嫌いなの？」
PRINTFORML 「私の事、やっぱりみんな怖がっているのかしら…」	PRINTFORML 「私の事、やっぱりみんな怖がっているのかしら…」
PRINTFORML 「どうして…どうしておかあさんがこんな目に……」	PRINTFORML 「どうして…どうしておかあさんがこんな目に……」
PRINTFORML (えーと、ガーターベルトってパンツの上？下？）	PRINTFORML (えーと、ガーターベルトってパンツの上？下？）
PRINTFORML 「ランドセル…やっぱり背負わないとだめよね？」	PRINTFORML 「ランドセル…やっぱり背負わないとだめよね？」
PRINTFORML 「変な服を着ざるを得ないよりはずっといいわね」	PRINTFORML 「変な服を着ざるを得ないよりはずっといいわね」
PRINTFORML 「ふぇえ……なんだか裸よりいやらしいかんじに」	PRINTFORML 「ふぇえ……なんだか裸よりいやらしいかんじに」
PRINTFORMDW 静葉は穣子をぎゅっと抱きしめると顔をしかめた	PRINTFORMDW 静葉は穣子をぎゅっと抱きしめると顔をしかめた
PRINTFORMW 「穣子ちゃん…臭いわよ…お風呂はいってたの？」	PRINTFORMW 「穣子ちゃん…臭いわよ…お風呂はいってたの？」
PRINTFORMW 「ねえ穣子ちゃん、後で異変解決の宴会があるの」	PRINTFORMW 「ねえ穣子ちゃん、後で異変解決の宴会があるの」
PRINTFORMDW 早く畑仕事をしたいとよく口にするようになった	PRINTFORMDW 早く畑仕事をしたいとよく口にするようになった
PRINTFORMDW 宴会の話しだとか取り留めのない話に花を咲かせ	PRINTFORMDW 宴会の話しだとか取り留めのない話に花を咲かせ
PRINTFORMDW 幻想郷は…どうなってしまっているのだろうか？	PRINTFORMDW 幻想郷は…どうなってしまっているのだろうか？
PRINTFORMW	「ごめんなさい…ごめんなさい…ごめんなさい…」	PRINTFORMW	「ごめんなさい…ごめんなさい…ごめんなさい…」
PRINTFORMDW	静葉は全身を汗でびっしょりと濡らし飛び起きた	PRINTFORMDW	静葉は全身を汗でびっしょりと濡らし飛び起きた
PRINTFORMDW 静葉は首を大きく横に振り嫌な考えを振り払った	PRINTFORMDW 静葉は首を大きく横に振り嫌な考えを振り払った
PRINTFORMDW それはこっちの台詞だと静葉に食って掛かる穣子	PRINTFORMDW それはこっちの台詞だと静葉に食って掛かる穣子
PRINTFORMDW もう少し心の整理がつくまではこのままにしよう	PRINTFORMDW もう少し心の整理がつくまではこのままにしよう
PRINTFORMW 「これからは秋をゴールデンカラーにするのよ！」	PRINTFORMW 「これからは秋をゴールデンカラーにするのよ！」
PRINTFORMDW 出産の苦しみにのた打ち回り悲鳴をあげる静葉…	PRINTFORMDW 出産の苦しみにのた打ち回り悲鳴をあげる静葉…
PRINTFORMW (目が覚めたら穣子ちゃん…帰ってくるかしら…)	PRINTFORMW (目が覚めたら穣子ちゃん…帰ってくるかしら…)
PRINTFORML 「ぜーぜー…あ、秋パワーを使うまでもないわ…」	PRINTFORML 「ぜーぜー…あ、秋パワーを使うまでもないわ…」
PRINTFORMDL 静葉はギャーギャー騒ぎながら必死に暴れている	PRINTFORMDL 静葉はギャーギャー騒ぎながら必死に暴れている
PRINTFORML 「悔しい…秋パワーがもっとあればこんな奴に…」	PRINTFORML 「悔しい…秋パワーがもっとあればこんな奴に…」
PRINTFORML 「もっと健康的なスポーツの秋にしましょ、ね？」	PRINTFORML 「もっと健康的なスポーツの秋にしましょ、ね？」
PRINTFORMDL 静葉はとろんとした笑顔で下半身を守っている。	PRINTFORMDL 静葉はとろんとした笑顔で下半身を守っている。
PRINTFORML 「穣子ちゃんのほうが食べ甲斐があるわよー！？」	PRINTFORML 「穣子ちゃんのほうが食べ甲斐があるわよー！？」
PRINTFORML 「わ、私のライバルとして…それは……卑怯……」	PRINTFORML 「わ、私のライバルとして…それは……卑怯……」
PRINTFORML 「こーら、ダメよ女の子のそんな場所さわっちゃ」	PRINTFORML 「こーら、ダメよ女の子のそんな場所さわっちゃ」
PRINTFORML 「もう…気持ちい秋のことしか考えられない……」	PRINTFORML 「もう…気持ちい秋のことしか考えられない……」
PRINTFORML 「はぁ……秋じゃなかったら逃げれたかどうか…」	PRINTFORML 「はぁ……秋じゃなかったら逃げれたかどうか…」
PRINTFORML (秋パワーがチャージされるまでは大人しく……)	PRINTFORML (秋パワーがチャージされるまでは大人しく……)
PRINTFORML 「秋といえどもそれはさすがにいただけないわ！」	PRINTFORML 「秋といえどもそれはさすがにいただけないわ！」
PRINTFORML 「なーんか私に冷たすぎるんじゃないかしらー？」	PRINTFORML 「なーんか私に冷たすぎるんじゃないかしらー？」
PRINTFORML 「つらいわー、力がありすぎるのも考えすぎねえ」	PRINTFORML 「つらいわー、力がありすぎるのも考えすぎねえ」
PRINTFORMDL 静葉は泣きながらも必死に這い出そうともがいた	PRINTFORMDL 静葉は泣きながらも必死に這い出そうともがいた
PRINTFORMDL 吐き出された静葉は悲鳴を上げながら逃げ出した	PRINTFORMDL 吐き出された静葉は悲鳴を上げながら逃げ出した
PRINTFORMDL 静葉は怯えた瞳で迫る巨大な口を見つめている…	PRINTFORMDL 静葉は怯えた瞳で迫る巨大な口を見つめている…
PRINTFORML 「お腹が…こんなに……どうして………こんな…」	PRINTFORML 「お腹が…こんなに……どうして………こんな…」
PRINTFORML (ううん、きっと助けを呼びに行ったのよね……）	PRINTFORML (ううん、きっと助けを呼びに行ったのよね……）
PRINTFORMDL (助けられたら……置いていくわけないわ……)	PRINTFORMDL (助けられたら……置いていくわけないわ……)
PRINTFORMDL 最近、穣子を見かけた気がすると教えてもらえた	PRINTFORMDL 最近、穣子を見かけた気がすると教えてもらえた
PRINTFORML 「戦闘は苦手だけど……お裁縫なら力になれるわ」	PRINTFORML 「戦闘は苦手だけど……お裁縫なら力になれるわ」
PRINTFORML 「交代ね、おかげさまでちょっとすっきりしたわ」	PRINTFORML 「交代ね、おかげさまでちょっとすっきりしたわ」
PRINTFORML 「ありがとう。体調が悪くて…とても助かります」	PRINTFORML 「ありがとう。体調が悪くて…とても助かります」
PRINTFORML 「心まで汚されたくないのに…ぁ…いやぁあ！？」	PRINTFORML 「心まで汚されたくないのに…ぁ…いやぁあ！？」
PRINTFORML 「こわれちゃう…こわれ…ぁあっいやあぁああ！」	PRINTFORML 「こわれちゃう…こわれ…ぁあっいやあぁああ！」
PRINTFORML 「静けさを司っているけど…こういうことは……」	PRINTFORML 「静けさを司っているけど…こういうことは……」
PRINTFORML 「こういうときに限って罠にひっかかるのよね…」	PRINTFORML 「こういうときに限って罠にひっかかるのよね…」
PRINTFORML 「やめて……ここ以外には何してもいいから……」	PRINTFORML 「やめて……ここ以外には何してもいいから……」
PRINTFORMDL 静葉は静かに、だが強い調子でそう言い残した。	PRINTFORMDL 静葉は静かに、だが強い調子でそう言い残した。
PRINTFORML (穣子ちゃんのおなか…あんなになっちゃって…)	PRINTFORML (穣子ちゃんのおなか…あんなになっちゃって…)
PRINTFORML 「じょ、冗談でしょう！？やめて！やめてええ！」	PRINTFORML 「じょ、冗談でしょう！？やめて！やめてええ！」
PRINTFORML 「はぁ…はぁ……許さない…絶対に許しません…」	PRINTFORML 「はぁ…はぁ……許さない…絶対に許しません…」
PRINTFORML 「か、神様の娘を食べようっていうのですか！？」	PRINTFORML 「か、神様の娘を食べようっていうのですか！？」
PRINTFORML 「穣子おばちゃん…な、なんで怖い顔するのぉ…」	PRINTFORML 「穣子おばちゃん…な、なんで怖い顔するのぉ…」
PRINTFORML 「よかった……ちょっとだけこわかったんだ……」	PRINTFORML 「よかった……ちょっとだけこわかったんだ……」
PRINTFORML 「裸のほうが……うう、どっちがマシかしら…」	PRINTFORML 「裸のほうが……うう、どっちがマシかしら…」
PRINTFORML 「今のままのほうがマシじゃないかしら…！？」	PRINTFORML 「今のままのほうがマシじゃないかしら…！？」
PRINTFORML 「これは早苗さんが外の世界で着ていた服よね」	PRINTFORML 「これは早苗さんが外の世界で着ていた服よね」
PRINTFORML 「あああ…よりによってこんなとこに穴が……」	PRINTFORML 「あああ…よりによってこんなとこに穴が……」
PRINTFORMDW 最近、眠っている時間がどんどん増えている…	PRINTFORMDW 最近、眠っている時間がどんどん増えている…
PRINTFORMDW とにかくもう一度迷宮へ入って確かめないと…	PRINTFORMDW とにかくもう一度迷宮へ入って確かめないと…
PRINTFORMW 「穣子ちゃん！？一体今までどこにいたの！？」	PRINTFORMW 「穣子ちゃん！？一体今までどこにいたの！？」
PRINTFORMDW 本当はお墓を作ってあげるべきなのだろうか？	PRINTFORMDW 本当はお墓を作ってあげるべきなのだろうか？
PRINTFORMDW 静葉となぜか穣子までオシオキされ幕をとじた	PRINTFORMDW 静葉となぜか穣子までオシオキされ幕をとじた
PRINTFORMW (神は創造するもの。摂理など作り直せばいい)	PRINTFORMW (神は創造するもの。摂理など作り直せばいい)
PRINTFORML 「しかしっ！神はそう簡単に食べられないわ！」	PRINTFORML 「しかしっ！神はそう簡単に食べられないわ！」
PRINTFORML 「もっと…もっと秋が深ければこんな奴らに…」	PRINTFORML 「もっと…もっと秋が深ければこんな奴らに…」
PRINTFORML 「若いっていいわね、でもおあずけよ、ふふっ」	PRINTFORML 「若いっていいわね、でもおあずけよ、ふふっ」
PRINTFORML 「アイアムウィナアアアアアアアアアアア！！」	PRINTFORML 「アイアムウィナアアアアアアアアアアア！！」
PRINTFORML 「うそうそうそ！無理無理無理！見ないで！！」	PRINTFORML 「うそうそうそ！無理無理無理！見ないで！！」
PRINTFORMDW 言いたいことだけ言って静葉は再び力尽きた…	PRINTFORMDW 言いたいことだけ言って静葉は再び力尽きた…
PRINTFORML 「秋には犠牲がつき物なの…うらまないでね！」	PRINTFORML 「秋には犠牲がつき物なの…うらまないでね！」
PRINTFORML 「ちょっとーー！私がまだ捕まってるわよー？」	PRINTFORML 「ちょっとーー！私がまだ捕まってるわよー？」
PRINTFORML 「私の秋パワーを必要としているのはだれ！？」	PRINTFORML 「私の秋パワーを必要としているのはだれ！？」
PRINTFORML 「秋オーラで気づかれたらどうしようかしら…」	PRINTFORML 「秋オーラで気づかれたらどうしようかしら…」
PRINTFORML 「そこはさすがにお姉ちゃんも勘弁願いたいわ」	PRINTFORML 「そこはさすがにお姉ちゃんも勘弁願いたいわ」
PRINTFORMDW 静葉は下腹部の圧迫感に思わず涙を滲ませた…	PRINTFORMDW 静葉は下腹部の圧迫感に思わず涙を滲ませた…
PRINTFORMDL 静葉はふらつく足取りで必死に逃げ出した……	PRINTFORMDL 静葉はふらつく足取りで必死に逃げ出した……
PRINTFORML 「秋なのに体調不良なんて…急性秋中毒かしら」	PRINTFORML 「秋なのに体調不良なんて…急性秋中毒かしら」
PRINTFORML (できるだけ…できるだけ目立たないように…)	PRINTFORML (できるだけ…できるだけ目立たないように…)
PRINTFORML 「いやっ……こんな時に追いかけてこないで！」	PRINTFORML 「いやっ……こんな時に追いかけてこないで！」
PRINTFORML 「震えてる場合じゃないわ……頑張らないと…」	PRINTFORML 「震えてる場合じゃないわ……頑張らないと…」
PRINTFORML 「ま、まだ初めてなんです…だからお願い……」	PRINTFORML 「ま、まだ初めてなんです…だからお願い……」
PRINTFORMDL 静葉はブンブンと首を横に必死に振っている。	PRINTFORMDL 静葉はブンブンと首を横に必死に振っている。
PRINTFORML (……よかった。穣子ちゃんは逃げられたのね)	PRINTFORML (……よかった。穣子ちゃんは逃げられたのね)
PRINTFORML 「早めに破れたところを直しておかなくちゃ…」	PRINTFORML 「早めに破れたところを直しておかなくちゃ…」
PRINTFORML （よかった…帽子を落としただけだったのね…）	PRINTFORML （よかった…帽子を落としただけだったのね…）
PRINTFORML 「穣子ちゃん、二手に分かれて行動しましょう。	PRINTFORML 「穣子ちゃん、二手に分かれて行動しましょう。
PRINTFORML 「こんな場所でも…寝れそうなくらい眠いわ…」	PRINTFORML 「こんな場所でも…寝れそうなくらい眠いわ…」
PRINTFORML 「でもね、できれば二人で一緒に外に出たい…」	PRINTFORML 「でもね、できれば二人で一緒に外に出たい…」
PRINTFORML 「はぁ…もうどのくらいここにいるのかしら…」	PRINTFORML 「はぁ…もうどのくらいここにいるのかしら…」
PRINTFORML 「…穣子ちゃん！？…そうよね、気のせいよね」	PRINTFORML 「…穣子ちゃん！？…そうよね、気のせいよね」
PRINTFORML 「穣子ちゃん、今どこで何をしてるのかしら…」	PRINTFORML 「穣子ちゃん、今どこで何をしてるのかしら…」
PRINTFORML 「ごめんね…ごめんね……ごめん…なさい……」	PRINTFORML 「ごめんね…ごめんね……ごめん…なさい……」
PRINTFORMDL 静葉は大声を上げて子供のように泣き続けた…	PRINTFORMDL 静葉は大声を上げて子供のように泣き続けた…
PRINTFORML 「だから服は…こんな場所で脱がされたら…！」	PRINTFORML 「だから服は…こんな場所で脱がされたら…！」
PRINTFORML 「おかあさんたすけて！ねえ！たすけてよぉ！」	PRINTFORML 「おかあさんたすけて！ねえ！たすけてよぉ！」
PRINTFORMW 「おかあさんが塗った紅葉…見たかった…な…」	PRINTFORMW 「おかあさんが塗った紅葉…見たかった…な…」
PRINTFORML 「一体みんなはここに来て何日目なのかしら？」	PRINTFORML 「一体みんなはここに来て何日目なのかしら？」
PRINTFORML 「まるで私の為に作られたみたいにピッタリ」	PRINTFORML 「まるで私の為に作られたみたいにピッタリ」
PRINTFORML (こんな派手な下着はいて動き回るなんて…)	PRINTFORML (こんな派手な下着はいて動き回るなんて…)
PRINTFORML 「サイズぴったり…着ろってことよねこれ…」	PRINTFORML 「サイズぴったり…着ろってことよねこれ…」
PRINTFORMW 「もう大丈夫。神隠しは二度と起こらないわ」	PRINTFORMW 「もう大丈夫。神隠しは二度と起こらないわ」
PRINTFORMW 「お姉ちゃん…穣子ちゃんを探してんだよ？」	PRINTFORMW 「お姉ちゃん…穣子ちゃんを探してんだよ？」
PRINTFORMDW どれだけの娘が巣立って行ったのだろうか？	PRINTFORMDW どれだけの娘が巣立って行ったのだろうか？
PRINTFORMDW 目が覚めたら穣子の笑顔をもう一度みたい…	PRINTFORMDW 目が覚めたら穣子の笑顔をもう一度みたい…
PRINTFORMDW	まだ丑三つ時、朝にはまだまだ時間がある…	PRINTFORMDW	まだ丑三つ時、朝にはまだまだ時間がある…
PRINTFORMDW	静葉は一人きりで冬支度を始めるのであった	PRINTFORMDW	静葉は一人きりで冬支度を始めるのであった
PRINTFORMW 「ねえ、今日は久しぶりに一緒に寝ましょ♪」	PRINTFORMW 「ねえ、今日は久しぶりに一緒に寝ましょ♪」
PRINTFORMDW それらのことをトゲトゲしい口調で説明した	PRINTFORMDW それらのことをトゲトゲしい口調で説明した
PRINTFORMDW そして、静葉が無事で嬉しいことを口にした	PRINTFORMDW そして、静葉が無事で嬉しいことを口にした
PRINTFORMW 「すごいわ穣子ちゃん！この完璧な彩☆色！」	PRINTFORMW 「すごいわ穣子ちゃん！この完璧な彩☆色！」
PRINTFORMDW 『へー、すごいねお姉ちゃん趣味最悪だね』	PRINTFORMDW 『へー、すごいねお姉ちゃん趣味最悪だね』
PRINTFORMDW 静葉が力尽きていった仲間達にできること…	PRINTFORMDW 静葉が力尽きていった仲間達にできること…
PRINTFORMDW 静葉は痛みに耐えそれだけをなんとか叫んだ	PRINTFORMDW 静葉は痛みに耐えそれだけをなんとか叫んだ
PRINTFORMDW 『だからおかあさん、そんなに怯えないで』	PRINTFORMDW 『だからおかあさん、そんなに怯えないで』
PRINTFORMDW 静葉の中で悪魔と天使が硬い握手を交わした	PRINTFORMDW 静葉の中で悪魔と天使が硬い握手を交わした
PRINTFORMW 「この迷宮を秋の『朱』に沈めることよッ！」	PRINTFORMW 「この迷宮を秋の『朱』に沈めることよッ！」
PRINTFORML 「ふふふ…秋とは耐えることにあるのよっ！」	PRINTFORML 「ふふふ…秋とは耐えることにあるのよっ！」
PRINTFORML 「パーフェクトッ！ゴッドツゥゥゥゥゥル！」	PRINTFORML 「パーフェクトッ！ゴッドツゥゥゥゥゥル！」
PRINTFORML 「次に会うときが貴方が秋色に染まる時よ！」	PRINTFORML 「次に会うときが貴方が秋色に染まる時よ！」
PRINTFORML 「喰らいなさい！静葉最強の弾幕秋キック！」	PRINTFORML 「喰らいなさい！静葉最強の弾幕秋キック！」
PRINTFORMDL 卑劣なヤクザキックを連続で叩き込まれる！	PRINTFORMDL 卑劣なヤクザキックを連続で叩き込まれる！
PRINTFORML 「げほっげほっ、秋リバースしかけたわ……」	PRINTFORML 「げほっげほっ、秋リバースしかけたわ……」
PRINTFORML 「ちょっ…ゴムゴム！！話きいってぇえ！！」	PRINTFORML 「ちょっ…ゴムゴム！！話きいってぇえ！！」
PRINTFORML 「秋の私の戦闘力は妖精をも凌駕するのよ！」	PRINTFORML 「秋の私の戦闘力は妖精をも凌駕するのよ！」
PRINTFORML 「次からは相手を見てケンカを売ることね！」	PRINTFORML 「次からは相手を見てケンカを売ることね！」
PRINTFORML 「さあ私の秋パワーに震え上がるがいいわ！」	PRINTFORML 「さあ私の秋パワーに震え上がるがいいわ！」
PRINTFORML 「秋の108の殺人技が一つ！秋待ち伏せ！」	PRINTFORML 「秋の108の殺人技が一つ！秋待ち伏せ！」
PRINTFORMDL 静葉は濁った瞳でふらふらと立ち上がった…	PRINTFORMDL 静葉は濁った瞳でふらふらと立ち上がった…
PRINTFORML 「……奴らは神をも越えているというの！？」	PRINTFORML 「……奴らは神をも越えているというの！？」
PRINTFORML 「も、もう脱がすものなんてないですよぉ…」	PRINTFORML 「も、もう脱がすものなんてないですよぉ…」
PRINTFORMDL 静葉は怯えながら弱々しい弾幕を放っている	PRINTFORMDL 静葉は怯えながら弱々しい弾幕を放っている
PRINTFORML 「出して…出して……ひっく…出してぇ……」	PRINTFORML 「出して…出して……ひっく…出してぇ……」
PRINTFORML (だめ…頭…ボーっとして……力…抜け……)	PRINTFORML (だめ…頭…ボーっとして……力…抜け……)
PRINTFORML (え……離して……くれた……？どうして…)	PRINTFORML (え……離して……くれた……？どうして…)
PRINTFORML 「か、神様を食べようっていうのですか！？」	PRINTFORML 「か、神様を食べようっていうのですか！？」
PRINTFORML 「やめて！それだけは！いやあああああ！！」	PRINTFORML 「やめて！それだけは！いやあああああ！！」
PRINTFORMDL 静葉は呆然と自分の下腹部を見つめている…	PRINTFORMDL 静葉は呆然と自分の下腹部を見つめている…
PRINTFORML 「うそ……何か産み付けられちゃったの…？」	PRINTFORML 「うそ……何か産み付けられちゃったの…？」
PRINTFORMDL まさか穣子も捕まってしまったのだろうか？	PRINTFORMDL まさか穣子も捕まってしまったのだろうか？
PRINTFORML (でも…私はきっともう助からないわね……)	PRINTFORML (でも…私はきっともう助からないわね……)
PRINTFORML (やっぱり穣子ちゃんも攫われていたのね…)	PRINTFORML (やっぱり穣子ちゃんも攫われていたのね…)
PRINTFORML 「ふふっ…お話ってこんなに楽しかったのね」	PRINTFORML 「ふふっ…お話ってこんなに楽しかったのね」
PRINTFORML 「少し趣向をこらして紅葉を浮かべてみたの」	PRINTFORML 「少し趣向をこらして紅葉を浮かべてみたの」
PRINTFORMDL 静葉は申し訳なさそうな表情で佇んでいる。	PRINTFORMDL 静葉は申し訳なさそうな表情で佇んでいる。
PRINTFORML 「少しずつこの環境に慣れてる自分が怖いわ」	PRINTFORML 「少しずつこの環境に慣れてる自分が怖いわ」
PRINTFORML 「何でもいいから体を隠せるものが欲しい…」	PRINTFORML 「何でもいいから体を隠せるものが欲しい…」
PRINTFORML 「もうこんなにボロボロ…着替えようかしら」	PRINTFORML 「もうこんなにボロボロ…着替えようかしら」
PRINTFORML 「･･･この匂い、私の体からしているの？」	PRINTFORML 「･･･この匂い、私の体からしているの？」
PRINTFORML (着替えセット…穣子ちゃんに使わなくちゃ)	PRINTFORML (着替えセット…穣子ちゃんに使わなくちゃ)
PRINTFORML 「お姉ちゃんの服使う？サイズ…あわないか」	PRINTFORML 「お姉ちゃんの服使う？サイズ…あわないか」
PRINTFORML 「私…これから一人でどうすればいいの…？」	PRINTFORML 「私…これから一人でどうすればいいの…？」
PRINTFORML 「やっと…やっと遭えたのにこんなのって…」	PRINTFORML 「やっと…やっと遭えたのにこんなのって…」
PRINTFORML 「穣子…ちゃんのこと……助けられたのに…」	PRINTFORML 「穣子…ちゃんのこと……助けられたのに…」
PRINTFORML 「何をする気ですか！？神に対し…て…え？」	PRINTFORML 「何をする気ですか！？神に対し…て…え？」
PRINTFORML 「このっ…いい加減にっ……してください！」	PRINTFORML 「このっ…いい加減にっ……してください！」
PRINTFORML 「まって！？抵抗したことは謝りますっ…！」	PRINTFORML 「まって！？抵抗したことは謝りますっ…！」
PRINTFORML 「あんまり弾幕ごっこは得意じゃないけど…」	PRINTFORML 「あんまり弾幕ごっこは得意じゃないけど…」
PRINTFORML 「おかあさん…きっと私が助けてあげる…！」	PRINTFORML 「おかあさん…きっと私が助けてあげる…！」
PRINTFORML 「ひとりよりみんなでいるほうが安心だよね」	PRINTFORML 「ひとりよりみんなでいるほうが安心だよね」
PRINTFORML 「お互いに外に出られるように頑張りましょ」	PRINTFORML 「お互いに外に出られるように頑張りましょ」
PRINTFORMDL 着替えセットの中身は静葉の普段着だった	PRINTFORMDL 着替えセットの中身は静葉の普段着だった
PRINTFORML 「く…うぐぐ…むりやり着ればなんとか…」	PRINTFORML 「く…うぐぐ…むりやり着ればなんとか…」
PRINTFORML 「きゃああ！？何か隠すもの…服をっ…！」	PRINTFORML 「きゃああ！？何か隠すもの…服をっ…！」
PRINTFORML 「ただでさえそんなに隠せてないのに……」	PRINTFORML 「ただでさえそんなに隠せてないのに……」
PRINTFORML 「も、もうこんなにぼろぼろなの！？……」	PRINTFORML 「も、もうこんなにぼろぼろなの！？……」
PRINTFORMDW そして静葉自身も自分の腕を鼻に近づけた	PRINTFORMDW そして静葉自身も自分の腕を鼻に近づけた
PRINTFORMDW	静葉は悪夢にうなされる事がとても増えた	PRINTFORMDW	静葉は悪夢にうなされる事がとても増えた
PRINTFORMDW	迷宮があった場所に静葉は今日も足を運ぶ	PRINTFORMDW	迷宮があった場所に静葉は今日も足を運ぶ
PRINTFORMW 「穣子ちゃん！ずっとどこ行ってたの！？」	PRINTFORMW 「穣子ちゃん！ずっとどこ行ってたの！？」
PRINTFORMDW そして笑顔が加虐的なものへと変貌してた	PRINTFORMDW そして笑顔が加虐的なものへと変貌してた
PRINTFORMDW 未だに静葉は穣子と連絡を取れずにいた…	PRINTFORMDW 未だに静葉は穣子と連絡を取れずにいた…
PRINTFORMW 「忌まわしい…本当に忌まわしい異変ね…」	PRINTFORMW 「忌まわしい…本当に忌まわしい異変ね…」
PRINTFORMDL 静葉は両手を広げて攻撃に備えて？いる？	PRINTFORMDL 静葉は両手を広げて攻撃に備えて？いる？
PRINTFORML 「だから追いかけてくるんじゃないわよ！」	PRINTFORML 「だから追いかけてくるんじゃないわよ！」
PRINTFORML 「くそっ！秋の力が足りないというの！？」	PRINTFORML 「くそっ！秋の力が足りないというの！？」
PRINTFORML 「戦略的撤退よ！逃げるわけじゃないわ！」	PRINTFORML 「戦略的撤退よ！逃げるわけじゃないわ！」
PRINTFORMDL 弾丸のような飛び膝蹴りが繰り出される！	PRINTFORMDL 弾丸のような飛び膝蹴りが繰り出される！
PRINTFORML 「ぜーぜー…私の心が…狂いの落ち葉……」	PRINTFORML 「ぜーぜー…私の心が…狂いの落ち葉……」
PRINTFORML 「これがルナティックを制する弾幕よっ！」	PRINTFORML 「これがルナティックを制する弾幕よっ！」
PRINTFORML 「秋縄抜けを披露するときがきたようね…」	PRINTFORML 「秋縄抜けを披露するときがきたようね…」
PRINTFORML 「ごふっ…死体に鞭打つような…ことを…」	PRINTFORML 「ごふっ…死体に鞭打つような…ことを…」
PRINTFORML 「こここここ…これでこそ私のライバル…」	PRINTFORML 「こここここ…これでこそ私のライバル…」
PRINTFORML 「ちょ…やめっ…おま……話っ…きいて…」	PRINTFORML 「ちょ…やめっ…おま……話っ…きいて…」
PRINTFORML 「あら、毛玉にぶつかったかとおもったわ」	PRINTFORML 「あら、毛玉にぶつかったかとおもったわ」
PRINTFORML 「ライバルの手で…最後を迎えるのも……」	PRINTFORML 「ライバルの手で…最後を迎えるのも……」
PRINTFORML 「ふふっ…いかされちゃうかと思ったわ…」	PRINTFORML 「ふふっ…いかされちゃうかと思ったわ…」
PRINTFORML 「ひゃっ…急に触られたらおどろいちゃう」	PRINTFORML 「ひゃっ…急に触られたらおどろいちゃう」
PRINTFORML 「あぁぁぁ！？秋が深まっちゃうのぉお！」	PRINTFORML 「あぁぁぁ！？秋が深まっちゃうのぉお！」
PRINTFORML 「もっと気持ちよくしていいのよ、うふふ」	PRINTFORML 「もっと気持ちよくしていいのよ、うふふ」
PRINTFORML (……秋じゃなかったらやられていたわね)	PRINTFORML (……秋じゃなかったらやられていたわね)
PRINTFORML 「秋スカートの紅葉が全部ちっちゃうっ！」	PRINTFORML 「秋スカートの紅葉が全部ちっちゃうっ！」
PRINTFORML 「秋ダッシュがなければ死んでいたわね…」	PRINTFORML 「秋ダッシュがなければ死んでいたわね…」
PRINTFORML 「まさか私を囮にして逃げようなーんて…」	PRINTFORML 「まさか私を囮にして逃げようなーんて…」
PRINTFORML 「むぐーー！もがもがむぐぐぐぐぐー！！」	PRINTFORML 「むぐーー！もがもがむぐぐぐぐぐー！！」
PRINTFORMDL 誰かの弱々しい息遣いが聞えた気がした。	PRINTFORMDL 誰かの弱々しい息遣いが聞えた気がした。
PRINTFORML 「秋だからって調子に乗りすぎた報いね…」	PRINTFORML 「秋だからって調子に乗りすぎた報いね…」
PRINTFORML 「紅葉を塗りたい…？ああ！禁断症状が！」	PRINTFORML 「紅葉を塗りたい…？ああ！禁断症状が！」
PRINTFORML 「秋…それは時に美しく時に神を狂わせる」	PRINTFORML 「秋…それは時に美しく時に神を狂わせる」
PRINTFORML 「…そろそろ出て行ってくれないかしら？」	PRINTFORML 「…そろそろ出て行ってくれないかしら？」
PRINTFORML 「妊娠の秋なんてきいたことないわよー！」	PRINTFORML 「妊娠の秋なんてきいたことないわよー！」
PRINTFORML 「入ったときより強くなってる気がする！」	PRINTFORML 「入ったときより強くなってる気がする！」
PRINTFORML 「どうして倒れてくれないの……ぐすっ…」	PRINTFORML 「どうして倒れてくれないの……ぐすっ…」
PRINTFORML 「あまり弾幕ごっこは得意じゃないけど…」	PRINTFORML 「あまり弾幕ごっこは得意じゃないけど…」
PRINTFORMDL 静葉は生気のない目で言葉を失っている…	PRINTFORMDL 静葉は生気のない目で言葉を失っている…
PRINTFORML 「やめっ……そんなとこに……きゃぁ！？」	PRINTFORML 「やめっ……そんなとこに……きゃぁ！？」
PRINTFORML 「いやっ！ヘンなとこ触ろうとしないで！」	PRINTFORML 「いやっ！ヘンなとこ触ろうとしないで！」
PRINTFORMDL 静葉は泣きながら全身を痙攣させている…	PRINTFORMDL 静葉は泣きながら全身を痙攣させている…
PRINTFORML 「あ……あぁ…私…食べられちゃったの？」	PRINTFORML 「あ……あぁ…私…食べられちゃったの？」
PRINTFORML 「穣子ちゃん…よかった、無事だったのね」	PRINTFORML 「穣子ちゃん…よかった、無事だったのね」
PRINTFORMDL それでも精一杯の笑顔で穣子を見送った…	PRINTFORMDL それでも精一杯の笑顔で穣子を見送った…
PRINTFORML 「服の穴、直してあげる。ほら、見せてね」	PRINTFORML 「服の穴、直してあげる。ほら、見せてね」
PRINTFORML 「恥ずかしい……新しい服はないの……？」	PRINTFORML 「恥ずかしい……新しい服はないの……？」
PRINTFORML (んー…声をかけたら邪魔しちゃうかな？)	PRINTFORML (んー…声をかけたら邪魔しちゃうかな？)
PRINTFORML 「あの…穣子ちゃんを見ませんでしたか？」	PRINTFORML 「あの…穣子ちゃんを見ませんでしたか？」
PRINTFORMDL しかし…この胸騒ぎは何なのだろうか…？	PRINTFORMDL しかし…この胸騒ぎは何なのだろうか…？
PRINTFORML 「そんな…！？教えてくれてありがとう！」	PRINTFORML 「そんな…！？教えてくれてありがとう！」
PRINTFORML 「よかった……一人だと心細かったの……」	PRINTFORML 「よかった……一人だと心細かったの……」
PRINTFORML 「戦闘はお願いしちゃってもいいかしら？」	PRINTFORML 「戦闘はお願いしちゃってもいいかしら？」
PRINTFORML 「心配しないで、お姉ちゃんは大丈夫よ。」	PRINTFORML 「心配しないで、お姉ちゃんは大丈夫よ。」
PRINTFORML 「…生暖かいのに横になるとちょっと寒い」	PRINTFORML 「…生暖かいのに横になるとちょっと寒い」
PRINTFORML 「……面倒な仕事押し付けてごめんなさい」	PRINTFORML 「……面倒な仕事押し付けてごめんなさい」
PRINTFORML 「もうすぐなのね……私…どうしたら……」	PRINTFORML 「もうすぐなのね……私…どうしたら……」
PRINTFORMDL 静葉は深刻な表情で部屋を探索している。	PRINTFORMDL 静葉は深刻な表情で部屋を探索している。
PRINTFORMW 「あなただけでも……無事に…逃……げ…」	PRINTFORMW 「あなただけでも……無事に…逃……げ…」
PRINTFORML 「ふぅ……なんだか元気になる気がするわ」	PRINTFORML 「ふぅ……なんだか元気になる気がするわ」
PRINTFORML 「家に泥棒とかはいってないといいけど…」	PRINTFORML 「家に泥棒とかはいってないといいけど…」
PRINTFORML 「一体今はここに来て何日目なのかしら？」	PRINTFORML 「一体今はここに来て何日目なのかしら？」
PRINTFORML 「頑張って直せばまだ大丈夫そうだけど…」	PRINTFORML 「頑張って直せばまだ大丈夫そうだけど…」
PRINTFORML 「きゃっ！？…いつのまに汚れたのかしら」	PRINTFORML 「きゃっ！？…いつのまに汚れたのかしら」
PRINTFORML 「穣子ちゃん、もう少しの辛抱だからね…」	PRINTFORML 「穣子ちゃん、もう少しの辛抱だからね…」
PRINTFORML (どうして私じゃなくて穣子ちゃんなの…)	PRINTFORML (どうして私じゃなくて穣子ちゃんなの…)
PRINTFORML 「せめて身を隠せる場所だけでもあれば…」	PRINTFORML 「せめて身を隠せる場所だけでもあれば…」
PRINTFORMW 「どう…したの？なんだか…怖いわよ…？」	PRINTFORMW 「どう…したの？なんだか…怖いわよ…？」
PRINTFORML 「ねえ…冗談よね？いや！やめて……ッ！」	PRINTFORML 「ねえ…冗談よね？いや！やめて……ッ！」
PRINTFORML 「こうみえても私、神様の娘なんですよ！」	PRINTFORML 「こうみえても私、神様の娘なんですよ！」
PRINTFORML 「せめて…早く…楽にして……ください…」	PRINTFORML 「せめて…早く…楽にして……ください…」
PRINTFORML 「ねえねえ！おそとのおはなしきかせて！」	PRINTFORML 「ねえねえ！おそとのおはなしきかせて！」
PRINTFORML 「体のラインが出ちゃって恥ずかしい…」	PRINTFORML 「体のラインが出ちゃって恥ずかしい…」
PRINTFORML 「あちこちブカブカで落ち着かないわ…」	PRINTFORML 「あちこちブカブカで落ち着かないわ…」
PRINTFORML 「この際、服の種類には目を瞑りましょ」	PRINTFORML 「この際、服の種類には目を瞑りましょ」
PRINTFORML 「ふふふ、嫌いじゃないわ。こういう服」	PRINTFORML 「ふふふ、嫌いじゃないわ。こういう服」
PRINTFORML 「やっと服を着れるのにこんなのって…」	PRINTFORML 「やっと服を着れるのにこんなのって…」
PRINTFORMDL 着替えセットの中身はセーラー服だった	PRINTFORMDL 着替えセットの中身はセーラー服だった
PRINTFORML 「もう裸とかわらないじゃないのよお…」	PRINTFORML 「もう裸とかわらないじゃないのよお…」
PRINTFORMDW 静葉は汚れてしまった服から着替える為	PRINTFORMDW 静葉は汚れてしまった服から着替える為
PRINTFORMW 「だから…ね、とりあえず服を着させて」	PRINTFORMW 「だから…ね、とりあえず服を着させて」
PRINTFORMDW 静葉はそちらを向き大きな悲鳴をあげた	PRINTFORMDW 静葉はそちらを向き大きな悲鳴をあげた
PRINTFORMW 「穣子ちゃんが寂しくないように、ね？」	PRINTFORMW 「穣子ちゃんが寂しくないように、ね？」
PRINTFORMDW 静葉もすっかり一人の生活に慣れだした	PRINTFORMDW 静葉もすっかり一人の生活に慣れだした
PRINTFORMDW 玄関が不意に開かれ静葉はびくりとする	PRINTFORMDW 玄関が不意に開かれ静葉はびくりとする
PRINTFORMW 「あら、穂子ちゃん、綺麗に塗れたわね」	PRINTFORMW 「あら、穂子ちゃん、綺麗に塗れたわね」
PRINTFORMDW 静葉の中の良心が冷静な言葉を送った。	PRINTFORMDW 静葉の中の良心が冷静な言葉を送った。
PRINTFORMDW 自分ひとりの足で穣子を探すのは難しい	PRINTFORMDW 自分ひとりの足で穣子を探すのは難しい
PRINTFORML 「えっちぃ、ダメだってばぁ♪…zzz」	PRINTFORML 「えっちぃ、ダメだってばぁ♪…zzz」
PRINTFORML 「あなたは性欲の秋…なのね…すぅ……」	PRINTFORML 「あなたは性欲の秋…なのね…すぅ……」
PRINTFORML 「ふふふっ、どうやら私の出番のようね」	PRINTFORML 「ふふふっ、どうやら私の出番のようね」
PRINTFORMDL へろへろとした回し蹴りが放たれた……	PRINTFORMDL へろへろとした回し蹴りが放たれた……
PRINTFORMDL 恥じらいを捨てた見事なかかと落しだ！	PRINTFORMDL 恥じらいを捨てた見事なかかと落しだ！
PRINTFORML 「くるうぅぅういのっ！落ち葉ぁあ！！」	PRINTFORML 「くるうぅぅういのっ！落ち葉ぁあ！！」
PRINTFORML 「秋パワー集めるのきもちいいのおお！」	PRINTFORML 「秋パワー集めるのきもちいいのおお！」
PRINTFORML 「秋パワーのフラッシュバックがっ！？」	PRINTFORML 「秋パワーのフラッシュバックがっ！？」
PRINTFORMDL 静葉は胸を守ろうと必死に身をよじった	PRINTFORMDL 静葉は胸を守ろうと必死に身をよじった
PRINTFORML 「げほっ…私が何をしたって言うの……」	PRINTFORML 「げほっ…私が何をしたって言うの……」
PRINTFORML 「ぜーぜー…なんとかなったみたいね…」	PRINTFORML 「ぜーぜー…なんとかなったみたいね…」
PRINTFORML 「きゃっ、秋下着まで痛んできてる！？」	PRINTFORML 「きゃっ、秋下着まで痛んできてる！？」
PRINTFORML (ああ、もっと叫びながら移動したい…)	PRINTFORML (ああ、もっと叫びながら移動したい…)
PRINTFORML 「秋じゃなかったらヤられていたかも…」	PRINTFORML 「秋じゃなかったらヤられていたかも…」
PRINTFORML 「はぁぁ…やっぱり秋は秋風呂に限るわ」	PRINTFORML 「はぁぁ…やっぱり秋は秋風呂に限るわ」
PRINTFORML 「ちゃ、チャンス！はやくにげないと…」	PRINTFORML 「ちゃ、チャンス！はやくにげないと…」
PRINTFORMDL 静葉は口を何度もパクパクさせている…	PRINTFORMDL 静葉は口を何度もパクパクさせている…
PRINTFORML 「私が…ここまで追い詰められるとは…」	PRINTFORML 「私が…ここまで追い詰められるとは…」
PRINTFORML 「視線を感じるわ…人気者はつらいわね」	PRINTFORML 「視線を感じるわ…人気者はつらいわね」
PRINTFORML 「替えの服がないわ…秋だというのに！」	PRINTFORML 「替えの服がないわ…秋だというのに！」
PRINTFORML 「あ、あの…手があたって……むにゃ…」	PRINTFORML 「あ、あの…手があたって……むにゃ…」
PRINTFORML (いやッ……こんな状態で触られたら…)	PRINTFORML (いやッ……こんな状態で触られたら…)
PRINTFORMDL 静葉は肩を抱き震えて座り込んでいる…	PRINTFORMDL 静葉は肩を抱き震えて座り込んでいる…
PRINTFORML 「食べていいものじゃないんですから！」	PRINTFORML 「食べていいものじゃないんですから！」
PRINTFORML 「出してってばぁ！お願い……出して…」	PRINTFORML 「出してってばぁ！お願い……出して…」
PRINTFORML (力に差があっても隙をつけばきっと…)	PRINTFORML (力に差があっても隙をつけばきっと…)
PRINTFORML 「私だって……必死になればきっと……」	PRINTFORML 「私だって……必死になればきっと……」
PRINTFORML 「それだけは…それだけはやめてっ…！」	PRINTFORML 「それだけは…それだけはやめてっ…！」
PRINTFORML 「ナカに…入ってないのに…そんな……」	PRINTFORML 「ナカに…入ってないのに…そんな……」
PRINTFORML 「やだっ！気持ち悪いっ！卵やだぁあ！」	PRINTFORML 「やだっ！気持ち悪いっ！卵やだぁあ！」
PRINTFORML 「赤ちゃんやだぁ！もう出さないでぇ！」	PRINTFORML 「赤ちゃんやだぁ！もう出さないでぇ！」
PRINTFORML 「おねがいっ…抜いてっ…抜いてぇえ！」	PRINTFORML 「おねがいっ…抜いてっ…抜いてぇえ！」
PRINTFORMDL 静葉の肺から苦しげな呻き声がこぼれた	PRINTFORMDL 静葉の肺から苦しげな呻き声がこぼれた
PRINTFORMDL 静葉は下唇を噛んで声を押し殺している	PRINTFORMDL 静葉は下唇を噛んで声を押し殺している
PRINTFORMDL 声を出しかけた静葉は慌てて口を押えた	PRINTFORMDL 声を出しかけた静葉は慌てて口を押えた
PRINTFORML (穣子ちゃんの顔を見ると安心するわね）	PRINTFORML (穣子ちゃんの顔を見ると安心するわね）
PRINTFORML 「みんなでこんな場所から逃げましょう」	PRINTFORML 「みんなでこんな場所から逃げましょう」
PRINTFORML 「万が一、服を破かれてもこれで安心ね」	PRINTFORML 「万が一、服を破かれてもこれで安心ね」
PRINTFORML 「いっそ一思いに殺して！殺してぇえ！」	PRINTFORML 「いっそ一思いに殺して！殺してぇえ！」
PRINTFORML 「どうしよう…何かがおなかの中に……」	PRINTFORML 「どうしよう…何かがおなかの中に……」
PRINTFORML 「ふふ……あかちゃん…ばけものの……」	PRINTFORML 「ふふ……あかちゃん…ばけものの……」
PRINTFORML 「気づかれたら……きっともうダメ……」	PRINTFORML 「気づかれたら……きっともうダメ……」
PRINTFORML (お願い……誰も私に気づかないで……)	PRINTFORML (お願い……誰も私に気づかないで……)
PRINTFORML 「少しでも身を守るものを見つけないと」	PRINTFORML 「少しでも身を守るものを見つけないと」
PRINTFORML 「何か外に出るヒントはないのかしら…」	PRINTFORML 「何か外に出るヒントはないのかしら…」
PRINTFORMW 「お姉ちゃんは……もう…ダ………メ…」	PRINTFORMW 「お姉ちゃんは……もう…ダ………メ…」
PRINTFORML 「私の事、みんな心配しているわよね…」	PRINTFORML 「私の事、みんな心配しているわよね…」
PRINTFORML 「穣子ちゃん、お姉ちゃんが守るから…」	PRINTFORML 「穣子ちゃん、お姉ちゃんが守るから…」
PRINTFORML 「穣子ちゃん、お姉ちゃんの服…着る？」	PRINTFORML 「穣子ちゃん、お姉ちゃんの服…着る？」
PRINTFORML 「私の能力…役に立たないわね…くすん」	PRINTFORML 「私の能力…役に立たないわね…くすん」
PRINTFORML 「ついこの間まで……元気だったのに…」	PRINTFORML 「ついこの間まで……元気だったのに…」
PRINTFORML 「抜いて……痛い…抜いて…ください…」	PRINTFORML 「抜いて……痛い…抜いて…ください…」
PRINTFORML 「ね、ねえ…手があたって……むにゃ…」	PRINTFORML 「ね、ねえ…手があたって……むにゃ…」
PRINTFORML 「おかあさん！助けをよんでくるから！」	PRINTFORML 「おかあさん！助けをよんでくるから！」
PRINTFORML 「もう怒られるようなことしないからね」	PRINTFORML 「もう怒られるようなことしないからね」
PRINTFORML 「私…あまり役に立たないわね…くすん」	PRINTFORML 「私…あまり役に立たないわね…くすん」
PRINTFORML 「ぅぅぅ…普段着てる服でよかった…」	PRINTFORML 「ぅぅぅ…普段着てる服でよかった…」
PRINTFORML 「ちょっと子供っぽすぎないかしら…」	PRINTFORML 「ちょっと子供っぽすぎないかしら…」
PRINTFORMDL 静葉は水着を手にして呆然としている	PRINTFORMDL 静葉は水着を手にして呆然としている
PRINTFORML 「こんなボロボロじゃ隠せないっ…！」	PRINTFORML 「こんなボロボロじゃ隠せないっ…！」
PRINTFORML 「私の自慢のスカートが…ひどい……」	PRINTFORML 「私の自慢のスカートが…ひどい……」
PRINTFORMW 「ごめんね…守ってあげられなくて…」	PRINTFORMW 「ごめんね…守ってあげられなくて…」
PRINTFORMDW	だが、結局穣子は帰ってこなかった…	PRINTFORMDW	だが、結局穣子は帰ってこなかった…
PRINTFORMW 「本当に…本当に心配したんだから！」	PRINTFORMW 「本当に…本当に心配したんだから！」
PRINTFORMDW 「秋が…秋が終わって………いる？」	PRINTFORMDW 「秋が…秋が終わって………いる？」
PRINTFORMDW この神をも越えた力を手に入れれば…	PRINTFORMDW この神をも越えた力を手に入れれば…
PRINTFORML 「体が火照っちゃって…戦えないの♪」	PRINTFORML 「体が火照っちゃって…戦えないの♪」
PRINTFORMDL 力ないヤクザキックが哀愁を誘う……	PRINTFORMDL 力ないヤクザキックが哀愁を誘う……
PRINTFORMDL 風を切る見事な回し蹴りが放たれた！	PRINTFORMDL 風を切る見事な回し蹴りが放たれた！
PRINTFORML 「ごめんなさい、手加減できなくて！」	PRINTFORML 「ごめんなさい、手加減できなくて！」
PRINTFORMDL 静葉は真剣な表情で必死に暴れている	PRINTFORMDL 静葉は真剣な表情で必死に暴れている
PRINTFORML 「チャアアアジ！秋ッ！パウワァー！」	PRINTFORML 「チャアアアジ！秋ッ！パウワァー！」
PRINTFORML 「いやー！やっぱり助けて離してー！」	PRINTFORML 「いやー！やっぱり助けて離してー！」
PRINTFORML 「まるで秋風ね、あなたの攻撃はっ！」	PRINTFORML 「まるで秋風ね、あなたの攻撃はっ！」
PRINTFORML 「ぁぁ……なんか目の前がかすんで…」	PRINTFORML 「ぁぁ……なんか目の前がかすんで…」
PRINTFORML 「ちょっと！どうしたらいいのこれ！」	PRINTFORML 「ちょっと！どうしたらいいのこれ！」
PRINTFORML 「ふふっ…モてる神様はつらいわね…」	PRINTFORML 「ふふっ…モてる神様はつらいわね…」
PRINTFORML 「私の秋パワーは魅力的ですものね、」	PRINTFORML 「私の秋パワーは魅力的ですものね、」
PRINTFORML 「私を助けてくれる人はいないの！？」	PRINTFORML 「私を助けてくれる人はいないの！？」
PRINTFORML 「秋が足りない奴らはいねーかー！！」	PRINTFORML 「秋が足りない奴らはいねーかー！！」
PRINTFORML 「秋パワー…秋パウワァはないの…？」	PRINTFORML 「秋パワー…秋パウワァはないの…？」
PRINTFORML 「秋が！秋が足りないぃぃぃいい！！」	PRINTFORML 「秋が！秋が足りないぃぃぃいい！！」
PRINTFORMDL 静葉は幸せそうに湯船に浸かっている	PRINTFORMDL 静葉は幸せそうに湯船に浸かっている
PRINTFORML 「早く寝ないとくまができちゃうわ…」	PRINTFORML 「早く寝ないとくまができちゃうわ…」
PRINTFORML 「いまいち秋って感じがしないのよね」	PRINTFORML 「いまいち秋って感じがしないのよね」
PRINTFORML 「ちょっと…シャレになってないわ…」	PRINTFORML 「ちょっと…シャレになってないわ…」
PRINTFORML 「はぁ…はぁ……やりてええええ！！」	PRINTFORML 「はぁ…はぁ……やりてええええ！！」
PRINTFORML 「ゴールド秋クロスを破壊するとは…」	PRINTFORML 「ゴールド秋クロスを破壊するとは…」
PRINTFORML 「この程度なら秋パワーで直せるわ！」	PRINTFORML 「この程度なら秋パワーで直せるわ！」
PRINTFORML 「秋サーチ！着替えセットはどこ！？」	PRINTFORML 「秋サーチ！着替えセットはどこ！？」
PRINTFORML 「くううう！私の秋の香りが悪臭に…」	PRINTFORML 「くううう！私の秋の香りが悪臭に…」
PRINTFORML 「……何かあったら助けてくださいね」	PRINTFORML 「……何かあったら助けてくださいね」
PRINTFORML 「動けないでしょう！？離してっ…！」	PRINTFORML 「動けないでしょう！？離してっ…！」
PRINTFORML 「あまり酷いとととと…？きゃぁ！？」	PRINTFORML 「あまり酷いとととと…？きゃぁ！？」
PRINTFORML 「出して…出して………出し…て……」	PRINTFORML 「出して…出して………出し…て……」
PRINTFORML 「天罰が怖くないのっ…許してぇ……」	PRINTFORML 「天罰が怖くないのっ…許してぇ……」
PRINTFORML (次が最後のチャンスかもしれない…)	PRINTFORML (次が最後のチャンスかもしれない…)
PRINTFORMDL 静葉は静かに啜り泣き続けている……	PRINTFORMDL 静葉は静かに啜り泣き続けている……
PRINTFORML 「中に･･･中に入ってる……ぁぁ…」	PRINTFORML 「中に･･･中に入ってる……ぁぁ…」
PRINTFORML (おなかの中か溶かされちゃう…！？)	PRINTFORML (おなかの中か溶かされちゃう…！？)
PRINTFORML 「やだぁあ！やめてやだやだやだぁ！」	PRINTFORML 「やだぁあ！やめてやだやだやだぁ！」
PRINTFORMDL 静葉は子供のように泣き叫んでいる…	PRINTFORMDL 静葉は子供のように泣き叫んでいる…
PRINTFORMDL 静葉は光のない瞳でなすがままだ……	PRINTFORMDL 静葉は光のない瞳でなすがままだ……
PRINTFORML 「壊れちゃう…心も…体も…っーー！」	PRINTFORML 「壊れちゃう…心も…体も…っーー！」
PRINTFORML 「どうしたら…どうしたらいいの……」	PRINTFORML 「どうしたら…どうしたらいいの……」
PRINTFORMDL 静葉は苦しそうなうめき声を漏らした	PRINTFORMDL 静葉は苦しそうなうめき声を漏らした
PRINTFORMDL まさか全滅してしまったのだろうか？	PRINTFORMDL まさか全滅してしまったのだろうか？
PRINTFORML 「穣子ちゃん…また助けに戻るから…」	PRINTFORML 「穣子ちゃん…また助けに戻るから…」
PRINTFORML （今はお話している場合じゃないわね）	PRINTFORML （今はお話している場合じゃないわね）
PRINTFORML 「迷惑かけないように気をつけるわ…」	PRINTFORML 「迷惑かけないように気をつけるわ…」
PRINTFORML 「限界なの…見張り…お願いします…」	PRINTFORML 「限界なの…見張り…お願いします…」
PRINTFORM 「やめて！やめてぇ！やめぇえぇえええ！	PRINTFORM 「やめて！やめてぇ！やめぇえぇえええ！
PRINTFORML 「少しは体の調子…もどったかしら？」	PRINTFORML 「少しは体の調子…もどったかしら？」
PRINTFORML 「少しでも早く……移動しないと……」	PRINTFORML 「少しでも早く……移動しないと……」
PRINTFORML 「危険が去るまでは隠れましょう……」	PRINTFORML 「危険が去るまでは隠れましょう……」
PRINTFORML 「罠を見つけなければいいのだけど…」	PRINTFORML 「罠を見つけなければいいのだけど…」
PRINTFORML 「信仰を強要するつもりはありません」	PRINTFORML 「信仰を強要するつもりはありません」
PRINTFORMDL 静葉は濁った瞳から涙を流している…	PRINTFORMDL 静葉は濁った瞳から涙を流している…
PRINTFORML 「…ぐすっ…はやくなんとかしないと」	PRINTFORML 「…ぐすっ…はやくなんとかしないと」
PRINTFORML 「気にするほどの汚れではないけど…」	PRINTFORML 「気にするほどの汚れではないけど…」
PRINTFORML 「穣子ちゃん…早く着替えたほうが…」	PRINTFORML 「穣子ちゃん…早く着替えたほうが…」
PRINTFORML 「はぁ……あ、ちょっと疲れただけよ」	PRINTFORML 「はぁ……あ、ちょっと疲れただけよ」
PRINTFORML 「どうして…どうして穣子ちゃんが…」	PRINTFORML 「どうして…どうして穣子ちゃんが…」
PRINTFORML 「どうして……なんでこんなものが…」	PRINTFORML 「どうして……なんでこんなものが…」
PRINTFORML 「どうりで…誰も見てないわけね……」	PRINTFORML 「どうりで…誰も見てないわけね……」
PRINTFORML 「そうしたら…穣子ちゃんのこと……」	PRINTFORML 「そうしたら…穣子ちゃんのこと……」
PRINTFORML 「やめて！はやく抜いてください！！」	PRINTFORML 「やめて！はやく抜いてください！！」
PRINTFORML 「これ以上やだぁ！もう許してよぉ！」	PRINTFORML 「これ以上やだぁ！もう許してよぉ！」
PRINTFORML 「わたしがおとりになるの？そんな…」	PRINTFORML 「わたしがおとりになるの？そんな…」
PRINTFORML 「ひっく…私…どうなるのかしら……」	PRINTFORML 「ひっく…私…どうなるのかしら……」
PRINTFORML 「だからもう少しだけ我慢してね…！」	PRINTFORML 「だからもう少しだけ我慢してね…！」
PRINTFORML 「おとうさん？ん～…よくわかんない」	PRINTFORML 「おとうさん？ん～…よくわかんない」
PRINTFORML 「外の世界…どんな場所なのかしら…」	PRINTFORML 「外の世界…どんな場所なのかしら…」
﻿PRINTFORML 「ぅぅぅ…着替えられてよかった…」	PRINTFORML 「ぅぅぅ…着替えられてよかった…」
PRINTFORML 「やっと視線を気にせず動けるわ…」	PRINTFORML 「やっと視線を気にせず動けるわ…」
PRINTFORML 「……色々な意味で着たくないです」	PRINTFORML 「……色々な意味で着たくないです」
PRINTFORML 「え…下着しかないの…？そんな…」	PRINTFORML 「え…下着しかないの…？そんな…」
PRINTFORML 「またすぐに脱がされちゃいそう…」	PRINTFORML 「またすぐに脱がされちゃいそう…」
PRINTFORML 「裸と大してかわらないじゃない…」	PRINTFORML 「裸と大してかわらないじゃない…」
PRINTFORML 「珍しく質素な服…というか水着ね」	PRINTFORML 「珍しく質素な服…というか水着ね」
PRINTFORML 「あんな下着でもあったほうが……」	PRINTFORML 「あんな下着でもあったほうが……」
PRINTFORML 「あああ…パレオがボロボロに……」	PRINTFORML 「あああ…パレオがボロボロに……」
PRINTFORML 「きゃっ……紐がきれちゃいそう…」	PRINTFORML 「きゃっ……紐がきれちゃいそう…」
PRINTFORMDW そして静葉はボロボロと涙を流した	PRINTFORMDW そして静葉はボロボロと涙を流した
PRINTFORMW 「ごめんね、守ってあげられなくて」	PRINTFORMW 「ごめんね、守ってあげられなくて」
PRINTFORMW	「ごめんなさい…ごめんなさい……」	PRINTFORMW	「ごめんなさい…ごめんなさい……」
PRINTFORMDW	だが、その中には穣子の姿がない…	PRINTFORMDW	だが、その中には穣子の姿がない…
PRINTFORMDW そしてついに諦めて帰ってきたこと	PRINTFORMDW そしてついに諦めて帰ってきたこと
PRINTFORMDW 『おかーさん、上手に塗れたよー』	PRINTFORMDW 『おかーさん、上手に塗れたよー』
PRINTFORMDW 自分の娘が行方不明になって数日…	PRINTFORMDW 自分の娘が行方不明になって数日…
PRINTFORMDW だが、すぐに静葉の中の悪魔が囁く	PRINTFORMDW だが、すぐに静葉の中の悪魔が囁く
PRINTFORML 口上作者は一切の責任を取りません。	PRINTFORML 口上作者は一切の責任を取りません。
PRINTFORMDW 穣子が人里に出かけてから既に三日	PRINTFORMDW 穣子が人里に出かけてから既に三日
PRINTFORMDW だが、心配せずにはいられなかった	PRINTFORMDW だが、心配せずにはいられなかった
PRINTFORMDL [0] 秋foooooooo！！	PRINTFORMDL [0] 秋foooooooo！！
PRINTFORMDW 静葉の性格と素質が変化しました。	PRINTFORMDW 静葉の性格と素質が変化しました。
PRINTFORMW 「穣子ちゃん…どうか無事でいて…」	PRINTFORMW 「穣子ちゃん…どうか無事でいて…」
PRINTFORMDW だが、もし万が一の事があったら…	PRINTFORMDW だが、もし万が一の事があったら…
PRINTFORML 「さあみるがいいわ！私の活躍を！」	PRINTFORML 「さあみるがいいわ！私の活躍を！」
PRINTFORML 「そろそろ出したほうが身の為よ？」	PRINTFORML 「そろそろ出したほうが身の為よ？」
PRINTFORML 「ひぃぃ！いいから出して出して！」	PRINTFORML 「ひぃぃ！いいから出して出して！」
PRINTFORML 「そろそろ離したほうが身の為よ？」	PRINTFORML 「そろそろ離したほうが身の為よ？」
PRINTFORML 「いやー！さすがにもう無理よー！」	PRINTFORML 「いやー！さすがにもう無理よー！」
PRINTFORML 「ああ…秋パワーが抜けていく……」	PRINTFORML 「ああ…秋パワーが抜けていく……」
PRINTFORML 「もっと…ちょうだい……ふふっ…」	PRINTFORML 「もっと…ちょうだい……ふふっ…」
PRINTFORML 「あんまりがっついちゃダメよぉ…」	PRINTFORML 「あんまりがっついちゃダメよぉ…」
PRINTFORML 「まさか私がザコとでもいうの…？」	PRINTFORML 「まさか私がザコとでもいうの…？」
PRINTFORML 「ぜーぜーぜー…冗談じゃないわ…」	PRINTFORML 「ぜーぜーぜー…冗談じゃないわ…」
PRINTFORML 「我ながら完璧な逃げ方だったわ！」	PRINTFORML 「我ながら完璧な逃げ方だったわ！」
PRINTFORMDL 騒がしかった外が急に静かになった	PRINTFORMDL 騒がしかった外が急に静かになった
PRINTFORMW 「むーーーーぐーーーーーーー！？」	PRINTFORMW 「むーーーーぐーーーーーーー！？」
PRINTFORML 「ほんとどうしたらいいのかしら…」	PRINTFORML 「ほんとどうしたらいいのかしら…」
PRINTFORML 「今は部屋を出れそうにないわね…」	PRINTFORML 「今は部屋を出れそうにないわね…」
PRINTFORML 「さあ！小さな秋を探しましょう！」	PRINTFORML 「さあ！小さな秋を探しましょう！」
PRINTFORML 「ひぃぃぃ…ずびばぜんでじだー！」	PRINTFORML 「ひぃぃぃ…ずびばぜんでじだー！」
PRINTFORML 「穣子ちゃんがやられたようだな…」	PRINTFORML 「穣子ちゃんがやられたようだな…」
PRINTFORML 「っしゃー！張り切っていくわよ！」	PRINTFORML 「っしゃー！張り切っていくわよ！」
PRINTFORML 「やだー寝ると冬が近づくのやだー」	PRINTFORML 「やだー寝ると冬が近づくのやだー」
PRINTFORML 「そろそろ着替えを探しましょうか」	PRINTFORML 「そろそろ着替えを探しましょうか」
PRINTFORML 「秋に相応しくない匂いがするわ…」	PRINTFORML 「秋に相応しくない匂いがするわ…」
PRINTFORML 「や…やめてくださいっ……ぅぅ…」	PRINTFORML 「や…やめてくださいっ……ぅぅ…」
PRINTFORML 「こないで…こないでください……」	PRINTFORML 「こないで…こないでください……」
PRINTFORML 「秋の弾幕、フォーリンブラスト！」	PRINTFORML 「秋の弾幕、フォーリンブラスト！」
PRINTFORML 「こうみえても私神様なんですよ！」	PRINTFORML 「こうみえても私神様なんですよ！」
PRINTFORML (暴れても……もうダメよね………)	PRINTFORML (暴れても……もうダメよね………)
PRINTFORML 「そ、そんなところ汚いですよ！？」	PRINTFORML 「そ、そんなところ汚いですよ！？」
PRINTFORML 「やめて…赤ちゃんできちゃう…！」	PRINTFORML 「やめて…赤ちゃんできちゃう…！」
PRINTFORML 「壊れちゃうから……やめてぇ……」	PRINTFORML 「壊れちゃうから……やめてぇ……」
PRINTFORML 「私はッ…私は苗床なんていやぁ！」	PRINTFORML 「私はッ…私は苗床なんていやぁ！」
PRINTFORML 「げほっ！？ゴバッゴホッ……！？」	PRINTFORML 「げほっ！？ゴバッゴホッ……！？」
PRINTFORML 「あぁ…あーーっ……ぁぁあぁ……」	PRINTFORML 「あぁ…あーーっ……ぁぁあぁ……」
PRINTFORML 「いや………やめて…そこだけは…」	PRINTFORML 「いや………やめて…そこだけは…」
PRINTFORML 「やめてっ！痛いことしないで…！」	PRINTFORML 「やめてっ！痛いことしないで…！」
PRINTFORMDL 静葉は顔を真っ赤にして耐えている	PRINTFORMDL 静葉は顔を真っ赤にして耐えている
PRINTFORML 「壊れちゃうのに……壊れたい……」	PRINTFORML 「壊れちゃうのに……壊れたい……」
PRINTFORML 「よかった……本当によかった……」	PRINTFORML 「よかった……本当によかった……」
PRINTFORML 「息が…あがって……くるしっ……」	PRINTFORML 「息が…あがって……くるしっ……」
PRINTFORML 「だからもう少しだけ我慢して…！」	PRINTFORML 「だからもう少しだけ我慢して…！」
PRINTFORML (もしかして……見捨てられたの？)	PRINTFORML (もしかして……見捨てられたの？)
PRINTFORMDL 静葉の瞳から大粒の涙がこぼれた。	PRINTFORMDL 静葉の瞳から大粒の涙がこぼれた。
PRINTFORML 「時間の感覚がくるってくるわ……」	PRINTFORML 「時間の感覚がくるってくるわ……」
PRINTFORML 「穣子ちゃんを探しているんです…」	PRINTFORML 「穣子ちゃんを探しているんです…」
PRINTFORML 「大丈夫よ、ちゃんと寝れてるわ…」	PRINTFORML 「大丈夫よ、ちゃんと寝れてるわ…」
PRINTFORML 「面倒ごと押し付けてごめんなさい」	PRINTFORML 「面倒ごと押し付けてごめんなさい」
PRINTFORML 「らくにっ！早くらくにしてよぉ！」	PRINTFORML 「らくにっ！早くらくにしてよぉ！」
PRINTFORML 「…私は戦闘は得意じゃありません」	PRINTFORML 「…私は戦闘は得意じゃありません」
PRINTFORML 「赤ちゃん…どうしたらいいの……」	PRINTFORML 「赤ちゃん…どうしたらいいの……」
PRINTFORML (はしたないのに…いけないのに…)	PRINTFORML (はしたないのに…いけないのに…)
PRINTFORML 「はやく着替えないと…恥ずかしい」	PRINTFORML 「はやく着替えないと…恥ずかしい」
PRINTFORML 「ひっ…こんなとこにまで粘液が…」	PRINTFORML 「ひっ…こんなとこにまで粘液が…」
PRINTFORML 「穣子ちゃん！？…気のせい…よね」	PRINTFORML 「穣子ちゃん！？…気のせい…よね」
PRINTFORMW 「それ……どうする気…え？や！？」	PRINTFORMW 「それ……どうする気…え？や！？」
PRINTFORML 「え…穣子ちゃん…何してる…の？」	PRINTFORML 「え…穣子ちゃん…何してる…の？」
PRINTFORML 「痛い…痛い…もういやあぁああ！」	PRINTFORML 「痛い…痛い…もういやあぁああ！」
PRINTFORML (むこうにいるのおかあさんかな？)	PRINTFORML (むこうにいるのおかあさんかな？)
PRINTFORML 「えーと…いろいろおぼえてますよ」	PRINTFORML 「えーと…いろいろおぼえてますよ」
PRINTFORML 「空･･･かぁ…想像もつかないわ」	PRINTFORML 「空･･･かぁ…想像もつかないわ」
PRINTFORML 「今は周りは敵だらけなのね…怖い」	PRINTFORML 「今は周りは敵だらけなのね…怖い」
PRINTFORML 「ふぇえ…恥ずかしかったです…」	PRINTFORML 「ふぇえ…恥ずかしかったです…」
PRINTFORML 「どうして名前が入っているの…」	PRINTFORML 「どうして名前が入っているの…」
PRINTFORML 「きゃああ！？服っ…服をっ…！」	PRINTFORML 「きゃああ！？服っ…服をっ…！」
PRINTFORML 「やだっ……下着みえちゃう……」	PRINTFORML 「やだっ……下着みえちゃう……」
PRINTFORML 「ひっ……やっぱり破れちゃう…」	PRINTFORML 「ひっ……やっぱり破れちゃう…」
PRINTFORML 「ただでさえ隠れてないのに……」	PRINTFORML 「ただでさえ隠れてないのに……」
PRINTFORMW 「穣子ちゃん！？帰ってたの！？」	PRINTFORMW 「穣子ちゃん！？帰ってたの！？」
PRINTFORMW 「ただいま。心配かけてごめんね」	PRINTFORMW 「ただいま。心配かけてごめんね」
PRINTFORMDW 首を横に振る穣子から離れる静葉	PRINTFORMDW 首を横に振る穣子から離れる静葉
PRINTFORMW 「ずっと…側にいればよかった…」	PRINTFORMW 「ずっと…側にいればよかった…」
PRINTFORMW 「大丈夫、料理をしていただけよ」	PRINTFORMW 「大丈夫、料理をしていただけよ」
PRINTFORMDW	今年もまた秋が終わり冬がくる…	PRINTFORMDW	今年もまた秋が終わり冬がくる…
PRINTFORMW 「ひゃっはああ！！秋ですよー！」	PRINTFORMW 「ひゃっはああ！！秋ですよー！」
PRINTFORMW 『ひゃっほおお！！秋ですよー！』	PRINTFORMW 『ひゃっほおお！！秋ですよー！』
PRINTFORMDW 静葉が体調不良で寝込んで数日…	PRINTFORMDW 静葉が体調不良で寝込んで数日…
PRINTFORMDL 静葉にとって秋は麻薬も同然ッ！	PRINTFORMDL 静葉にとって秋は麻薬も同然ッ！
PRINTFORMDL オープニングの続きを見ますか？	PRINTFORMDL オープニングの続きを見ますか？
PRINTFORML 「秋パワーを使うまでもないわ！」	PRINTFORML 「秋パワーを使うまでもないわ！」
PRINTFORML 「ひゃっはあー！超秋武神羅斬！」	PRINTFORML 「ひゃっはあー！超秋武神羅斬！」
PRINTFORMDL 答えるように肉壁が激しく蠢いた	PRINTFORMDL 答えるように肉壁が激しく蠢いた
PRINTFORMDL 静葉は必死におしりを庇っている	PRINTFORMDL 静葉は必死におしりを庇っている
PRINTFORML 「もう…このままでいっか…ぁん」	PRINTFORML 「もう…このままでいっか…ぁん」
PRINTFORML 「あ、あらら……手遅れかしら？」	PRINTFORML 「あ、あらら……手遅れかしら？」
PRINTFORML 「けっこう派手に穴があいたわね」	PRINTFORML 「けっこう派手に穴があいたわね」
PRINTFORMDL リビングバインは戸惑っている…	PRINTFORMDL リビングバインは戸惑っている…
PRINTFORMDL 殺気を放ちながら静葉が吼える！	PRINTFORMDL 殺気を放ちながら静葉が吼える！
PRINTFORML 「熱心な信者の気配を感じるわ！」	PRINTFORML 「熱心な信者の気配を感じるわ！」
PRINTFORML 「私の力がいらないと言うのね？」	PRINTFORML 「私の力がいらないと言うのね？」
PRINTFORML 「まだ秋なのになんだか寒気が…」	PRINTFORML 「まだ秋なのになんだか寒気が…」
PRINTFORML 「誰か…誰か万能薬を……早く…」	PRINTFORML 「誰か…誰か万能薬を……早く…」
PRINTFORML 「こうなったらヤケだ！秋突撃！」	PRINTFORML 「こうなったらヤケだ！秋突撃！」
PRINTFORML (とにかく見つからないように…)	PRINTFORML (とにかく見つからないように…)
PRINTFORML 「穣子の無念は私が晴らすッ！！」	PRINTFORML 「穣子の無念は私が晴らすッ！！」
PRINTFORML 「ふぁあ…ねーむーいーのーよー」	PRINTFORML 「ふぁあ…ねーむーいーのーよー」
PRINTFORML 「睡眠の秋なのよー寝たいのー！」	PRINTFORML 「睡眠の秋なのよー寝たいのー！」
PRINTFORML 「ふぅぅ…さすがに疲れるわねえ」	PRINTFORML 「ふぅぅ…さすがに疲れるわねえ」
PRINTFORML 「この洞窟を秋色に染めるには…」	PRINTFORML 「この洞窟を秋色に染めるには…」
PRINTFORML 「塗り損ねた樹を早く塗りたいわ」	PRINTFORML 「塗り損ねた樹を早く塗りたいわ」
PRINTFORMDL 静葉は身を硬くして震えている…	PRINTFORMDL 静葉は身を硬くして震えている…
PRINTFORML 「ごめんなさいっ！もうダメっ！」	PRINTFORML 「ごめんなさいっ！もうダメっ！」
PRINTFORML (逃げなきゃ…逃げなくちゃ……)	PRINTFORML (逃げなきゃ…逃げなくちゃ……)
PRINTFORML 「こ、これ当たったら痛いわよ？」	PRINTFORML 「こ、これ当たったら痛いわよ？」
PRINTFORML 「だめ……私の力じゃやっぱり…」	PRINTFORML 「だめ……私の力じゃやっぱり…」
PRINTFORML 「ひっく…このまま…きっと……」	PRINTFORML 「ひっく…このまま…きっと……」
PRINTFORML (やっぱり………私の力じゃ……)	PRINTFORML (やっぱり………私の力じゃ……)
PRINTFORML 「早く…楽にして……ください…」	PRINTFORML 「早く…楽にして……ください…」
PRINTFORML 「お願いだから…いれないで……」	PRINTFORML 「お願いだから…いれないで……」
PRINTFORML 「あはっ……あはは…ドロドロ…」	PRINTFORML 「あはっ……あはは…ドロドロ…」
PRINTFORML (もう……唇…痺れ……舌が……)	PRINTFORML (もう……唇…痺れ……舌が……)
PRINTFORML 「いやっ！お願い許してっ……！」	PRINTFORML 「いやっ！お願い許してっ……！」
PRINTFORML 「だめぇ！ここだけは許してぇ！」	PRINTFORML 「だめぇ！ここだけは許してぇ！」
PRINTFORML 「いやっ！こんな化物にっ……！」	PRINTFORML 「いやっ！こんな化物にっ……！」
PRINTFORML (なんとか振りほどかないと…！)	PRINTFORML (なんとか振りほどかないと…！)
PRINTFORML 「ナカに……ひっく…ナカに……」	PRINTFORML 「ナカに……ひっく…ナカに……」
PRINTFORML 「お姉ちゃんと情報交換しましょ」	PRINTFORML 「お姉ちゃんと情報交換しましょ」
PRINTFORML 「身を守る為には協力は必須よね」	PRINTFORML 「身を守る為には協力は必須よね」
PRINTFORML 「ごめんなさい…もう…眠くて…」	PRINTFORML 「ごめんなさい…もう…眠くて…」
PRINTFORML (お腹の中に何か……まさか……)	PRINTFORML (お腹の中に何か……まさか……)
PRINTFORML 「ほんとは動くのが辛いだけ……」	PRINTFORML 「ほんとは動くのが辛いだけ……」
PRINTFORML 「ひっ！？……気のせい･･･？」	PRINTFORML 「ひっ！？……気のせい･･･？」
PRINTFORML 「脱出できた人…いるのかしら？」	PRINTFORML 「脱出できた人…いるのかしら？」
PRINTFORML 「誰が何のためにこんな場所を…」	PRINTFORML 「誰が何のためにこんな場所を…」
PRINTFORML 「こんな状態で化物にあったら…」	PRINTFORML 「こんな状態で化物にあったら…」
PRINTFORML 「もう化物を産むしかないのね…」	PRINTFORML 「もう化物を産むしかないのね…」
PRINTFORML 「今は何よりも着替えよ着替え！」	PRINTFORML 「今は何よりも着替えよ着替え！」
PRINTFORML 「もう布が殆どのこってないわ…」	PRINTFORML 「もう布が殆どのこってないわ…」
PRINTFORML 「穣子ちゃん、着替えあるわよ？」	PRINTFORML 「穣子ちゃん、着替えあるわよ？」
PRINTFORML 「帰ったらまずはお風呂かしら…」	PRINTFORML 「帰ったらまずはお風呂かしら…」
PRINTFORML 「せめて今が秋ならよかったわね」	PRINTFORML 「せめて今が秋ならよかったわね」
PRINTFORML 「妹一人守れないで何が神様よ…」	PRINTFORML 「妹一人守れないで何が神様よ…」
PRINTFORML 「こんな…酷いこと…やめて……」	PRINTFORML 「こんな…酷いこと…やめて……」
PRINTFORML 「裂けちゃうっ…裂けちゃうぅ…」	PRINTFORML 「裂けちゃうっ…裂けちゃうぅ…」
PRINTFORML 「すぅ……大声…だしちゃうよ？」	PRINTFORML 「すぅ……大声…だしちゃうよ？」
PRINTFORML 「どっちがお姉ちゃんなのかな？」	PRINTFORML 「どっちがお姉ちゃんなのかな？」
PRINTFORML 「居心地悪いし消しちゃいましょ」	PRINTFORML 「居心地悪いし消しちゃいましょ」
PRINTFORML 「ふあ、歩き疲れてきちゃった…」	PRINTFORML 「ふあ、歩き疲れてきちゃった…」
PRINTFORML 「選択の余地無し…なのよね…」	PRINTFORML 「選択の余地無し…なのよね…」
PRINTFORML 「…なんで名札に私の名前まで」	PRINTFORML 「…なんで名札に私の名前まで」
PRINTFORML 「…着替えるのやめようかしら」	PRINTFORML 「…着替えるのやめようかしら」
PRINTFORML 「ひらひらしていて可愛いわね」	PRINTFORML 「ひらひらしていて可愛いわね」
PRINTFORML 「どこをどう隠せっていうの…」	PRINTFORML 「どこをどう隠せっていうの…」
PRINTFORML 「あああ…もうどうしたら……」	PRINTFORML 「あああ…もうどうしたら……」
PRINTFORML 「きゃあっ…スカートに穴が…」	PRINTFORML 「きゃあっ…スカートに穴が…」
PRINTFORMDW 静葉は一秒でも早く服を着る為	PRINTFORMDW 静葉は一秒でも早く服を着る為
PRINTFORMDW 静葉は傷んだ服から着替える為	PRINTFORMDW 静葉は傷んだ服から着替える為
PRINTFORMW 「穣子ちゃん…もう大丈夫よ…」	PRINTFORMW 「穣子ちゃん…もう大丈夫よ…」
PRINTFORMW 「よかった…無事でよかった…」	PRINTFORMW 「よかった…無事でよかった…」
PRINTFORMDW 「秋が…終わって……いる…」	PRINTFORMDW 「秋が…終わって……いる…」
PRINTFORMW 「よおこそオータムランドへ！」	PRINTFORMW 「よおこそオータムランドへ！」
PRINTFORMDW 通常の状態でスタートします。	PRINTFORMDW 通常の状態でスタートします。
PRINTFORMDW 静葉の目頭がカーッと熱くなる	PRINTFORMDW 静葉の目頭がカーッと熱くなる
PRINTFORMDW 叫んでも誰も答えてはくれない	PRINTFORMDW 叫んでも誰も答えてはくれない
PRINTFORMW (なら…ここに穣子ちゃんも…)	PRINTFORMW (なら…ここに穣子ちゃんも…)
PRINTFORML 「私は今からオ○ニーするの！」	PRINTFORML 「私は今からオ○ニーするの！」
PRINTFORML 「秋パワーが漲ってくるわ！！」	PRINTFORML 「秋パワーが漲ってくるわ！！」
PRINTFORML 「私を食べて満足してるようね」	PRINTFORML 「私を食べて満足してるようね」
PRINTFORML 「ふふふっ、あまえんぼさんね」	PRINTFORML 「ふふふっ、あまえんぼさんね」
PRINTFORML 「でも見ないでえええええ！！」	PRINTFORML 「でも見ないでえええええ！！」
PRINTFORML 「おなかの中に冬の気配が……」	PRINTFORML 「おなかの中に冬の気配が……」
PRINTFORML 「みーのーりーこーちゃーん？」	PRINTFORML 「みーのーりーこーちゃーん？」
PRINTFORML 「敵ね！？気のせいだったわ！」	PRINTFORML 「敵ね！？気のせいだったわ！」
PRINTFORML 「秋パワーがすーわーれーるー」	PRINTFORML 「秋パワーがすーわーれーるー」
PRINTFORML 「ううん、冬が近いのかしら？」	PRINTFORML 「ううん、冬が近いのかしら？」
PRINTFORML 「お風呂でさっぱりしたいわね」	PRINTFORML 「お風呂でさっぱりしたいわね」
PRINTFORML 「きゃっ！？へんなベタベタが」	PRINTFORML 「きゃっ！？へんなベタベタが」
PRINTFORML 「秋パワーが溢れてヤヴァイわ」	PRINTFORML 「秋パワーが溢れてヤヴァイわ」
PRINTFORML 「段々と戦闘にもなれてきたわ」	PRINTFORML 「段々と戦闘にもなれてきたわ」
PRINTFORML 「……けほっ…げほっげほっ！」	PRINTFORML 「……けほっ…げほっげほっ！」
PRINTFORML 「すぅ……大声…だしますよ？」	PRINTFORML 「すぅ……大声…だしますよ？」
PRINTFORML 「み、見逃してくださいっ…！」	PRINTFORML 「み、見逃してくださいっ…！」
PRINTFORML (とにかく今は逃げないと……)	PRINTFORML (とにかく今は逃げないと……)
PRINTFORML 「おねがいっ！あっち行って！」	PRINTFORML 「おねがいっ！あっち行って！」
PRINTFORML 「当てさえ出来れば私でも……」	PRINTFORML 「当てさえ出来れば私でも……」
PRINTFORMDL 静葉は必死な形相で暴れている	PRINTFORMDL 静葉は必死な形相で暴れている
PRINTFORML 「そんなに絡みつかないで…！」	PRINTFORML 「そんなに絡みつかないで…！」
PRINTFORML 「きゃっ…た、助かった……？」	PRINTFORML 「きゃっ…た、助かった……？」
PRINTFORML 「出して…出して………出し…」	PRINTFORML 「出して…出して………出し…」
PRINTFORML 「壊れ…ちゃう……私…もう…」	PRINTFORML 「壊れ…ちゃう……私…もう…」
PRINTFORML 「離してっ…！聞いてるのっ！」	PRINTFORML 「離してっ…！聞いてるのっ！」
PRINTFORML (避けなきゃ……でも…もう…)	PRINTFORML (避けなきゃ……でも…もう…)
PRINTFORML 「やめてっ…ぁ…ぁぁぁぁあ！」	PRINTFORML 「やめてっ…ぁ…ぁぁぁぁあ！」
PRINTFORML 「離してぇ！家に帰してぇえ！」	PRINTFORML 「離してぇ！家に帰してぇえ！」
PRINTFORML 「いやぁ！？ふ、服が全部っ…」	PRINTFORML 「いやぁ！？ふ、服が全部っ…」
PRINTFORML 「もうイきたくないーーーっ！」	PRINTFORML 「もうイきたくないーーーっ！」
PRINTFORML 「動けるうちに…にげないと…」	PRINTFORML 「動けるうちに…にげないと…」
PRINTFORML 「え…え…お腹の中に…え…？」	PRINTFORML 「え…え…お腹の中に…え…？」
PRINTFORML 「よかった…逃げれたみたいね」	PRINTFORML 「よかった…逃げれたみたいね」
PRINTFORML 「はぁ…はぁ……終わったの？」	PRINTFORML 「はぁ…はぁ……終わったの？」
PRINTFORML （一緒に行動するべきかしら？）	PRINTFORML （一緒に行動するべきかしら？）
PRINTFORML 「ここは二手にわかれましょう」	PRINTFORML 「ここは二手にわかれましょう」
PRINTFORML 「ぅぅ…これで着替えられるわ」	PRINTFORML 「ぅぅ…これで着替えられるわ」
PRINTFORML 「ん……寝れなくはないわね…」	PRINTFORML 「ん……寝れなくはないわね…」
PRINTFORMDL 静葉は呆然と立ち尽くしている	PRINTFORMDL 静葉は呆然と立ち尽くしている
PRINTFORML 「………また…どうせ…すぐに」	PRINTFORML 「………また…どうせ…すぐに」
PRINTFORML 「ちょっと休憩も兼ねて…ね？」	PRINTFORML 「ちょっと休憩も兼ねて…ね？」
PRINTFORML 「こんな初めてなんてイヤっ！」	PRINTFORML 「こんな初めてなんてイヤっ！」
PRINTFORMW 「ごめん…ね…穣子ちゃん……」	PRINTFORMW 「ごめん…ね…穣子ちゃん……」
PRINTFORML 「………ばか…もう知らないっ」	PRINTFORML 「………ばか…もう知らないっ」
PRINTFORML 「……私はこれからどうしたら」	PRINTFORML 「……私はこれからどうしたら」
PRINTFORML 「眠すぎて…欠伸すらでない…」	PRINTFORML 「眠すぎて…欠伸すらでない…」
PRINTFORML 「はぁ……はぁ……おなかが…」	PRINTFORML 「はぁ……はぁ……おなかが…」
PRINTFORML 「だるい…疲れがとれない……」	PRINTFORML 「だるい…疲れがとれない……」
PRINTFORML 「疲れがたまってるのかしら…」	PRINTFORML 「疲れがたまってるのかしら…」
PRINTFORML 「穣子ちゃん、しっかりして！」	PRINTFORML 「穣子ちゃん、しっかりして！」
PRINTFORML 「気付薬…早く見つけないと…」	PRINTFORML 「気付薬…早く見つけないと…」
PRINTFORML 「…ねえ……どうしてなの…？」	PRINTFORML 「…ねえ……どうしてなの…？」
PRINTFORMDL 静葉のMPが100になった…	PRINTFORMDL 静葉のMPが100になった…
PRINTFORML 「え…み、穣子…ちゃん……？」	PRINTFORML 「え…み、穣子…ちゃん……？」
PRINTFORML 「なに…そ…れ……え？え？？」	PRINTFORML 「なに…そ…れ……え？え？？」
PRINTFORML 「話きいてよお！ほどいてー！」	PRINTFORML 「話きいてよお！ほどいてー！」
PRINTFORML 「戦闘は苦手だけど……頑張る」	PRINTFORML 「戦闘は苦手だけど……頑張る」
PRINTFORML 「ふう…なんとか着れたわ…」	PRINTFORML 「ふう…なんとか着れたわ…」
PRINTFORML 「やだっ……みえちゃう……」	PRINTFORML 「やだっ……みえちゃう……」
PRINTFORML 「早くかわりになる服を……」	PRINTFORML 「早くかわりになる服を……」
PRINTFORMDW 穣子はこくんと小さく頷いた	PRINTFORMDW 穣子はこくんと小さく頷いた
PRINTFORMDW 人知れず異変を解決した静葉	PRINTFORMDW 人知れず異変を解決した静葉
PRINTFORMDW 化物の子供を妊娠している…	PRINTFORMDW 化物の子供を妊娠している…
PRINTFORMDW 『穣子おばちゃんもみてー』	PRINTFORMDW 『穣子おばちゃんもみてー』
PRINTFORMDW 『一緒に楽しくくらそうね』	PRINTFORMDW 『一緒に楽しくくらそうね』
PRINTFORMDL [1] やっぱり秋以外で…	PRINTFORMDL [1] やっぱり秋以外で…
PRINTFORMW 「何！？何が起きてるの！？」	PRINTFORMW 「何！？何が起きてるの！？」
PRINTFORMW (まさか…私も神隠しに！？)	PRINTFORMW (まさか…私も神隠しに！？)
PRINTFORML 「やんっ、えっちなんだから」	PRINTFORML 「やんっ、えっちなんだから」
PRINTFORML 「秋だというのに…なぜ……」	PRINTFORML 「秋だというのに…なぜ……」
PRINTFORMDL 戦闘がおわったのだろうか？	PRINTFORMDL 戦闘がおわったのだろうか？
PRINTFORML 「あなたの判断は正しいわ！」	PRINTFORML 「あなたの判断は正しいわ！」
PRINTFORML 「ううう、お腹けんないで…」	PRINTFORML 「ううう、お腹けんないで…」
PRINTFORML 「オラァ！！秋の登場よ！！」	PRINTFORML 「オラァ！！秋の登場よ！！」
PRINTFORML 「何か…何か役に立つものは」	PRINTFORML 「何か…何か役に立つものは」
PRINTFORML 「セーフ！セーフよね今の！」	PRINTFORML 「セーフ！セーフよね今の！」
PRINTFORML 「だが奴は妖怪の山最弱……」	PRINTFORML 「だが奴は妖怪の山最弱……」
PRINTFORML 「この私は穣子とは違う！！」	PRINTFORML 「この私は穣子とは違う！！」
PRINTFORML 「さあ出口はどこかしら！？」	PRINTFORML 「さあ出口はどこかしら！？」
PRINTFORML 「…怖い。私の強さがね！！」	PRINTFORML 「…怖い。私の強さがね！！」
PRINTFORML (どこかで落ち着いて一発…)	PRINTFORML (どこかで落ち着いて一発…)
PRINTFORML 「秋度が汚れて力が出ない…」	PRINTFORML 「秋度が汚れて力が出ない…」
PRINTFORML 「許して……お願いです……」	PRINTFORML 「許して……お願いです……」
PRINTFORML 「私に囮になれと？そんな…」	PRINTFORML 「私に囮になれと？そんな…」
PRINTFORML 「…今は距離を詰めるべきね」	PRINTFORML 「…今は距離を詰めるべきね」
PRINTFORML 「もうあっち行ってよぉ……」	PRINTFORML 「もうあっち行ってよぉ……」
PRINTFORML 「お願いッ！スペルカード！」	PRINTFORML 「お願いッ！スペルカード！」
PRINTFORML 「ごめんね…穣子ちゃん……」	PRINTFORML 「ごめんね…穣子ちゃん……」
PRINTFORML 「や、やだ…！不届きもの！」	PRINTFORML 「や、やだ…！不届きもの！」
PRINTFORML 「いやぁ！やめてください！」	PRINTFORML 「いやぁ！やめてください！」
PRINTFORML (いけない！捕まっちゃう！)	PRINTFORML (いけない！捕まっちゃう！)
PRINTFORML 「止めて！出すのやめてぇ！」	PRINTFORML 「止めて！出すのやめてぇ！」
PRINTFORML 「やっ…やめてっ…ひぃぃ…」	PRINTFORML 「やっ…やめてっ…ひぃぃ…」
PRINTFORML 「た、卵！？や、やめっ…！」	PRINTFORML 「た、卵！？や、やめっ…！」
PRINTFORML 「ぅえ…ぅぇぇええぇぇ……」	PRINTFORML 「ぅえ…ぅぇぇええぇぇ……」
PRINTFORML 「やだっ…ナカにっ……！？」	PRINTFORML 「やだっ…ナカにっ……！？」
PRINTFORML 「あはは…このまま…私……」	PRINTFORML 「あはは…このまま…私……」
PRINTFORML (もう……抵抗できない……)	PRINTFORML (もう……抵抗できない……)
PRINTFORML 「いやああ！食べないで…！」	PRINTFORML 「いやああ！食べないで…！」
PRINTFORML (よかった…外れてくれた…)	PRINTFORML (よかった…外れてくれた…)
PRINTFORML 「ひゃっ！？……はずれた？」	PRINTFORML 「ひゃっ！？……はずれた？」
PRINTFORML 「もうこれ以上戦えないわ…」	PRINTFORML 「もうこれ以上戦えないわ…」
PRINTFORML 「や、やだっ…何が入って…」	PRINTFORML 「や、やだっ…何が入って…」
PRINTFORML 「怖かった……怖かった……」	PRINTFORML 「怖かった……怖かった……」
PRINTFORML 「穣子ちゃん逃げてええ！！」	PRINTFORML 「穣子ちゃん逃げてええ！！」
PRINTFORML 「もう…大丈夫かしら……？」	PRINTFORML 「もう…大丈夫かしら……？」
PRINTFORML 「あなたもついてないわね…」	PRINTFORML 「あなたもついてないわね…」
PRINTFORML 「……なかなか寝付けないわ」	PRINTFORML 「……なかなか寝付けないわ」
PRINTFORML (全然眠った気がしないわ…)	PRINTFORML (全然眠った気がしないわ…)
PRINTFORML 「秋の風よ、静寂と平穏を…」	PRINTFORML 「秋の風よ、静寂と平穏を…」
PRINTFORML 「どこか眠れそうな場所……」	PRINTFORML 「どこか眠れそうな場所……」
PRINTFORML 「おなかの中で動いてる……」	PRINTFORML 「おなかの中で動いてる……」
PRINTFORML (全身気持ちよくて…もう…)	PRINTFORML (全身気持ちよくて…もう…)
PRINTFORML 「着替えがないのは不安ね…」	PRINTFORML 「着替えがないのは不安ね…」
PRINTFORML 「早くお風呂にはいりたいわ」	PRINTFORML 「早くお風呂にはいりたいわ」
PRINTFORML 「穣子ちゃん…無事かしら？」	PRINTFORML 「穣子ちゃん…無事かしら？」
PRINTFORML 「会いたいよ…穣子ちゃん…」	PRINTFORML 「会いたいよ…穣子ちゃん…」
PRINTFORML 「あら？……気のせいかしら」	PRINTFORML 「あら？……気のせいかしら」
PRINTFORML 「そんな……穣子ちゃん……」	PRINTFORML 「そんな……穣子ちゃん……」
PRINTFORML 「ひっ！？な、なんなの！？」	PRINTFORML 「ひっ！？な、なんなの！？」
PRINTFORML 「や…やめてねっ……ぅぅ…」	PRINTFORML 「や…やめてねっ……ぅぅ…」
PRINTFORML 「こないで…こないでぇ……」	PRINTFORML 「こないで…こないでぇ……」
PRINTFORML 「……何かあったら助けてね」	PRINTFORML 「……何かあったら助けてね」
PRINTFORML 「おかあさん…助けてよぉ…」	PRINTFORML 「おかあさん…助けてよぉ…」
PRINTFORML 「おかあさんお話しようよ！」	PRINTFORML 「おかあさんお話しようよ！」
PRINTFORML 「あ、あんまり見ないで…」	PRINTFORML 「あ、あんまり見ないで…」
PRINTFORML 「穴だらけに…ひどい……」	PRINTFORML 「穴だらけに…ひどい……」
PRINTFORML 「きゃっ……大きい穴が…」	PRINTFORML 「きゃっ……大きい穴が…」
PRINTFORML 「裸…！？いやあぁあ！？」	PRINTFORML 「裸…！？いやあぁあ！？」
PRINTFORML 「やだっ……穴だらけ……」	PRINTFORML 「やだっ……穴だらけ……」
PRINTFORMW 「どうしたの穣子ちゃん？」	PRINTFORMW 「どうしたの穣子ちゃん？」
PRINTFORMDW あの異変から既に数週間…	PRINTFORMDW あの異変から既に数週間…
PRINTFORMDW 「お風呂、入れてあげる」	PRINTFORMDW 「お風呂、入れてあげる」
PRINTFORMDW 「そうだ…冬眠しよう…」	PRINTFORMDW 「そうだ…冬眠しよう…」
PRINTFORMDW 静葉はごくりと生唾を飲む	PRINTFORMDW 静葉はごくりと生唾を飲む
PRINTFORMDW 確かに穣子は心配ではある	PRINTFORMDW 確かに穣子は心配ではある
PRINTFORML 「最近のナンパは強引ね♪」	PRINTFORML 「最近のナンパは強引ね♪」
PRINTFORML 「もう勘弁してぇえええ！」	PRINTFORML 「もう勘弁してぇえええ！」
PRINTFORML 「みたか神の力！秋の力！」	PRINTFORML 「みたか神の力！秋の力！」
PRINTFORML (…まだ生きてるじゃない)	PRINTFORML (…まだ生きてるじゃない)
PRINTFORML 「なにかしら…気分が……」	PRINTFORML 「なにかしら…気分が……」
PRINTFORML 「誰か！誰かたすけてー！」	PRINTFORML 「誰か！誰かたすけてー！」
PRINTFORML 「いやっ……こないで……」	PRINTFORML 「いやっ……こないで……」
PRINTFORML 「追いかけてこないでぇ！」	PRINTFORML 「追いかけてこないでぇ！」
PRINTFORML 「道具があれば少しは……」	PRINTFORML 「道具があれば少しは……」
PRINTFORML 「くぅ…きりがないわ……」	PRINTFORML 「くぅ…きりがないわ……」
PRINTFORML 「っくぅ…！そんなっ……」	PRINTFORML 「っくぅ…！そんなっ……」
PRINTFORML (だめ…力………抜けて…)	PRINTFORML (だめ…力………抜けて…)
PRINTFORML 「死にたく…ないよぉ……」	PRINTFORML 「死にたく…ないよぉ……」
PRINTFORML 「やだっ！気持ち悪いっ！」	PRINTFORML 「やだっ！気持ち悪いっ！」
PRINTFORML 「いやぁ！！いやぁあ！！」	PRINTFORML 「いやぁ！！いやぁあ！！」
PRINTFORML 「ぁ…ぁぁ…こんなに……」	PRINTFORML 「ぁ…ぁぁ…こんなに……」
PRINTFORML 「植物のくせに…酷い……」	PRINTFORML 「植物のくせに…酷い……」
PRINTFORML 「ぅぅぅ…こんなのって…」	PRINTFORML 「ぅぅぅ…こんなのって…」
PRINTFORML 「もうダメ……っあああ！」	PRINTFORML 「もうダメ……っあああ！」
PRINTFORML 「きゃあっ！あぶないっ！」	PRINTFORML 「きゃあっ！あぶないっ！」
PRINTFORML 「ぁぁ………ぁぁっ…ぁ…」	PRINTFORML 「ぁぁ………ぁぁっ…ぁ…」
PRINTFORML (……何か…穣子ちゃんに)	PRINTFORML (……何か…穣子ちゃんに)
PRINTFORML 「必ず助けに戻るから……」	PRINTFORML 「必ず助けに戻るから……」
PRINTFORML 「ふぁ…おやすみなさい…」	PRINTFORML 「ふぁ…おやすみなさい…」
PRINTFORML 「おふとん……ほしいわ…」	PRINTFORML 「おふとん……ほしいわ…」
PRINTFORML 「……あ、もう交代なのね」	PRINTFORML 「……あ、もう交代なのね」
PRINTFORML 「意外と寝れなるものね…」	PRINTFORML 「意外と寝れなるものね…」
PRINTFORML 「いやっ！もういやぁあ！」	PRINTFORML 「いやっ！もういやぁあ！」
PRINTFORML 「………できちゃったの？」	PRINTFORML 「………できちゃったの？」
PRINTFORML 「思い切って…やあああ！」	PRINTFORML 「思い切って…やあああ！」
PRINTFORML 「今は身を潜めましょう…」	PRINTFORML 「今は身を潜めましょう…」
PRINTFORMW 「どうして……どうして…」	PRINTFORMW 「どうして……どうして…」
PRINTFORMW 「今…あいにいく…ね……」	PRINTFORMW 「今…あいにいく…ね……」
PRINTFORML 「誰でもいいの…助けて…」	PRINTFORML 「誰でもいいの…助けて…」
PRINTFORML 「着替え…あったわよね？」	PRINTFORML 「着替え…あったわよね？」
PRINTFORML 「裸は…さすがに…ぅぅぅ」	PRINTFORML 「裸は…さすがに…ぅぅぅ」
PRINTFORML 「だいぶ汚れちゃったわ…」	PRINTFORML 「だいぶ汚れちゃったわ…」
PRINTFORML 「ちょっと汚れちゃったわ」	PRINTFORML 「ちょっと汚れちゃったわ」
PRINTFORML 「ごめんね…穣子ちゃん…」	PRINTFORML 「ごめんね…穣子ちゃん…」
PRINTFORML 「今は進むしかないわね…」	PRINTFORML 「今は進むしかないわね…」
PRINTFORMDL 静葉のTPが0になった…	PRINTFORMDL 静葉のTPが0になった…
PRINTFORML 「ひっく…穣子ちゃん……」	PRINTFORML 「ひっく…穣子ちゃん……」
PRINTFORML 「許して……おねがい……」	PRINTFORML 「許して……おねがい……」
PRINTFORML 「おかあさん…助けて……」	PRINTFORML 「おかあさん…助けて……」
PRINTFORML (……あ…おかあさん…だ)	PRINTFORML (……あ…おかあさん…だ)
PRINTFORML 「外の世界、みてみたいわ」	PRINTFORML 「外の世界、みてみたいわ」
PRINTFORML 「さよなら……静葉さん…」	PRINTFORML 「さよなら……静葉さん…」
PRINTFORML 「外に出れるのかしら……」	PRINTFORML 「外に出れるのかしら……」
PRINTFORML 「おかあ……さん…なの？」	PRINTFORML 「おかあ……さん…なの？」
PRINTFORML 「ぼろぼろじゃない服…」	PRINTFORML 「ぼろぼろじゃない服…」
PRINTFORML 「これ、小さすぎるもの」	PRINTFORML 「これ、小さすぎるもの」
PRINTFORML 「いやっ！見ないでっ！」	PRINTFORML 「いやっ！見ないでっ！」
PRINTFORML 「下着まで……ぐすっ…」	PRINTFORML 「下着まで……ぐすっ…」
PRINTFORML 「早めに直さないと……」	PRINTFORML 「早めに直さないと……」
PRINTFORML 「肌が見えちゃう……！」	PRINTFORML 「肌が見えちゃう……！」
PRINTFORMW 『秋がきたああああ！！』	PRINTFORMW 『秋がきたああああ！！』
PRINTFORMDW 静葉は自分の耳を疑った	PRINTFORMDW 静葉は自分の耳を疑った
PRINTFORMDW 異変が解決して数ヶ月…	PRINTFORMDW 異変が解決して数ヶ月…
PRINTFORMW ((ええその通りね！))	PRINTFORMW ((ええその通りね！))
PRINTFORML では、よい触手ライフを…	PRINTFORML では、よい触手ライフを…
PRINTFORML 「秋の私は一味違うわ！」	PRINTFORML 「秋の私は一味違うわ！」
PRINTFORML 「全てを貫く秋の力よ！」	PRINTFORML 「全てを貫く秋の力よ！」
PRINTFORML 「ふぁ、息がつまって…」	PRINTFORML 「ふぁ、息がつまって…」
PRINTFORMDL 静葉の瞳に光が戻った！	PRINTFORMDL 静葉の瞳に光が戻った！
PRINTFORML 「相手が悪かったわね！」	PRINTFORML 「相手が悪かったわね！」
PRINTFORML 「だれかいるのかしら？」	PRINTFORML 「だれかいるのかしら？」
PRINTFORML 「はぁっ！秋忍び足！！」	PRINTFORML 「はぁっ！秋忍び足！！」
PRINTFORML 「秋アイテムはどこ！？」	PRINTFORML 「秋アイテムはどこ！？」
PRINTFORML 「いたたたたたたた！？」	PRINTFORML 「いたたたたたたた！？」
PRINTFORML 「秋パワーがたりない…」	PRINTFORML 「秋パワーがたりない…」
PRINTFORML (うう、ムズムズするぅ)	PRINTFORML (うう、ムズムズするぅ)
PRINTFORML 「お願い…来ないで……」	PRINTFORML 「お願い…来ないで……」
PRINTFORML 「ど、道具を使えば……」	PRINTFORML 「ど、道具を使えば……」
PRINTFORML 「少しでもいい位置に…」	PRINTFORML 「少しでもいい位置に…」
PRINTFORML 「……いやっ！怖いっ！」	PRINTFORML 「……いやっ！怖いっ！」
PRINTFORML 「誰か…誰か助けて……」	PRINTFORML 「誰か…誰か助けて……」
PRINTFORML 「お願い……当たって…」	PRINTFORML 「お願い……当たって…」
PRINTFORML 「スペルカード発動ッ！」	PRINTFORML 「スペルカード発動ッ！」
PRINTFORML 「吐き出し…きゃぁ！？」	PRINTFORML 「吐き出し…きゃぁ！？」
PRINTFORML 「出して…出れそう…？」	PRINTFORML 「出して…出れそう…？」
PRINTFORML 「ぁ……ぁぁ…誰か……」	PRINTFORML 「ぁ……ぁぁ…誰か……」
PRINTFORML 「ひっく……えっく……」	PRINTFORML 「ひっく……えっく……」
PRINTFORML 「……やだ…もうやだぁ」	PRINTFORML 「……やだ…もうやだぁ」
PRINTFORML 「どうして…こんな……」	PRINTFORML 「どうして…こんな……」
PRINTFORML 「ぅぅぅ…こんなのって…	PRINTFORML 「ぅぅぅ…こんなのって…
PRINTFORML 「げほっ……許して……」	PRINTFORML 「げほっ……許して……」
PRINTFORML 「もう痛いのいやっ……」	PRINTFORML 「もう痛いのいやっ……」
PRINTFORML 「もう…動かないで……」	PRINTFORML 「もう…動かないで……」
PRINTFORML (目の前が…かすむ……)	PRINTFORML (目の前が…かすむ……)
PRINTFORML 「お願いっ！助けてぇ！」	PRINTFORML 「お願いっ！助けてぇ！」
PRINTFORML 「み……みの……ぁぁ…」	PRINTFORML 「み……みの……ぁぁ…」
PRINTFORML 「大丈夫？怪我はない？」	PRINTFORML 「大丈夫？怪我はない？」
PRINTFORML 「私が知ってることは…」	PRINTFORML 「私が知ってることは…」
PRINTFORML 「情報交換しましょうか」	PRINTFORML 「情報交換しましょうか」
PRINTFORML 「早く外にでたいわね…」	PRINTFORML 「早く外にでたいわね…」
PRINTFORML 「とっても助かります…」	PRINTFORML 「とっても助かります…」
PRINTFORML 「もう、もうやだぁあ！」	PRINTFORML 「もう、もうやだぁあ！」
PRINTFORM 「やっ…だめ…ぁ…ぁぁ……	PRINTFORM 「やっ…だめ…ぁ…ぁぁ……
PRINTFORML 「さあ、綺麗にするわよ」	PRINTFORML 「さあ、綺麗にするわよ」
PRINTFORML 「もう…疲れちゃった…」	PRINTFORML 「もう…疲れちゃった…」
PRINTFORML 「痛い…産まれそう……」	PRINTFORML 「痛い…産まれそう……」
PRINTFORML 「気付薬…使わないと…」	PRINTFORML 「気付薬…使わないと…」
PRINTFORML 「穣子ちゃん…大丈夫？」	PRINTFORML 「穣子ちゃん…大丈夫？」
PRINTFORML 「…え……や、いや！？」	PRINTFORML 「…え……や、いや！？」
PRINTFORML 「や、やだ…！えっち！」	PRINTFORML 「や、やだ…！えっち！」
PRINTFORML 「情報交換しましょうね」	PRINTFORML 「情報交換しましょうね」
PRINTFORMW 「外の世界…秋の景色…」	PRINTFORMW 「外の世界…秋の景色…」
PRINTFORML 「はやく着替えたい…」	PRINTFORML 「はやく着替えたい…」
PRINTFORML 「やだぁ……ぐすっ…」	PRINTFORML 「やだぁ……ぐすっ…」
PRINTFORMW 「よかった…無事で…」	PRINTFORMW 「よかった…無事で…」
PRINTFORMDW ついに秋がやってきた	PRINTFORMDW ついに秋がやってきた
PRINTFORMW (そうだその通りだ！)	PRINTFORMW (そうだその通りだ！)
PRINTFORML 「秋リザレクション！」	PRINTFORML 「秋リザレクション！」
PRINTFORML 「でもっ！でもよっ！」	PRINTFORML 「でもっ！でもよっ！」
PRINTFORML 「…は、離れなきゃ！」	PRINTFORML 「…は、離れなきゃ！」
PRINTFORML 「えいっ！えいっ…！」	PRINTFORML 「えいっ！えいっ…！」
PRINTFORML 「しっかり頑張れば…」	PRINTFORML 「しっかり頑張れば…」
PRINTFORML 「近づかないでーー！」	PRINTFORML 「近づかないでーー！」
PRINTFORML 「出して！お願い…！」	PRINTFORML 「出して！お願い…！」
PRINTFORML 「はぁっ…はぁっ……」	PRINTFORML 「はぁっ…はぁっ……」
PRINTFORML 「ぅぅ…出してぇ……」	PRINTFORML 「ぅぅ…出してぇ……」
PRINTFORML 「この調子…なら……」	PRINTFORML 「この調子…なら……」
PRINTFORML 「ち、近づかないで！」	PRINTFORML 「ち、近づかないで！」
PRINTFORML 「いや………やめて…」	PRINTFORML 「いや………やめて…」
PRINTFORML 「もう……ダメ………」	PRINTFORML 「もう……ダメ………」
PRINTFORML 「きゃっ…服がっ！？」	PRINTFORML 「きゃっ…服がっ！？」
PRINTFORML 「きゃぁああああ！？」	PRINTFORML 「きゃぁああああ！？」
PRINTFORML 「え……どうして…？」	PRINTFORML 「え……どうして…？」
PRINTFORML 「もう…帰りたい……」	PRINTFORML 「もう…帰りたい……」
PRINTFORML 「人……？妖怪……？」	PRINTFORML 「人……？妖怪……？」
PRINTFORML 「嬉しい…怖かった…」	PRINTFORML 「嬉しい…怖かった…」
PRINTFORML 「もう…これ以上は…」	PRINTFORML 「もう…これ以上は…」
PRINTFORML 「おふとんが恋しい…」	PRINTFORML 「おふとんが恋しい…」
PRINTFORML 「このお礼はいつか…」	PRINTFORML 「このお礼はいつか…」
PRINTFORML 「誰か……助けて……」	PRINTFORML 「誰か……助けて……」
PRINTFORML 「いやぁああああ！！」	PRINTFORML 「いやぁああああ！！」
PRINTFORML 「せめて今が秋なら…」	PRINTFORML 「せめて今が秋なら…」
PRINTFORML 「……もう…ダメかも」	PRINTFORML 「……もう…ダメかも」
PRINTFORML 「もう…眠気が限界…」	PRINTFORML 「もう…眠気が限界…」
PRINTFORML 「ふぁぁ…眠いわ……」	PRINTFORML 「ふぁぁ…眠いわ……」
PRINTFORML 「着替え…ないかしら」	PRINTFORML 「着替え…ないかしら」
PRINTFORML 「穣子ちゃん大丈夫？」	PRINTFORML 「穣子ちゃん大丈夫？」
PRINTFORML 「早く脱出したいわね」	PRINTFORML 「早く脱出したいわね」
PRINTFORML 「出口…どこかしら？」	PRINTFORML 「出口…どこかしら？」
PRINTFORML 「帰れるのかしら……」	PRINTFORML 「帰れるのかしら……」
PRINTFORML 「嘘でしょ…ねえ……」	PRINTFORML 「嘘でしょ…ねえ……」
PRINT_SEARCH_INFO_2を流用	PRINT_SEARCH_INFO_2を流用
PRINTFORMW 「いやあぁあああ！！」	PRINTFORMW 「いやあぁあああ！！」
PRINTFORML 「私…神様なのに…」	PRINTFORML 「私…神様なのに…」
PRINTFORML 「服が…ひどい……」	PRINTFORML 「服が…ひどい……」
PRINTFORMDW これで一緒に帰れる	PRINTFORMDW これで一緒に帰れる
PRINTFORMDW そして悲鳴をあげた	PRINTFORMDW そして悲鳴をあげた
PRINTFORMDW 『へーそーふーん』	PRINTFORMDW 『へーそーふーん』
PRINTFORMDW 『わあい超嬉しい』	PRINTFORMDW 『わあい超嬉しい』
PRINTFORML 「あ……もうダメ♪」	PRINTFORML 「あ……もうダメ♪」
PRINTFORML 「お・あ・ず・け♪」	PRINTFORML 「お・あ・ず・け♪」
PRINTFORML 「秋回避！秋回避！」	PRINTFORML 「秋回避！秋回避！」
PRINTFORML 「な、何かしら…？」	PRINTFORML 「な、何かしら…？」
PRINTFORMW 「秋がある限り……」	PRINTFORMW 「秋がある限り……」
PRINTFORMW 「魂は……不滅……」	PRINTFORMW 「魂は……不滅……」
PRINTFORML 「今のうちに……！」	PRINTFORML 「今のうちに……！」
PRINTFORML そして再び力尽きた…	PRINTFORML そして再び力尽きた…
PRINTFORML 「うう、べたべたよ」	PRINTFORML 「うう、べたべたよ」
PRINTFORML 「怖いけど…でも…」	PRINTFORML 「怖いけど…でも…」
PRINTFORML 「もう無理ですっ…」	PRINTFORML 「もう無理ですっ…」
PRINTFORML 「このぉ！きゃっ！」	PRINTFORML 「このぉ！きゃっ！」
PRINTFORML 「出れ…たの……？」	PRINTFORML 「出れ…たの……？」
PRINTFORML 「ぁ……ぁぁ………」	PRINTFORML 「ぁ……ぁぁ………」
PRINTFORML 「もう……ダメ……」	PRINTFORML 「もう……ダメ……」
PRINTFORML 「きゃぁ･･･！？」	PRINTFORML 「きゃぁ･･･！？」
PRINTFORML 「いやっいやぁっ！」	PRINTFORML 「いやっいやぁっ！」
PRINTFORML 「また……ふふっ…」	PRINTFORML 「また……ふふっ…」
PRINTFORML 「痛いッ！痛いぃ！」	PRINTFORML 「痛いッ！痛いぃ！」
PRINTFORML 「痛いっ、痛いっ！」	PRINTFORML 「痛いっ、痛いっ！」
PRINTFORML 「服……破けて……」	PRINTFORML 「服……破けて……」
PRINTFORML 「まだ…続けるの？」	PRINTFORML 「まだ…続けるの？」
PRINTFORML 「や、やめなさい！」	PRINTFORML 「や、やめなさい！」
PRINTFORML 「誰か…助けて……」	PRINTFORML 「誰か…助けて……」
PRINTFORML 「た、たおしたっ！」	PRINTFORML 「た、たおしたっ！」
PRINTFORML 「たおせた…の…？」	PRINTFORML 「たおせた…の…？」
PRINTFORML 「穣子ちゃん………」	PRINTFORML 「穣子ちゃん………」
PRINTFORML 「ここまで……ね…」	PRINTFORML 「ここまで……ね…」
PRINTFORML （やっと見つけた…）	PRINTFORML （やっと見つけた…）
PRINTFORML (誰かいるの……？)	PRINTFORML (誰かいるの……？)
PRINTFORML 「おやすみなさい…」	PRINTFORML 「おやすみなさい…」
PRINTFORML 「覚悟を決めて……」	PRINTFORML 「覚悟を決めて……」
PRINTFORML 「ありが……とう…」	PRINTFORML 「ありが……とう…」
PRINTFORML 「たすか…ったの？」	PRINTFORML 「たすか…ったの？」
PRINTFORML 「髪の毛ぼさぼさ…」	PRINTFORML 「髪の毛ぼさぼさ…」
PRINTFORML 「すごいにおい……」	PRINTFORML 「すごいにおい……」
PRINTFORML 「はぁ……心配ね…」	PRINTFORML 「はぁ……心配ね…」
PRINTFORML 「ごめん…なさい…」	PRINTFORML 「ごめん…なさい…」
PRINTFORML 「おかあさん………」	PRINTFORML 「おかあさん………」
PRINTFORML 「おか…あさん…？」	PRINTFORML 「おか…あさん…？」
PRINTFORML 「えへへ…なあに？」	PRINTFORML 「えへへ…なあに？」
PRINTFORMW 「穣子ちゃん！？」	PRINTFORMW 「穣子ちゃん！？」
PRINTFORMDW 以上が建前である	PRINTFORMDW 以上が建前である
PRINTFORMW 「穣子ちゃん……」	PRINTFORMW 「穣子ちゃん……」
PRINTFORML 「冬が…冬が……」	PRINTFORML 「冬が…冬が……」
PRINTFORML 「……まだ眠いわ」	PRINTFORML 「……まだ眠いわ」
PRINTFORMDL だが静葉は涙目だ	PRINTFORMDL だが静葉は涙目だ
PRINTFORML 「いい秋してる？」	PRINTFORML 「いい秋してる？」
PRINTFORML 「……ぅぅぅぅぅ」	PRINTFORML 「……ぅぅぅぅぅ」
PRINTFORML 「早く寝たいわ…」	PRINTFORML 「早く寝たいわ…」
PRINTFORML （休憩したい……）	PRINTFORML （休憩したい……）
PRINTFORML 「みちゃヤです…」	PRINTFORML 「みちゃヤです…」
PRINTFORML 「もうイヤァァ！」	PRINTFORML 「もうイヤァァ！」
PRINTFORML 「集中…集中……」	PRINTFORML 「集中…集中……」
PRINTFORML 「あたって……！」	PRINTFORML 「あたって……！」
PRINTFORML 「はぁ…はぁ……」	PRINTFORML 「はぁ…はぁ……」
PRINTFORML 「う……くぅ……」	PRINTFORML 「う……くぅ……」
PRINTFORML 「ぁ……ぅぁ……」	PRINTFORML 「ぁ……ぅぁ……」
PRINTFORML 「ーーーーっ！！」	PRINTFORML 「ーーーーっ！！」
PRINTFORML 「……死んじゃう」	PRINTFORML 「……死んじゃう」
PRINTFORML 「服っ…破け……」	PRINTFORML 「服っ…破け……」
PRINTFORML 「気持ち悪い…！」	PRINTFORML 「気持ち悪い…！」
PRINTFORML 「ふぇえええ！？」	PRINTFORML 「ふぇえええ！？」
PRINTFORML 「あ……ぁぁ……」	PRINTFORML 「あ……ぁぁ……」
PRINTFORML 「穣子ちゃん！？」	PRINTFORML 「穣子ちゃん！？」
PRINTFORML 「私でいいの…？」	PRINTFORML 「私でいいの…？」
PRINTFORML 「二手に…ですね」	PRINTFORML 「二手に…ですね」
PRINTFORML 「お腹…くるし…」	PRINTFORML 「お腹…くるし…」
PRINTFORML 「ぁ…ぁあぁ！？」	PRINTFORML 「ぁ…ぁあぁ！？」
PRINTFORML 「ふぁあぁあ！？」	PRINTFORML 「ふぁあぁあ！？」
PRINTFORML 「……あ…あら？」	PRINTFORML 「……あ…あら？」
PRINTFORML 「逃げなくちゃ…」	PRINTFORML 「逃げなくちゃ…」
PRINTFORML 「……無事でいて」	PRINTFORML 「……無事でいて」
PRINTFORML 「調子…悪いわ…」	PRINTFORML 「調子…悪いわ…」
PRINTFORML 「もう、散々ね…」	PRINTFORML 「もう、散々ね…」
PRINTFORML 「穣子ちゃん……」	PRINTFORML 「穣子ちゃん……」
PRINTFORML 「痛い…痛い……」	PRINTFORML 「痛い…痛い……」
PRINTFORML 「ぅ…ぅぅん……」	PRINTFORML 「ぅ…ぅぅん……」
PRINTFORML 「おかあさんだ！」	PRINTFORML 「おかあさんだ！」
PRINTFORML 「おかーさーん！」	PRINTFORML 「おかーさーん！」
PRINTFORML 「いつもの服…」	PRINTFORML 「いつもの服…」
PRINTFORML 「え？え？え？」	PRINTFORML 「え？え？え？」
PRINTFORML 「もう穴が！？」	PRINTFORML 「もう穴が！？」
PRINTFORMW 「どうしたの？」	PRINTFORMW 「どうしたの？」
PRINTFORMDW 『ただいま…』	PRINTFORMDW 『ただいま…』
PRINTFORMDW それから数年後	PRINTFORMDW それから数年後
PRINTFORMDW 「逃げて！！」	PRINTFORMDW 「逃げて！！」
PRINTFORMDW 『おかあさん』	PRINTFORMDW 『おかあさん』
PRINTFORMDL [1] 秋以外	PRINTFORMDL [1] 秋以外
PRINTFORMDL [1] いいえ	PRINTFORMDL [1] いいえ
PRINTFORML 「暴力の秋……」	PRINTFORML 「暴力の秋……」
PRINTFORML 「もみじっ！？」	PRINTFORML 「もみじっ！？」
PRINTFORML 「秋ですよー！」	PRINTFORML 「秋ですよー！」
PRINTFORML 「………ぁきぃ」	PRINTFORML 「………ぁきぃ」
PRINTFORML 「………………」	PRINTFORML 「………………」
PRINTFORML 「秋！最☆高！」	PRINTFORML 「秋！最☆高！」
PRINTFORML 「お、重い……」	PRINTFORML 「お、重い……」
PRINTFORML 「んんんっ！？」	PRINTFORML 「んんんっ！？」
PRINTFORML 「は、離して！」	PRINTFORML 「は、離して！」
PRINTFORML 「怖かった……」	PRINTFORML 「怖かった……」
PRINTFORML 「限界……よ…」	PRINTFORML 「限界……よ…」
PRINTFORML 「……めまいが」	PRINTFORML 「……めまいが」
PRINTFORML 「と、突撃ー！」	PRINTFORML 「と、突撃ー！」
PRINTFORML 「そーっと……」	PRINTFORML 「そーっと……」
PRINTFORML 「よかった……」	PRINTFORML 「よかった……」
PRINTFORMW 「穣子ちゃん…」	PRINTFORMW 「穣子ちゃん…」
PRINTFORML 「………ぁぁぁ」	PRINTFORML 「………ぁぁぁ」
PRINTFORML 「穣子ちゃん…」	PRINTFORML 「穣子ちゃん…」
PRINTFORML 「ん………え？」	PRINTFORML 「ん………え？」
PRINTFORML 「もう無理っ…」	PRINTFORML 「もう無理っ…」
PRINTFORMW 「おかあさん…」	PRINTFORMW 「おかあさん…」
PRINTFORMDW 「まって！」	PRINTFORMDW 「まって！」
PRINTFORMDW 『えへへー』	PRINTFORMDW 『えへへー』
PRINTFORMDL 今の季節は？	PRINTFORMDL 今の季節は？
PRINTFORMDL [0] はい	PRINTFORMDL [0] はい
PRINTFORML 「もう秋…？」	PRINTFORML 「もう秋…？」
PRINTFORML 「秋キック！」	PRINTFORML 「秋キック！」
PRINTFORML 「突撃よー！」	PRINTFORML 「突撃よー！」
PRINTFORML 「怖いっ……」	PRINTFORML 「怖いっ……」
PRINTFORML 「あ……ぁぁ」	PRINTFORML 「あ……ぁぁ」
PRINTFORML 「きゃあ！？」	PRINTFORML 「きゃあ！？」
PRINTFORML 「きゃああ！」	PRINTFORML 「きゃああ！」
PRINTFORML 「ぐすっ……」	PRINTFORML 「ぐすっ……」
PRINTFORML 「……ぐすっ」	PRINTFORML 「……ぐすっ」
PRINTFORML 「うーん……」	PRINTFORML 「うーん……」
PRINTFORML 「……ぅぅ」	PRINTFORML 「……ぅぅ」
PRINTFORML 「違う……」	PRINTFORML 「違う……」
PRINTFORML 「やるぞ！」	PRINTFORML 「やるぞ！」
PRINTFORML 「うくっ…」	PRINTFORML 「うくっ…」
PRINTFORML 「……んっ」	PRINTFORML 「……んっ」
PRINTFORML 「怖いっ…」	PRINTFORML 「怖いっ…」
PRINTFORML 「ひぃっ…」	PRINTFORML 「ひぃっ…」
PRINTFORML 「誰か……」	PRINTFORML 「誰か……」
PRINTFORML 「やめ……」	PRINTFORML 「やめ……」
PRINTFORML 「きゃあ！」	PRINTFORML 「きゃあ！」
PRINTFORML 「あ………」	PRINTFORML 「あ………」
PRINTFORML 「ひぃ！？」	PRINTFORML 「ひぃ！？」
PRINTFORML 「…交代ね」	PRINTFORML 「…交代ね」
PRINTFORML 「ひっ……」	PRINTFORML 「ひっ……」
PRINTFORML 「はぁ……」	PRINTFORML 「はぁ……」
PRINTFORMDW もう一発	PRINTFORMDW もう一発
PRINTFORMDW 何故か？	PRINTFORMDW 何故か？
PRINTFORMDL いらない	PRINTFORMDL いらない
PRINTFORML 「くぅ…」	PRINTFORML 「くぅ…」
PRINTFORML 「………」	PRINTFORML 「………」
PRINTFORML 「あ……」	PRINTFORML 「あ……」
PRINTFORML 「穣子…」	PRINTFORML 「穣子…」
PRINTFORML 「…怖い」	PRINTFORML 「…怖い」
PRINTFORMDW ………	PRINTFORMDW ………
PRINTFORMW 「へ？」	PRINTFORMW 「へ？」
PRINTFORML 「……」	PRINTFORML 「……」
PRINTFORMDW ……	PRINTFORMDW ……
PRINTFORMW ………	PRINTFORMW ………
PRINTFORMDL …？	PRINTFORMDL …？
PRINTFORML 「？」	PRINTFORML 「？」
PRINTFORMDW …	PRINTFORMDW …
PRINTFORMW ……	PRINTFORMW ……
PRINTFORMDL 	PRINTFORMDL 
PRINTFORMDL		PRINTFORMDL	
PRINTFORMW …	PRINTFORMW …
PRINTFORMDW 	PRINTFORMDW 
PRINTFORML 」	PRINTFORML 」
PRINTFORML 	PRINTFORML 
PRINTFORMDL	PRINTFORMDL
PRINTFORML	PRINTFORML
PRINTL	PRINTL
