//口上:

PRINTFORML 「いっそ果物で隠したら……だめよ、そんな盛り方！迷宮がいかがわしいお店になってしまうわ！」	PRINTFORML 「いっそ果物で隠したら……だめよ、そんな盛り方！迷宮がいかがわしいお店になってしまうわ！」
PRINTFORML 「私は秋の神。さあ、迷える子羊よ！これまでの秋に関する行いを思う存分告白していいのよ！」	PRINTFORML 「私は秋の神。さあ、迷える子羊よ！これまでの秋に関する行いを思う存分告白していいのよ！」
PRINTFORMDL 目を覚ましたらめんどくさそうだと思いながらも%CALLNAME:1%は穣子の手を取った	PRINTFORMDL 目を覚ましたらめんどくさそうだと思いながらも%CALLNAME:1%は穣子の手を取った
PRINTFORML (この手の迷宮は、歩くたびに秋パワーがチャージされるんでしょ……。緑の巫女が言ってた)	PRINTFORML (この手の迷宮は、歩くたびに秋パワーがチャージされるんでしょ……。緑の巫女が言ってた)
PRINTFORML 「こうなったら逆転の八つ裂きを狙うしか……。スイートポテトォ、スライサァァァァッ！」	PRINTFORML 「こうなったら逆転の八つ裂きを狙うしか……。スイートポテトォ、スライサァァァァッ！」
PRINTFORMDL そう判断した%CALLNAME:1%は静かになるし穣子をおいていくことにした……	PRINTFORMDL そう判断した%CALLNAME:1%は静かになるし穣子をおいていくことにした……
PRINTFORML 「さあ、今のうちに私ごとチェーンソーで！……あー、痛そうだから他の手でお願い！」	PRINTFORML 「さあ、今のうちに私ごとチェーンソーで！……あー、痛そうだから他の手でお願い！」
PRINTFORML 「……ごめんなさい。私が許しても、秋の秩序があなたたちの存在を許さなかったの」	PRINTFORML 「……ごめんなさい。私が許しても、秋の秩序があなたたちの存在を許さなかったの」
PRINTFORML 「リン・ビョウ・トウ・シャ・コン・デン・エイ・ネン・シ・ザイｌ！……はぁっ！」	PRINTFORML 「リン・ビョウ・トウ・シャ・コン・デン・エイ・ネン・シ・ザイｌ！……はぁっ！」
PRINTFORML 「秋の栄養の塊である私を利用しようというのね！賢明な作戦だけど最低よ！」	PRINTFORML 「秋の栄養の塊である私を利用しようというのね！賢明な作戦だけど最低よ！」
PRINTFORML 「ここは私が引き受けるわ！でも、賞味期限が切れるまでに助けに来てね！」	PRINTFORML 「ここは私が引き受けるわ！でも、賞味期限が切れるまでに助けに来てね！」
PRINTFORML 「リン・ビョウ・トウ・シャ・ハン・デン・シュウ・ジュ！……はぁっ！」	PRINTFORML 「リン・ビョウ・トウ・シャ・ハン・デン・シュウ・ジュ！……はぁっ！」
PRINTFORML 「どうして種まきと同時に実ってるのよ！こんなのズルっこでしょ！？」	PRINTFORML 「どうして種まきと同時に実ってるのよ！こんなのズルっこでしょ！？」
PRINTFORML 「収穫量増加。サバイバリティ溢れる私の秋パワーは魅力的だものね！」	PRINTFORML 「収穫量増加。サバイバリティ溢れる私の秋パワーは魅力的だものね！」
PRINTFORML 「私の豊穣なる肢体をいつまでも晒しているわけにもいかないのだけど」	PRINTFORML 「私の豊穣なる肢体をいつまでも晒しているわけにもいかないのだけど」
PRINTFORML 「春の眠さも、夏の暑さも、冬の寒さも、全部耐えてきたんだから！」	PRINTFORML 「春の眠さも、夏の暑さも、冬の寒さも、全部耐えてきたんだから！」
PRINTFORML 「えっ？ウソでしょ、もう実り始めたの！？神の私の許可も得ずに？」	PRINTFORML 「えっ？ウソでしょ、もう実り始めたの！？神の私の許可も得ずに？」
PRINTFORML 「神様だって怯えるに決まってるでしょ。なんなのよ、あいつらは！」	PRINTFORML 「神様だって怯えるに決まってるでしょ。なんなのよ、あいつらは！」
PRINTFORMDL そう突如叫び立ち上がった穣子だがすぐにバタリと倒れてしまった…	PRINTFORMDL そう突如叫び立ち上がった穣子だがすぐにバタリと倒れてしまった…
PRINTFORML 「この根性が腐り切った迷宮を、土壌から秋改築してやるんだから…」	PRINTFORML 「この根性が腐り切った迷宮を、土壌から秋改築してやるんだから…」
PRINTFORMDL もちろん秋姉妹のテンションが荒ぶり狂気に満ちる秋ですよねー！	PRINTFORMDL もちろん秋姉妹のテンションが荒ぶり狂気に満ちる秋ですよねー！
PRINTFORML 「さあ、ありがたく踏まれなさい！敵性農家の農作物のようにね！」	PRINTFORML 「さあ、ありがたく踏まれなさい！敵性農家の農作物のようにね！」
PRINTFORML 「め、めくっていいのは秋へのカウントダウンカレンダーだけよ！」	PRINTFORML 「め、めくっていいのは秋へのカウントダウンカレンダーだけよ！」
PRINTFORML 「愛が花咲く麦ばーたーけー……って、そんなわけあるかバカー！」	PRINTFORML 「愛が花咲く麦ばーたーけー……って、そんなわけあるかバカー！」
PRINTFORMDL 完全に燃え尽きて力尽きた穣子を守りながら探索は出来そうにない	PRINTFORMDL 完全に燃え尽きて力尽きた穣子を守りながら探索は出来そうにない
PRINTFORML 「……秋パワーが切れてきた今の私じゃ、役に立てそうにないから」	PRINTFORML 「……秋パワーが切れてきた今の私じゃ、役に立てそうにないから」
PRINTFORML 「最後の悪あがきになるかもね……。いけ！技の木枯らし１号！」	PRINTFORML 「最後の悪あがきになるかもね……。いけ！技の木枯らし１号！」
PRINTFORML 「私よりも、赤とんぼでも捕まえたほうが楽しいんじゃない！？」	PRINTFORML 「私よりも、赤とんぼでも捕まえたほうが楽しいんじゃない！？」
PRINTFORML 「うーん、私が様子を見てくるわ。あなたはここでじっとしてて」	PRINTFORML 「うーん、私が様子を見てくるわ。あなたはここでじっとしてて」
PRINTFORML 「あなたの判断は正しいわ！これからが秋のチュートリアルよ！」	PRINTFORML 「あなたの判断は正しいわ！これからが秋のチュートリアルよ！」
PRINTFORML 「桃色果実が溢れちゃう♥ ど、どこかで間引きしないとぉ♥」	PRINTFORML 「桃色果実が溢れちゃう♥ ど、どこかで間引きしないとぉ♥」
PRINTFORML 「ズタズタにされて、体中から液漏れ放水を始めるといいわ！」	PRINTFORML 「ズタズタにされて、体中から液漏れ放水を始めるといいわ！」
PRINTFORML 「武器の扱い方？収穫祭の流鏑馬で覚えたわ！ハイヤァーッ！」	PRINTFORML 「武器の扱い方？収穫祭の流鏑馬で覚えたわ！ハイヤァーッ！」
PRINTFORML 「落ち着いて小さい秋の数を数えれば、次でどうにかなるはず」	PRINTFORML 「落ち着いて小さい秋の数を数えれば、次でどうにかなるはず」
PRINTFORML 「いつまでもそうやってムギムギできるとは思わないことね！」	PRINTFORML 「いつまでもそうやってムギムギできるとは思わないことね！」
PRINTFORML 「……どうやら擦りっ擦りの触手おろしで反撃されたいようね」	PRINTFORML 「……どうやら擦りっ擦りの触手おろしで反撃されたいようね」
PRINTFORML 「手遅れだとしても、このまま収穫なんてさせるわけには……」	PRINTFORML 「手遅れだとしても、このまま収穫なんてさせるわけには……」
PRINTFORML 「ぜーはー……秋モードじゃなかったら逃げきれたかどうか…」	PRINTFORML 「ぜーはー……秋モードじゃなかったら逃げきれたかどうか…」
PRINTFORMDL 冬が…冬が…と虚ろな瞳で呟く穣子を放置することはできない	PRINTFORMDL 冬が…冬が…と虚ろな瞳で呟く穣子を放置することはできない
PRINTFORML 「う、うぅぅ…秋だからって、調子に乗りすぎだったのかな…」	PRINTFORML 「う、うぅぅ…秋だからって、調子に乗りすぎだったのかな…」
PRINTFORML 「オータムパワァァ！エキストリームマックスーーーッ！！」	PRINTFORML 「オータムパワァァ！エキストリームマックスーーーッ！！」
PRINTFORML 「わ、わたしよりスレンダーな静葉姉さんの方が良くない？」	PRINTFORML 「わ、わたしよりスレンダーな静葉姉さんの方が良くない？」
PRINTFORML 「え、えーと。ここはどこ！？地底？それとも季節の狭間？」	PRINTFORML 「え、えーと。ここはどこ！？地底？それとも季節の狭間？」
PRINTFORML 「うーん、整地をつづければ外に出れるとおもったのだけど」	PRINTFORML 「うーん、整地をつづければ外に出れるとおもったのだけど」
PRINTFORMDL 秋を背負った宿命の二人に、今、紅色の戦いの時来たる。	PRINTFORMDL 秋を背負った宿命の二人に、今、紅色の戦いの時来たる。
PRINTFORML 「さあ、存分に見るがいいわ！秋に似合う農具の活躍を！」	PRINTFORML 「さあ、存分に見るがいいわ！秋に似合う農具の活躍を！」
PRINTFORML 「ハメ技ってのはこうやってやるのよ！マッハふみふみ！」	PRINTFORML 「ハメ技ってのはこうやってやるのよ！マッハふみふみ！」
PRINTFORML 「収穫はタイミング勝負。早すぎても遅すぎても駄目……」	PRINTFORML 「収穫はタイミング勝負。早すぎても遅すぎても駄目……」
PRINTFORMDL 穣子は言葉にならない声をあげ全身を痙攣させている……	PRINTFORMDL 穣子は言葉にならない声をあげ全身を痙攣させている……
PRINTFORML 「秋ステルスのはずが、香りで位置がばれちゃってる！？」	PRINTFORML 「秋ステルスのはずが、香りで位置がばれちゃってる！？」
PRINTFORML 「全裸のまま畑で野晒しなんて、まっぴらごめんだもの！」	PRINTFORML 「全裸のまま畑で野晒しなんて、まっぴらごめんだもの！」
PRINTFORML 「対人友好度トップクラスの私が来たからにはもう安心！」	PRINTFORML 「対人友好度トップクラスの私が来たからにはもう安心！」
PRINTFORML 「ここは秋リーサルツインで二手に分かれるべきみたい！」	PRINTFORML 「ここは秋リーサルツインで二手に分かれるべきみたい！」
PRINTFORML 「秋チュートリアルはこれでいったんおしまい。またね！」	PRINTFORML 「秋チュートリアルはこれでいったんおしまい。またね！」
PRINTFORML 「香りにつられてのこのこやってきたところを……ふふっ」	PRINTFORML 「香りにつられてのこのこやってきたところを……ふふっ」
PRINTFORML 「温泉の秋！健康の秋！フルーツ牛乳も準備おっけーよ！」	PRINTFORML 「温泉の秋！健康の秋！フルーツ牛乳も準備おっけーよ！」
PRINTFORML 「この防御を崩せたカラスは、一羽たりともいないわ！」	PRINTFORML 「この防御を崩せたカラスは、一羽たりともいないわ！」
PRINTFORML 「安心なさい！秋は逃げない。また巡ってくるものよ！」	PRINTFORML 「安心なさい！秋は逃げない。また巡ってくるものよ！」
PRINTFORML 「もう後がないかもね……。いけ！力の木枯らし２号！」	PRINTFORML 「もう後がないかもね……。いけ！力の木枯らし２号！」
PRINTFORML 「千の刃よ、邪悪を切り裂け！農符『千刃コキコキ』！」	PRINTFORML 「千の刃よ、邪悪を切り裂け！農符『千刃コキコキ』！」
PRINTFORMDL 穣子はだらしなく顔をゆるませ甘えるような声をあげた	PRINTFORMDL 穣子はだらしなく顔をゆるませ甘えるような声をあげた
PRINTFORML 「秋…それは時たま情熱的に神をも狂わせる魔性の季節」	PRINTFORML 「秋…それは時たま情熱的に神をも狂わせる魔性の季節」
PRINTFORML 「私の秋パワーを吸い取ろうなんて罰当たりな化物ね！」	PRINTFORML 「私の秋パワーを吸い取ろうなんて罰当たりな化物ね！」
PRINTFORML 「農薬の効果が残っているけど♥ やってみるしか♥」	PRINTFORML 「農薬の効果が残っているけど♥ やってみるしか♥」
PRINTFORML 「わ、私は秋のテンションにやられてなんて事を……」	PRINTFORML 「わ、私は秋のテンションにやられてなんて事を……」
PRINTFORML 「いっちゃう♥ イっちゃう♥♥ イッちゃう♥♥♥」	PRINTFORML 「いっちゃう♥ イっちゃう♥♥ イッちゃう♥♥♥」
PRINTFORML 「……静葉お姉……ちゃん、離れたく……ないよ……」	PRINTFORML 「……静葉お姉……ちゃん、離れたく……ないよ……」
PRINTFORML 「……見られて恥ずかしい体はしてないつもりだけど」	PRINTFORML 「……見られて恥ずかしい体はしてないつもりだけど」
PRINTFORML 「私の能力を言ってみなさい！この植物崩れどもが！」	PRINTFORML 「私の能力を言ってみなさい！この植物崩れどもが！」
PRINTFORML 「香水のせいで敵に気づかれたらどうしようかしら…」	PRINTFORML 「香水のせいで敵に気づかれたらどうしようかしら…」
PRINTFORML 「んー、お風呂に浮かべたい果実はあったかしら……」	PRINTFORML 「んー、お風呂に浮かべたい果実はあったかしら……」
PRINTFORML 「今までありがとう。またお互い無事であいたいわね」	PRINTFORML 「今までありがとう。またお互い無事であいたいわね」
PRINTFORML 「きゃっ！？果物はつぶれてないのに変なベタベタが」	PRINTFORML 「きゃっ！？果物はつぶれてないのに変なベタベタが」
PRINTFORML 「わたしぃ……ふぃ～……ムギムギ……ふゃ～……」	PRINTFORML 「わたしぃ……ふぃ～……ムギムギ……ふゃ～……」
PRINTFORML 「はぁ……はぁ……あ、秋パワーが品切れ寸前ね…」	PRINTFORML 「はぁ……はぁ……あ、秋パワーが品切れ寸前ね…」
PRINTFORML 「くっ！持ちきれない秋パワーが溢れ出しちゃう！」	PRINTFORML 「くっ！持ちきれない秋パワーが溢れ出しちゃう！」
PRINTFORML 「ああっ、全自動ってこんなにも素晴らしいのね！」	PRINTFORML 「ああっ、全自動ってこんなにも素晴らしいのね！」
PRINTFORML 「いたずらが趣旨のお祭りもあるにはあるけど……」	PRINTFORML 「いたずらが趣旨のお祭りもあるにはあるけど……」
PRINTFORML 「こ、こんな農法は絶対に認めないんだからぁ……」	PRINTFORML 「こ、こんな農法は絶対に認めないんだからぁ……」
PRINTFORML （これ以上触らないで♥ もう完熟してるからぁ♥）	PRINTFORML （これ以上触らないで♥ もう完熟してるからぁ♥）
PRINTFORML 「信者以外の人は、あんまりじろじろ見ないで！！」	PRINTFORML 「信者以外の人は、あんまりじろじろ見ないで！！」
PRINTFORML 「稲穂でくすぐったら吐き出してくれないかな……」	PRINTFORML 「稲穂でくすぐったら吐き出してくれないかな……」
PRINTFORML 「まあ、あなたなら私がいなくても大丈夫でしょう」	PRINTFORML 「まあ、あなたなら私がいなくても大丈夫でしょう」
PRINTFORML 「耳を澄ませば聞こえるはずよ。そう！秋の音が！」	PRINTFORML 「耳を澄ませば聞こえるはずよ。そう！秋の音が！」
PRINTFORMDL 迷宮に秘められた人妖総苗床化計画の謎とは！？	PRINTFORMDL 迷宮に秘められた人妖総苗床化計画の謎とは！？
PRINTFORML 「私の秋から、簡単に逃げられると思わないで！」	PRINTFORML 「私の秋から、簡単に逃げられると思わないで！」
PRINTFORML 「ダメよ！そんな包装じゃ、果物が痛むでしょ！」	PRINTFORML 「ダメよ！そんな包装じゃ、果物が痛むでしょ！」
PRINTFORML 「ダメっ♥ これダメっ♥♥ ダメなのぉ♥♥♥」	PRINTFORML 「ダメっ♥ これダメっ♥♥ ダメなのぉ♥♥♥」
PRINTFORML 「そ、そこはあんたの畑じゃないでしょうに……」	PRINTFORML 「そ、そこはあんたの畑じゃないでしょうに……」
PRINTFORML 「……こんな奴らに肌を晒すことになるなんて！」	PRINTFORML 「……こんな奴らに肌を晒すことになるなんて！」
PRINTFORML 「秋！力！転！心！了！オータムチェンジャー！」	PRINTFORML 「秋！力！転！心！了！オータムチェンジャー！」
PRINTFORML 「は、早くどこかで果樹園の手入れをしないと♥」	PRINTFORML 「は、早くどこかで果樹園の手入れをしないと♥」
PRINTFORML 「ぜーはー…つまみ食いなんて冗談じゃないわ…」	PRINTFORML 「ぜーはー…つまみ食いなんて冗談じゃないわ…」
PRINTFORML 「産地直送ダッシュがなければ危なかったかも…」	PRINTFORML 「産地直送ダッシュがなければ危なかったかも…」
PRINTFORML 「さあ！秋について！素晴らしい秋について！！」	PRINTFORML 「さあ！秋について！素晴らしい秋について！！」
PRINTFORML 「秋属性の敵は木っ端みじんにデストロイよ！！」	PRINTFORML 「秋属性の敵は木っ端みじんにデストロイよ！！」
PRINTFORML 「さあ、これからの土壌の浄化なら私に任せて！」	PRINTFORML 「さあ、これからの土壌の浄化なら私に任せて！」
PRINTFORML 「新たな信者の予感！　あ、気のせいだったわ！」	PRINTFORML 「新たな信者の予感！　あ、気のせいだったわ！」
PRINTFORML 「外に出たら秋が終わっていたら、どうしよう！」	PRINTFORML 「外に出たら秋が終わっていたら、どうしよう！」
PRINTFORML 「……奴らは神の力をも越えているというの！？」	PRINTFORML 「……奴らは神の力をも越えているというの！？」
PRINTFORML (どこかで落ち着いて果樹園耕作したいよぉ…♥)	PRINTFORML (どこかで落ち着いて果樹園耕作したいよぉ…♥)
PRINTFORML 「着替えとっとと使ってパーフェクト秋穣子に！」	PRINTFORML 「着替えとっとと使ってパーフェクト秋穣子に！」
PRINTFORML 「そろそろマジカルオータムチェンジをしたいわ」	PRINTFORML 「そろそろマジカルオータムチェンジをしたいわ」
PRINTFORML （えっちな香りになってたらどうしよう……♥）	PRINTFORML （えっちな香りになってたらどうしよう……♥）
PRINTFORML 「秋はね、状況の移り変わりが早い物なのよ！」	PRINTFORML 「秋はね、状況の移り変わりが早い物なのよ！」
PRINTFORML 「葡萄ならわけてあげるから、離してってば！」	PRINTFORML 「葡萄ならわけてあげるから、離してってば！」
PRINTFORML 「くるっ♥ なにかくるっ♥♥ あーッ♥♥♥」	PRINTFORML 「くるっ♥ なにかくるっ♥♥ あーッ♥♥♥」
PRINTFORML 「肥料に転生できるなんて、思わないことね！」	PRINTFORML 「肥料に転生できるなんて、思わないことね！」
PRINTFORML 「もう…気持ちいいことしか考えられない……」	PRINTFORML 「もう…気持ちいいことしか考えられない……」
PRINTFORML 「衣服につけておいた非常食が落ちてるっ！？」	PRINTFORML 「衣服につけておいた非常食が落ちてるっ！？」
PRINTFORML 「こちらこそ助かるわ！これからよろしくね！」	PRINTFORML 「こちらこそ助かるわ！これからよろしくね！」
PRINTFORML 「おなかの中の実りの気配が強まっていく……」	PRINTFORML 「おなかの中の実りの気配が強まっていく……」
PRINTFORML 「秋の作物しか育たない土地にしてあげるわ！」	PRINTFORML 「秋の作物しか育たない土地にしてあげるわ！」
PRINTFORMDL 穣子はふらつく足取りで必死に逃げ出した……	PRINTFORMDL 穣子はふらつく足取りで必死に逃げ出した……
PRINTFORML 「焦らないで！まだちゃんと焼けてないわ！」	PRINTFORML 「焦らないで！まだちゃんと焼けてないわ！」
PRINTFORML 「静葉姉さんと私、どちらに叱られたいの？」	PRINTFORML 「静葉姉さんと私、どちらに叱られたいの？」
PRINTFORML 「あ、秋がこなくなっちゃってもいいの！？」	PRINTFORML 「あ、秋がこなくなっちゃってもいいの！？」
PRINTFORML 「もうっ！変な匂いがついちゃうじゃない！」	PRINTFORML 「もうっ！変な匂いがついちゃうじゃない！」
PRINTFORML 「そんなに私の香りをスンスンしないでよ！」	PRINTFORML 「そんなに私の香りをスンスンしないでよ！」
PRINTFORML 「こうしている間にも貴重な秋タイムが……」	PRINTFORML 「こうしている間にも貴重な秋タイムが……」
PRINTFORML 「無理矢理、耕されるなんて絶対に嫌……！」	PRINTFORML 「無理矢理、耕されるなんて絶対に嫌……！」
PRINTFORML 「やめてよしてさわらないで発芽しちゃう！」	PRINTFORML 「やめてよしてさわらないで発芽しちゃう！」
PRINTFORML 「みなぎる秋の力！秋の使者オータム穣子！」	PRINTFORML 「みなぎる秋の力！秋の使者オータム穣子！」
PRINTFORML 「秋チュートリアルの受講者が来たようね！」	PRINTFORML 「秋チュートリアルの受講者が来たようね！」
PRINTFORML 「お芋を焼いたら、誰か来てくれないかなぁ」	PRINTFORML 「お芋を焼いたら、誰か来てくれないかなぁ」
PRINTFORMDL 穣子は濁った瞳でふらふらと立ち上がった…	PRINTFORMDL 穣子は濁った瞳でふらふらと立ち上がった…
PRINTFORML 「神様が…ここまで追い詰められるなんて…」	PRINTFORML 「神様が…ここまで追い詰められるなんて…」
PRINTFORML 「無理矢理収穫することも無理のようね……」	PRINTFORML 「無理矢理収穫することも無理のようね……」
PRINTFORML (どこかで……フルーツポンチつくろ……♥)	PRINTFORML (どこかで……フルーツポンチつくろ……♥)
PRINTFORML 「早めに着替えたほうがいいと思うけど……」	PRINTFORML 「早めに着替えたほうがいいと思うけど……」
PRINTFORML 「秋スコープ！着替えセットはどこなの！？」	PRINTFORML 「秋スコープ！着替えセットはどこなの！？」
PRINTFORMDL 運命が姉妹を導き、秋の神話は今、蘇る。	PRINTFORMDL 運命が姉妹を導き、秋の神話は今、蘇る。
PRINTFORML 「そういう農法を教えた覚えは……むにゃ」	PRINTFORML 「そういう農法を教えた覚えは……むにゃ」
PRINTFORML 「な、なんなの、この農薬の効果は……♥」	PRINTFORML 「な、なんなの、この農薬の効果は……♥」
PRINTFORML 「無謀な連作はダメ！違う畑にしなさい！」	PRINTFORML 「無謀な連作はダメ！違う畑にしなさい！」
PRINTFORML 「覚えてなさい！次は負けないんだから！」	PRINTFORML 「覚えてなさい！次は負けないんだから！」
PRINTFORML 「次に耕されたい奴から、前に出なさい！」	PRINTFORML 「次に耕されたい奴から、前に出なさい！」
PRINTFORML 「ひゃーん！一揆の力が私にも宿るわー！」	PRINTFORML 「ひゃーん！一揆の力が私にも宿るわー！」
PRINTFORML 「悔しい…こうも日干しにされるなんて…」	PRINTFORML 「悔しい…こうも日干しにされるなんて…」
PRINTFORML 「ムギムギもモギモギも駄目だってばぁ！」	PRINTFORML 「ムギムギもモギモギも駄目だってばぁ！」
PRINTFORML 「溢れる秋の力！秋の使者オータム穣子！」	PRINTFORML 「溢れる秋の力！秋の使者オータム穣子！」
PRINTFORMDL 誰かの弱々しい息遣いが聞えた気がした。	PRINTFORMDL 誰かの弱々しい息遣いが聞えた気がした。
PRINTFORML 「罠なんて無駄よ！はぁっ！秋忍び足！！」	PRINTFORML 「罠なんて無駄よ！はぁっ！秋忍び足！！」
PRINTFORML 「動けないときには……動かない勇気を！」	PRINTFORML 「動けないときには……動かない勇気を！」
PRINTFORML 「秋の夜は寝やすいはずよ！ね、寝よ？！」	PRINTFORML 「秋の夜は寝やすいはずよ！ね、寝よ？！」
PRINTFORML 「はぁ…はぁ……まだおかわりする気？」	PRINTFORML 「はぁ…はぁ……まだおかわりする気？」
PRINTFORML 「アンタ達の根っこ、すべて刈り取る！」	PRINTFORML 「アンタ達の根っこ、すべて刈り取る！」
PRINTFORML 「これがッ！ノンストップ秋メドレー！」	PRINTFORML 「これがッ！ノンストップ秋メドレー！」
PRINTFORML 「良くも秋の魅力あふれる私の衣装を！」	PRINTFORML 「良くも秋の魅力あふれる私の衣装を！」
PRINTFORML 「セオリー通りに皮を剥いてきたわね！」	PRINTFORML 「セオリー通りに皮を剥いてきたわね！」
PRINTFORML 「あーっ♥ あーっ♥♥ あーっ♥♥♥」	PRINTFORML 「あーっ♥ あーっ♥♥ あーっ♥♥♥」
PRINTFORML 「豊穣ってこういうことじゃないのに！」	PRINTFORML 「豊穣ってこういうことじゃないのに！」
PRINTFORML 「きょ、許可なくモギモギしないでよ！」	PRINTFORML 「きょ、許可なくモギモギしないでよ！」
PRINTFORML 「秋のターンはめぐりが早いわ！次っ！」	PRINTFORML 「秋のターンはめぐりが早いわ！次っ！」
PRINTFORML 「もうここまで脱穀が進んできてる！？」	PRINTFORML 「もうここまで脱穀が進んできてる！？」
PRINTFORML 「えっ♥ちょっとまって♥今はだめぇ♥」	PRINTFORML 「えっ♥ちょっとまって♥今はだめぇ♥」
PRINTFORML 「簡単に食べられてたまるもんですか！」	PRINTFORML 「簡単に食べられてたまるもんですか！」
PRINTFORML 「農具の一つでも見つかるといいけど！」	PRINTFORML 「農具の一つでも見つかるといいけど！」
PRINTFORML 「人里で約束したのよ……次の収穫……」	PRINTFORML 「人里で約束したのよ……次の収穫……」
PRINTFORMDL 穣子は口を何度もパクパクさせている…	PRINTFORMDL 穣子は口を何度もパクパクさせている…
PRINTFORML 「神様を拉致った事を後悔させてやるわ」	PRINTFORML 「神様を拉致った事を後悔させてやるわ」
PRINTFORML 「さすがに普段の仕事の方がマシよー！」	PRINTFORML 「さすがに普段の仕事の方がマシよー！」
PRINTFORML 「ゴールド秋ドレスが破壊されるとは…」	PRINTFORML 「ゴールド秋ドレスが破壊されるとは…」
PRINTFORML 「段々とこの迷宮にも慣れてきたかなぁ」	PRINTFORML 「段々とこの迷宮にも慣れてきたかなぁ」
PRINTFORML 「アンタ達の農作業は今期で廃業よ！」	PRINTFORML 「アンタ達の農作業は今期で廃業よ！」
PRINTFORML 「秋の魅力、存分に味わうがいいわ！」	PRINTFORML 「秋の魅力、存分に味わうがいいわ！」
PRINTFORML 「食欲の秋だからって、これは駄目！」	PRINTFORML 「食欲の秋だからって、これは駄目！」
PRINTFORML 「とりあえずウニで刺してみよう……」	PRINTFORML 「とりあえずウニで刺してみよう……」
PRINTFORML 「連作を避ければ大丈夫のはず……！」	PRINTFORML 「連作を避ければ大丈夫のはず……！」
PRINTFORML 「まずは土壌の改善を図らないと……」	PRINTFORML 「まずは土壌の改善を図らないと……」
PRINTFORML 「種をまかれるなんて絶対に嫌……！」	PRINTFORML 「種をまかれるなんて絶対に嫌……！」
PRINTFORML （このままじゃこんなやつらに……！）	PRINTFORML （このままじゃこんなやつらに……！）
PRINTFORML 「押さえつければ神に勝てるとでも？」	PRINTFORML 「押さえつければ神に勝てるとでも？」
PRINTFORML 「まさかの食べ放題コースってわけ？」	PRINTFORML 「まさかの食べ放題コースってわけ？」
PRINTFORML 「た、食べる前にお供え物しよ？ね？」	PRINTFORML 「た、食べる前にお供え物しよ？ね？」
PRINTFORML 「ひっ、肥料ごとぶちまけられた！？」	PRINTFORML 「ひっ、肥料ごとぶちまけられた！？」
PRINTFORML 「美味しい栗には棘があるんだから！」	PRINTFORML 「美味しい栗には棘があるんだから！」
PRINTFORML 「ぁぁ……なんか目の前がかすんで…」	PRINTFORML 「ぁぁ……なんか目の前がかすんで…」
PRINTFORML 「姉さんの方が裁縫は得意だけど……」	PRINTFORML 「姉さんの方が裁縫は得意だけど……」
PRINTFORML 「こんな場所だけど、いい秋してる？」	PRINTFORML 「こんな場所だけど、いい秋してる？」
PRINTFORML 「今はこの地を整地するのが先決よ…」	PRINTFORML 「今はこの地を整地するのが先決よ…」
PRINTFORML 「お願いだから、それだけは許して！」	PRINTFORML 「お願いだから、それだけは許して！」
PRINTFORMDL 穣子は幸せそうに湯船に浸かっている	PRINTFORMDL 穣子は幸せそうに湯船に浸かっている
PRINTFORML 「神様は……約束を守るんだから……」	PRINTFORML 「神様は……約束を守るんだから……」
PRINTFORML 「いやー。寝ると冬が近づくのいやー」	PRINTFORML 「いやー。寝ると冬が近づくのいやー」
PRINTFORML 「ちょっと…シャレになってないよ…」	PRINTFORML 「ちょっと…シャレになってないよ…」
PRINTFORML 「とほほ。私の甘い匂いがだいなし…」	PRINTFORML 「とほほ。私の甘い匂いがだいなし…」
PRINTFORML 「うう、べったべたのぐっちょぐちょ」	PRINTFORML 「うう、べったべたのぐっちょぐちょ」
PRINTFORML 「甘酒でべたべたならまだマシかなぁ」	PRINTFORML 「甘酒でべたべたならまだマシかなぁ」
PRINTFORMDL 【幻想郷に触手宮の魔の手、迫る】	PRINTFORMDL 【幻想郷に触手宮の魔の手、迫る】
PRINTFORMDL そして出会いが、次の悲劇を呼ぶ。	PRINTFORMDL そして出会いが、次の悲劇を呼ぶ。
PRINTFORML 「豊かで柔らかいって……すぅ……」	PRINTFORML 「豊かで柔らかいって……すぅ……」
PRINTFORML 「農機具の性能、甘く見ないでよ！」	PRINTFORML 「農機具の性能、甘く見ないでよ！」
PRINTFORML 「味見されるなんて絶対に嫌……！」	PRINTFORML 「味見されるなんて絶対に嫌……！」
PRINTFORML 「もう種まきの季節は終わり……！」	PRINTFORML 「もう種まきの季節は終わり……！」
PRINTFORML 「あ、危ない……平常心、平常心…」	PRINTFORML 「あ、危ない……平常心、平常心…」
PRINTFORML 「わ、私の畑を荒らさないでぇ……」	PRINTFORML 「わ、私の畑を荒らさないでぇ……」
PRINTFORML 「ふ、不作にしてやるんだから……」	PRINTFORML 「ふ、不作にしてやるんだから……」
PRINTFORML 「あんたには違う畑がお似合いよ！」	PRINTFORML 「あんたには違う畑がお似合いよ！」
PRINTFORML 「ちょ、ちょっと目立つ色かも！？」	PRINTFORML 「ちょ、ちょっと目立つ色かも！？」
PRINTFORML 「中身の味は落ちないとはいえ……」	PRINTFORML 「中身の味は落ちないとはいえ……」
PRINTFORML 「もしもし、そこにだれかいるの？」	PRINTFORML 「もしもし、そこにだれかいるの？」
PRINTFORML 「この場所から早く離れないと……」	PRINTFORML 「この場所から早く離れないと……」
PRINTFORML 「ぱんぱかぱーん！秋の登場よ！！」	PRINTFORML 「ぱんぱかぱーん！秋の登場よ！！」
PRINTFORML 「さあ！小さな秋を見つけるわよ！」	PRINTFORML 「さあ！小さな秋を見つけるわよ！」
PRINTFORML 「はぁぁ…美容の秘訣は秋風呂よね」	PRINTFORML 「はぁぁ…美容の秘訣は秋風呂よね」
PRINTFORML 「よきかなよきかな。はぁ…幸せ…」	PRINTFORML 「よきかなよきかな。はぁ…幸せ…」
PRINTFORML (うう、こんなに熟してるのにぃ♥)	PRINTFORML (うう、こんなに熟してるのにぃ♥)
PRINTFORML 「招待は収穫祭だけでいいのになぁ」	PRINTFORML 「招待は収穫祭だけでいいのになぁ」
﻿PRINTFORML 静葉姉さんの秋モードに合わせる。	PRINTFORML 静葉姉さんの秋モードに合わせる。
PRINTFORMDL 戦いが人を動かし、別れを生み、	PRINTFORMDL 戦いが人を動かし、別れを生み、
PRINTFORMDL あなたはまだ本当の秋を知らない	PRINTFORMDL あなたはまだ本当の秋を知らない
PRINTFORML 「その種は、撒かないで…zzz」	PRINTFORML 「その種は、撒かないで…zzz」
PRINTFORML 「くっ！秋の力が足りないの！？」	PRINTFORML 「くっ！秋の力が足りないの！？」
PRINTFORML 「あたり一面、整地してみせる！」	PRINTFORML 「あたり一面、整地してみせる！」
PRINTFORML 「果実を持ち歩きすぎたかも……」	PRINTFORML 「果実を持ち歩きすぎたかも……」
PRINTFORML 「そろそろお腹いっぱいでしょ？」	PRINTFORML 「そろそろお腹いっぱいでしょ？」
PRINTFORML 「溶けちゃう！果物とけちゃう！」	PRINTFORML 「溶けちゃう！果物とけちゃう！」
PRINTFORML 「剥かれるなんて絶対に嫌……！」	PRINTFORML 「剥かれるなんて絶対に嫌……！」
PRINTFORML 「私の香りをスンスンしないで！」	PRINTFORML 「私の香りをスンスンしないで！」
PRINTFORML 「動かざる事、妖怪の山の如し！」	PRINTFORML 「動かざる事、妖怪の山の如し！」
PRINTFORML 「くっ、甘い匂いで誘いすぎた？」	PRINTFORML 「くっ、甘い匂いで誘いすぎた？」
PRINTFORML (……どうしよう静葉お姉ちゃん)	PRINTFORML (……どうしよう静葉お姉ちゃん)
PRINTFORML 「ぜーはー…間一髪ってところ…」	PRINTFORML 「ぜーはー…間一髪ってところ…」
PRINTFORML 「これが秋の力！見たか神の力！」	PRINTFORML 「これが秋の力！見たか神の力！」
PRINTFORML 「……静葉お姉ちゃん、ごめんね」	PRINTFORML 「……静葉お姉ちゃん、ごめんね」
PRINTFORML 「つまみ食いされたみたいに……」	PRINTFORML 「つまみ食いされたみたいに……」
PRINTFORML 「まだまだ秋は終わらせないわ！」	PRINTFORML 「まだまだ秋は終わらせないわ！」
PRINTFORML (とにかく見つからないように…)	PRINTFORML (とにかく見つからないように…)
PRINTFORML 「静葉姉さんの方が得意そう……」	PRINTFORML 「静葉姉さんの方が得意そう……」
PRINTFORML 「痛ッ、こんなのいやぁぁぁっ！」	PRINTFORML 「痛ッ、こんなのいやぁぁぁっ！」
PRINTFORML 「私じゃ足手まといだものね……」	PRINTFORML 「私じゃ足手まといだものね……」
PRINTFORML 「みなぎるわー。あふれるわー。」	PRINTFORML 「みなぎるわー。あふれるわー。」
PRINTFORML 「よーし！栄養チャージ完了よ！」	PRINTFORML 「よーし！栄養チャージ完了よ！」
PRINTFORML 「うまく秋モードに入れない……」	PRINTFORML 「うまく秋モードに入れない……」
PRINTFORML 「自分で修繕できる人はいいなぁ」	PRINTFORML 「自分で修繕できる人はいいなぁ」
PRINTFORML 「そろそろ着替えを探したいけど」	PRINTFORML 「そろそろ着替えを探したいけど」
PRINTFORML 「何で落ちないの、この汚れ……」	PRINTFORML 「何で落ちないの、この汚れ……」
PRINTFORML 「いつのまにか変なジャムが……」	PRINTFORML 「いつのまにか変なジャムが……」
PRINTFORMDL ～衝撃のスーパー秋姉妹登場～	PRINTFORMDL ～衝撃のスーパー秋姉妹登場～
PRINTFORMDL 寂しさと終焉の象徴　秋　静葉	PRINTFORMDL 寂しさと終焉の象徴　秋　静葉
PRINTFORMDL 豊かさと稔りの象徴　秋　穣子	PRINTFORMDL 豊かさと稔りの象徴　秋　穣子
PRINTFORML 「グレープシードマシンガン！」	PRINTFORML 「グレープシードマシンガン！」
PRINTFORML 「実りのウニをくらいなさい！」	PRINTFORML 「実りのウニをくらいなさい！」
PRINTFORML 「侵略すること芋焼火の如し！」	PRINTFORML 「侵略すること芋焼火の如し！」
PRINTFORML 「貫け！農符『千石どおし』！」	PRINTFORML 「貫け！農符『千石どおし』！」
PRINTFORML 「秋はみんなのものでしょ！？」	PRINTFORML 「秋はみんなのものでしょ！？」
PRINTFORML 「ふふっ…また信者が増えたわ」	PRINTFORML 「ふふっ…また信者が増えたわ」
PRINTFORML 「さ、作物を見つけないと……」	PRINTFORML 「さ、作物を見つけないと……」
PRINTFORML 「このままじゃ遭難しそう……」	PRINTFORML 「このままじゃ遭難しそう……」
PRINTFORML 「迷宮ローラー作戦でいくわ！」	PRINTFORML 「迷宮ローラー作戦でいくわ！」
PRINTFORML 「もう少し私に力があればなぁ」	PRINTFORML 「もう少し私に力があればなぁ」
PRINTFORML 「早く寝ないと肌が痛むよー…」	PRINTFORML 「早く寝ないと肌が痛むよー…」
PRINTFORML 「秋パワーがすーわーれーるー」	PRINTFORML 「秋パワーがすーわーれーるー」
PRINTFORML 「も、もしかしてこのお腹……」	PRINTFORML 「も、もしかしてこのお腹……」
PRINTFORML 「全裸はさすがに抵抗あるわー」	PRINTFORML 「全裸はさすがに抵抗あるわー」
PRINTFORML 「私に似合う替えの服がない…」	PRINTFORML 「私に似合う替えの服がない…」
PRINTFORML 「新鮮な果実を仕入れたいなー」	PRINTFORML 「新鮮な果実を仕入れたいなー」
PRINTFORMDL 【穣子口上からのお知らせ】	PRINTFORMDL 【穣子口上からのお知らせ】
PRINTFORML （静葉お姉ちゃん、助けて♥）	PRINTFORML （静葉お姉ちゃん、助けて♥）
PRINTFORML （えっちな気分にされてる♥）	PRINTFORML （えっちな気分にされてる♥）
PRINTFORML 「五穀豊穣ファイブハンド！」	PRINTFORML 「五穀豊穣ファイブハンド！」
PRINTFORML 「一歩も退かないんだから！」	PRINTFORML 「一歩も退かないんだから！」
PRINTFORML 「大人しく脱穀されなさい！」	PRINTFORML 「大人しく脱穀されなさい！」
PRINTFORML 「そろそろ収穫タイムよ！！」	PRINTFORML 「そろそろ収穫タイムよ！！」
PRINTFORML 「さあ、地ならしの時間ね！」	PRINTFORML 「さあ、地ならしの時間ね！」
PRINTFORML 「せっかくの香水が台無し！」	PRINTFORML 「せっかくの香水が台無し！」
PRINTFORML 「稲穂じゃらしの要領で……」	PRINTFORML 「稲穂じゃらしの要領で……」
PRINTFORML 「ああ…秋パワーがもう……」	PRINTFORML 「ああ…秋パワーがもう……」
PRINTFORML 「姉さん……ごめんなさい…」	PRINTFORML 「姉さん……ごめんなさい…」
PRINTFORML 「この程度の攻撃くらいで！」	PRINTFORML 「この程度の攻撃くらいで！」
PRINTFORML 「秋スウェー！秋スウェー！」	PRINTFORML 「秋スウェー！秋スウェー！」
PRINTFORML 「な、夏服にされちゃう！？」	PRINTFORML 「な、夏服にされちゃう！？」
PRINTFORML 「静かなること紅葉林の如し」	PRINTFORML 「静かなること紅葉林の如し」
PRINTFORML 「何か…何か役に立つものは」	PRINTFORML 「何か…何か役に立つものは」
PRINTFORMW 「もう一度……収穫祭を……」	PRINTFORMW 「もう一度……収穫祭を……」
PRINTFORML 「秋もまた、別れの季節ね…」	PRINTFORML 「秋もまた、別れの季節ね…」
PRINTFORML 「ふぁあ…ねーむーいーぞー」	PRINTFORML 「ふぁあ…ねーむーいーぞー」
PRINTFORML 「白が似合うのは冬よー……」	PRINTFORML 「白が似合うのは冬よー……」
PRINTFORML 「湯汲みでさっぱりしたいわ」	PRINTFORML 「湯汲みでさっぱりしたいわ」
PRINTFORML 「香水の効果がイマイチに…」	PRINTFORML 「香水の効果がイマイチに…」
PRINTFORML 「ふぅぅ…さすがに疲れるぅ」	PRINTFORML 「ふぅぅ…さすがに疲れるぅ」
PRINTFORML 「もぅ……収穫の時期ぃ？」	PRINTFORML 「もぅ……収穫の時期ぃ？」
PRINTFORML 「ゆるさないんだからぁ♥」	PRINTFORML 「ゆるさないんだからぁ♥」
PRINTFORML 「よくもこんなマネをッ♥」	PRINTFORML 「よくもこんなマネをッ♥」
PRINTFORML （あっ♥いま、ジワって♥）	PRINTFORML （あっ♥いま、ジワって♥）
PRINTFORML （これじゃ、漏れちゃう♥）	PRINTFORML （これじゃ、漏れちゃう♥）
PRINTFORML 「足には自信があるのよ！」	PRINTFORML 「足には自信があるのよ！」
PRINTFORML 「笑止千万、不届き千万！」	PRINTFORML 「笑止千万、不届き千万！」
PRINTFORML （た、耐えないとぉ……！）	PRINTFORML （た、耐えないとぉ……！）
PRINTFORML （あ、喘ぐわけには……！）	PRINTFORML （あ、喘ぐわけには……！）
PRINTFORML 「これでも神様なんだぞ！」	PRINTFORML 「これでも神様なんだぞ！」
PRINTFORML 「秋センサーに反応アリ！」	PRINTFORML 「秋センサーに反応アリ！」
PRINTFORML 「姉さんと一緒なら……！」	PRINTFORML 「姉さんと一緒なら……！」
PRINTFORML 「秋ストーンはないの…？」	PRINTFORML 「秋ストーンはないの…？」
PRINTFORML 「秋パワーが減少ちゅう…」	PRINTFORML 「秋パワーが減少ちゅう…」
PRINTFORML 「枯れてくれないのね……」	PRINTFORML 「枯れてくれないのね……」
PRINTFORML 「戦闘と罠ばっかりー……」	PRINTFORML 「戦闘と罠ばっかりー……」
PRINTFORML では、よい触手ライフを…	PRINTFORML では、よい触手ライフを…
PRINTFORML 「こ、こんな状態じゃ♥」	PRINTFORML 「こ、こんな状態じゃ♥」
PRINTFORML 「ひ、ひきょうものッ♥」	PRINTFORML 「ひ、ひきょうものッ♥」
PRINTFORML 「ふぅーっ♥ふぅーっ♥」	PRINTFORML 「ふぅーっ♥ふぅーっ♥」
PRINTFORML 「この先は行き止まり！」	PRINTFORML 「この先は行き止まり！」
PRINTFORML 「これ以上はさせない！」	PRINTFORML 「これ以上はさせない！」
PRINTFORML 「疾き事、秋風の如く！」	PRINTFORML 「疾き事、秋風の如く！」
PRINTFORML 「力づくってわけね……」	PRINTFORML 「力づくってわけね……」
PRINTFORML 「た、種植えを……！？」	PRINTFORML 「た、種植えを……！？」
PRINTFORML 「見え見えなんだから！」	PRINTFORML 「見え見えなんだから！」
PRINTFORML 「んー、少し調子が……」	PRINTFORML 「んー、少し調子が……」
PRINTFORML 「視線を感じるけど……」	PRINTFORML 「視線を感じるけど……」
PRINTFORML 「こ、この成分はぁ♥」	PRINTFORML 「こ、この成分はぁ♥」
PRINTFORML 「はぁ♥はぁ♥はぁ♥」	PRINTFORML 「はぁ♥はぁ♥はぁ♥」
PRINTFORML 「火照ってるのにッ♥」	PRINTFORML 「火照ってるのにッ♥」
PRINTFORML （む、胸ぇ♥乳首が♥）	PRINTFORML （む、胸ぇ♥乳首が♥）
PRINTFORML （無理っ♥今は無理♥）	PRINTFORML （無理っ♥今は無理♥）
PRINTFORML 「次はこっちを整地！」	PRINTFORML 「次はこっちを整地！」
PRINTFORML 「焼き芋ファイアー！」	PRINTFORML 「焼き芋ファイアー！」
PRINTFORML 「やっ、やめてぇぇ！」	PRINTFORML 「やっ、やめてぇぇ！」
PRINTFORML 「よくもやったわね！」	PRINTFORML 「よくもやったわね！」
PRINTFORML 「くぅぅぅ……んッ！」	PRINTFORML 「くぅぅぅ……んッ！」
PRINTFORML 「焼き芋用スモーク！」	PRINTFORML 「焼き芋用スモーク！」
PRINTFORML 「オータムファイッ！」	PRINTFORML 「オータムファイッ！」
PRINTFORML 「……ごめんなさい！」	PRINTFORML 「……ごめんなさい！」
PRINTFORML 「秋の速達便よー！！」	PRINTFORML 「秋の速達便よー！！」
PRINTFORML 「ぜーはー…ぜーはー」	PRINTFORML 「ぜーはー…ぜーはー」
PRINTFORML 「秋の七草はどこ！？」	PRINTFORML 「秋の七草はどこ！？」
PRINTFORML 「秋リザレクション！」	PRINTFORML 「秋リザレクション！」
PRINTFORML 「実りの秋！最★高！」	PRINTFORML 「実りの秋！最★高！」
PRINTFORML 「出口はどこなの！？」	PRINTFORML 「出口はどこなの！？」
PRINTFORML 「……育つのがはやい」	PRINTFORML 「……育つのがはやい」
PRINTFORML 「悪い予感がする……」	PRINTFORML 「悪い予感がする……」
PRINTFORML 「足裏の感触が―……」	PRINTFORML 「足裏の感触が―……」
PRINTFORML 「……まだ生育中ぅ」	PRINTFORML 「……まだ生育中ぅ」
PRINTFORML （濡れてきちゃう♥）	PRINTFORML （濡れてきちゃう♥）
PRINTFORML （疼いちゃうよぉ♥）	PRINTFORML （疼いちゃうよぉ♥）
PRINTFORML （敏感にされたッ♥）	PRINTFORML （敏感にされたッ♥）
PRINTFORML 「ライスシャワー！」	PRINTFORML 「ライスシャワー！」
PRINTFORML 「げほっげほっ……」	PRINTFORML 「げほっげほっ……」
PRINTFORML 「新型の除草剤！？」	PRINTFORML 「新型の除草剤！？」
PRINTFORML 「ああああああっ！」	PRINTFORML 「ああああああっ！」
PRINTFORML 「これくらいなら！」	PRINTFORML 「これくらいなら！」
PRINTFORML 「もう…このまま…」	PRINTFORML 「もう…このまま…」
PRINTFORML 「きゃっ…離れろ！」	PRINTFORML 「きゃっ…離れろ！」
PRINTFORML 「悪い害虫を駆除！」	PRINTFORML 「悪い害虫を駆除！」
PRINTFORML 「無理はしないでね」	PRINTFORML 「無理はしないでね」
PRINTFORMDL 続発する神隠し。	PRINTFORMDL 続発する神隠し。
PRINTFORML 「冬は…休業……」	PRINTFORML 「冬は…休業……」
PRINTFORML （ア、アソコが♥）	PRINTFORML （ア、アソコが♥）
PRINTFORML 「秋のカーテン！」	PRINTFORML 「秋のカーテン！」
PRINTFORML 「はぁ…はぁ……」	PRINTFORML 「はぁ…はぁ……」
PRINTFORML 「絶対に嫌……！」	PRINTFORML 「絶対に嫌……！」
PRINTFORML 「何よこれぇ……」	PRINTFORML 「何よこれぇ……」
PRINTFORML 「げほっげほっ…」	PRINTFORML 「げほっげほっ…」
PRINTFORML 「く、苦しい……」	PRINTFORML 「く、苦しい……」
PRINTFORML 「や、やめっ……」	PRINTFORML 「や、やめっ……」
PRINTFORML 「やっ、やめっ！」	PRINTFORML 「やっ、やめっ！」
PRINTFORML 「気持ちいい……」	PRINTFORML 「気持ちいい……」
PRINTFORML 「んんんッ……！」	PRINTFORML 「んんんッ……！」
PRINTFORML 「や、やめてよ！」	PRINTFORML 「や、やめてよ！」
PRINTFORML 「そ、そんな……」	PRINTFORML 「そ、そんな……」
PRINTFORML （休憩したい……）	PRINTFORML （休憩したい……）
PRINTFORML 「次のエリアは～」	PRINTFORML 「次のエリアは～」
PRINTFORML （どうしよう♥）	PRINTFORML （どうしよう♥）
PRINTFORML （ク、クリが♥）	PRINTFORML （ク、クリが♥）
PRINTFORML 「暴力の秋……」	PRINTFORML 「暴力の秋……」
PRINTFORML 「きゃぁぁぁ！」	PRINTFORML 「きゃぁぁぁ！」
PRINTFORML 「あああぁ……」	PRINTFORML 「あああぁ……」
PRINTFORML 「それだめぇ…」	PRINTFORML 「それだめぇ…」
PRINTFORML 「夢の終わり…」	PRINTFORML 「夢の終わり…」
PRINTFORML 「ぅ…ぁぁ……」	PRINTFORML 「ぅ…ぁぁ……」
PRINTFORML 「秋ですよー！」	PRINTFORML 「秋ですよー！」
PRINTFORML 「………ぁきぃ」	PRINTFORML 「………ぁきぃ」
PRINTFORML 「………………」	PRINTFORML 「………………」
PRINTFORML 「早く寝たい…」	PRINTFORML 「早く寝たい…」
PRINTFORML 「げほっ……」	PRINTFORML 「げほっ……」
PRINTFORML 「かはっ……」	PRINTFORML 「かはっ……」
PRINTFORML 「許してぇ…」	PRINTFORML 「許してぇ…」
PRINTFORMDL 今の季節？	PRINTFORMDL 今の季節？
PRINTFORML 「……ぅぅ」	PRINTFORML 「……ぅぅ」
PRINTFORML 「力がっ…」	PRINTFORML 「力がっ…」
PRINTFORML 「あひぃ…」	PRINTFORML 「あひぃ…」
PRINTFORML 「うぅ……」	PRINTFORML 「うぅ……」
PRINTFORML 「痛っ…」	PRINTFORML 「痛っ…」
PRINTFORMDL …？	PRINTFORMDL …？
PRINTFORMDL 	PRINTFORMDL 
PRINTFORML 	PRINTFORML 
PRINTL 	PRINTL 
