//口上:

PRINTFORMDL %CALLNAME:TARGET%の瞳にはまだ幾分かの光はあるものの、抵抗する気力は残っていなかった……	PRINTFORMDL %CALLNAME:TARGET%の瞳にはまだ幾分かの光はあるものの、抵抗する気力は残っていなかった……
PRINTFORML （ま、前に行けば他の人より触ってくれるかしら……　って、駄目よ、私、何を考えてるの……！？）	PRINTFORML （ま、前に行けば他の人より触ってくれるかしら……　って、駄目よ、私、何を考えてるの……！？）
PRINTFORMDL 触手生物に捕われている%CALLNAME:TARGET%が諦めたように首を落とした……	PRINTFORMDL 触手生物に捕われている%CALLNAME:TARGET%が諦めたように首を落とした……
PRINTFORMDL まるで自分に言い聞かせるように、%CALLNAME:TARGET%はつぶやいている……	PRINTFORMDL まるで自分に言い聞かせるように、%CALLNAME:TARGET%はつぶやいている……
PRINTFORMW 「ﾌ､ﾌﾌﾌ…… ｱﾅﾀ､厄ｲﾜ､厄ｲﾜﾖ､ﾜﾀｼｶﾞｾﾞﾝﾌﾞｽｯﾃｱｹﾞﾙﾜ……！」	PRINTFORMW 「ﾌ､ﾌﾌﾌ…… ｱﾅﾀ､厄ｲﾜ､厄ｲﾜﾖ､ﾜﾀｼｶﾞｾﾞﾝﾌﾞｽｯﾃｱｹﾞﾙﾜ……！」
PRINTFORML 「……突然、ごめんなさい。一度、貯まった厄をひとけのないところで流してくる必要があるの」	PRINTFORML 「……突然、ごめんなさい。一度、貯まった厄をひとけのないところで流してくる必要があるの」
PRINTFORML 「からだのぉ……ちょうしぃ……ととのえることはぁ……たいせつなんだからぁ……あっ……」	PRINTFORML 「からだのぉ……ちょうしぃ……ととのえることはぁ……たいせつなんだからぁ……あっ……」
PRINTFORML 「これからよろしく、%CALLNAME:(ARG:1)%、一緒に出口を探しましょう」	PRINTFORML 「これからよろしく、%CALLNAME:(ARG:1)%、一緒に出口を探しましょう」
PRINTFORML 「これからよろしく、%CALLNAME:(ARG:1)%、何とかして脱出しましょう」	PRINTFORML 「これからよろしく、%CALLNAME:(ARG:1)%、何とかして脱出しましょう」
PRINTFORML 「ここは……？うーん、周囲から感じる厄の濃度が高すぎるわ。集めてる場合じゃなさそう」	PRINTFORML 「ここは……？うーん、周囲から感じる厄の濃度が高すぎるわ。集めてる場合じゃなさそう」
PRINTFORMDL %CALLNAME:TARGET%は何とか身を守ろうと体をよじって抵抗している！	PRINTFORMDL %CALLNAME:TARGET%は何とか身を守ろうと体をよじって抵抗している！
PRINTFORMDL %CALLNAME:TARGET%は朱に染まる顔を振って正気を保とうとしている	PRINTFORMDL %CALLNAME:TARGET%は朱に染まる顔を振って正気を保とうとしている
PRINTFORMDL そう判断した%CALLNAME:1%は苦渋の決断で雛をおいていくことにした……	PRINTFORMDL そう判断した%CALLNAME:1%は苦渋の決断で雛をおいていくことにした……
PRINTFORMDL %CALLNAME:TARGET%は快楽に飲まれ、抵抗することを放棄した……	PRINTFORMDL %CALLNAME:TARGET%は快楽に飲まれ、抵抗することを放棄した……
PRINTFORMDL %CALLNAME:TARGET%の表情からはすっかり余裕が消えている……	PRINTFORMDL %CALLNAME:TARGET%の表情からはすっかり余裕が消えている……
PRINTFORML 「こ、これじゃ…かわいいって言ってくれる人に……幻滅されちゃう……ふぁ……」	PRINTFORML 「こ、これじゃ…かわいいって言ってくれる人に……幻滅されちゃう……ふぁ……」
PRINTFORML 「落ちている道具を見る限り、この迷宮は幻想郷をターゲットにしていると思うわ」	PRINTFORML 「落ちている道具を見る限り、この迷宮は幻想郷をターゲットにしていると思うわ」
PRINTFORMDL %CALLNAME:TARGET%は体の疼きを抑えながら身を守っている！	PRINTFORMDL %CALLNAME:TARGET%は体の疼きを抑えながら身を守っている！
PRINTFORMDL %CALLNAME:TARGET%は知らず知らず前へと歩みを進めている！	PRINTFORMDL %CALLNAME:TARGET%は知らず知らず前へと歩みを進めている！
PRINTFORMDL %CALLNAME:TARGET%は頭を抱え込んで身を守ろうとしてる！	PRINTFORMDL %CALLNAME:TARGET%は頭を抱え込んで身を守ろうとしてる！
PRINTFORML 「迷宮による能力低下の影響で、私に少しくらいなら近づいても大丈夫みたい」	PRINTFORML 「迷宮による能力低下の影響で、私に少しくらいなら近づいても大丈夫みたい」
PRINTFORMDL %CALLNAME:TARGET%は恐怖で小さく震えているようだ……	PRINTFORMDL %CALLNAME:TARGET%は恐怖で小さく震えているようだ……
PRINTFORML 「あまり武術は得意じゃないんだけれど……　そうも言ってられないわね」	PRINTFORML 「あまり武術は得意じゃないんだけれど……　そうも言ってられないわね」
PRINTFORML 「こ、このままじゃ厄を引き受けられないから、仕方ないの……んっ……」	PRINTFORML 「こ、このままじゃ厄を引き受けられないから、仕方ないの……んっ……」
PRINTFORML 「だから……　こうして……　私が犠牲になって誰かが助かるなら……」	PRINTFORML 「だから……　こうして……　私が犠牲になって誰かが助かるなら……」
PRINTFORMDL そういって%CALLNAME:TARGET%達は眠りに就いた……	PRINTFORMDL そういって%CALLNAME:TARGET%達は眠りに就いた……
PRINTFORML 「こ、怖いけど、わ、私が……　厄神の私が前に行かなくちゃ……！」	PRINTFORML 「こ、怖いけど、わ、私が……　厄神の私が前に行かなくちゃ……！」
PRINTFORMDL %CALLNAME:TARGET%の目には涙が浮かんでいる……	PRINTFORMDL %CALLNAME:TARGET%の目には涙が浮かんでいる……
PRINTFORML 「痛っ……　っ！？　な、なにこれっ……？　あっ……はぁっ……！」	PRINTFORML 「痛っ……　っ！？　な、なにこれっ……？　あっ……はぁっ……！」
PRINTFORMDL そう言って%CALLNAME:TARGET%は眠りに就いた……	PRINTFORMDL そう言って%CALLNAME:TARGET%は眠りに就いた……
PRINTFORML 「い、いつもは…こんなに…はしたなくは……しないの……んっ……」	PRINTFORML 「い、いつもは…こんなに…はしたなくは……しないの……んっ……」
PRINTFORML 「ほら、%CALLNAME:(ARG:1)%、目を覚まして……」	PRINTFORML 「ほら、%CALLNAME:(ARG:1)%、目を覚まして……」
PRINTFORML 「……ありがとう、これからよろしくね、%CALLNAME:1%」	PRINTFORML 「……ありがとう、これからよろしくね、%CALLNAME:1%」
PRINTFORML 「汚れてると厄が溜まりやすいのよね……　清潔にしておかなくちゃ」	PRINTFORML 「汚れてると厄が溜まりやすいのよね……　清潔にしておかなくちゃ」
PRINTFORML 「あ、はぁ……　だめよ、わたし……　正気を……　保たないと……」	PRINTFORML 「あ、はぁ……　だめよ、わたし……　正気を……　保たないと……」
PRINTFORMDL %CALLNAME:TARGET%は頬を染めて悶えている……	PRINTFORMDL %CALLNAME:TARGET%は頬を染めて悶えている……
PRINTFORML （これからも厄を払い続けるためにも、今だけはどうか幸運を……）	PRINTFORML （これからも厄を払い続けるためにも、今だけはどうか幸運を……）
PRINTFORMDL %CALLNAME:TARGET%は陵辱に身を任せている……	PRINTFORMDL %CALLNAME:TARGET%は陵辱に身を任せている……
PRINTFORML 「きゃあっ……！　……っ！？　ど、毒っ……！？　気分がっ……」	PRINTFORML 「きゃあっ……！　……っ！？　ど、毒っ……！？　気分がっ……」
PRINTFORML 「こ、こうしないと厄って払えないから、仕方ないの……んっ……」	PRINTFORML 「こ、こうしないと厄って払えないから、仕方ないの……んっ……」
PRINTFORML 「や、厄をため込みすぎると誰でもこうなっちゃうだけからぁ……」	PRINTFORML 「や、厄をため込みすぎると誰でもこうなっちゃうだけからぁ……」
PRINTFORML 「弱気になってたら駄目よ……こういう時こそ前に飛ばないと……」	PRINTFORML 「弱気になってたら駄目よ……こういう時こそ前に飛ばないと……」
PRINTFORML 「……あの、よかったら……　一緒に行ってもいいかしら……？」	PRINTFORML 「……あの、よかったら……　一緒に行ってもいいかしら……？」
PRINTFORMDL %CALLNAME:TARGET%は裸体を隠している……	PRINTFORMDL %CALLNAME:TARGET%は裸体を隠している……
PRINTFORML 「……そうよ、私は厄神……　厄を引き受けるのがお仕事……」	PRINTFORML 「……そうよ、私は厄神……　厄を引き受けるのがお仕事……」
PRINTFORML 「な、なにこれ……　うっ！？　うえっ……　き、気分が……」	PRINTFORML 「な、なにこれ……　うっ！？　うえっ……　き、気分が……」
PRINTFORML 「こわれちゃうっ♥ こわされちゃうよぉ♥♥ あーっ♥♥♥」	PRINTFORML 「こわれちゃうっ♥ こわされちゃうよぉ♥♥ あーっ♥♥♥」
PRINTFORML 「えっ……　あっ、な……に、これ……　もしかし……て……」	PRINTFORML 「えっ……　あっ、な……に、これ……　もしかし……て……」
PRINTFORML 「うぅ……倒れる前にたまっている厄をどうにかしないと……」	PRINTFORML 「うぅ……倒れる前にたまっている厄をどうにかしないと……」
PRINTFORML 「はい、新しい服よ。似合うかどうかはわからないけど……」	PRINTFORML 「はい、新しい服よ。似合うかどうかはわからないけど……」
PRINTFORML 「お願い……！　倒れて……っ！　お願いだからぁっ……！」	PRINTFORML 「お願い……！　倒れて……っ！　お願いだからぁっ……！」
PRINTFORML 「もう少し衣服が残っている方が自信があるのだけれど……」	PRINTFORML 「もう少し衣服が残っている方が自信があるのだけれど……」
PRINTFORML 「私だけで倒せるなら、いくらでも引き受けるのだけど……」	PRINTFORML 「私だけで倒せるなら、いくらでも引き受けるのだけど……」
PRINTFORML 「ありがとう、%CALLNAME:(ARG:2)%……」	PRINTFORML 「ありがとう、%CALLNAME:(ARG:2)%……」
PRINTFORML 「一人でするのは慣れて……あっ　わたし、なにをいって…」	PRINTFORML 「一人でするのは慣れて……あっ　わたし、なにをいって…」
PRINTFORML 「い、今は１体１体相手にしてたら……　まずいわ……！」	PRINTFORML 「い、今は１体１体相手にしてたら……　まずいわ……！」
PRINTFORML 「落ちついて動けば、私でも十分に対応できるはずよ……」	PRINTFORML 「落ちついて動けば、私でも十分に対応できるはずよ……」
PRINTFORML 「結界を張って……　ふぅ、汚れを落としておきましょう」	PRINTFORML 「結界を張って……　ふぅ、汚れを落としておきましょう」
PRINTFORML 「こ、怖いけど……　倒すには前に、出ないと……っ！」	PRINTFORML 「こ、怖いけど……　倒すには前に、出ないと……っ！」
PRINTFORML 「厄の螺旋で貫いて！スパイラルバッドフォーチュン！」	PRINTFORML 「厄の螺旋で貫いて！スパイラルバッドフォーチュン！」
PRINTFORML 「普段の弾幕ごっこなら当てるだけでいいんだけど……」	PRINTFORML 「普段の弾幕ごっこなら当てるだけでいいんだけど……」
PRINTFORML 「に、逃がしたら駄目よ……私がここで倒さないと……」	PRINTFORML 「に、逃がしたら駄目よ……私がここで倒さないと……」
PRINTFORMDL 雛は言葉にならない声をあげ全身を痙攣させている……	PRINTFORMDL 雛は言葉にならない声をあげ全身を痙攣させている……
PRINTFORML 「ひぃっ♥ もう吸えないからぁ♥♥ 許してぇ♥♥♥」	PRINTFORML 「ひぃっ♥ もう吸えないからぁ♥♥ 許してぇ♥♥♥」
PRINTFORML 「きちゃうっ♥ きもちいいのがっ♥♥ あひぃ♥♥♥」	PRINTFORML 「きちゃうっ♥ きもちいいのがっ♥♥ あひぃ♥♥♥」
PRINTFORML 「むりっ♥ これ無理ぃ♥♥ もう無理だからぁ♥♥♥」	PRINTFORML 「むりっ♥ これ無理ぃ♥♥ もう無理だからぁ♥♥♥」
PRINTFORML 「ありがとう、%CALLNAME:(ARG:1)%」	PRINTFORML 「ありがとう、%CALLNAME:(ARG:1)%」
PRINTFORMDL 虚ろな瞳で倒れ込んでいる雛を放置することはできない	PRINTFORMDL 虚ろな瞳で倒れ込んでいる雛を放置することはできない
PRINTFORML 「……そう、仕方がないわね。　……本当にありがとう」	PRINTFORML 「……そう、仕方がないわね。　……本当にありがとう」
PRINTFORML 「厄集め……途中放棄に……ごめん……な……さい……」	PRINTFORML 「厄集め……途中放棄に……ごめん……な……さい……」
PRINTFORML 「これだけの厄量よ？受け止めきれると思わないで！」	PRINTFORML 「これだけの厄量よ？受け止めきれると思わないで！」
PRINTFORML 「やめてっ！　こないでこないでこないでぇぇっ！？」	PRINTFORML 「やめてっ！　こないでこないでこないでぇぇっ！？」
PRINTFORML 「んっ、動けないようにしちゃえば、変なことは……」	PRINTFORML 「んっ、動けないようにしちゃえば、変なことは……」
PRINTFORML 「ひいっ、や、やめてっ、あっ……！　んうっ……！」	PRINTFORML 「ひいっ、や、やめてっ、あっ……！　んうっ……！」
PRINTFORML 「いっちゃう♥ イっちゃう♥♥ イッちゃう♥♥♥」	PRINTFORML 「いっちゃう♥ イっちゃう♥♥ イッちゃう♥♥♥」
PRINTFORML 「かんじてるっ♥ かんじちゃう♥♥ あーッ♥♥♥」	PRINTFORML 「かんじてるっ♥ かんじちゃう♥♥ あーッ♥♥♥」
PRINTFORMDL 雛はだらしなく顔をゆるませ甘えるような声をあげた	PRINTFORMDL 雛はだらしなく顔をゆるませ甘えるような声をあげた
PRINTFORML 「やっ、そこっ、だめっ、ああっ、くあぁぁっ……！」	PRINTFORML 「やっ、そこっ、だめっ、ああっ、くあぁぁっ……！」
PRINTFORML 「あんなやつらに肌を見られることになるなんて……」	PRINTFORML 「あんなやつらに肌を見られることになるなんて……」
PRINTFORML (んっ、はぁっ……　だ、だめっ、このままじゃ……)	PRINTFORML (んっ、はぁっ……　だ、だめっ、このままじゃ……)
PRINTFORML （気持ち、いい……　　私……　　もう、駄目……）	PRINTFORML （気持ち、いい……　　私……　　もう、駄目……）
PRINTFORML 「みないで♥ みないでッ♥♥ みないでぇ♥♥♥」	PRINTFORML 「みないで♥ みないでッ♥♥ みないでぇ♥♥♥」
PRINTFORML 「まっ♥ まってぇ♥♥ おねがいだからぁ♥♥♥」	PRINTFORML 「まっ♥ まってぇ♥♥ おねがいだからぁ♥♥♥」
PRINTFORML 「……ごめんなさい。きっと助けにくるから……！」	PRINTFORML 「……ごめんなさい。きっと助けにくるから……！」
PRINTFORML 「私は、厄神だから大丈夫。無事に脱出してね……」	PRINTFORML 「私は、厄神だから大丈夫。無事に脱出してね……」
PRINTFORMDL %CALLNAME:1%は雛の綺麗な手を取った	PRINTFORMDL %CALLNAME:1%は雛の綺麗な手を取った
PRINTFORML 「……ありがとう。この恩は決して忘れないわ……」	PRINTFORML 「……ありがとう。この恩は決して忘れないわ……」
PRINTFORML 「這ってでも……厄を払うために……わたしは……」	PRINTFORML 「這ってでも……厄を払うために……わたしは……」
PRINTFORML 「生きて帰って、厄を集める仕事に戻らないと……」	PRINTFORML 「生きて帰って、厄を集める仕事に戻らないと……」
PRINTFORML （んっ……　はっ、い、今は集中しないと……！）	PRINTFORML （んっ……　はっ、い、今は集中しないと……！）
PRINTFORML 「や、やめて、こないでっ、あっちいってっ……」	PRINTFORML 「や、やめて、こないでっ、あっちいってっ……」
PRINTFORML 「回転しながら攻撃すれば何とかなるはずよ……」	PRINTFORML 「回転しながら攻撃すれば何とかなるはずよ……」
PRINTFORML 「ダメっ♥ これダメっ♥♥ ダメなのぉ♥♥♥」	PRINTFORML 「ダメっ♥ これダメっ♥♥ ダメなのぉ♥♥♥」
PRINTFORML 「やめっ♥ やめてぇ♥♥ イっちゃうぅ♥♥♥」	PRINTFORML 「やめっ♥ やめてぇ♥♥ イっちゃうぅ♥♥♥」
PRINTFORML 「あっ、ひゃあっ、いあっ、ひっ、ああっ……！」	PRINTFORML 「あっ、ひゃあっ、いあっ、ひっ、ああっ……！」
PRINTFORML 「私が呼び寄せてるわけじゃないと思うけど……」	PRINTFORML 「私が呼び寄せてるわけじゃないと思うけど……」
PRINTFORML 「みんな……どうか無事に……　脱出してね……」	PRINTFORML 「みんな……どうか無事に……　脱出してね……」
PRINTFORML 「危険だけど、一度別れるしかないみたいね……」	PRINTFORML 「危険だけど、一度別れるしかないみたいね……」
PRINTFORML 「じっとしてたら余計に落ち込んでしまうわ……」	PRINTFORML 「じっとしてたら余計に落ち込んでしまうわ……」
PRINTFORML 「……戦闘は苦手。　次に襲われたら、もう……」	PRINTFORML 「……戦闘は苦手。　次に襲われたら、もう……」
PRINTFORML 「私が居ない間、幻想郷の厄は大丈夫かしら……」	PRINTFORML 「私が居ない間、幻想郷の厄は大丈夫かしら……」
PRINTFORML 「お花をあげてもすぐに枯れてしまいそうね……」	PRINTFORML 「お花をあげてもすぐに枯れてしまいそうね……」
PRINTFORML 「でちゃう♥ でちゃうぅ♥♥ あーっ♥♥♥」	PRINTFORML 「でちゃう♥ でちゃうぅ♥♥ あーっ♥♥♥」
PRINTFORML 「こんなっ♥ こんなのぉ♥♥ むりぃ♥♥♥」	PRINTFORML 「こんなっ♥ こんなのぉ♥♥ むりぃ♥♥♥」
PRINTFORML 「こんなっ♥ されたらぁ♥♥ むりぃ♥♥♥」	PRINTFORML 「こんなっ♥ されたらぁ♥♥ むりぃ♥♥♥」
PRINTFORML 「ダメっ♥ 漏れちゃうっ♥♥ ダメぇ♥♥♥」	PRINTFORML 「ダメっ♥ 漏れちゃうっ♥♥ ダメぇ♥♥♥」
PRINTFORML 「戦いでは役に立たないかもしれないけど……」	PRINTFORML 「戦いでは役に立たないかもしれないけど……」
PRINTFORML 「厄から守ることしかできないのだけれど……」	PRINTFORML 「厄から守ることしかできないのだけれど……」
PRINTFORMDL 力尽きた雛を守りながら探索は出来そうにない	PRINTFORMDL 力尽きた雛を守りながら探索は出来そうにない
PRINTFORML 「私が最初に起きているわ。先に眠っていいわ」	PRINTFORML 「私が最初に起きているわ。先に眠っていいわ」
PRINTFORML 「少しでも体を動かして気分を変えないと……」	PRINTFORML 「少しでも体を動かして気分を変えないと……」
PRINTFORML 「見覚えのあるお守りが落ちてたりするのよね」	PRINTFORML 「見覚えのあるお守りが落ちてたりするのよね」
PRINTFORML 「またみんなと妖怪の山で水浴びしたいわ……」	PRINTFORML 「またみんなと妖怪の山で水浴びしたいわ……」
PRINTFORML 「だ、だめよっ……　近寄らないでっ……！」	PRINTFORML 「だ、だめよっ……　近寄らないでっ……！」
PRINTFORML 「このままじゃ、全部駄目にされちゃう……」	PRINTFORML 「このままじゃ、全部駄目にされちゃう……」
PRINTFORML 「これっ♥ これダメっ♥♥ ダメぇ♥♥♥」	PRINTFORML 「これっ♥ これダメっ♥♥ ダメぇ♥♥♥」
PRINTFORML 「ひっ♥ ひぃい♥♥ こわれちゃう♥♥♥」	PRINTFORML 「ひっ♥ ひぃい♥♥ こわれちゃう♥♥♥」
PRINTFORML 「そっ、そっちはっ……　んくぅぅぅっ……」	PRINTFORML 「そっ、そっちはっ……　んくぅぅぅっ……」
PRINTFORML 「んふぅっ、ああっ、熱っ、んんんッ……！」	PRINTFORML 「んふぅっ、ああっ、熱っ、んんんッ……！」
PRINTFORML 「いあっ、ひっ、あっ、あああああっ……！」	PRINTFORML 「いあっ、ひっ、あっ、あああああっ……！」
PRINTFORML 「下着は駄目。絶対に駄目なんだからぁ……」	PRINTFORML 「下着は駄目。絶対に駄目なんだからぁ……」
PRINTFORML 「えっ♥ まって♥ まだ敵がいたなんて♥」	PRINTFORML 「えっ♥ まって♥ まだ敵がいたなんて♥」
PRINTFORML 「いざとなったら見捨ててもいいからね……」	PRINTFORML 「いざとなったら見捨ててもいいからね……」
PRINTFORML 「……ここなら、多分大丈夫と思うけど……」	PRINTFORML 「……ここなら、多分大丈夫と思うけど……」
PRINTFORML 「私の回転で、すべて吹き飛ばしてみせるわ」	PRINTFORML 「私の回転で、すべて吹き飛ばしてみせるわ」
PRINTFORML 「見覚えのある人形が落ちてたりするのよね」	PRINTFORML 「見覚えのある人形が落ちてたりするのよね」
PRINTFORMDL 雛はふらつく足取りで必死に逃げ出した……	PRINTFORMDL 雛はふらつく足取りで必死に逃げ出した……
PRINTFORML 「……う、少し……　大きくなってる……？」	PRINTFORML 「……う、少し……　大きくなってる……？」
PRINTFORML 「……すぅ～……すりぷる……すぅ～……」	PRINTFORML 「……すぅ～……すりぷる……すぅ～……」
PRINTFORML 「強すぎず弱すぎず……　これぐらいっ！」	PRINTFORML 「強すぎず弱すぎず……　これぐらいっ！」
PRINTFORML 「た、倒れて……！　お願いだから……！」	PRINTFORML 「た、倒れて……！　お願いだから……！」
PRINTFORML 「な、なんとか……　避けれたみたい……」	PRINTFORML 「な、なんとか……　避けれたみたい……」
PRINTFORML 「力、はいらないよ……ごめん、なさい…」	PRINTFORML 「力、はいらないよ……ごめん、なさい…」
PRINTFORMDL 誰かの弱々しい息遣いが聞えた気がした。	PRINTFORMDL 誰かの弱々しい息遣いが聞えた気がした。
PRINTFORMDL 雛は濁った瞳でふらふらと立ち上がった…	PRINTFORMDL 雛は濁った瞳でふらふらと立ち上がった…
PRINTFORML 「厄集め……必ず……生きて帰るんだ……」	PRINTFORML 「厄集め……必ず……生きて帰るんだ……」
PRINTFORML 「お願い。せめて、厄だけはとらせて……」	PRINTFORML 「お願い。せめて、厄だけはとらせて……」
PRINTFORML 「あ、はぁっ……！　だ、大分大きく……」	PRINTFORML 「あ、はぁっ……！　だ、大分大きく……」
PRINTFORML （しゅうちゅうして……平常心を……♥）	PRINTFORML （しゅうちゅうして……平常心を……♥）
PRINTFORML 「……嫌なことはこれで忘れるに限るわ」	PRINTFORML 「……嫌なことはこれで忘れるに限るわ」
PRINTFORML 「ん、やっぱり服はちゃんとしないとね」	PRINTFORML 「ん、やっぱり服はちゃんとしないとね」
PRINTFORML 「こういうのはバランスが肝要なのよね」	PRINTFORML 「こういうのはバランスが肝要なのよね」
PRINTFORML 「使わずに犯されるなんていやなのぉ！」	PRINTFORML 「使わずに犯されるなんていやなのぉ！」
PRINTFORML 「は、はやくっ！はやく倒さないと！！」	PRINTFORML 「は、はやくっ！はやく倒さないと！！」
PRINTFORML 「だめっ、ちからが、はいらなっ……！」	PRINTFORML 「だめっ、ちからが、はいらなっ……！」
PRINTFORML 「柔らかいらしいけど、絶対に嫌……！」	PRINTFORML 「柔らかいらしいけど、絶対に嫌……！」
PRINTFORML 「痛いっ、熱いっ……！　ああっ……！」	PRINTFORML 「痛いっ、熱いっ……！　ああっ……！」
PRINTFORML 「あーっ♥ あーっ♥♥ あーっ♥♥♥」	PRINTFORML 「あーっ♥ あーっ♥♥ あーっ♥♥♥」
PRINTFORML 「あっ♥ あふれっ♥♥ あーッ♥♥♥」	PRINTFORML 「あっ♥ あふれっ♥♥ あーッ♥♥♥」
PRINTFORML 「やぁっ、だめっ、しないでぇっ……！」	PRINTFORML 「やぁっ、だめっ、しないでぇっ……！」
PRINTFORML 「や、厄を掻き出さないと……ふぁ……」	PRINTFORML 「や、厄を掻き出さないと……ふぁ……」
PRINTFORML 「追い返すだけじゃ意味がなさそう……」	PRINTFORML 「追い返すだけじゃ意味がなさそう……」
PRINTFORML 「何か使えそうなものはないかしら……」	PRINTFORML 「何か使えそうなものはないかしら……」
PRINTFORML 「っ、遅かったわ、ごめんなさいっ……」	PRINTFORML 「っ、遅かったわ、ごめんなさいっ……」
PRINTFORML （……私の中に、居る……　のよね……）	PRINTFORML （……私の中に、居る……　のよね……）
PRINTFORML 「お願い……！　目を覚まして……！」	PRINTFORML 「お願い……！　目を覚まして……！」
PRINTFORML 「ご、ごめんなさい、もう無理……！」	PRINTFORML 「ご、ごめんなさい、もう無理……！」
PRINTFORML 「流れて！全部どこかへ流されてよ！」	PRINTFORML 「流れて！全部どこかへ流されてよ！」
PRINTFORML 「駄目ぇ！性処理人形は嫌なの……！」	PRINTFORML 「駄目ぇ！性処理人形は嫌なの……！」
PRINTFORML 「す、吸われてるのっ……！？ あっ」	PRINTFORML 「す、吸われてるのっ……！？ あっ」
PRINTFORML 「この衣装、気にいってるのに……！」	PRINTFORML 「この衣装、気にいってるのに……！」
PRINTFORML 「よし。近づけなくしてやったわ……」	PRINTFORML 「よし。近づけなくしてやったわ……」
PRINTFORML 「もう十分でしょ、満足してよぉ……」	PRINTFORML 「もう十分でしょ、満足してよぉ……」
PRINTFORML 「私の周囲には厄が渦巻くんだから！」	PRINTFORML 「私の周囲には厄が渦巻くんだから！」
PRINTFORML 「厄は、巡り巡ってあなたの元へ……」	PRINTFORML 「厄は、巡り巡ってあなたの元へ……」
PRINTFORML 「お願いだから、それだけは許して！」	PRINTFORML 「お願いだから、それだけは許して！」
PRINTFORML 「私の力って、健康に悪そうだけど…」	PRINTFORML 「私の力って、健康に悪そうだけど…」
PRINTFORML 「……やくをぉ……すわせてぇ……」	PRINTFORML 「……やくをぉ……すわせてぇ……」
PRINTFORML 「や、あっ、だめっ、んうっ……！」	PRINTFORML 「や、あっ、だめっ、んうっ……！」
PRINTFORML （だ、駄目よ、集中しないと……♥）	PRINTFORML （だ、駄目よ、集中しないと……♥）
PRINTFORML 「んっ、くぅっ、や、やめて……！」	PRINTFORML 「んっ、くぅっ、や、やめて……！」
PRINTFORML 「ひ、も、もう……　やめて……っ」	PRINTFORML 「ひ、も、もう……　やめて……っ」
PRINTFORML 「とりあえず一息つきましょう……」	PRINTFORML 「とりあえず一息つきましょう……」
PRINTFORML （ぁ……　からだが、かってに……）	PRINTFORML （ぁ……　からだが、かってに……）
PRINTFORML 「厄の塊、ぜんぶ受け取りなさい！」	PRINTFORML 「厄の塊、ぜんぶ受け取りなさい！」
PRINTFORML 「や、やめて、こないでぇっ……！」	PRINTFORML 「や、やめて、こないでぇっ……！」
PRINTFORML 「あぁっ……　ち、ちからがっ……」	PRINTFORML 「あぁっ……　ち、ちからがっ……」
PRINTFORML 「このっ……　ここから出してぇ！」	PRINTFORML 「このっ……　ここから出してぇ！」
PRINTFORML 「あっ、そこはっ、んぁぁぁぁっ！」	PRINTFORML 「あっ、そこはっ、んぁぁぁぁっ！」
PRINTFORML 「んああっ、そこは、だめっ……！」	PRINTFORML 「んああっ、そこは、だめっ……！」
PRINTFORML 「もう……　動かない、わよ……ね」	PRINTFORML 「もう……　動かない、わよ……ね」
PRINTFORML 「だめ……厄が……逃げていく……」	PRINTFORML 「だめ……厄が……逃げていく……」
PRINTFORML 「あっ、ああああああああっ……！」	PRINTFORML 「あっ、ああああああああっ……！」
PRINTFORML 「やっ、下着までっ、見えてっ……」	PRINTFORML 「やっ、下着までっ、見えてっ……」
PRINTFORML 「……やだ。もう服がこんなことに」	PRINTFORML 「……やだ。もう服がこんなことに」
PRINTFORML 「えっ……　あっ、なに、これ……」	PRINTFORML 「えっ……　あっ、なに、これ……」
PRINTFORML 「あらゆる厄災が降りかかるのよ？」	PRINTFORML 「あらゆる厄災が降りかかるのよ？」
PRINTFORML 「うっ、あっ、だっ、駄目っ……♥」	PRINTFORML 「うっ、あっ、だっ、駄目っ……♥」
PRINTFORML 「使えなくなった装備品の確認を…」	PRINTFORML 「使えなくなった装備品の確認を…」
PRINTFORML 「勝ってくるから、ここで待ってて」	PRINTFORML 「勝ってくるから、ここで待ってて」
PRINTFORML 「優しく吸ってあげるね……ちゅっ」	PRINTFORML 「優しく吸ってあげるね……ちゅっ」
PRINTFORML 「……ここなら多分大丈夫と思うわ」	PRINTFORML 「……ここなら多分大丈夫と思うわ」
PRINTFORML 「今のうちに距離を稼がないと……」	PRINTFORML 「今のうちに距離を稼がないと……」
PRINTFORML 「急がば回れ。くるくるくるくる♪」	PRINTFORML 「急がば回れ。くるくるくるくる♪」
PRINTFORMDL 雛は幸せそうに湯船に浸かっている	PRINTFORMDL 雛は幸せそうに湯船に浸かっている
PRINTFORML 「あっ、ああっ……　んんっ……！」	PRINTFORML 「あっ、ああっ……　んんっ……！」
PRINTFORML 「……何かしら？　体の調子が……」	PRINTFORML 「……何かしら？　体の調子が……」
PRINTFORML (あっ♥ あっ♥ 回ると震動が♥)	PRINTFORML (あっ♥ あっ♥ 回ると震動が♥)
PRINTFORML 「ごーにん　ばやしの　笛太鼓……」	PRINTFORML 「ごーにん　ばやしの　笛太鼓……」
PRINTFORML 「触られるのは慣れてないのよ……」	PRINTFORML 「触られるのは慣れてないのよ……」
PRINTFORML 「……やくをぉ……だしてぇ……」	PRINTFORML 「……やくをぉ……だしてぇ……」
PRINTFORML 「くっ……　あ、あたって……♥」	PRINTFORML 「くっ……　あ、あたって……♥」
PRINTFORML （か、回転したら…擦れて……♥）	PRINTFORML （か、回転したら…擦れて……♥）
PRINTFORML 「牽制になればいいんだけど……」	PRINTFORML 「牽制になればいいんだけど……」
PRINTFORML 「うっ、こ、こうなったら……！」	PRINTFORML 「うっ、こ、こうなったら……！」
PRINTFORML 「どこでもいいから当たってぇ！」	PRINTFORML 「どこでもいいから当たってぇ！」
PRINTFORML 「い、やっ……！　ぅぅぅ……！」	PRINTFORML 「い、やっ……！　ぅぅぅ……！」
PRINTFORML 「うぅ、怖い……　けど……っ！」	PRINTFORML 「うぅ、怖い……　けど……っ！」
PRINTFORML 「は、早く……　倒れてっ……！」	PRINTFORML 「は、早く……　倒れてっ……！」
PRINTFORML 「狙い済まして……　そこよっ！」	PRINTFORML 「狙い済まして……　そこよっ！」
PRINTFORML 「まずは動きを殺いでから……！」	PRINTFORML 「まずは動きを殺いでから……！」
PRINTFORML 「やんっ、はなし、てぇっ……！」	PRINTFORML 「やんっ、はなし、てぇっ……！」
PRINTFORML 「やっ、あっ、ひっ、ふあっ……」	PRINTFORML 「やっ、あっ、ひっ、ふあっ……」
PRINTFORML 「やっ、それぇ、しないでっ……」	PRINTFORML 「やっ、それぇ、しないでっ……」
PRINTFORML 「んっ、くっ、ふあっ、やっ……」	PRINTFORML 「んっ、くっ、ふあっ、やっ……」
PRINTFORML 「はぁん……！なっ、なにを……」	PRINTFORML 「はぁん……！なっ、なにを……」
PRINTFORML 「遅かれ早かれこうなるのは……」	PRINTFORML 「遅かれ早かれこうなるのは……」
PRINTFORML 「最低の結末は避けたいけど……」	PRINTFORML 「最低の結末は避けたいけど……」
PRINTFORML 「後どれぐらい居るのかしら……」	PRINTFORML 「後どれぐらい居るのかしら……」
PRINTFORML 「わたし…こわされちゃった……」	PRINTFORML 「わたし…こわされちゃった……」
PRINTFORML 「追い返すのは得意なんだから！」	PRINTFORML 「追い返すのは得意なんだから！」
PRINTFORML 「ふう。何とか勝てたみたい……」	PRINTFORML 「ふう。何とか勝てたみたい……」
PRINTFORML 「少し何か探してみましょう……」	PRINTFORML 「少し何か探してみましょう……」
PRINTFORML 「何か利用できそうなものは……」	PRINTFORML 「何か利用できそうなものは……」
PRINTFORML 「痛ッ、こんなのいやぁぁぁっ！」	PRINTFORML 「痛ッ、こんなのいやぁぁぁっ！」
PRINTFORML 「う、うぅぅ……あ、ありがとう」	PRINTFORML 「う、うぅぅ……あ、ありがとう」
PRINTFORML 「……私は、間違えてたのかしら」	PRINTFORML 「……私は、間違えてたのかしら」
PRINTFORML 「もぅ……メディ…ったらぁ…」	PRINTFORML 「もぅ……メディ…ったらぁ…」
PRINTFORML 「これで整えていきましょう！」	PRINTFORML 「これで整えていきましょう！」
PRINTFORML 「当てないと意味がないものね」	PRINTFORML 「当てないと意味がないものね」
PRINTFORML 「お、お願い、当たって……！」	PRINTFORML 「お、お願い、当たって……！」
PRINTFORML 「くっ、たっ、倒れてっ……！」	PRINTFORML 「くっ、たっ、倒れてっ……！」
PRINTFORML 「いくわよ……！　あたって！」	PRINTFORML 「いくわよ……！　あたって！」
PRINTFORML 「こういうことなら私だって！」	PRINTFORML 「こういうことなら私だって！」
PRINTFORML 「残弾はまだあるんだからっ！」	PRINTFORML 「残弾はまだあるんだからっ！」
PRINTFORML 「遠心力を活かせば私だって！」	PRINTFORML 「遠心力を活かせば私だって！」
PRINTFORML （チャンスを見計らって……！）	PRINTFORML （チャンスを見計らって……！）
PRINTFORML 「いぁっ、いっ、あぐっ……！」	PRINTFORML 「いぁっ、いっ、あぐっ……！」
PRINTFORML 「あっ、ひくぅっ、やぁっ……」	PRINTFORML 「あっ、ひくぅっ、やぁっ……」
PRINTFORML 「ひいっ、やぁっ、だめっ……」	PRINTFORML 「ひいっ、やぁっ、だめっ……」
PRINTFORML 「あぁっ！？でも、まだ……！」	PRINTFORML 「あぁっ！？でも、まだ……！」
PRINTFORML 「あぁっ！？見切れなかった！」	PRINTFORML 「あぁっ！？見切れなかった！」
PRINTFORML （お願い、当たらないで……♥）	PRINTFORML （お願い、当たらないで……♥）
PRINTFORML 「この先には行かせるものか！」	PRINTFORML 「この先には行かせるものか！」
PRINTFORML 「あら……　これは使えそうね」	PRINTFORML 「あら……　これは使えそうね」
PRINTFORML 「睡眠のとれそうな場所は……」	PRINTFORML 「睡眠のとれそうな場所は……」
PRINTFORML 「んぅ……　少しだるいわ……」	PRINTFORML 「んぅ……　少しだるいわ……」
PRINTFORML 「まぁ……にとりったらぁ…」	PRINTFORML 「まぁ……にとりったらぁ…」
PRINTFORML 「むねぇ……吸ったらぁ……」	PRINTFORML 「むねぇ……吸ったらぁ……」
PRINTFORML 「柔らかいって……すぅ……」	PRINTFORML 「柔らかいって……すぅ……」
PRINTFORML （カラダ、火照ってる……♥）	PRINTFORML （カラダ、火照ってる……♥）
PRINTFORML （えっちな厄が漏れる……♥）	PRINTFORML （えっちな厄が漏れる……♥）
PRINTFORML （リボンが……擦れて……♥）	PRINTFORML （リボンが……擦れて……♥）
PRINTFORML 「何かあったはずだけど……」	PRINTFORML 「何かあったはずだけど……」
PRINTFORML 「今のうちに逃げましょう！」	PRINTFORML 「今のうちに逃げましょう！」
PRINTFORML 「戦うのは苦手なのに……！」	PRINTFORML 「戦うのは苦手なのに……！」
PRINTFORML 「さっさと倒さないと……！」	PRINTFORML 「さっさと倒さないと……！」
PRINTFORML 「こんな時こそ冷静に……！」	PRINTFORML 「こんな時こそ冷静に……！」
PRINTFORML 「どこかにいってよぉぉぉ！」	PRINTFORML 「どこかにいってよぉぉぉ！」
PRINTFORML 「んひゅぅっ、らめっ……！」	PRINTFORML 「んひゅぅっ、らめっ……！」
PRINTFORML 「この大鐘婆の火でぇ……！」	PRINTFORML 「この大鐘婆の火でぇ……！」
PRINTFORML 「んっ、ち、ちからがっ……」	PRINTFORML 「んっ、ち、ちからがっ……」
PRINTFORML 「くぅっ、あっ、はぁっ……」	PRINTFORML 「くぅっ、あっ、はぁっ……」
PRINTFORML 「ボロにしちゃ駄目ぇ……！」	PRINTFORML 「ボロにしちゃ駄目ぇ……！」
PRINTFORML 「いあっ、ひっ、くぅあっ！」	PRINTFORML 「いあっ、ひっ、くぅあっ！」
PRINTFORML 「あっ、こらっ、やめてっ！」	PRINTFORML 「あっ、こらっ、やめてっ！」
PRINTFORML 「ひっ、あっ、んあっ……！」	PRINTFORML 「ひっ、あっ、んあっ……！」
PRINTFORML 「いあっ、あっ、ふあっ……」	PRINTFORML 「いあっ、あっ、ふあっ……」
PRINTFORML 「ま、間に合わなかった……」	PRINTFORML 「ま、間に合わなかった……」
PRINTFORML 「ど、どうってことない……」	PRINTFORML 「ど、どうってことない……」
PRINTFORML 「攻めるのは苦手だけど……」	PRINTFORML 「攻めるのは苦手だけど……」
PRINTFORML 「こころが……流されて……」	PRINTFORML 「こころが……流されて……」
PRINTFORML 「ぁぁ……何も守れない……」	PRINTFORML 「ぁぁ……何も守れない……」
PRINTFORML 「厄センサーがマックス……」	PRINTFORML 「厄センサーがマックス……」
PRINTFORML 「ひっ、い、いやぁっ……！」	PRINTFORML 「ひっ、い、いやぁっ……！」
PRINTFORML 「何も見逃さないように……」	PRINTFORML 「何も見逃さないように……」
PRINTFORML 「ちょっと…こんなのって…」	PRINTFORML 「ちょっと…こんなのって…」
PRINTFORML 「いっ、あっ、痛いっ……！」	PRINTFORML 「いっ、あっ、痛いっ……！」
PRINTFORML 「出口はどこなのかしら……」	PRINTFORML 「出口はどこなのかしら……」
PRINTFORML 「明かりをつけましょう……」	PRINTFORML 「明かりをつけましょう……」
PRINTFORML 「だめぇ……アリスぅ……」	PRINTFORML 「だめぇ……アリスぅ……」
PRINTFORML 「く、う……　ふぅっ……」	PRINTFORML 「く、う……　ふぅっ……」
PRINTFORML 「ご、ごめんなさい……！」	PRINTFORML 「ご、ごめんなさい……！」
PRINTFORML 「少しでも当てやすく……」	PRINTFORML 「少しでも当てやすく……」
PRINTFORML 「くっ、こ、これで……！」	PRINTFORML 「くっ、こ、これで……！」
PRINTFORML 「ひ、ひるませればっ……」	PRINTFORML 「ひ、ひるませればっ……」
PRINTFORML 「このっ……　離してぇ！」	PRINTFORML 「このっ……　離してぇ！」
PRINTFORML 「ひっ、痛っ、やあっ……」	PRINTFORML 「ひっ、痛っ、やあっ……」
PRINTFORML 「よっ、よけきれない！？」	PRINTFORML 「よっ、よけきれない！？」
PRINTFORML （た、耐えないとぉ……！）	PRINTFORML （た、耐えないとぉ……！）
PRINTFORML （あ、喘ぐわけには……！）	PRINTFORML （あ、喘ぐわけには……！）
PRINTFORML 「ひっ、あっ、やっ……！」	PRINTFORML 「ひっ、あっ、やっ……！」
PRINTFORML 「んうっ、あっ、だめっ！」	PRINTFORML 「んうっ、あっ、だめっ！」
PRINTFORML 「やっ、そこはだめっ……」	PRINTFORML 「やっ、そこはだめっ……」
PRINTFORML 「うそっ！？捕まった！？」	PRINTFORML 「うそっ！？捕まった！？」
PRINTFORML 「逆らわずに受け流す……」	PRINTFORML 「逆らわずに受け流す……」
PRINTFORML 「ギリギリだったけど……」	PRINTFORML 「ギリギリだったけど……」
PRINTFORML 「こ、こんな格好じゃ……」	PRINTFORML 「こ、こんな格好じゃ……」
PRINTFORML 「一緒に脱出しましょうね」	PRINTFORML 「一緒に脱出しましょうね」
PRINTFORML 「こういう時は私の出番ね」	PRINTFORML 「こういう時は私の出番ね」
PRINTFORML  (罠を警戒しながら……)	PRINTFORML  (罠を警戒しながら……)
PRINTFORML では、よい触手ライフを…	PRINTFORML では、よい触手ライフを…
PRINTFORML 「あぁ……もみじぃ……」	PRINTFORML 「あぁ……もみじぃ……」
PRINTFORML （おちつかないと……♥）	PRINTFORML （おちつかないと……♥）
PRINTFORML （む、胸が擦れて……♥）	PRINTFORML （む、胸が擦れて……♥）
PRINTFORML （いま、ジワって……♥）	PRINTFORML （いま、ジワって……♥）
PRINTFORML 「こ、こないでっ……！」	PRINTFORML 「こ、こないでっ……！」
PRINTFORML 「これで落ち着いて……」	PRINTFORML 「これで落ち着いて……」
PRINTFORML 「私が前に行くわ……！」	PRINTFORML 「私が前に行くわ……！」
PRINTFORML 「距離をとらないと……」	PRINTFORML 「距離をとらないと……」
PRINTFORML 「動きを制限しないと！」	PRINTFORML 「動きを制限しないと！」
PRINTFORML 「んっ……　んんぅっ！」	PRINTFORML 「んっ……　んんぅっ！」
PRINTFORML 「一気に回転すれば……」	PRINTFORML 「一気に回転すれば……」
PRINTFORML 「やってみるしか……♥」	PRINTFORML 「やってみるしか……♥」
PRINTFORML 「ひっ、いっ…………！」	PRINTFORML 「ひっ、いっ…………！」
PRINTFORML 「うっ、痛っ、ひっ……」	PRINTFORML 「うっ、痛っ、ひっ……」
PRINTFORML 「はっ、離れ…あがっ！」	PRINTFORML 「はっ、離れ…あがっ！」
PRINTFORML 「うっ、何をしたの……」	PRINTFORML 「うっ、何をしたの……」
PRINTFORML 「んぁっ、だめっ……！」	PRINTFORML 「んぁっ、だめっ……！」
PRINTFORML 「感覚、おかしくぅ……」	PRINTFORML 「感覚、おかしくぅ……」
PRINTFORML 「んっ、あっ、くぅっ…」	PRINTFORML 「んっ、あっ、くぅっ…」
PRINTFORML 「やっ、あっ、だめっ！」	PRINTFORML 「やっ、あっ、だめっ！」
PRINTFORML 「これじゃ動けない！？」	PRINTFORML 「これじゃ動けない！？」
PRINTFORML 「だ、だされた……！？」	PRINTFORML 「だ、だされた……！？」
PRINTFORML 「ふぅ、何とか避けれた」	PRINTFORML 「ふぅ、何とか避けれた」
PRINTFORML 「激流を制するのよ……」	PRINTFORML 「激流を制するのよ……」
PRINTFORML 「厄災の中心にようこそ」	PRINTFORML 「厄災の中心にようこそ」
PRINTFORML 「に、逃げないと……！」	PRINTFORML 「に、逃げないと……！」
PRINTFORML 「さあ、厄払いの時間よ」	PRINTFORML 「さあ、厄払いの時間よ」
PRINTFORML 「もらっていきましょう」	PRINTFORML 「もらっていきましょう」
PRINTFORML (厄漏れしないように…)	PRINTFORML (厄漏れしないように…)
PRINTFORML (罠を警戒しながら……)	PRINTFORML (罠を警戒しながら……)
PRINTFORML 「……私の赤ちゃん……」	PRINTFORML 「……私の赤ちゃん……」
PRINTFORML 「……早く脱出しないと」	PRINTFORML 「……早く脱出しないと」
PRINTFORML 「くるくるくるくる～♪」	PRINTFORML 「くるくるくるくる～♪」
PRINTFORML （ア、アソコが……♥）	PRINTFORML （ア、アソコが……♥）
PRINTFORML 「さ、触らないでっ！」	PRINTFORML 「さ、触らないでっ！」
PRINTFORML 「一気に決めるわよ！」	PRINTFORML 「一気に決めるわよ！」
PRINTFORML 「まとめて効率的に！」	PRINTFORML 「まとめて効率的に！」
PRINTFORML 「絶対に駄目よ……！」	PRINTFORML 「絶対に駄目よ……！」
PRINTFORML 「ひっ、きゃあっ！？」	PRINTFORML 「ひっ、きゃあっ！？」
PRINTFORML 「うっ、げっ、ぁ……」	PRINTFORML 「うっ、げっ、ぁ……」
PRINTFORML 「やっ、きゃあっ…！」	PRINTFORML 「やっ、きゃあっ…！」
PRINTFORML 「破かないでぇ……！」	PRINTFORML 「破かないでぇ……！」
PRINTFORML 「わ、わたしの服……」	PRINTFORML 「わ、わたしの服……」
PRINTFORML 「いぃ…いいよぉ……」	PRINTFORML 「いぃ…いいよぉ……」
PRINTFORML 「くぅぅぅ……んッ！」	PRINTFORML 「くぅぅぅ……んッ！」
PRINTFORML 「か、感じちゃう……」	PRINTFORML 「か、感じちゃう……」
PRINTFORML 「んっ、あんっ……！」	PRINTFORML 「んっ、あんっ……！」
PRINTFORML 「やっ、だめっ……！」	PRINTFORML 「やっ、だめっ……！」
PRINTFORML 「ひっ、んあっ……！」	PRINTFORML 「ひっ、んあっ……！」
PRINTFORML 「きゃぁ！やめてぇ！」	PRINTFORML 「きゃぁ！やめてぇ！」
PRINTFORML 「ふぅ、倒したわ……」	PRINTFORML 「ふぅ、倒したわ……」
PRINTFORML 「……もうリボンしか」	PRINTFORML 「……もうリボンしか」
PRINTFORML 「次に備えないと……」	PRINTFORML 「次に備えないと……」
PRINTFORML 「無事だったみたいね」	PRINTFORML 「無事だったみたいね」
PRINTFORML 「あら、これは……？」	PRINTFORML 「あら、これは……？」
PRINTFORML 「いい物を見つけたわ」	PRINTFORML 「いい物を見つけたわ」
PRINTFORML 「ここは少し強気に！」	PRINTFORML 「ここは少し強気に！」
PRINTFORML 「くるくるくるくる♪」	PRINTFORML 「くるくるくるくる♪」
PRINTFORML 「……あ、ありがとう」	PRINTFORML 「……あ、ありがとう」
PRINTFORML 「どこかで睡眠を……」	PRINTFORML 「どこかで睡眠を……」
PRINTFORML (はぁ…♥ はぁ…♥)	PRINTFORML (はぁ…♥ はぁ…♥)
PRINTFORML 「すぅ……すぅ……」	PRINTFORML 「すぅ……すぅ……」
PRINTFORML （もう濡れて……♥）	PRINTFORML （もう濡れて……♥）
PRINTFORML （どうしよう……♥）	PRINTFORML （どうしよう……♥）
PRINTFORML （ク、クリが……♥）	PRINTFORML （ク、クリが……♥）
PRINTFORML 「派手にいくわよ！」	PRINTFORML 「派手にいくわよ！」
PRINTFORML 「こ、こないでっ！」	PRINTFORML 「こ、こないでっ！」
PRINTFORML 「うっ、げぇっ……」	PRINTFORML 「うっ、げぇっ……」
PRINTFORML 「ひっ、痛あっ……」	PRINTFORML 「ひっ、痛あっ……」
PRINTFORML 「げほっげほっ……」	PRINTFORML 「げほっげほっ……」
PRINTFORML 「ああああああっ！」	PRINTFORML 「ああああああっ！」
PRINTFORML 「やっ、やめぇぇ！」	PRINTFORML 「やっ、やめぇぇ！」
PRINTFORML 「避けきれない…！」	PRINTFORML 「避けきれない…！」
PRINTFORML 「あっ、んうっ……」	PRINTFORML 「あっ、んうっ……」
PRINTFORML 「あっ、やぁっ……」	PRINTFORML 「あっ、やぁっ……」
PRINTFORML 「きゃっ…離れて！」	PRINTFORML 「きゃっ…離れて！」
PRINTFORML 「きゃぁ！体が！？」	PRINTFORML 「きゃぁ！体が！？」
PRINTFORML 「反応が遅れた！？」	PRINTFORML 「反応が遅れた！？」
PRINTFORML 「誘い込まれた！？」	PRINTFORML 「誘い込まれた！？」
PRINTFORML 「きゃぁ！やだぁ！」	PRINTFORML 「きゃぁ！やだぁ！」
PRINTFORML 「い、今のって……」	PRINTFORML 「い、今のって……」
PRINTFORML 「よ、汚された……」	PRINTFORML 「よ、汚された……」
PRINTFORML 「……幸運かしら？」	PRINTFORML 「……幸運かしら？」
PRINTFORML 「……あら、あれは」	PRINTFORML 「……あら、あれは」
PRINTFORML 「調子はどうかしら」	PRINTFORML 「調子はどうかしら」
PRINTFORML 「厄を払いましょう」	PRINTFORML 「厄を払いましょう」
PRINTFORML 「……ごめんなさい」	PRINTFORML 「……ごめんなさい」
PRINTFORML 「ごめんなさい……」	PRINTFORML 「ごめんなさい……」
PRINTFORML （疼いてる……♥）	PRINTFORML （疼いてる……♥）
PRINTFORML 「ぅ、うぅ……！」	PRINTFORML 「ぅ、うぅ……！」
PRINTFORML 「一気にいくわ！」	PRINTFORML 「一気にいくわ！」
PRINTFORML 「絶対に嫌……！」	PRINTFORML 「絶対に嫌……！」
PRINTFORML 「何をしてぇ……」	PRINTFORML 「何をしてぇ……」
PRINTFORML 「げほっげほっ…」	PRINTFORML 「げほっげほっ…」
PRINTFORML 「や、やめっ……」	PRINTFORML 「や、やめっ……」
PRINTFORML 「く、苦しい……」	PRINTFORML 「く、苦しい……」
PRINTFORML 「やっ、やめっ！」	PRINTFORML 「やっ、やめっ！」
PRINTFORML 「やめてよぉ……」	PRINTFORML 「やめてよぉ……」
PRINTFORML 「やめないでぇ…」	PRINTFORML 「やめないでぇ…」
PRINTFORML 「もっとほしい…」	PRINTFORML 「もっとほしい…」
PRINTFORML 「気持ちいい……」	PRINTFORML 「気持ちいい……」
PRINTFORML 「んんんッ……！」	PRINTFORML 「んんんッ……！」
PRINTFORML 「きゃぁ！体が！」	PRINTFORML 「きゃぁ！体が！」
PRINTFORML 「走らないと……」	PRINTFORML 「走らないと……」
PRINTFORML 「や、やめてよ！」	PRINTFORML 「や、やめてよ！」
PRINTFORML （休憩したい……）	PRINTFORML （休憩したい……）
PRINTFORML 「すぅ…zzz」	PRINTFORML 「すぅ…zzz」
PRINTFORML 「今の間に……」	PRINTFORML 「今の間に……」
PRINTFORML 「このぉ……！」	PRINTFORML 「このぉ……！」
PRINTFORML 「いやぁぁぁ！」	PRINTFORML 「いやぁぁぁ！」
PRINTFORML 「……そこっ！」	PRINTFORML 「……そこっ！」
PRINTFORML 「きゃぁぁぁ！」	PRINTFORML 「きゃぁぁぁ！」
PRINTFORML 「あああぁ……」	PRINTFORML 「あああぁ……」
PRINTFORML 「それだめぇ…」	PRINTFORML 「それだめぇ…」
PRINTFORML 「ひぃあっ！？」	PRINTFORML 「ひぃあっ！？」
PRINTFORML 「呑まれる！？」	PRINTFORML 「呑まれる！？」
PRINTFORML 「……こっち！」	PRINTFORML 「……こっち！」
PRINTFORML 「もう服が……」	PRINTFORML 「もう服が……」
PRINTFORML 「お互い災難ね」	PRINTFORML 「お互い災難ね」
PRINTFORML 「ぅ…ぁぁ……」	PRINTFORML 「ぅ…ぁぁ……」
PRINTFORML 「ららばい……」	PRINTFORML 「ららばい……」
PRINTFORML 「厄いわね……」	PRINTFORML 「厄いわね……」
﻿PRINTFORML 雛可愛いよ雛。	PRINTFORML 雛可愛いよ雛。
PRINTFORML 「げほっ……」	PRINTFORML 「げほっ……」
PRINTFORML 「うぇぇ……」	PRINTFORML 「うぇぇ……」
PRINTFORML 「かはっ……」	PRINTFORML 「かはっ……」
PRINTFORML 「やめぇ……」	PRINTFORML 「やめぇ……」
PRINTFORML 「うぐっ……」	PRINTFORML 「うぐっ……」
PRINTFORML 「げうっ……」	PRINTFORML 「げうっ……」
PRINTFORML 「あうっ……」	PRINTFORML 「あうっ……」
PRINTFORML 「しまった！」	PRINTFORML 「しまった！」
PRINTFORML 「速いっ！？」	PRINTFORML 「速いっ！？」
PRINTFORML 「えぇっ！？」	PRINTFORML 「えぇっ！？」
PRINTFORML 「そんな！？」	PRINTFORML 「そんな！？」
PRINTFORML 「ええっ！？」	PRINTFORML 「ええっ！？」
PRINTFORML 「ナカに……」	PRINTFORML 「ナカに……」
PRINTFORML 「厄いわ……」	PRINTFORML 「厄いわ……」
PRINTFORML 「っ……！」	PRINTFORML 「っ……！」
PRINTFORML 「ゃぁ……」	PRINTFORML 「ゃぁ……」
PRINTFORML 「ぉぇ……」	PRINTFORML 「ぉぇ……」
PRINTFORML 「がっ……」	PRINTFORML 「がっ……」
PRINTFORML 「……ぅぅ」	PRINTFORML 「……ぅぅ」
PRINTFORML 「力がっ…」	PRINTFORML 「力がっ…」
PRINTFORML 「すごぃ…」	PRINTFORML 「すごぃ…」
PRINTFORML 「あひぃ…」	PRINTFORML 「あひぃ…」
PRINTFORML 「嫌ぁ……」	PRINTFORML 「嫌ぁ……」
PRINTFORML 「っ……！	PRINTFORML 「っ……！
PRINTFORML 「ぁ……」	PRINTFORML 「ぁ……」
PRINTFORML 「痛っ…」	PRINTFORML 「痛っ…」
PRINTFORML 「……」	PRINTFORML 「……」
PRINTFORMDL …？	PRINTFORMDL …？
PRINTFORML 	PRINTFORML 
PRINTL 	PRINTL 
