//口上:

PRINTFORML ★　☆　★　☆　★　☆　★　☆　★　☆　★　☆　★　☆　★　☆　★　☆　★　☆　★　☆　★　☆	PRINTFORML ★　☆　★　☆　★　☆　★　☆　★　☆　★　☆　★　☆　★　☆　★　☆　★　☆　★　☆　★　☆
PRINTFORML ☆　★　☆　★　☆　★　☆　★　☆　★　☆　★　☆　★　☆　★　☆　★　☆　★　☆　★　☆　★	PRINTFORML ☆　★　☆　★　☆　★　☆　★　☆　★　☆　★　☆　★　☆　★　☆　★　☆　★　☆　★　☆　★
PRINTFORMDW 縋りつくような早苗の泣き声をその場に残して、%CALLNAME:1%は逃げ出した……	PRINTFORMDW 縋りつくような早苗の泣き声をその場に残して、%CALLNAME:1%は逃げ出した……
PRINTFORMW 「こういうの付けてる人居ましたね…私が言うのも難ですが、本当に効果あるのかしら？」	PRINTFORMW 「こういうの付けてる人居ましたね…私が言うのも難ですが、本当に効果あるのかしら？」
PRINTFORML 基本的に真面目ですが、テンション(TP)が上がると変な事を口走るようになります。	PRINTFORML 基本的に真面目ですが、テンション(TP)が上がると変な事を口走るようになります。
PRINTFORMW 「気色悪いですけど、一匹捕まえれば見世物くらいにはなるんじゃないですかね？」	PRINTFORMW 「気色悪いですけど、一匹捕まえれば見世物くらいにはなるんじゃないですかね？」
PRINTFORMW 「私から言い出しておいて難ですけど、良いんですか？こんな物頂いちゃって…」	PRINTFORMW 「私から言い出しておいて難ですけど、良いんですか？こんな物頂いちゃって…」
PRINTFORMW 「襲ってきたから咄嗟にやっつけちゃったけど…弾幕ごっこをする気も無ければ	PRINTFORMW 「襲ってきたから咄嗟にやっつけちゃったけど…弾幕ごっこをする気も無ければ
PRINTFORML 「大分霊力が残ってますね…誰のだか分かりませんが、使わせて貰いましょう」	PRINTFORML 「大分霊力が残ってますね…誰のだか分かりませんが、使わせて貰いましょう」
PRINTFORMDW 早苗の懇願も虚しく、%ARGS:1%は早苗を犯そうと触手を蠢かせた…	PRINTFORMDW 早苗の懇願も虚しく、%ARGS:1%は早苗を犯そうと触手を蠢かせた…
PRINTFORMW 　私も、此処じゃせいぜいサイコロで６ばっかり出せるくらいです。くすん」	PRINTFORMW 　私も、此処じゃせいぜいサイコロで６ばっかり出せるくらいです。くすん」
PRINTFORMW 「『気付け薬』って書いてありますね。使えそうなので拾っておきましょう」	PRINTFORMW 「『気付け薬』って書いてありますね。使えそうなので拾っておきましょう」
PRINTFORMW 「ゆっくり寝たいのは分かりますけど、余裕が無いのも事実なんですよね…」	PRINTFORMW 「ゆっくり寝たいのは分かりますけど、余裕が無いのも事実なんですよね…」
PRINTFORMW 「霊夢さんなら大丈夫……！自力で脱出できるに、決まってるんだから…」	PRINTFORMW 「霊夢さんなら大丈夫……！自力で脱出できるに、決まってるんだから…」
PRINTFORMW 「えっ、う、嘘……ま、待って下さいっ…！今、見捨てられたら、私……！	PRINTFORMW 「えっ、う、嘘……ま、待って下さいっ…！今、見捨てられたら、私……！
PRINTFORMW 「いつぞやの仙人様が私の事を『ひそーせんぱく』と言っていたのですが…	PRINTFORMW 「いつぞやの仙人様が私の事を『ひそーせんぱく』と言っていたのですが…
PRINTFORMDW 早苗は生唾をごくりと飲み込み、見せつけられたモノを凝視している…	PRINTFORMDW 早苗は生唾をごくりと飲み込み、見せつけられたモノを凝視している…
PRINTFORMDW 耐え切れないように、早苗は熱っぽい表情で自分の指を咥えている……	PRINTFORMDW 耐え切れないように、早苗は熱っぽい表情で自分の指を咥えている……
PRINTFORMW 　言葉も通じないみたいですね……うーん、どうしたらいいんだろう？」	PRINTFORMW 　言葉も通じないみたいですね……うーん、どうしたらいいんだろう？」
PRINTFORMW 「ふふふ…こいつらをやっつけるのも、段々楽しくなってきました…！」	PRINTFORMW 「ふふふ…こいつらをやっつけるのも、段々楽しくなってきました…！」
PRINTFORMW 「待ち伏せと言っても、大して備えられてる訳ではないんですよねぇ…」	PRINTFORMW 「待ち伏せと言っても、大して備えられてる訳ではないんですよねぇ…」
PRINTFORMW 「じゃあ私が…あ、ちょっ…ちょっと待って下さい！心の準備が…！？」	PRINTFORMW 「じゃあ私が…あ、ちょっ…ちょっと待って下さい！心の準備が…！？」
PRINTFORMW 今なら誰にも！神奈子様や諏訪子様にだって負ける気がしません！！！！	PRINTFORMW 今なら誰にも！神奈子様や諏訪子様にだって負ける気がしません！！！！
PRINTFORMW 「な…！？中は駄目ぇっ！嫌、嫌っ！！嫌ぁぁぁぁぁぁぁッッ！！！」	PRINTFORMW 「な…！？中は駄目ぇっ！嫌、嫌っ！！嫌ぁぁぁぁぁぁぁッッ！！！」
PRINTFORM 　さなえのことぉ…もっと…ぐちゃぐちゃにきもちよくしてくださいぃ…	PRINTFORM 　さなえのことぉ…もっと…ぐちゃぐちゃにきもちよくしてくださいぃ…
PRINTFORMW 　あれ…わたし……なんでここから脱出しなきゃいけないんだっけ……	PRINTFORMW 　あれ…わたし……なんでここから脱出しなきゃいけないんだっけ……
PRINTFORMW 「嫌っ！中は嫌ぁッ！こっ、こどもできちゃうぅぅぅぅぅ！！？？」	PRINTFORMW 「嫌っ！中は嫌ぁッ！こっ、こどもできちゃうぅぅぅぅぅ！！？？」
PRINTFORMDW 熱い吐息を吐きながら、早苗はもじもじと股間を擦りあわせた……	PRINTFORMDW 熱い吐息を吐きながら、早苗はもじもじと股間を擦りあわせた……
PRINTFORMDW そんな事を言いつつも、小傘が無事だったことに安心している様だ	PRINTFORMDW そんな事を言いつつも、小傘が無事だったことに安心している様だ
PRINTFORMW 　こう、オンバシラでどっかーんと！…無理ですよね、やっぱり…」	PRINTFORMW 　こう、オンバシラでどっかーんと！…無理ですよね、やっぱり…」
PRINTFORMW 「最近ちゃんと寝られてませんね…睡眠不足は美容の天敵なのに…」	PRINTFORMW 「最近ちゃんと寝られてませんね…睡眠不足は美容の天敵なのに…」
PRINTFORMDW 早苗は体を隠そうとするが、手足を拘束された早苗は動けない！	PRINTFORMDW 早苗は体を隠そうとするが、手足を拘束された早苗は動けない！
PRINTFORMW 「私達が組めばどんな異変でもちょちょいのちょい！ですよね♪」	PRINTFORMW 「私達が組めばどんな異変でもちょちょいのちょい！ですよね♪」
PRINTFORMDW 裸の状態で体を締め付けられ、早苗は必死にもがいている……	PRINTFORMDW 裸の状態で体を締め付けられ、早苗は必死にもがいている……
PRINTFORMW 　た、態勢を整えたら、すぐ助けに来てくれるんですよね…！？	PRINTFORMW 　た、態勢を整えたら、すぐ助けに来てくれるんですよね…！？
PRINTFORMW 「痛…！？…う、嘘……嫌……私……こんな、化け物に………」	PRINTFORMW 「痛…！？…う、嘘……嫌……私……こんな、化け物に………」
PRINTFORMW 「ありがとうございます…これでなんとかなると思います……」	PRINTFORMW 「ありがとうございます…これでなんとかなると思います……」
PRINTFORMW 「ありがとうございます！使うかどうかは分かりませんけど…」	PRINTFORMW 「ありがとうございます！使うかどうかは分かりませんけど…」
PRINTFORMW 「これは伝説の…『エクスカリパー』！…え、違うんですか？」	PRINTFORMW 「これは伝説の…『エクスカリパー』！…え、違うんですか？」
PRINTFORMW 「セブーン！…あれ、タロウだっけ？まぁ、どっちでもいいや」	PRINTFORMW 「セブーン！…あれ、タロウだっけ？まぁ、どっちでもいいや」
PRINTFORMW 「今回ほど腕時計を持ってて良かったと思う時はありませんね」	PRINTFORMW 「今回ほど腕時計を持ってて良かったと思う時はありませんね」
PRINTFORMDW 早苗は風呂がよほど心地良いのか、湯船でうとうとしている…	PRINTFORMDW 早苗は風呂がよほど心地良いのか、湯船でうとうとしている…
PRINTFORMW 「え、別行動ですか？一緒にいた方が安全だと思うんですけど…	PRINTFORMW 「え、別行動ですか？一緒にいた方が安全だと思うんですけど…
PRINTFORMW 「何だか体が軽いですね！もう何も怖くないって感じです！！」	PRINTFORMW 「何だか体が軽いですね！もう何も怖くないって感じです！！」
PRINTFORMW な、何だかとてつもなく元気と勇気とやる気が出てきました！！	PRINTFORMW な、何だかとてつもなく元気と勇気とやる気が出てきました！！
PRINTFORMW 「もしかして、天井に穴が…って、そんな訳無いですよねー…」	PRINTFORMW 「もしかして、天井に穴が…って、そんな訳無いですよねー…」
PRINTFORMW （は…早く……こいつを振りほどいて、ここから脱出して……！	PRINTFORMW （は…早く……こいつを振りほどいて、ここから脱出して……！
PRINTFORMW 「そうやって私に乱暴する気でしょう…エロ同人みたいに！」	PRINTFORMW 「そうやって私に乱暴する気でしょう…エロ同人みたいに！」
PRINTFORMW 「魔法少女、さなえ☆マギカ！…あ、アレは杖持ってないか」	PRINTFORMW 「魔法少女、さなえ☆マギカ！…あ、アレは杖持ってないか」
PRINTFORMW 「レベルが高くて言う事聞かないとかじゃないですよね…？」	PRINTFORMW 「レベルが高くて言う事聞かないとかじゃないですよね…？」
PRINTFORMW 「ブラウニーって言うんですか？美味しそうな名前ですね！」	PRINTFORMW 「ブラウニーって言うんですか？美味しそうな名前ですね！」
PRINTFORMW 「一か所ぐらい、こんなのが湧かない部屋が無いんですか…」	PRINTFORMW 「一か所ぐらい、こんなのが湧かない部屋が無いんですか…」
PRINTFORMDW 早苗は辛そうな顔など一切見せずに仲間の体を洗っている…	PRINTFORMDW 早苗は辛そうな顔など一切見せずに仲間の体を洗っている…
PRINTFORML 　………わ、分かりました。一人で…何とかやってみます…」	PRINTFORML 　………わ、分かりました。一人で…何とかやってみます…」
PRINTFORMW 「は、恥ずかしいけど…手を使わないと戦えないし……！」	PRINTFORMW 「は、恥ずかしいけど…手を使わないと戦えないし……！」
PRINTFORMW 「ごめんなさい、神奈子様！必ず助けに戻りますから…！」	PRINTFORMW 「ごめんなさい、神奈子様！必ず助けに戻りますから…！」
PRINTFORMW 「ごめんなさい、諏訪子様！必ず助けに戻りますから…！」	PRINTFORMW 「ごめんなさい、諏訪子様！必ず助けに戻りますから…！」
PRINTFORMW 「痛…！？……え、あ…もしかして……やっちゃった…？」	PRINTFORMW 「痛…！？……え、あ…もしかして……やっちゃった…？」
PRINTFORMW 「ごめんなさい、今の私には助けられそうもありません…」	PRINTFORMW 「ごめんなさい、今の私には助けられそうもありません…」
PRINTFORMW 「さっさとこんな異変解決して、一緒に宴会しましょうね！	PRINTFORMW 「さっさとこんな異変解決して、一緒に宴会しましょうね！
PRINTFORMW 　え、『早苗はあんまりお酒飲まないじゃないか？』って？	PRINTFORMW 　え、『早苗はあんまりお酒飲まないじゃないか？』って？
PRINTFORMW 「お、ｵﾝﾄﾞｩﾙﾙﾗｷﾞｯﾀﾝﾃﾞｨｽｶー！？」			PRINTFORMW 「お、ｵﾝﾄﾞｩﾙﾙﾗｷﾞｯﾀﾝﾃﾞｨｽｶー！？」		
PRINTFORMW 「え、えーと！何が何の役に立つか分からないですからね！	PRINTFORMW 「え、えーと！何が何の役に立つか分からないですからね！
PRINTFORMW 「余り、壁に手をついて歩きたくは、ないんですけどね…」	PRINTFORMW 「余り、壁に手をついて歩きたくは、ないんですけどね…」
PRINTFORMW 　どうして…今はそんな事より、ここから離れないと…！」	PRINTFORMW 　どうして…今はそんな事より、ここから離れないと…！」
PRINTFORMW 「ころおさけ…んく…ぷはぁ！すごくおいしいれすね……」	PRINTFORMW 「ころおさけ…んく…ぷはぁ！すごくおいしいれすね……」
PRINTFORMW 「い、何時までもジッとしてると思ったら大間違いです！」	PRINTFORMW 「い、何時までもジッとしてると思ったら大間違いです！」
PRINTFORMW 「見せてあげましょう、建御名方の力！風祝の奇跡を！！」	PRINTFORMW 「見せてあげましょう、建御名方の力！風祝の奇跡を！！」
PRINTFORMW （私…こんな化け物に犯されて…感じちゃってる…！？）	PRINTFORMW （私…こんな化け物に犯されて…感じちゃってる…！？）
PRINTFORMW 「ふふん♪そう簡単に乙女の柔肌が拝めるもんですか！」	PRINTFORMW 「ふふん♪そう簡単に乙女の柔肌が拝めるもんですか！」
PRINTFORMDW 早苗は顔を真っ赤にしながら残り少ない布を押さえた！	PRINTFORMDW 早苗は顔を真っ赤にしながら残り少ない布を押さえた！
PRINTFORMW 「だ、大丈夫です……話すくらいは、出来ますから……」	PRINTFORMW 「だ、大丈夫です……話すくらいは、出来ますから……」
PRINTFORMW 「女子が二人以上揃ったら、やっぱり恋バナですよね！」	PRINTFORMW 「女子が二人以上揃ったら、やっぱり恋バナですよね！」
PRINTFORMW 　外の世界には場酔いという良い言葉がありましてね…」	PRINTFORMW 　外の世界には場酔いという良い言葉がありましてね…」
PRINTFORMW 「……何やってんのかしら、私。こんなのを助けて……」	PRINTFORMW 「……何やってんのかしら、私。こんなのを助けて……」
PRINTFORMW 「何だかよく分かりませんが、有り難く頂戴しましょう」	PRINTFORMW 「何だかよく分かりませんが、有り難く頂戴しましょう」
PRINTFORMW 「部屋がこんなじゃ、おちおち休めもしませんからね…」	PRINTFORMW 「部屋がこんなじゃ、おちおち休めもしませんからね…」
PRINTFORMDW 早苗は心なしか楽しそうに壁の触手を掻き消している…	PRINTFORMDW 早苗は心なしか楽しそうに壁の触手を掻き消している…
PRINTFORMW 「みなさん、休める時にしっかり休んでおきましょう！」	PRINTFORMW 「みなさん、休める時にしっかり休んでおきましょう！」
﻿PRINTFORMW は「;」を左につけるか消すかしたほうがよいでしょう	PRINTFORMW は「;」を左につけるか消すかしたほうがよいでしょう
PRINTFORMW 　……もしかして、見捨てられちゃったの…かな…？）	PRINTFORMW 　……もしかして、見捨てられちゃったの…かな…？）
PRINTFORMW 「やっぱりミシャグジ様の降神の儀式とは違いますか？	PRINTFORMW 「やっぱりミシャグジ様の降神の儀式とは違いますか？
PRINTFORMW 「良いもの持ってるじゃないですか！寄越しなさい！」	PRINTFORMW 「良いもの持ってるじゃないですか！寄越しなさい！」
PRINTFORMW 「わぁ、ありがとうございます。助かっちゃいます♪」	PRINTFORMW 「わぁ、ありがとうございます。助かっちゃいます♪」
PRINTFORMW 「万全の状態ではないので、お力になれるかどうか…」	PRINTFORMW 「万全の状態ではないので、お力になれるかどうか…」
PRINTFORMW 「しっかりしてください！早苗です！分かりますか？」	PRINTFORMW 「しっかりしてください！早苗です！分かりますか？」
PRINTFORMW 「ほ、本当にお願いしますね…信頼してますから…！」	PRINTFORMW 「ほ、本当にお願いしますね…信頼してますから…！」
PRINTFORMW 「ふっふっふ。飛んで火に入る何とやら、ですね…！」	PRINTFORMW 「ふっふっふ。飛んで火に入る何とやら、ですね…！」
PRINTFORMW 「結界が機能しているうちにゆっくり休まないと……」	PRINTFORMW 「結界が機能しているうちにゆっくり休まないと……」
PRINTFORMW 「んく…んく…ぷはぁ！山の水より美味しいですね！」	PRINTFORMW 「んく…んく…ぷはぁ！山の水より美味しいですね！」
PRINTFORMW 「腰を入れて、力が入りすぎないよう……振り抜く！」	PRINTFORMW 「腰を入れて、力が入りすぎないよう……振り抜く！」
PRINTFORMW 「そ、そそ、そんなの見せつけないでくださいっ！」	PRINTFORMW 「そ、そそ、そんなの見せつけないでくださいっ！」
PRINTFORMDW 早苗は期待と不安が入り混じった表情をしている…	PRINTFORMDW 早苗は期待と不安が入り混じった表情をしている…
PRINTFORMW 「あぁもう！無駄に器用なのが腹立たしいですね！」	PRINTFORMW 「あぁもう！無駄に器用なのが腹立たしいですね！」
PRINTFORMW 　皆に見られながらオナニーして興奮しちゃう……っ	PRINTFORMW 　皆に見られながらオナニーして興奮しちゃう……っ
PRINTFORMW 「神に代わって、オシオキよっ☆……なんちゃって」	PRINTFORMW 「神に代わって、オシオキよっ☆……なんちゃって」
PRINTFORMW 「やっぱりマグロ食ってるようなのは駄目ですね！」	PRINTFORMW 「やっぱりマグロ食ってるようなのは駄目ですね！」
PRINTFORMW 　……で、出来れば…助けに来てくださいねー……」	PRINTFORMW 　……で、出来れば…助けに来てくださいねー……」
PRINTFORMW 「不安ですけど、まぁ一人にしとくよりは良いかな…	PRINTFORMW 「不安ですけど、まぁ一人にしとくよりは良いかな…
PRINTFORMW 「揺すって起きなかったら引っぱたいてください…」	PRINTFORMW 「揺すって起きなかったら引っぱたいてください…」
PRINTFORMW 「…………い、いけない。浄化に集中しないと…！」	PRINTFORMW 「…………い、いけない。浄化に集中しないと…！」
PRINTFORMW 「ふぅ…走らなくてもツラいものはツラいですね…」	PRINTFORMW 「ふぅ…走らなくてもツラいものはツラいですね…」
PRINTFORMW 「これなら一人の方が早く出口が見つかりそうだわ。	PRINTFORMW 「これなら一人の方が早く出口が見つかりそうだわ。
PRINTFORMW 「今のはバギクロスではありません…私のバギです」	PRINTFORMW 「今のはバギクロスではありません…私のバギです」
PRINTFORMW 「喰らいなさい！　秘術『グレイソーマタージ』！」	PRINTFORMW 「喰らいなさい！　秘術『グレイソーマタージ』！」
PRINTFORMW 「これで一網打尽です！　開海『モーゼの奇跡』！」	PRINTFORMW 「これで一網打尽です！　開海『モーゼの奇跡』！」
PRINTFORMW 「腋を締めて、狙いは中央…動きを読んで、撃つ！」	PRINTFORMW 「腋を締めて、狙いは中央…動きを読んで、撃つ！」
PRINTFORMW 「次いつ武器が手に入るか分かりませんものね……」	PRINTFORMW 「次いつ武器が手に入るか分かりませんものね……」
PRINTFORMW （わ、私が…囮になれば…その間に他の人は……！）	PRINTFORMW （わ、私が…囮になれば…その間に他の人は……！）
PRINTFORMW 「中で膨らんで…嘘……も、もしかして……！！」	PRINTFORMW 「中で膨らんで…嘘……も、もしかして……！！」
PRINTFORMDW 早苗は恥ずかしさの余り縮こまってしまった…！	PRINTFORMDW 早苗は恥ずかしさの余り縮こまってしまった…！
PRINTFORMW 「うぐ…？………！い、いけない…私ったら…！」	PRINTFORMW 「うぐ…？………！い、いけない…私ったら…！」
PRINTFORMW 「はぁっ…はぁっ…な、何とか勝てましたね……」	PRINTFORMW 「はぁっ…はぁっ…な、何とか勝てましたね……」
PRINTFORMDW 早苗は据わった目で敵の死骸を見つめている…！	PRINTFORMDW 早苗は据わった目で敵の死骸を見つめている…！
PRINTFORMW 「ふぅ……いくら倒してもキリがありませんね…」	PRINTFORMW 「ふぅ……いくら倒してもキリがありませんね…」
PRINTFORMW 「あの…お腹のことは…訊かないでください……」	PRINTFORMW 「あの…お腹のことは…訊かないでください……」
PRINTFORMW 「ここにいると不思議とお腹が減りませんよねぇ。	PRINTFORMW 「ここにいると不思議とお腹が減りませんよねぇ。
PRINTFORMW 　………や、やっぱりこの話止めましょうか…！」	PRINTFORMW 　………や、やっぱりこの話止めましょうか…！」
PRINTFORMW 「そ、そんな物何処で見つけてくるんですか…？」	PRINTFORMW 「そ、そんな物何処で見つけてくるんですか…？」
PRINTFORMW 「ご、ごめんなさい…私一人では心許ないので…」	PRINTFORMW 「ご、ごめんなさい…私一人では心許ないので…」
PRINTFORMDW 早苗は勝手に慌てながら見つけた物をしまった…	PRINTFORMDW 早苗は勝手に慌てながら見つけた物をしまった…
PRINTFORMW 「お茶は私より神奈子様の方が好きなんけどなぁ」	PRINTFORMW 「お茶は私より神奈子様の方が好きなんけどなぁ」
PRINTFORMW 「この壁、どういう原理で修復してるんでしょう…	PRINTFORMW 「この壁、どういう原理で修復してるんでしょう…
PRINTFORMW 「お風呂ですよー♪体を綺麗にしましょうね～♪」	PRINTFORMW 「お風呂ですよー♪体を綺麗にしましょうね～♪」
PRINTFORMW 　こんな異変ぐらい、一人で解決してみせます！」	PRINTFORMW 　こんな異変ぐらい、一人で解決してみせます！」
PRINTFORMW 「お、落ちたらアレの中に……ゾッとしますね…」	PRINTFORMW 「お、落ちたらアレの中に……ゾッとしますね…」
PRINTFORM 　このコにさわられてると…なんかキモチイイし……	PRINTFORM 　このコにさわられてると…なんかキモチイイし……
PRINTFORMW 「もう駄目…お、おかしくなっちゃうからぁっ！」	PRINTFORMW 「もう駄目…お、おかしくなっちゃうからぁっ！」
PRINTFORMW 「そ、そんなの…見せつけないで下さい…っ！」	PRINTFORMW 「そ、そんなの…見せつけないで下さい…っ！」
PRINTFORM 　おかひくなるぅぅぅぅぅぅぅぅぅぅぅぅぅぅぅう	PRINTFORM 　おかひくなるぅぅぅぅぅぅぅぅぅぅぅぅぅぅぅう
PRINTFORMW 「当たらなければどうという事はありません！」	PRINTFORMW 「当たらなければどうという事はありません！」
PRINTFORMW 「ご、ごめんなさいぃ…もう、ゆるしてぇ……」	PRINTFORMW 「ご、ごめんなさいぃ…もう、ゆるしてぇ……」
PRINTFORM 「そんなにみつめられると、てれちゃいますぅ……	PRINTFORM 「そんなにみつめられると、てれちゃいますぅ……
PRINTFORM （わ、私……敵の前でオナニーしちゃってるぅ……	PRINTFORM （わ、私……敵の前でオナニーしちゃってるぅ……
PRINTFORMW 「私は大丈夫ですから…！早く安全な所へ……！	PRINTFORMW 「私は大丈夫ですから…！早く安全な所へ……！
PRINTFORMW 「霊夢さん！良かった、無事だったんですね！」	PRINTFORMW 「霊夢さん！良かった、無事だったんですね！」
PRINTFORMW 　…そ、そんなに睨む事ないじゃないですか…」	PRINTFORMW 　…そ、そんなに睨む事ないじゃないですか…」
PRINTFORMW 　はぁ…早く脱出してシャワーを浴びたいです」	PRINTFORMW 　はぁ…早く脱出してシャワーを浴びたいです」
PRINTFORMW 　じょ、情報交換、ですよね？…えーっと……」	PRINTFORMW 　じょ、情報交換、ですよね？…えーっと……」
PRINTFORMW 「えーっと、私はここをこう通って来たから…」	PRINTFORMW 「えーっと、私はここをこう通って来たから…」
PRINTFORMW 「ここを通るなら気を付けた方がいいですよ…」	PRINTFORMW 「ここを通るなら気を付けた方がいいですよ…」
PRINTFORMW 　すぐ異変を解決して、お助けしますから……」	PRINTFORMW 　すぐ異変を解決して、お助けしますから……」
PRINTFORMW 　いやー、一回やってみたかったんですよね！」	PRINTFORMW 　いやー、一回やってみたかったんですよね！」
PRINTFORMW 「賢者の石ってアレですよね！鋼のなんとか！」	PRINTFORMW 「賢者の石ってアレですよね！鋼のなんとか！」
PRINTFORMW 「な、何でサイズがぴったりなんでしょう……」	PRINTFORMW 「な、何でサイズがぴったりなんでしょう……」
PRINTFORMW 「怪しいのが近づいてきたら起こして下さい…」	PRINTFORMW 「怪しいのが近づいてきたら起こして下さい…」
PRINTFORMW 「封印とか浄化は専門じゃないんですけどねぇ」	PRINTFORMW 「封印とか浄化は専門じゃないんですけどねぇ」
PRINTFORMW 「う、うぅ……ちょっと待って下さいよぉ…！」	PRINTFORMW 「う、うぅ……ちょっと待って下さいよぉ…！」
PRINTFORMW 「走ってたら逆に眠くなくなってきた様な…！」	PRINTFORMW 「走ってたら逆に眠くなくなってきた様な…！」
PRINTFORMDW 早苗は無警戒に次の部屋へ突っ込んでいった！	PRINTFORMDW 早苗は無警戒に次の部屋へ突っ込んでいった！
PRINTFORMW 「うーん…ジッとしてると寝ちゃいそうです…」	PRINTFORMW 「うーん…ジッとしてると寝ちゃいそうです…」
PRINTFORMW 　…分かりました。お互い気を付けましょうね」	PRINTFORMW 　…分かりました。お互い気を付けましょうね」
PRINTFORMW 「あ、後で泣きついたって知りませんからね！」	PRINTFORMW 「あ、後で泣きついたって知りませんからね！」
PRINTFORMW 「え、待って下さいよ！神奈子様ってばぁー！」	PRINTFORMW 「え、待って下さいよ！神奈子様ってばぁー！」
PRINTFORMW 「そんな見え見えの不意打ち、効きませんよ！」	PRINTFORMW 「そんな見え見えの不意打ち、効きませんよ！」
PRINTFORMDW 早苗は複雑な表情で触手の蠢く壁を見ている…	PRINTFORMDW 早苗は複雑な表情で触手の蠢く壁を見ている…
PRINTFORMW 「ひ…そ、そんなとこ入っちゃ…くぅんっ！？」	PRINTFORMW 「ひ…そ、そんなとこ入っちゃ…くぅんっ！？」
PRINTFORMW 「ひゃう！？早く、落とさないと…んんっ！？」	PRINTFORMW 「ひゃう！？早く、落とさないと…んんっ！？」
PRINTFORMW 「吹き飛びなさい！　大奇跡『八坂の神風』！」	PRINTFORMW 「吹き飛びなさい！　大奇跡『八坂の神風』！」
PRINTFORMW （ど、どうにか…こいつから離れないと……！）	PRINTFORMW （ど、どうにか…こいつから離れないと……！）
PRINTFORMW 「ナカはっ…！ナカだけは、絶対駄目ですっ！」	PRINTFORMW 「ナカはっ…！ナカだけは、絶対駄目ですっ！」
PRINTFORMW 「うあﾞッ！？…うぅ……ごめんなさいぃ…」	PRINTFORMW 「うあﾞッ！？…うぅ……ごめんなさいぃ…」
PRINTFORMDW 早苗は下腹部の強烈な違和感に眉を顰めた！	PRINTFORMDW 早苗は下腹部の強烈な違和感に眉を顰めた！
PRINTFORMW 「ひゃっ！？ま、まさか脱がす気ですか！？」	PRINTFORMW 「ひゃっ！？ま、まさか脱がす気ですか！？」
PRINTFORMW 　……………………………………………………	PRINTFORMW 　……………………………………………………
PRINTFORMW 「だ、大丈夫……では、なさそうですね……」	PRINTFORMW 「だ、大丈夫……では、なさそうですね……」
PRINTFORMW 「ここの化け物もやっぱり驚いてくれない…？	PRINTFORMW 「ここの化け物もやっぱり驚いてくれない…？
PRINTFORMW 「やっぱり、みんな能力が制限されてるのね…	PRINTFORMW 「やっぱり、みんな能力が制限されてるのね…
PRINTFORMW 「神奈子様がいらっしゃれば百人力ですよ！」	PRINTFORMW 「神奈子様がいらっしゃれば百人力ですよ！」
PRINTFORMW 「諏訪子様がいらっしゃれば百人力ですよ！」	PRINTFORMW 「諏訪子様がいらっしゃれば百人力ですよ！」
PRINTFORMW 　くれぐれも邪魔だけはしないで下さいね？」	PRINTFORMW 　くれぐれも邪魔だけはしないで下さいね？」
PRINTFORMW 「何か見つかったら、後で見せてください…」	PRINTFORMW 「何か見つかったら、後で見せてください…」
PRINTFORMW 「私、あんまりお酒飲めないんですけど……」	PRINTFORMW 「私、あんまりお酒飲めないんですけど……」
PRINTFORMW 「能力の上がる種ってドラ○エみたいですね」	PRINTFORMW 「能力の上がる種ってドラ○エみたいですね」
PRINTFORMW 「お先にどうぞ。見張りはお任せください！」	PRINTFORMW 「お先にどうぞ。見張りはお任せください！」
PRINTFORMW 「はぁ…はぁ…ふ、不便な体ですね、全く…」	PRINTFORMW 「はぁ…はぁ…ふ、不便な体ですね、全く…」
PRINTFORMW 「ふぁ…ぁ…そろそろ一休みしたいですね…」	PRINTFORMW 「ふぁ…ぁ…そろそろ一休みしたいですね…」
PRINTFORMDW 早苗は踏んぞり返りながら歩を進めている！	PRINTFORMDW 早苗は踏んぞり返りながら歩を進めている！
PRINTFORMDW 早苗はヘンな歩き方で足音を消している…！	PRINTFORMDW 早苗はヘンな歩き方で足音を消している…！
PRINTFORMDW 早苗は小刻みに震えながら息を殺している…	PRINTFORMDW 早苗は小刻みに震えながら息を殺している…
PRINTFORMDW 早苗は四肢を投げ出して脱力しきっている…	PRINTFORMDW 早苗は四肢を投げ出して脱力しきっている…
PRINTFORML 「……けほっ、けほっ……た、助かった…！？	PRINTFORML 「……けほっ、けほっ……た、助かった…！？
PRINTFORMW 「おぉ…！何だか急に元気が出てきました！」	PRINTFORMW 「おぉ…！何だか急に元気が出てきました！」
PRINTFORMDW 早苗はナカに感じる違和感に青褪めている…	PRINTFORMDW 早苗はナカに感じる違和感に青褪めている…
PRINTFORMW URRRRYYYYYYYYYYYY！！！」	PRINTFORMW URRRRYYYYYYYYYYYY！！！」
PRINTFORMW 「いちいち相手をしてたら埒が明きませんね」	PRINTFORMW 「いちいち相手をしてたら埒が明きませんね」
PRINTFORM 　いぐぅうぅうぅうぅうぅうぅうぅうぅうぅゥ	PRINTFORM 　いぐぅうぅうぅうぅうぅうぅうぅうぅうぅゥ
PRINTFORMW 「今のは神回避でしたね！現人神だけに！」	PRINTFORMW 「今のは神回避でしたね！現人神だけに！」
PRINTFORMW 「乱暴すると女の子に嫌われちゃいますよ」	PRINTFORMW 「乱暴すると女の子に嫌われちゃいますよ」
PRINTFORMDW 早苗は軽やかなステップを披露している！	PRINTFORMDW 早苗は軽やかなステップを披露している！
PRINTFORMW 「今の攻撃、本気じゃなかったような…？」	PRINTFORMW 「今の攻撃、本気じゃなかったような…？」
PRINTFORMW 「戦って倒すだけが勝利ではないのです！」	PRINTFORMW 「戦って倒すだけが勝利ではないのです！」
PRINTFORM 「寝る前に…っふぅ…ちょっと、だけ…んんっ	PRINTFORM 「寝る前に…っふぅ…ちょっと、だけ…んんっ
PRINTFORMW 「無事だったんですね…ちょっと意外です」	PRINTFORMW 「無事だったんですね…ちょっと意外です」
PRINTFORMW 「神奈子様の御力でどうにかなりませんか？	PRINTFORMW 「神奈子様の御力でどうにかなりませんか？
PRINTFORMW 「…………………………………………………	PRINTFORMW 「…………………………………………………
PRINTFORMW 「情報は多いに越した事は無いですからね」	PRINTFORMW 「情報は多いに越した事は無いですからね」
PRINTFORMW 「協力して、この異変を解決しましょう！」	PRINTFORMW 「協力して、この異変を解決しましょう！」
PRINTFORM 「すみません、こちらも余裕が無いもので…」	PRINTFORM 「すみません、こちらも余裕が無いもので…」
PRINTFORMW 「迷惑をかける訳にはいきませんので…！」	PRINTFORMW 「迷惑をかける訳にはいきませんので…！」
PRINTFORMW 「一人の方が動きやすいのよね、色々と。」	PRINTFORMW 「一人の方が動きやすいのよね、色々と。」
PRINTFORMW 「使って害が無ければ良いんですけど……」	PRINTFORMW 「使って害が無ければ良いんですけど……」
PRINTFORMW 「これって…霊夢さんが落としたのかな？」	PRINTFORMW 「これって…霊夢さんが落としたのかな？」
PRINTFORMW 「あぁ、ふかふかのベッドで寝たいです…」	PRINTFORMW 「あぁ、ふかふかのベッドで寝たいです…」
PRINTFORMW 「ちゃんと寝れるときに寝ておかないと…」	PRINTFORMW 「ちゃんと寝れるときに寝ておかないと…」
PRINTFORMW 「さぁ、何処からでもかかって来なさい！」	PRINTFORMW 「さぁ、何処からでもかかって来なさい！」
PRINTFORMDW 早苗は何故か楽しそうに身を隠している…	PRINTFORMDW 早苗は何故か楽しそうに身を隠している…
PRINTFORMDW 早苗は鼻唄まじりで風呂を満喫している…	PRINTFORMDW 早苗は鼻唄まじりで風呂を満喫している…
PRINTFORMW 「んく…んく…ふぅ、落ち着きますねー…」	PRINTFORMW 「んく…んく…ふぅ、落ち着きますねー…」
PRINTFORMW 「あ…急に来たから避けちゃったけど……」	PRINTFORMW 「あ…急に来たから避けちゃったけど……」
PRINTFORMDW 早苗は複雑な表情で落とし穴を見ている…	PRINTFORMDW 早苗は複雑な表情で落とし穴を見ている…
PRINTFORMW 「な、何コレ……！体が…ムズムズする…」	PRINTFORMW 「な、何コレ……！体が…ムズムズする…」
PRINTFORMDW 早苗は咄嗟に息を止めてガスをしのいだ！	PRINTFORMDW 早苗は咄嗟に息を止めてガスをしのいだ！
PRINTFORMW 「ま、まだ使い時じゃありませんかね…？」	PRINTFORMW 「ま、まだ使い時じゃありませんかね…？」
PRINTFORMW 「い、いつも通りやるだけなんだから…！」	PRINTFORMW 「い、いつも通りやるだけなんだから…！」
PRINTFORMW 「『覇王翔吼拳』を使わざるを得ませんね」	PRINTFORMW 「『覇王翔吼拳』を使わざるを得ませんね」
PRINTFORMW 　なんか……どうでもよくなっちゃった……	PRINTFORMW 　なんか……どうでもよくなっちゃった……
PRINTFORMW 　私は……私は――――――――――――）	PRINTFORMW 　私は……私は――――――――――――）
PRINTFORM 「お、お願い…もう……我慢できないのぉ……	PRINTFORM 「お、お願い…もう……我慢できないのぉ……
PRINTFORMW はその行の左にある「;」を消しましょう	PRINTFORMW はその行の左にある「;」を消しましょう
PRINTFORML 早苗口上(仮)ver2013_0608	PRINTFORML 早苗口上(仮)ver2013_0608
PRINTFORMW 「…そう何発も貰ってられませんね…！」	PRINTFORMW 「…そう何発も貰ってられませんね…！」
PRINTFORMW 「う、うぐ……うぇ……ひぐ……っ……」	PRINTFORMW 「う、うぐ……うぇ……ひぐ……っ……」
PRINTFORMDW 早苗はドヤ顔で味方の方を振り返った！	PRINTFORMDW 早苗はドヤ顔で味方の方を振り返った！
PRINTFORMW 「もしかして…焦らしてるんですか…？」	PRINTFORMW 「もしかして…焦らしてるんですか…？」
PRINTFORMDW 早苗の姿はかえって扇情的に見える……	PRINTFORMDW 早苗の姿はかえって扇情的に見える……
PRINTFORMW 「今なら神にでも負ける気はしません！」	PRINTFORMW 「今なら神にでも負ける気はしません！」
PRINTFORMW 　だ、大丈夫です！何ともありません！」	PRINTFORMW 　だ、大丈夫です！何ともありません！」
PRINTFORMW 「はふぅ……今、捕まったりしたら……」	PRINTFORMW 「はふぅ……今、捕まったりしたら……」
PRINTFORMW 「はぁ、はぁ……逃げきれ……た……？」	PRINTFORMW 「はぁ、はぁ……逃げきれ……た……？」
PRINTFORMDW そうつぶやいた早苗の声は震えていた…	PRINTFORMDW そうつぶやいた早苗の声は震えていた…
PRINTFORMW 　……………え、あ。ご、ごめんなさい！	PRINTFORMW 　……………え、あ。ご、ごめんなさい！
PRINTFORMW 「そういえば、あの部屋に良いモノが…」	PRINTFORMW 「そういえば、あの部屋に良いモノが…」
PRINTFORMW 「ほっとくわけにもいかないでしょ……」	PRINTFORMW 「ほっとくわけにもいかないでしょ……」
PRINTFORMW 「すみません、ご迷惑おかけしました…」	PRINTFORMW 「すみません、ご迷惑おかけしました…」
PRINTFORMW 「て、敵は…追って来てませんよね…？」	PRINTFORMW 「て、敵は…追って来てませんよね…？」
PRINTFORMDW 早苗は深夜テンションになってきた…！	PRINTFORMDW 早苗は深夜テンションになってきた…！
PRINTFORMW 「結界とかは専門ではないんですけどね」	PRINTFORMW 「結界とかは専門ではないんですけどね」
PRINTFORML 「ちょ、待っ……あぁ、行っちゃった…」	PRINTFORML 「ちょ、待っ……あぁ、行っちゃった…」
PRINTFORM 「じゃあ私が…あ、そんな…いきなり……っ	PRINTFORM 「じゃあ私が…あ、そんな…いきなり……っ
PRINTFORMW 「余り手加減する余裕も無いのですが…」	PRINTFORMW 「余り手加減する余裕も無いのですが…」
PRINTFORMW 「ふっふっふ…速さが足りませんね！！」	PRINTFORMW 「ふっふっふ…速さが足りませんね！！」
PRINTFORMW 「逃がしません！　秘法『九字刺し』！」	PRINTFORMW 「逃がしません！　秘法『九字刺し』！」
PRINTFORMW 「構えるのも辛くなってきましたね……」	PRINTFORMW 「構えるのも辛くなってきましたね……」
PRINTFORMW 「余り節約する余裕も無いのですが……」	PRINTFORMW 「余り節約する余裕も無いのですが……」
PRINTFORMW 「残弾なんて気にしてられません……！」	PRINTFORMW 「残弾なんて気にしてられません……！」
PRINTFORMW （細かい事は考えない…全力で……っ！）	PRINTFORMW （細かい事は考えない…全力で……っ！）
PRINTFORMW 「こ、このぉ…離せっ…！離してぇっ！」	PRINTFORMW 「こ、このぉ…離せっ…！離してぇっ！」
PRINTFORMW 　私……こいつに食べられちゃうんだ……	PRINTFORMW 　私……こいつに食べられちゃうんだ……
PRINTFORMW 「…っ…馬鹿力ですね、コイツら…！」	PRINTFORMW 「…っ…馬鹿力ですね、コイツら…！」
PRINTFORM 「たくさん、かわいがってくださいね……	PRINTFORM 「たくさん、かわいがってくださいね……
PRINTFORM 　せーえきでいっぱいにしてくださいぃ…	PRINTFORM 　せーえきでいっぱいにしてくださいぃ…
PRINTFORMDW 「うぅ、もうお嫁に行けない……」 	PRINTFORMDW 「うぅ、もうお嫁に行けない……」 
PRINTFORMW 「あぅ、もう殆ど裸じゃないですか…」	PRINTFORMW 「あぅ、もう殆ど裸じゃないですか…」
PRINTFORMW 「『てめーは私を怒らせた』、です！」	PRINTFORMW 「『てめーは私を怒らせた』、です！」
PRINTFORMDW 早苗は変な決めポーズをとっている！	PRINTFORMDW 早苗は変な決めポーズをとっている！
PRINTFORMW （もしかして私……期待してた…！？）	PRINTFORMW （もしかして私……期待してた…！？）
PRINTFORMW 「どうやら追ってこないみたいですね」	PRINTFORMW 「どうやら追ってこないみたいですね」
PRINTFORMW 「き、きっと助けに戻りますから…！」	PRINTFORMW 「き、きっと助けに戻りますから…！」
PRINTFORMW 　……信じて、良いんですよね……？」	PRINTFORMW 　……信じて、良いんですよね……？」
PRINTFORMW 「だ、誰も見てません……よね……？」	PRINTFORMW 「だ、誰も見てません……よね……？」
PRINTFORMW 「神奈子様！ご無事で何よりです…！」	PRINTFORMW 「神奈子様！ご無事で何よりです…！」
PRINTFORMW 「諏訪子様！ご無事で何よりです…！」	PRINTFORMW 「諏訪子様！ご無事で何よりです…！」
PRINTFORMW 「良かった、話が通じそうな人だ…！」	PRINTFORMW 「良かった、話が通じそうな人だ…！」
PRINTFORMW 　一体どういう意味なんでしょう…？」	PRINTFORMW 　一体どういう意味なんでしょう…？」
PRINTFORMW 「これから宜しくお願いしますねっ！」	PRINTFORMW 「これから宜しくお願いしますねっ！」
PRINTFORM 「私だって持ち合わせ少ないんですよ？」	PRINTFORM 「私だって持ち合わせ少ないんですよ？」
PRINTFORMW 「す、すみません！ちょっと用事が！」	PRINTFORMW 「す、すみません！ちょっと用事が！」
PRINTFORMW 「うーん、どこかで見たような……？」	PRINTFORMW 「うーん、どこかで見たような……？」
PRINTFORMW 「なんでこんな所に缶コーヒーが…？」	PRINTFORMW 「なんでこんな所に缶コーヒーが…？」
PRINTFORMW 「何処か…安全に休める場所は…！？」	PRINTFORMW 「何処か…安全に休める場所は…！？」
PRINTFORMW 「ゆっくり歩いてたら襲われそうで…」	PRINTFORMW 「ゆっくり歩いてたら襲われそうで…」
PRINTFORMW 「何か逆に楽しくなってきました…！」	PRINTFORMW 「何か逆に楽しくなってきました…！」
PRINTFORML 「こっ……！この状態で、ですか…！？	PRINTFORML 「こっ……！この状態で、ですか…！？
PRINTFORMW 「飲んだ方が良かったんでしょうか…」	PRINTFORMW 「飲んだ方が良かったんでしょうか…」
PRINTFORMW 「入った方が良かったんでしょうか…」	PRINTFORMW 「入った方が良かったんでしょうか…」
PRINTFORMW 「ふ、服が狙いだったみたいですね…」	PRINTFORMW 「ふ、服が狙いだったみたいですね…」
PRINTFORMW …ふ、ふぉぉぉぉぉぉぉぉぉお！！！！	PRINTFORMW …ふ、ふぉぉぉぉぉぉぉぉぉお！！！！
PRINTFORMW 「まだそんなに眠くありませんからね」	PRINTFORMW 「まだそんなに眠くありませんからね」
PRINTFORMW 「纏めてぶっとばして差し上げます！」	PRINTFORMW 「纏めてぶっとばして差し上げます！」
PRINTFORMW 「余り手加減する余裕も無いのですが」	PRINTFORMW 「余り手加減する余裕も無いのですが」
PRINTFORMW 「動きさえ止めれば、こんな奴……！」	PRINTFORMW 「動きさえ止めれば、こんな奴……！」
PRINTFORMW 「お、お願い……もう、辞めて……！」	PRINTFORMW 「お、お願い……もう、辞めて……！」
PRINTFORM 　んﾞんぅ――――――――――ッッッ	PRINTFORM 　んﾞんぅ――――――――――ッッッ
PRINTFORM 「あぁ…吸っちゃ駄目…なのにぃ……」	PRINTFORM 「あぁ…吸っちゃ駄目…なのにぃ……」
PRINTFORMW 「ひっ…なっ…何！？これぇっ！？」	PRINTFORMW 「ひっ…なっ…何！？これぇっ！？」
PRINTFORMW 「つ、捕まってたまるもんですか！」	PRINTFORMW 「つ、捕まってたまるもんですか！」
PRINTFORMW 「貴女がこの異変の元凶ですね…！」	PRINTFORMW 「貴女がこの異変の元凶ですね…！」
PRINTFORMW 「ちゃちゃっとやっつけましょう！」	PRINTFORMW 「ちゃちゃっとやっつけましょう！」
PRINTFORMW 「つ、次は…勝てるかどうか…っ…」	PRINTFORMW 「つ、次は…勝てるかどうか…っ…」
PRINTFORMW 「ふぅ、なんとか巻いたみたいです」	PRINTFORMW 「ふぅ、なんとか巻いたみたいです」
PRINTFORMW 「どう考えても妖怪よね…あの偽物」	PRINTFORMW 「どう考えても妖怪よね…あの偽物」
PRINTFORMW 「分かりました、協力しましょう！」	PRINTFORMW 「分かりました、協力しましょう！」
PRINTFORMW 　一応！一応拾っておきましょう！」	PRINTFORMW 　一応！一応拾っておきましょう！」
PRINTFORMW 「サクっとお掃除して休みましょう」	PRINTFORMW 「サクっとお掃除して休みましょう」
PRINTFORMW 　余り考えたくはありませんけど…」	PRINTFORMW 　余り考えたくはありませんけど…」
PRINTFORMW 「どこか安全に休める場所は…っと」	PRINTFORMW 「どこか安全に休める場所は…っと」
PRINTFORMW 「だいなみーっく！えんとりー！！」	PRINTFORMW 「だいなみーっく！えんとりー！！」
PRINTFORMW 「隠れんぼしてるみたいですね…！」	PRINTFORMW 「隠れんぼしてるみたいですね…！」
PRINTFORMDW 早苗は不敵な笑みを浮かべている…	PRINTFORMDW 早苗は不敵な笑みを浮かべている…
PRINTFORMW 「御札の罠でも仕掛けましょうか？」	PRINTFORMW 「御札の罠でも仕掛けましょうか？」
PRINTFORMW 「迂闊に動くと危ないですからね…」	PRINTFORMW 「迂闊に動くと危ないですからね…」
PRINTFORMW 「私だってもう子供じゃないんです！	PRINTFORMW 「私だってもう子供じゃないんです！
PRINTFORMW 「諏訪子さ……あ、あれ？居ない？」	PRINTFORMW 「諏訪子さ……あ、あれ？居ない？」
PRINTFORMW 「んんー、冷たくて気持ちいい……」	PRINTFORMW 「んんー、冷たくて気持ちいい……」
PRINTFORMW 「あ、あれ…急に、しかい…が……」	PRINTFORMW 「あ、あれ…急に、しかい…が……」
PRINTFORMW 「見るからに怪しいですからね……」	PRINTFORMW 「見るからに怪しいですからね……」
PRINTFORMW 「憑き物が落ちたような気がします」	PRINTFORMW 「憑き物が落ちたような気がします」
PRINTFORMW 「い、今のは危なかったですね…！」	PRINTFORMW 「い、今のは危なかったですね…！」
PRINTFORMW 「…ぷはぁ！び、びっくりした……」	PRINTFORMW 「…ぷはぁ！び、びっくりした……」
PRINTFORMDW 早苗は目蓋が重くなるのを感じた…	PRINTFORMDW 早苗は目蓋が重くなるのを感じた…
PRINTFORMW 「…急に気怠くなってきました……」	PRINTFORMW 「…急に気怠くなってきました……」
PRINTFORMW 「……歯磨き粉みたいな味がします」	PRINTFORMW 「……歯磨き粉みたいな味がします」
PRINTFORMW 「う、嘘……入ってきちゃった……」	PRINTFORMW 「う、嘘……入ってきちゃった……」
PRINTFORMW 　　　　　　　　ﾚﾎﾞﾘｭｰｼｮﾝ	PRINTFORMW 　　　　　　　　ﾚﾎﾞﾘｭｰｼｮﾝ
PRINTFORMW 「弾を込めないと撃てませんからね」	PRINTFORMW 「弾を込めないと撃てませんからね」
PRINTFORMW 「もう、弾幕打つのも億劫なのに！」	PRINTFORMW 「もう、弾幕打つのも億劫なのに！」
PRINTFORMW 「離し…なさぁぁぁぁぁぁぁい！！」	PRINTFORMW 「離し…なさぁぁぁぁぁぁぁい！！」
PRINTFORMW 「さっさと……吹き飛びなさいっ！」	PRINTFORMW 「さっさと……吹き飛びなさいっ！」
PRINTFORMW 「こういうのはコツが居るんですよ」	PRINTFORMW 「こういうのはコツが居るんですよ」
PRINTFORMW 「がぁ…ッ…も、もぉいやぁ……」	PRINTFORMW 「がぁ…ッ…も、もぉいやぁ……」
PRINTFORM 　ごめんなさっいﾞッあﾞッあﾞぁッ	PRINTFORM 　ごめんなさっいﾞッあﾞッあﾞぁッ
PRINTFORM 　あﾞあﾞあﾞぁぁぁぁぁぁあッッッ	PRINTFORM 　あﾞあﾞあﾞぁぁぁぁぁぁあッッッ
PRINTFORMW 「さ、触らないでください…っ！」	PRINTFORMW 「さ、触らないでください…っ！」
PRINTFORMDW 早苗はひとり満足そうに頷いた！	PRINTFORMDW 早苗はひとり満足そうに頷いた！
PRINTFORMW 「きゃぁっ！？何するんですか！」	PRINTFORMW 「きゃぁっ！？何するんですか！」
PRINTFORMDW 大事な部分を手で隠している……	PRINTFORMDW 大事な部分を手で隠している……
PRINTFORMDW 早苗は無心で自慰に耽っている！	PRINTFORMDW 早苗は無心で自慰に耽っている！
PRINTFORMW 　無茶言わないでくださいよ……」	PRINTFORMW 　無茶言わないでくださいよ……」
PRINTFORMW 「空気がじっとりしてますよねー…	PRINTFORMW 「空気がじっとりしてますよねー…
PRINTFORMW 「このご恩は必ずお返しします！」	PRINTFORMW 「このご恩は必ずお返しします！」
PRINTFORMW 「お先に失礼します………ぐぅ…」	PRINTFORMW 「お先に失礼します………ぐぅ…」
PRINTFORMW 「どこの壁もこんな感じでしたね」	PRINTFORMW 「どこの壁もこんな感じでしたね」
PRINTFORMDW 早苗は無駄に全力疾走している！	PRINTFORMDW 早苗は無駄に全力疾走している！
PRINTFORMW 「ここは勢い良く行きましょう！」	PRINTFORMW 「ここは勢い良く行きましょう！」
PRINTFORMW 「い、今襲われたりしたら……！」	PRINTFORMW 「い、今襲われたりしたら……！」
PRINTFORMW 「何だか肝試しみたいですね…！」	PRINTFORMW 「何だか肝試しみたいですね…！」
PRINTFORMW 「こんな所の水飲めませんよね…」	PRINTFORMW 「こんな所の水飲めませんよね…」
PRINTFORMW 「ひっ…！？嫌っ！は、離し…！」	PRINTFORMW 「ひっ…！？嫌っ！は、離し…！」
PRINTFORMW 「………………………………………	PRINTFORMW 「………………………………………
PRINTFORMW 「いやぁ、試してみるもんですね」	PRINTFORMW 「いやぁ、試してみるもんですね」
PRINTFORMW 「い、いてて……不注意でしたね」	PRINTFORMW 「い、いてて……不注意でしたね」
PRINTFORMW 「私のリロードは　革命　です！」	PRINTFORMW 「私のリロードは　革命　です！」
PRINTFORMW 「お、落ち着いて狙うのよ……！」	PRINTFORMW 「お、落ち着いて狙うのよ……！」
PRINTFORMW 「準備『神風を喚ぶ星の儀式』！」	PRINTFORMW 「準備『神風を喚ぶ星の儀式』！」
PRINTFORMW 「う、上手く力が入らない……！」	PRINTFORMW 「う、上手く力が入らない……！」
PRINTFORMW 「大人しくやられて下さいっ！！」	PRINTFORMW 「大人しくやられて下さいっ！！」
PRINTFORMW （あぁ…もう逃げられないんだ……	PRINTFORMW （あぁ…もう逃げられないんだ……
PRINTFORMW 「あう……いたいのはいやぁ…」	PRINTFORMW 「あう……いたいのはいやぁ…」
PRINTFORMW 「そんなの見せつけられたら……	PRINTFORMW 「そんなの見せつけられたら……
PRINTFORMW 　き、気持ち良くなんかぁっ！」	PRINTFORMW 　き、気持ち良くなんかぁっ！」
PRINTFORMW 「い、今捕まったりしたら…！」	PRINTFORMW 「い、今捕まったりしたら…！」
PRINTFORMW 「や、やるしかありません…！」	PRINTFORMW 「や、やるしかありません…！」
PRINTFORMW 「…そんな……神奈子、様……」	PRINTFORMW 「…そんな……神奈子、様……」
PRINTFORMW 「…そんな……諏訪子、様……」	PRINTFORMW 「…そんな……諏訪子、様……」
PRINTFORMW 「…そんな……霊夢、さん……」	PRINTFORMW 「…そんな……霊夢、さん……」
PRINTFORMW 　…貴女って相当呑気よね……」	PRINTFORMW 　…貴女って相当呑気よね……」
PRINTFORMW 「奇跡で何とかならないかって？	PRINTFORMW 「奇跡で何とかならないかって？
PRINTFORMW 「ふふふ……おばーかさんっ♪」	PRINTFORMW 「ふふふ……おばーかさんっ♪」
PRINTFORMW 「お人好しが過ぎたかしら……」	PRINTFORMW 「お人好しが過ぎたかしら……」
PRINTFORMW 「足手纏いですよね…きっと…」	PRINTFORMW 「足手纏いですよね…きっと…」
PRINTFORMW 「マイ抱き枕が恋しいですね…」	PRINTFORMW 「マイ抱き枕が恋しいですね…」
PRINTFORMW 「て、敵が居ませんように…！」	PRINTFORMW 「て、敵が居ませんように…！」
PRINTFORMW 「もう嫌ぁ…家に帰りたい……」	PRINTFORMW 「もう嫌ぁ…家に帰りたい……」
PRINTFORMW 「走ったら転んじゃいそうで…」	PRINTFORMW 「走ったら転んじゃいそうで…」
PRINTFORMW 　ごめん　な　さ　…　…　…）	PRINTFORMW 　ごめん　な　さ　…　…　…）
PRINTFORMW 　もう…駄目かと思いました…」	PRINTFORMW 　もう…駄目かと思いました…」
PRINTFORMW 「こ、これってもしかして……」	PRINTFORMW 「こ、これってもしかして……」
PRINTFORMW 「ひぁっ！？…ふ、服が……！」	PRINTFORMW 「ひぁっ！？…ふ、服が……！」
PRINTFORMW 「お、落ちたらアレの中に……」	PRINTFORMW 「お、落ちたらアレの中に……」
PRINTFORMW 「ほ、他を当たってください…」	PRINTFORMW 「ほ、他を当たってください…」
PRINTFORMW 「今マトモに喰らったら……！」	PRINTFORMW 「今マトモに喰らったら……！」
PRINTFORMW 「この…さっさと倒れなさい！」	PRINTFORMW 「この…さっさと倒れなさい！」
PRINTFORMW 「離しなさい、このケダモノ！」	PRINTFORMW 「離しなさい、このケダモノ！」
PRINTFORM 「こっ…こんなにキモチイイのっ…	PRINTFORM 「こっ…こんなにキモチイイのっ…
PRINTFORM 　ほ、欲しくなっちゃいますぅ…	PRINTFORM 　ほ、欲しくなっちゃいますぅ…
PRINTFORM 　お願いぃ…いやぁっあっあﾞッ	PRINTFORM 　お願いぃ…いやぁっあっあﾞッ
PRINTFORM 　ひぁぁぁぁぁぁぁぁぁぁッッッ	PRINTFORM 　ひぁぁぁぁぁぁぁぁぁぁッッッ
PRINTFORMW 「も、やめっ……くぅっ！？」	PRINTFORMW 「も、やめっ……くぅっ！？」
PRINTFORMW 「そう何度も躱せませんね…」	PRINTFORMW 「そう何度も躱せませんね…」
PRINTFORMW 「素人ね、間合いが遠いわ！」	PRINTFORMW 「素人ね、間合いが遠いわ！」
PRINTFORMW 「い、嫌…近寄らないで…！」	PRINTFORMW 「い、嫌…近寄らないで…！」
PRINTFORMW 「うぅっ…ヌルヌルする……」	PRINTFORMW 「うぅっ…ヌルヌルする……」
PRINTFORMD 自身の躰を抱くように胸を隠す	PRINTFORMD 自身の躰を抱くように胸を隠す
PRINTFORMD もじもじとしながら秘所を隠す	PRINTFORMD もじもじとしながら秘所を隠す
PRINTFORMW （うぅ…み、見られてる……）	PRINTFORMW （うぅ…み、見られてる……）
PRINTFORMW 「み、見ないで下さい……！」	PRINTFORMW 「み、見ないで下さい……！」
PRINTFORMW （……足音が遠ざかっていく…	PRINTFORMW （……足音が遠ざかっていく…
PRINTFORMW 早苗は青褪めて硬直している…	PRINTFORMW 早苗は青褪めて硬直している…
PRINTFORMW 「偽物…じゃないですよね？」	PRINTFORMW 「偽物…じゃないですよね？」
PRINTFORMW 「手分けして探索しましょう」	PRINTFORMW 「手分けして探索しましょう」
PRINTFORMW 「すみませんがお借りします。	PRINTFORMW 「すみませんがお借りします。
PRINTFORMW 「ふふふ……残念でしたね！」	PRINTFORMW 「ふふふ……残念でしたね！」
PRINTFORMW 「汚物は消毒だ～！（ボォァッ	PRINTFORMW 「汚物は消毒だ～！（ボォァッ
PRINTFORMW 「ニンジャウォークですよ！」	PRINTFORMW 「ニンジャウォークですよ！」
PRINTFORMW 「ここは慎重に行きましょう」	PRINTFORMW 「ここは慎重に行きましょう」
PRINTFORMW 　わたし　んじゃうの…かな…	PRINTFORMW 　わたし　んじゃうの…かな…
PRINTFORMW 　という訳で失礼しますね。」	PRINTFORMW 　という訳で失礼しますね。」
PRINTFORM 「もう駄目…ガマンできないっ…	PRINTFORM 「もう駄目…ガマンできないっ…
PRINTFORMW 「何だか良い匂いですね……」	PRINTFORMW 「何だか良い匂いですね……」
PRINTFORM す、吸っちゃだめぇぇぇぇぇぇえ	PRINTFORM す、吸っちゃだめぇぇぇぇぇぇえ
PRINTFORMW 「風祝を甘く見ないことね！」	PRINTFORMW 「風祝を甘く見ないことね！」
PRINTFORMW 「これが私の…全力全開！！」	PRINTFORMW 「これが私の…全力全開！！」
PRINTFORMW （あ、汗で…手が…滑る…！）	PRINTFORMW （あ、汗で…手が…滑る…！）
PRINTFORM 　もぉ…ガマン、できないぃ……	PRINTFORM 　もぉ…ガマン、できないぃ……
PRINTFORML 空欄が多いのでまだ(仮)。	PRINTFORML 空欄が多いのでまだ(仮)。
PRINTFORMW 「み、見ないでぇーっ！？」	PRINTFORMW 「み、見ないでぇーっ！？」
PRINTFORMW （い、今触られたら…っ！）	PRINTFORMW （い、今触られたら…っ！）
PRINTFORM 　み、皆に見られてるのにっっ	PRINTFORM 　み、皆に見られてるのにっっ
PRINTFORM 　見ないでぇぇぇぇぇぇぇぇっ	PRINTFORM 　見ないでぇぇぇぇぇぇぇぇっ
PRINTFORM 　敵の前でオナニーするのぉ…	PRINTFORM 　敵の前でオナニーするのぉ…
PRINTFORMW 「早く終わらせましょう！」	PRINTFORMW 「早く終わらせましょう！」
PRINTFORMW 「風祝をなめないことね！」	PRINTFORMW 「風祝をなめないことね！」
PRINTFORMW 「へ、変な事するから…！」	PRINTFORMW 「へ、変な事するから…！」
PRINTFORMW 「あなたでは役不足です！」	PRINTFORMW 「あなたでは役不足です！」
PRINTFORMW 「あ…よ、良かったぁ……」	PRINTFORMW 「あ…よ、良かったぁ……」
PRINTFORMW 「………じゃ、じゃあまた」	PRINTFORMW 「………じゃ、じゃあまた」
PRINTFORMW 　かなこさま…すわこさま…	PRINTFORMW 　かなこさま…すわこさま…
PRINTFORMW 「あ、ありがとうございます	PRINTFORMW 「あ、ありがとうございます
PRINTFORML 「むぅ、失礼な人ですね！」	PRINTFORML 「むぅ、失礼な人ですね！」
PRINTFORMW 「今の内にリロードを…！」	PRINTFORMW 「今の内にリロードを…！」
PRINTFORMW 「これが！奇跡の力です！」	PRINTFORMW 「これが！奇跡の力です！」
PRINTFORMW 「お願い…当たって……！」	PRINTFORMW 「お願い…当たって……！」
PRINTFORMW 「さ、触らないでぇ……っ」	PRINTFORMW 「さ、触らないでぇ……っ」
PRINTFORM 　は、入って…来てるぅ……	PRINTFORM 　は、入って…来てるぅ……
PRINTFORMW 「乙女の貞操の危機！？」	PRINTFORMW 「乙女の貞操の危機！？」
PRINTFORMW 「な、何だか悪寒が……」	PRINTFORMW 「な、何だか悪寒が……」
PRINTFORMW 「ぐ…マズいですね……」	PRINTFORMW 「ぐ…マズいですね……」
PRINTFORMW 「嫌っ！ふ、服が…！？」	PRINTFORMW 「嫌っ！ふ、服が…！？」
PRINTFORMW 「は、離してぇ……っ！」	PRINTFORMW 「は、離してぇ……っ！」
PRINTFORM 「か、体を鎮めないと……っ	PRINTFORM 「か、体を鎮めないと……っ
PRINTFORM 　みんな起きちゃうのにぃ…	PRINTFORM 　みんな起きちゃうのにぃ…
PRINTFORMW 「『進撃の早苗』です！」	PRINTFORMW 「『進撃の早苗』です！」
PRINTFORMW 「んー……良いお湯…♪」	PRINTFORMW 「んー……良いお湯…♪」
PRINTFORM 「駄目…ガマンできないっ…	PRINTFORM 「駄目…ガマンできないっ…
PRINTFORMW 「ひっ…捕まっ……！？」	PRINTFORMW 「ひっ…捕まっ……！？」
PRINTFORM 　ひぁぁぁぁぁぁぁぁぁぁあ	PRINTFORM 　ひぁぁぁぁぁぁぁぁぁぁあ
PRINTFORMW 「これくらいですかね？」	PRINTFORMW 「これくらいですかね？」
PRINTFORMW 「お願い…当たって…！」	PRINTFORMW 「お願い…当たって…！」
PRINTFORMW 「次で仕留めます……！」	PRINTFORMW 「次で仕留めます……！」
PRINTFORMW 「足元がお留守ですよ？」	PRINTFORMW 「足元がお留守ですよ？」
PRINTFORMW 「一気にやっつけます！」	PRINTFORMW 「一気にやっつけます！」
PRINTFORMW 「ちょっと勿体無いかな」	PRINTFORMW 「ちょっと勿体無いかな」
PRINTFORMW 「ちょこまかするなー！」	PRINTFORMW 「ちょこまかするなー！」
PRINTFORMW （隙を見てにげなきゃ…）	PRINTFORMW （隙を見てにげなきゃ…）
PRINTFORMW 「ココは弱いんです…！」	PRINTFORMW 「ココは弱いんです…！」
PRINTFORMW 「もう…ナカ…嫌ぁ……」	PRINTFORMW 「もう…ナカ…嫌ぁ……」
PRINTFORMW 「ッ…もう、離し……」	PRINTFORMW 「ッ…もう、離し……」
PRINTFORMW 「か…は……ッ…！？」	PRINTFORMW 「か…は……ッ…！？」
PRINTFORM 　イッちゃうぅぅぅぅぅぅ	PRINTFORM 　イッちゃうぅぅぅぅぅぅ
PRINTFORM 頭、おかしくなっちゃうぅ	PRINTFORM 頭、おかしくなっちゃうぅ
PRINTFORM 嫌ああぁぁぁぁぁぁぁぁぁ	PRINTFORM 嫌ああぁぁぁぁぁぁぁぁぁ
PRINTFORM 　ゆるしてぇ……ひぁあっ	PRINTFORM 　ゆるしてぇ……ひぁあっ
PRINTFORMW 「もぉ…やめてぇ……」	PRINTFORMW 「もぉ…やめてぇ……」
PRINTFORMW 「嫌っ！離してっ…！」	PRINTFORMW 「嫌っ！離してっ…！」
PRINTFORM 　いっぱいきてるぅぅぅっ	PRINTFORM 　いっぱいきてるぅぅぅっ
PRINTFORMW 「狙いが甘いですね！」	PRINTFORMW 「狙いが甘いですね！」
PRINTFORMW 「狙いが浅いですね！」	PRINTFORMW 「狙いが浅いですね！」
PRINTFORMW 「嫌ぁ、離してぇっ！」	PRINTFORMW 「嫌ぁ、離してぇっ！」
PRINTFORM 　へ…変態痴女ですっ…ん	PRINTFORM 　へ…変態痴女ですっ…ん
PRINTFORM 　手ぇ止まんないぃぃぃっ	PRINTFORM 　手ぇ止まんないぃぃぃっ
PRINTFORMW 「…むにゃむにゃ……」	PRINTFORMW 「…むにゃむにゃ……」
PRINTFORM 「はぁっ……　はぁっ……	PRINTFORM 「はぁっ……　はぁっ……
PRINTFORM が、我慢…できない……っ	PRINTFORM が、我慢…できない……っ
PRINTFORMW 「え……わ、私…！？」	PRINTFORMW 「え……わ、私…！？」
PRINTFORMW 「無事だったんですね」	PRINTFORMW 「無事だったんですね」
PRINTFORMW 「私が守らなきゃ……」	PRINTFORMW 「私が守らなきゃ……」
PRINTFORM 「これは良いモノです！」	PRINTFORM 「これは良いモノです！」
PRINTFORMW 「な、ナカはっ！駄目っ	PRINTFORMW 「な、ナカはっ！駄目っ
PRINTFORMW 「派手に行きますよ！」	PRINTFORMW 「派手に行きますよ！」
PRINTFORMW 「節約、節約っと……」	PRINTFORMW 「節約、節約っと……」
PRINTFORMW 「大サービスです！！」	PRINTFORMW 「大サービスです！！」
PRINTFORMW 「最小限の動きで……」	PRINTFORMW 「最小限の動きで……」
PRINTFORMW 「何事も適度が一番！」	PRINTFORMW 「何事も適度が一番！」
PRINTFORMW 「何事も全力が一番！」	PRINTFORMW 「何事も全力が一番！」
PRINTFORMW 「触らないで……！」	PRINTFORMW 「触らないで……！」
PRINTFORMD 顔を真っ赤にしながら	PRINTFORMD 顔を真っ赤にしながら
PRINTFORM 　んんんんんんんんんん	PRINTFORM 　んんんんんんんんんん
PRINTFORM 　癖になっちゃうぅ……	PRINTFORM 　癖になっちゃうぅ……
PRINTFORM 　い…いっかい、だけ…	PRINTFORM 　い…いっかい、だけ…
PRINTFORM 「こんな物で良ければ」	PRINTFORM 「こんな物で良ければ」
PRINTFORMW 「に、偽物ーっ！？」	PRINTFORMW 「に、偽物ーっ！？」
PRINTFORMW 「ばたんきゅー……」	PRINTFORMW 「ばたんきゅー……」
PRINTFORMW （…あ…いしき　が…	PRINTFORMW （…あ…いしき　が…
PRINTFORM 嫌ぁぁぁぁぁぁぁぁぁあ	PRINTFORM 嫌ぁぁぁぁぁぁぁぁぁあ
PRINTFORMW 「もう…嫌ぁ……！」	PRINTFORMW 「もう…嫌ぁ……！」
PRINTFORMW 「『覇』ッッッ！！」	PRINTFORMW 「『覇』ッッッ！！」
PRINTFORMW 「『破』ッッッ！！」	PRINTFORMW 「『破』ッッッ！！」
PRINTFORMW 「避けるなら……！」	PRINTFORMW 「避けるなら……！」
PRINTFORMW 「焦りは禁物ですね」	PRINTFORMW 「焦りは禁物ですね」
PRINTFORMW 「強めに行きます！」	PRINTFORMW 「強めに行きます！」
PRINTFORMW 「弱点を狙います！」	PRINTFORMW 「弱点を狙います！」
PRINTFORMW 「でりゃぁぁぁっ！！	PRINTFORMW 「でりゃぁぁぁっ！！
PRINTFORMW 「っぐぅ……！？」	PRINTFORMW 「っぐぅ……！？」
PRINTFORM 　もう…ゆるひてぇ…	PRINTFORM 　もう…ゆるひてぇ…
PRINTFORM 「ご、ごめんなさいぃ	PRINTFORM 「ご、ごめんなさいぃ
PRINTFORMW 「い、嫌っ…！？」	PRINTFORMW 「い、嫌っ…！？」
PRINTFORMW 「服…駄目っ…！」	PRINTFORMW 「服…駄目っ…！」
PRINTFORM 「ん…さ、早苗はぁ…	PRINTFORM 「ん…さ、早苗はぁ…
PRINTFORMW 「スキありです！」	PRINTFORMW 「スキありです！」
PRINTFORMW 「朝飯前でしたね」	PRINTFORMW 「朝飯前でしたね」
PRINTFORMW 「ひ、酷い……！」	PRINTFORMW 「ひ、酷い……！」
PRINTFORMW 「助太刀します！」	PRINTFORMW 「助太刀します！」
PRINTFORMW 「大丈夫ですか？」	PRINTFORMW 「大丈夫ですか？」
PRINTFORMW 「ふんふふ～ん♪」	PRINTFORMW 「ふんふふ～ん♪」
PRINTFORM 「あ…こ、これは……	PRINTFORM 「あ…こ、これは……
PRINTFORMW 「一旦様子見です」	PRINTFORMW 「一旦様子見です」
PRINTFORMW 「イヤ───ッ！」	PRINTFORMW 「イヤ───ッ！」
PRINTFORMW 「逃がしません！」	PRINTFORMW 「逃がしません！」
PRINTFORM 「はぁ、はぁっ……	PRINTFORM 「はぁ、はぁっ……
PRINTFORM 　できなっ……あっ	PRINTFORM 　できなっ……あっ
PRINTFORMW 「い、今です！」	PRINTFORMW 「い、今です！」
PRINTFORM 「や、やめっ…あっ	PRINTFORM 「や、やめっ…あっ
PRINTFORMW 「逃しません！」	PRINTFORMW 「逃しません！」
PRINTFORMW 「小手調べです」	PRINTFORMW 「小手調べです」
PRINTFORMW 「スキありっ！」	PRINTFORMW 「スキありっ！」
PRINTFORMW 「痛ぁっ！？」	PRINTFORMW 「痛ぁっ！？」
PRINTFORM 「もうッ…うぐぁ	PRINTFORM 「もうッ…うぐぁ
PRINTFORM （あ…頭の中……	PRINTFORM （あ…頭の中……
PRINTFORM 　きもちいい…っ	PRINTFORM 　きもちいい…っ
PRINTFORM 　も、もっとぉ…	PRINTFORM 　も、もっとぉ…
PRINTFORM 　そこっ駄目ぇ…	PRINTFORM 　そこっ駄目ぇ…
PRINTFORM 　あったかいの…	PRINTFORM 　あったかいの…
PRINTFORM 「さなえのナカ…	PRINTFORM 「さなえのナカ…
PRINTFORMW 「危なぁ！？」	PRINTFORMW 「危なぁ！？」
PRINTFORM 　み、見ないでっ	PRINTFORM 　み、見ないでっ
PRINTFORM 　戦えない…し…	PRINTFORM 　戦えない…し…
PRINTFORMW 「て、敵！？」	PRINTFORMW 「て、敵！？」
PRINTFORMW 「見敵必殺♪」	PRINTFORMW 「見敵必殺♪」
PRINTFORMW 「えぇいっ！」	PRINTFORMW 「えぇいっ！」
PRINTFORM 　真っ白に……	PRINTFORM 　真っ白に……
PRINTFORMW 「ひっ…！」	PRINTFORMW 「ひっ…！」
PRINTFORMW 「嫌ぁ…！」	PRINTFORMW 「嫌ぁ…！」
PRINTFORM 　も、もうっ…	PRINTFORM 　も、もうっ…
PRINTFORM 　はぅぅぅぅう	PRINTFORM 　はぅぅぅぅう
PRINTFORM （声出したら…	PRINTFORM （声出したら…
PRINTFORM 　んぅぅぅぅう	PRINTFORM 　んぅぅぅぅう
PRINTFORMW 「～～～♪」	PRINTFORMW 「～～～♪」
PRINTFORMW 「奇跡よ！」	PRINTFORMW 「奇跡よ！」
PRINTFORM 「ぅあﾞぁッ	PRINTFORM 「ぅあﾞぁッ
PRINTFORM 「うぁあﾞッ	PRINTFORM 「うぁあﾞッ
PRINTFORM 　しゅごぃい	PRINTFORM 　しゅごぃい
PRINTFORM 　ふぁあぁっ	PRINTFORM 　ふぁあぁっ
PRINTFORM 　くぅ……っ	PRINTFORM 　くぅ……っ
PRINTFORM 「んんっ……	PRINTFORM 「んんっ……
PRINTFORM 「も、もうっ	PRINTFORM 「も、もうっ
PRINTFORM 　か、体が…	PRINTFORM 　か、体が…
PRINTFORMW 「へ…？」	PRINTFORMW 「へ…？」
PRINTFORM （か、体が…	PRINTFORM （か、体が…
PRINTFORMW 「風よ！」	PRINTFORMW 「風よ！」
PRINTFORMW 「星よ！」	PRINTFORMW 「星よ！」
PRINTFORM 　んﾞんッ	PRINTFORM 　んﾞんッ
PRINTFORM 　おかひっ	PRINTFORM 　おかひっ
PRINTFORM 　イくっ…	PRINTFORM 　イくっ…
PRINTFORM 　れすぅ…	PRINTFORM 　れすぅ…
PRINTFORM 　やめてッ	PRINTFORM 　やめてッ
PRINTFORM 「ふぁあっ	PRINTFORM 「ふぁあっ
PRINTFORM 「んんっ…	PRINTFORM 「んんっ…
PRINTFORM 「ひぁあっ	PRINTFORM 「ひぁあっ
PRINTFORM （あぁっ…	PRINTFORM （あぁっ…
PRINTFORM 「ん……っ	PRINTFORM 「ん……っ
PRINTFORM 　我慢…っ	PRINTFORM 　我慢…っ
PRINTFORM 「ふあぁ…	PRINTFORM 「ふあぁ…
PRINTFORM 　熱く……	PRINTFORM 　熱く……
PRINTFORM 熱い………	PRINTFORM 熱い………
PRINTFORM 「うあぁっ	PRINTFORM 「うあぁっ
PRINTFORM 「ごめッ	PRINTFORM 「ごめッ
PRINTFORM 　ッくぅ	PRINTFORM 　ッくぅ
PRINTFORM 　あﾞッ	PRINTFORM 　あﾞッ
PRINTFORM 　いぐッ	PRINTFORM 　いぐッ
PRINTFORM 「おﾞッ	PRINTFORM 「おﾞッ
PRINTFORM 「はぅう	PRINTFORM 「はぅう
PRINTFORM 　そこぉ	PRINTFORM 　そこぉ
PRINTFORM 「んぁあ	PRINTFORM 「んぁあ
PRINTFORM 「ふぁあ	PRINTFORM 「ふぁあ
PRINTFORM 　あぁっ	PRINTFORM 　あぁっ
PRINTFORM 「ひぁっ	PRINTFORM 「ひぁっ
PRINTFORM 「あぁっ	PRINTFORM 「あぁっ
PRINTFORMD 早苗は	PRINTFORMD 早苗は
PRINTFORMD 涙目で	PRINTFORMD 涙目で
PRINTFORM 「んぅ…	PRINTFORM 「んぅ…
PRINTFORM 　んん…	PRINTFORM 　んん…
PRINTFORM 　あぁん	PRINTFORM 　あぁん
PRINTFORMW 「！」	PRINTFORMW 「！」
PRINTFORM あぁ…っ	PRINTFORM あぁ…っ
PRINTFORM 「あっ…	PRINTFORM 「あっ…
PRINTFORM 「あっ	PRINTFORM 「あっ
PRINTFORM 「もっ	PRINTFORM 「もっ
PRINTFORMW 　」	PRINTFORMW 　」
PRINTFORMW 「」	PRINTFORMW 「」
PRINTFORML 　」	PRINTFORML 　」
PRINTFORMW 」	PRINTFORMW 」
PRINTFORMW ）	PRINTFORMW ）
PRINTFORML 」	PRINTFORML 」
PRINTFORML ）	PRINTFORML ）
PRINTFORMW 「	PRINTFORMW 「
PRINTFORMW 　	PRINTFORMW 　
PRINTFORMDW 	PRINTFORMDW 
PRINTFORMW 	PRINTFORMW 
PRINTFORML 	PRINTFORML 
PRINTFORM	PRINTFORM
