//口上:

PRINTFORMDL %CALLNAME_43_0(CFLAG:900, 1, ARGS:1)%のドッペルゲンガーは%CALLNAME:(TARGET)%が跪いたのを確認すると、前髪を鷲掴みにして顔をあげさせ	PRINTFORMDL %CALLNAME_43_0(CFLAG:900, 1, ARGS:1)%のドッペルゲンガーは%CALLNAME:(TARGET)%が跪いたのを確認すると、前髪を鷲掴みにして顔をあげさせ
PRINTFORMDW %CALLNAME:(TARGET)%は愛しい%CALLNAME_43_0(CFLAG:900, 1, ARGS:1)%の幻影に抵抗する事を諦め、屈従の道を選んだ。	PRINTFORMDW %CALLNAME:(TARGET)%は愛しい%CALLNAME_43_0(CFLAG:900, 1, ARGS:1)%の幻影に抵抗する事を諦め、屈従の道を選んだ。
PRINTFORMDW その極悪な快感の暴虐の前に、快楽を求めるだけの器官と成り果てた%CALLNAME:(TARGET)%のオンバシラは、すぐにも射精してしまいそうだ。	PRINTFORMDW その極悪な快感の暴虐の前に、快楽を求めるだけの器官と成り果てた%CALLNAME:(TARGET)%のオンバシラは、すぐにも射精してしまいそうだ。
PRINTFORMDW 血管を浮かび上がらせビクビクと痙攣する、身の丈にも及ぶ巨大な竿は幾本もの巻きついた触手によって、まるでボンレスハムのように、扱き、縛り上げられ	PRINTFORMDW 血管を浮かび上がらせビクビクと痙攣する、身の丈にも及ぶ巨大な竿は幾本もの巻きついた触手によって、まるでボンレスハムのように、扱き、縛り上げられ
PRINTFORMDW %CALLNAME:(TARGET)%は拘束から逃れようとしたが、その動きを察知したかの様に触手が蠢き、呆気なく絶頂させられてしまった。	PRINTFORMDW %CALLNAME:(TARGET)%は拘束から逃れようとしたが、その動きを察知したかの様に触手が蠢き、呆気なく絶頂させられてしまった。
PRINTFORMDW %CALLNAME:(TARGET)%は、触手の存在が目に入っていないかのように、首を傾げながら触手の上で足踏みを繰り返している…。	PRINTFORMDW %CALLNAME:(TARGET)%は、触手の存在が目に入っていないかのように、首を傾げながら触手の上で足踏みを繰り返している…。
PRINTFORMDW 膝を付いて痙攣する%CALLNAME:(TARGET)%の下半身に誘導ホルモンを浴びせ、より大量の仲間と共に一層残虐に蹂躙し始めた。	PRINTFORMDW 膝を付いて痙攣する%CALLNAME:(TARGET)%の下半身に誘導ホルモンを浴びせ、より大量の仲間と共に一層残虐に蹂躙し始めた。
PRINTFORMDW 血管を浮かび上がらせビクビクと痙攣する、身の丈にも及ぶ巨大な竿は幾本もの触手によって、まるでボンレスハムのように、扱き縛り上げられ	PRINTFORMDW 血管を浮かび上がらせビクビクと痙攣する、身の丈にも及ぶ巨大な竿は幾本もの触手によって、まるでボンレスハムのように、扱き縛り上げられ
PRINTFORMDW それは彼女の中に潜んでいた『何もかもかなぐり捨てて堕ちてしまいたい』という、もう一つの一面であり、抗いようの無い事実でもあった。	PRINTFORMDW それは彼女の中に潜んでいた『何もかもかなぐり捨てて堕ちてしまいたい』という、もう一つの一面であり、抗いようの無い事実でもあった。
PRINTFORMDW 望まぬお産によって生み落とされた鬼子を、せめて自ら始末しようと、%CALLNAME:(TARGET)%は死に物狂いで手を伸ばすが	PRINTFORMDW 望まぬお産によって生み落とされた鬼子を、せめて自ら始末しようと、%CALLNAME:(TARGET)%は死に物狂いで手を伸ばすが
PRINTFORMDW アヘ顔を晒して痙攣する%CALLNAME:(TARGET)%の恥芯は、血管脈打つ男性器のようなオンバシラへと作り変えられていた。	PRINTFORMDW アヘ顔を晒して痙攣する%CALLNAME:(TARGET)%の恥芯は、血管脈打つ男性器のようなオンバシラへと作り変えられていた。
PRINTFORMDW 自分の幻影にいたぶられる%CALLNAME:(TARGET)%は、無言のはずのドッぺルゲンガーが、何かを囁いたような気がした。	PRINTFORMDW 自分の幻影にいたぶられる%CALLNAME:(TARGET)%は、無言のはずのドッぺルゲンガーが、何かを囁いたような気がした。
PRINTFORMDL %CALLNAME:(TARGET)%のドッペルゲンガーは自らの原型となった本人を跪かせると、前髪を鷲掴みにして顔を上げさせ	PRINTFORMDL %CALLNAME:(TARGET)%のドッペルゲンガーは自らの原型となった本人を跪かせると、前髪を鷲掴みにして顔を上げさせ
PRINTFORMDW 触手服に何度もイかされ、息も絶え絶えになって抵抗すら出来なくなった%CALLNAME:(TARGET)%を改めて襲い始めた。	PRINTFORMDW 触手服に何度もイかされ、息も絶え絶えになって抵抗すら出来なくなった%CALLNAME:(TARGET)%を改めて襲い始めた。
PRINTFORMW 触手は「抵抗するな」とでも言わんばかりに%CALLNAME:(TARGET)%の性感帯を攻めたて、強烈なアクメを叩きこんだ。	PRINTFORMW 触手は「抵抗するな」とでも言わんばかりに%CALLNAME:(TARGET)%の性感帯を攻めたて、強烈なアクメを叩きこんだ。
PRINTFORMDW 触手服に何度もイかされ、息も絶え絶えになって抵抗すら出来なくなった%CALLNAME:(TARGET)%を改めて襲い始めた	PRINTFORMDW 触手服に何度もイかされ、息も絶え絶えになって抵抗すら出来なくなった%CALLNAME:(TARGET)%を改めて襲い始めた
PRINTFORMDW %CALLNAME:(TARGET)%は一声気合を入れると、自身の陰核に食い込もうとしていた寄生体を力任せに引きちぎった。	PRINTFORMDW %CALLNAME:(TARGET)%は一声気合を入れると、自身の陰核に食い込もうとしていた寄生体を力任せに引きちぎった。
PRINTFORMDW その極悪な快感の暴虐の前に、さしもの軍神・八坂神奈子も白目を剥き、舌を突き出して無様に喘ぎ、呼吸すらままならない有様だ。	PRINTFORMDW その極悪な快感の暴虐の前に、さしもの軍神・八坂神奈子も白目を剥き、舌を突き出して無様に喘ぎ、呼吸すらままならない有様だ。
PRINTFORMDW 神の血を半分受け継ぎ、授乳によってたっぷり神奈子の力を奪い取った呪われ子は彼女の手を振り切ると、闇の奥に溶けて行った…。	PRINTFORMDW 神の血を半分受け継ぎ、授乳によってたっぷり神奈子の力を奪い取った呪われ子は彼女の手を振り切ると、闇の奥に溶けて行った…。
PRINTFORMDW %CALLNAME:(TARGET)%は一度逃げようとした後、振り返って再び触手にしがみ付き、熱っぽく求愛しはじめた。	PRINTFORMDW %CALLNAME:(TARGET)%は一度逃げようとした後、振り返って再び触手にしがみ付き、熱っぽく求愛しはじめた。
PRINTFORMDW まるで固形物のように“重い”ザーメンの塊は、噴出した後も滴り落ちる事なく、射晴した神奈子自身にベットリこびり付いた。	PRINTFORMDW まるで固形物のように“重い”ザーメンの塊は、噴出した後も滴り落ちる事なく、射晴した神奈子自身にベットリこびり付いた。
PRINTFORMDW %CALLNAME:(TARGET)%は激しく腰を突き上げながらも快感に耐え、オンバシラの底で神の粥を滾らせている…	PRINTFORMDW %CALLNAME:(TARGET)%は激しく腰を突き上げながらも快感に耐え、オンバシラの底で神の粥を滾らせている…
PRINTFORMDW 力を貯めようと試みる度に激しい快楽に襲われ、%CALLNAME:(TARGET)%は蕩けた表情でイき狂っている…。	PRINTFORMDW 力を貯めようと試みる度に激しい快楽に襲われ、%CALLNAME:(TARGET)%は蕩けた表情でイき狂っている…。
PRINTFORMDW 熱い滾りを堰き止める事などできず、絶頂と共に凄まじい濁流となって、神奈子のオンバシラを内側から抉るように噴出する。	PRINTFORMDW 熱い滾りを堰き止める事などできず、絶頂と共に凄まじい濁流となって、神奈子のオンバシラを内側から抉るように噴出する。
PRINTFORMDW オンバシラを責めたてられ盛大に射精させられた神奈子は、絶頂の余韻に白目をむいて痙攣し、立ち上がる気力もないようだ。	PRINTFORMDW オンバシラを責めたてられ盛大に射精させられた神奈子は、絶頂の余韻に白目をむいて痙攣し、立ち上がる気力もないようだ。
PRINTFORMDW 醜く腫れ上がり、快楽を貪る為だけの器官に成り下がった巨大亀頭の先端には、色の濃い先走りがブクブクと泡立っている。	PRINTFORMDW 醜く腫れ上がり、快楽を貪る為だけの器官に成り下がった巨大亀頭の先端には、色の濃い先走りがブクブクと泡立っている。
PRINTFORMDW やがて生まれてくるであろう、わが子に狂気と愛情の入り混じる歪んだ愛着を抱き、腹を愛おしそうに撫でながら微笑んだ。	PRINTFORMDW やがて生まれてくるであろう、わが子に狂気と愛情の入り混じる歪んだ愛着を抱き、腹を愛おしそうに撫でながら微笑んだ。
PRINTFORMDL %CALLNAME:(TARGET)%の下半身を覆い尽くし、陰核を嬲っていた淫蟲の大群が満足したように解散すると	PRINTFORMDL %CALLNAME:(TARGET)%の下半身を覆い尽くし、陰核を嬲っていた淫蟲の大群が満足したように解散すると
PRINTFORMDW %CALLNAME:(TARGET)%は胸の中に性器を埋めさせ、間から顔を出している鈴口に舌を這わせている…。	PRINTFORMDW %CALLNAME:(TARGET)%は胸の中に性器を埋めさせ、間から顔を出している鈴口に舌を這わせている…。
PRINTFORMDW 黒光りする亀頭から噴出した特濃精液は天井に叩き付けられると、下でノビている射精者自身の上にドチャッと落下した。	PRINTFORMDW 黒光りする亀頭から噴出した特濃精液は天井に叩き付けられると、下でノビている射精者自身の上にドチャッと落下した。
PRINTFORMDW 真っ黒な亀頭の先に蓋をする、滴る事のない超粘質カウパーを掻き分けるように、竿の内部にまで極細触手が侵入し嬲られ	PRINTFORMDW 真っ黒な亀頭の先に蓋をする、滴る事のない超粘質カウパーを掻き分けるように、竿の内部にまで極細触手が侵入し嬲られ
PRINTFORMDW 自分が“繁殖の為の苗床に過ぎない”という事実を叩きつけられた神奈子は、歯をカタカタと鳴らして顔を青ざめさせた。	PRINTFORMDW 自分が“繁殖の為の苗床に過ぎない”という事実を叩きつけられた神奈子は、歯をカタカタと鳴らして顔を青ざめさせた。
PRINTFORMDW 父親の思い出を掘り起こされ、幼児退行をおこした%CALLNAME:(TARGET)%は、幼稚な遊びを始めた。	PRINTFORMDW 父親の思い出を掘り起こされ、幼児退行をおこした%CALLNAME:(TARGET)%は、幼稚な遊びを始めた。
PRINTFORMDW 辺り一面に広がるザーメンゼリーの中で溺れるように、神加奈子は白目を剥いて痙攣し、脱力したまま横たわっていた。	PRINTFORMDW 辺り一面に広がるザーメンゼリーの中で溺れるように、神加奈子は白目を剥いて痙攣し、脱力したまま横たわっていた。
PRINTFORMDW 己の肉棒を深く咥え込まれた%CALLNAME:(TARGET)%は、こみ上げてくる快感から必死に耐えている…	PRINTFORMDW 己の肉棒を深く咥え込まれた%CALLNAME:(TARGET)%は、こみ上げてくる快感から必死に耐えている…
PRINTFORMDW %CALLNAME:(TARGET)%の醜く開発されてしまったオンバシラは、触手によって容赦なく蹂躙された。	PRINTFORMDW %CALLNAME:(TARGET)%の醜く開発されてしまったオンバシラは、触手によって容赦なく蹂躙された。
PRINTFORMDW その付け根にぶら下がる、熱く滾った粥のような本番汁を蓄えた巨大な睾丸まで、口の付いた触手でシャブられている。	PRINTFORMDW その付け根にぶら下がる、熱く滾った粥のような本番汁を蓄えた巨大な睾丸まで、口の付いた触手でシャブられている。
PRINTFORMDW 触手の責めによって盛大に射精させられた神奈子は、絶頂の余韻に白目をむいて痙攣し、立ち上がる気力もないようだ。	PRINTFORMDW 触手の責めによって盛大に射精させられた神奈子は、絶頂の余韻に白目をむいて痙攣し、立ち上がる気力もないようだ。
PRINTFORMDW 神奈子はオンバシラへの責めによって盛大に射精させられ、その精力と共に体力を使い果たし、へたり込んでしまった。	PRINTFORMDW 神奈子はオンバシラへの責めによって盛大に射精させられ、その精力と共に体力を使い果たし、へたり込んでしまった。
PRINTFORMDW まるで、三人を待ち構えていたかのように、突然湧き出した異形の群れに襲撃され、彼女達は散り散りになってしまう。	PRINTFORMDW まるで、三人を待ち構えていたかのように、突然湧き出した異形の群れに襲撃され、彼女達は散り散りになってしまう。
PRINTFORMDW 形状大きさ様々な、グロテスクな色彩の触手生物達が、粘液をぬたつかせながら、ゆっくりと神奈子に這い寄って来る。	PRINTFORMDW 形状大きさ様々な、グロテスクな色彩の触手生物達が、粘液をぬたつかせながら、ゆっくりと神奈子に這い寄って来る。
PRINTFORMDL 祟り神としての本性を現した諏訪子は、かつての相方である%CALLNAME:(TARGET)%を屈服させると	PRINTFORMDL 祟り神としての本性を現した諏訪子は、かつての相方である%CALLNAME:(TARGET)%を屈服させると
PRINTFORMDW 交配期に入ったヴァギナの様に、嫌らしく挿入を待ち侘びる乳穴の奥で、ヘドロ状の母乳がゴボゴボと泡立っている。	PRINTFORMDW 交配期に入ったヴァギナの様に、嫌らしく挿入を待ち侘びる乳穴の奥で、ヘドロ状の母乳がゴボゴボと泡立っている。
PRINTFORMDW 触手と一体化し、性欲を垂れ流すミジャグジを体に絡ませながら、かつての相方を取り込もうと食指を伸ばしてきた。	PRINTFORMDW 触手と一体化し、性欲を垂れ流すミジャグジを体に絡ませながら、かつての相方を取り込もうと食指を伸ばしてきた。
PRINTFORMDW 母乳を絞り尽くされた%CALLNAME:(TARGET)%は、みっともないアヘ顔を晒しながら痙攣している。	PRINTFORMDW 母乳を絞り尽くされた%CALLNAME:(TARGET)%は、みっともないアヘ顔を晒しながら痙攣している。
PRINTFORMDW まるで二人を待ち構えていたかのように、突然湧き出した異形の群れに襲撃され、彼女達は離れ離れになってしまう。	PRINTFORMDW まるで二人を待ち構えていたかのように、突然湧き出した異形の群れに襲撃され、彼女達は離れ離れになってしまう。
PRINTFORMDW まるで二柱を待ち構えていたかのように、突然湧き出した異形の群れに襲撃され、彼女達は離れ離れになってしまう。	PRINTFORMDW まるで二柱を待ち構えていたかのように、突然湧き出した異形の群れに襲撃され、彼女達は離れ離れになってしまう。
PRINTFORMDW %CALLNAME:(TARGET)%の醜く開発されてしまったオンバシラを、無数の触手が容赦なく蹂躙する！	PRINTFORMDW %CALLNAME:(TARGET)%の醜く開発されてしまったオンバシラを、無数の触手が容赦なく蹂躙する！
PRINTFORMDW その付け根にぶら下がる、煮え滾る粥のような本番汁を蓄えた巨大な睾丸まで、口の付いた触手でシャブられている。	PRINTFORMDW その付け根にぶら下がる、煮え滾る粥のような本番汁を蓄えた巨大な睾丸まで、口の付いた触手でシャブられている。
PRINTFORMDW ようやく具現を解除する事に成功した神奈子は、尚も疼き続ける陰核を両手で押さえ、ふやけた表情で喘いでいる。	PRINTFORMDW ようやく具現を解除する事に成功した神奈子は、尚も疼き続ける陰核を両手で押さえ、ふやけた表情で喘いでいる。
PRINTFORMDW 戦闘中の自慰によって盛大に射精した神奈子は、絶頂の余韻に白目をむいて痙攣し、立ち上がる気力もないようだ。	PRINTFORMDW 戦闘中の自慰によって盛大に射精した神奈子は、絶頂の余韻に白目をむいて痙攣し、立ち上がる気力もないようだ。
PRINTFORMDW 彼女達は、唯一残った一柱である神奈子をも取り込もうと、粘液滴る無数の触手を絡み合わせながら伸ばしてきた。	PRINTFORMDW 彼女達は、唯一残った一柱である神奈子をも取り込もうと、粘液滴る無数の触手を絡み合わせながら伸ばしてきた。
PRINTFORMDW 自身の身体に起こったおぞましい変化に、神奈子は恐怖と絶望の入り混じった、狂気の笑みを浮かべて涙を流した。	PRINTFORMDW 自身の身体に起こったおぞましい変化に、神奈子は恐怖と絶望の入り混じった、狂気の笑みを浮かべて涙を流した。
PRINTFORMDW 一般の人間のみならず、ある程度実力のある人妖までもが被害に会い始め、いよいよ新たな異変として認められた。	PRINTFORMDW 一般の人間のみならず、ある程度実力のある人妖までもが被害に会い始め、いよいよ新たな異変として認められた。
PRINTFORMDW まるで神奈子を待ち構えていたかのように、突然湧き出した異形の群れに襲撃され、彼女は追い詰められてしまう。	PRINTFORMDW まるで神奈子を待ち構えていたかのように、突然湧き出した異形の群れに襲撃され、彼女は追い詰められてしまう。
PRINTFORMDW %CALLNAME:(TARGET)%は本性を現した祟り神に弄り犯されるまま、屈従の道へ堕ちていった。	PRINTFORMDW %CALLNAME:(TARGET)%は本性を現した祟り神に弄り犯されるまま、屈従の道へ堕ちていった。
PRINTFORMDW 『もう諦めなさい神奈子…どこに逃げ隠れしたって見つけ出して、ぶっ壊れるまで犯しまくってやるんだから♪』	PRINTFORMDW 『もう諦めなさい神奈子…どこに逃げ隠れしたって見つけ出して、ぶっ壊れるまで犯しまくってやるんだから♪』
PRINTFORMDL 神社に残してきたもう一柱の神「諏訪子」や、風祝「早苗」の止めるのも聞かず、異変解決に飛び出していった。	PRINTFORMDL 神社に残してきたもう一柱の神「諏訪子」や、風祝「早苗」の止めるのも聞かず、異変解決に飛び出していった。
PRINTFORMDW 失踪者達の足跡を辿るうち、異常な瘴気を発している洞穴を見つけた神奈子は、息巻いて中に突入したのだが……	PRINTFORMDW 失踪者達の足跡を辿るうち、異常な瘴気を発している洞穴を見つけた神奈子は、息巻いて中に突入したのだが……
PRINTFORMDW どろどろに蕩けた表情を浮かべ、%CALLNAME:(TARGET)%はぐったりと快楽に震えている…。	PRINTFORMDW どろどろに蕩けた表情を浮かべ、%CALLNAME:(TARGET)%はぐったりと快楽に震えている…。
PRINTFORMDW 神奈子は、異形のイチモツと化したオンバシラを痙攣する様に突き出し、言葉にならない声で慈悲をせがんだ。	PRINTFORMDW 神奈子は、異形のイチモツと化したオンバシラを痙攣する様に突き出し、言葉にならない声で慈悲をせがんだ。
PRINTFORMDW %CALLNAME:(TARGET)%は胸の中に性器を埋めさせ、間から踊る触手に舌を這わせている…。	PRINTFORMDW %CALLNAME:(TARGET)%は胸の中に性器を埋めさせ、間から踊る触手に舌を這わせている…。
PRINTFORMDW %CALLNAME:(TARGET)%は、すっかり拡張開発されきった乳腺の穴を広げ、挿入をねだった。	PRINTFORMDW %CALLNAME:(TARGET)%は、すっかり拡張開発されきった乳腺の穴を広げ、挿入をねだった。
PRINTFORMDW 神奈子は敵を前にした自慰によって盛大に射精し、その精力と共に体力を使い果たし、へたり込んでしまった。	PRINTFORMDW 神奈子は敵を前にした自慰によって盛大に射精し、その精力と共に体力を使い果たし、へたり込んでしまった。
PRINTFORMDW 神奈子は触手の責めによって盛大に射精させられ、その精力と共に体力を使い果たし、へたり込んでしまった。	PRINTFORMDW 神奈子は触手の責めによって盛大に射精させられ、その精力と共に体力を使い果たし、へたり込んでしまった。
PRINTFORMDW 失踪者達の足跡を辿るうち、異常な瘴気を発している洞穴を見つけた三人は、息巻いて中に突入したのだが……	PRINTFORMDW 失踪者達の足跡を辿るうち、異常な瘴気を発している洞穴を見つけた三人は、息巻いて中に突入したのだが……
PRINTFORMDW 失踪者達の足跡を辿るうち、異常な瘴気を発している洞穴を見つけた二人は、息巻いて中に突入したのだが……	PRINTFORMDW 失踪者達の足跡を辿るうち、異常な瘴気を発している洞穴を見つけた二人は、息巻いて中に突入したのだが……
PRINTFORMDW 妊娠への欲求に負けた神奈子は、発情しきった雌の表情を浮かべ、危険日を迎えた子宮への中出しを求めた。	PRINTFORMDW 妊娠への欲求に負けた神奈子は、発情しきった雌の表情を浮かべ、危険日を迎えた子宮への中出しを求めた。
PRINTFORMDL 両腕で抱える程に竿を肥大化させられ、幾らでも射精するよう感度の制限を破壊され、煮え立つ白いマグマを	PRINTFORMDL 両腕で抱える程に竿を肥大化させられ、幾らでも射精するよう感度の制限を破壊され、煮え立つ白いマグマを
PRINTFORMDW 常に精製し続ける醜く膨れ上がった睾丸を移植された神奈子のオンバシラが、まるで爆ぜるように脈動した。	PRINTFORMDW 常に精製し続ける醜く膨れ上がった睾丸を移植された神奈子のオンバシラが、まるで爆ぜるように脈動した。
PRINTFORMDW 常識を超える膨大な射精と共に、神奈子は背骨を折らん程に仰け反りながら、白目を剥いてひっくり返った。	PRINTFORMDW 常識を超える膨大な射精と共に、神奈子は背骨を折らん程に仰け反りながら、白目を剥いてひっくり返った。
PRINTFORMDW %CALLNAME:(TARGET)%はまるで子供の様に無邪気な笑顔で、着ている服を脱ぎ捨てた。	PRINTFORMDW %CALLNAME:(TARGET)%はまるで子供の様に無邪気な笑顔で、着ている服を脱ぎ捨てた。
PRINTFORMDW 信管のように鋭敏化したオンバシラの快感神経が暴走し、神奈子の全身を焼き尽くすようなアクメが襲う。	PRINTFORMDW 信管のように鋭敏化したオンバシラの快感神経が暴走し、神奈子の全身を焼き尽くすようなアクメが襲う。
PRINTFORMDW 自慰によって盛大に射精した神奈子は、絶頂の余韻に白目をむいて痙攣し、立ち上がる気力もないようだ。	PRINTFORMDW 自慰によって盛大に射精した神奈子は、絶頂の余韻に白目をむいて痙攣し、立ち上がる気力もないようだ。
PRINTFORMDW 触手と完全に一体化し、変わり果ててしまった早苗が、底を尽く事の無い煮え滾った性欲を叩きつけようと	PRINTFORMDW 触手と完全に一体化し、変わり果ててしまった早苗が、底を尽く事の無い煮え滾った性欲を叩きつけようと
PRINTFORMDW 『ふふっ…強がってる割には足元が震えてるじゃないの……本当はアンタだって気持ちよくなりたい癖に』	PRINTFORMDW 『ふふっ…強がってる割には足元が震えてるじゃないの……本当はアンタだって気持ちよくなりたい癖に』
PRINTFORMDW %CALLNAME:(TARGET)%は小さくなった手のひらで全身をペタペタ確認しながら喚いた。	PRINTFORMDW %CALLNAME:(TARGET)%は小さくなった手のひらで全身をペタペタ確認しながら喚いた。
PRINTFORMDW %CALLNAME:(TARGET)%は自分の巫女に嬲り犯されるまま、屈従の道へ堕ちていった。	PRINTFORMDW %CALLNAME:(TARGET)%は自分の巫女に嬲り犯されるまま、屈従の道へ堕ちていった。
PRINTFORMDL 胴回り程もある黒光りする“超根”は、その根元にぶら下がる二つの巨大な欲望の淫玉から常に湧き出す	PRINTFORMDL 胴回り程もある黒光りする“超根”は、その根元にぶら下がる二つの巨大な欲望の淫玉から常に湧き出す
PRINTFORMDW %CALLNAME:(TARGET)%は触手の上にまたがり、ゆっくりと割れ目を擦り付けている…	PRINTFORMDW %CALLNAME:(TARGET)%は触手の上にまたがり、ゆっくりと割れ目を擦り付けている…
PRINTFORMDW 消耗の激しい%CALLNAME:(TARGET)%は肩で息をし、探索するのも辛そうな様子だ…。	PRINTFORMDW 消耗の激しい%CALLNAME:(TARGET)%は肩で息をし、探索するのも辛そうな様子だ…。
PRINTFORMDW 神奈子は、すっかり交配準備完了の子宮だけは死守すべく、顔を真っ赤にしながら肛門を差し出した。	PRINTFORMDW 神奈子は、すっかり交配準備完了の子宮だけは死守すべく、顔を真っ赤にしながら肛門を差し出した。
PRINTFORMDW %CALLNAME:(TARGET)%は、さも当然であるかの様に敵の身体にしなだれかかった。	PRINTFORMDW %CALLNAME:(TARGET)%は、さも当然であるかの様に敵の身体にしなだれかかった。
PRINTFORMDW %CALLNAME:(TARGET)%は蠢く触手を、自分の注連縄と交換して身体に巻きつけた…	PRINTFORMDW %CALLNAME:(TARGET)%は蠢く触手を、自分の注連縄と交換して身体に巻きつけた…
PRINTFORMDW 神奈子は生地の内側で蠢く触手の感触に震えつつ、それに屈した自分の不甲斐なさを歯噛みしている。	PRINTFORMDW 神奈子は生地の内側で蠢く触手の感触に震えつつ、それに屈した自分の不甲斐なさを歯噛みしている。
PRINTFORMDL 淫魔と化した風祝は、かつての主柱である%CALLNAME:(TARGET)%を屈服させると	PRINTFORMDL 淫魔と化した風祝は、かつての主柱である%CALLNAME:(TARGET)%を屈服させると
PRINTFORMDW %CALLNAME:(TARGET)%は我ままな様子で口を尖らせ、再び触手に身体を預けた。	PRINTFORMDW %CALLNAME:(TARGET)%は我ままな様子で口を尖らせ、再び触手に身体を預けた。
PRINTFORMDW %CALLNAME:(TARGET)%の目には、ヒュプノが愛しい巫女に見えているようだ…。	PRINTFORMDW %CALLNAME:(TARGET)%の目には、ヒュプノが愛しい巫女に見えているようだ…。
PRINTFORMDW 異形の触手と同化し快楽の権化と化した早苗は、主柱の淫乱さから分裂した瓜二つの淫魔に体を預け	PRINTFORMDW 異形の触手と同化し快楽の権化と化した早苗は、主柱の淫乱さから分裂した瓜二つの淫魔に体を預け
PRINTFORMDW %CALLNAME:(TARGET)%は敵の触手を掴むと、それを自分の胸にあて微笑んだ。	PRINTFORMDW %CALLNAME:(TARGET)%は敵の触手を掴むと、それを自分の胸にあて微笑んだ。
PRINTFORMDW さしもの軍神も到底耐える事はできず、床に転がりながら血の混じった胃液を吐き散らしている。	PRINTFORMDW さしもの軍神も到底耐える事はできず、床に転がりながら血の混じった胃液を吐き散らしている。
PRINTFORMDW 神奈子は自慰によって盛大に射精し、その精力と共に体力を使い果たし、へたり込んでしまった。	PRINTFORMDW 神奈子は自慰によって盛大に射精し、その精力と共に体力を使い果たし、へたり込んでしまった。
PRINTFORMW 『もっと膣内射精されて苗床にされて妊娠したい……だから『私』はここで『私』に犯されるの☆』	PRINTFORMW 『もっと膣内射精されて苗床にされて妊娠したい……だから『私』はここで『私』に犯されるの☆』
PRINTFORMDW %CALLNAME:(TARGET)%は何ら躊躇う事無く、触手の前に肢体を投げ出した。	PRINTFORMDW %CALLNAME:(TARGET)%は何ら躊躇う事無く、触手の前に肢体を投げ出した。
PRINTFORMDW 触手達の陵辱に屈し、身も心も性欲の権化へと作りかえられてしまった、守矢の一柱と巫女……	PRINTFORMDW 触手達の陵辱に屈し、身も心も性欲の権化へと作りかえられてしまった、守矢の一柱と巫女……
PRINTFORMW 「……早苗と二人っきりで行動したのは迂闊だったか……祟り神のヤツもつれてくるべきだった」	PRINTFORMW 「……早苗と二人っきりで行動したのは迂闊だったか……祟り神のヤツもつれてくるべきだった」
PRINTFORMDW 『私はずっと、神奈子さまの体が欲しかったのに……気付いてくださらなかったなんて……』	PRINTFORMDW 『私はずっと、神奈子さまの体が欲しかったのに……気付いてくださらなかったなんて……』
PRINTFORMDW %CALLNAME:(TARGET)%はぷんぷんと頬を膨らませて触手に抗議している。	PRINTFORMDW %CALLNAME:(TARGET)%はぷんぷんと頬を膨らませて触手に抗議している。
PRINTFORMDW 異形の触手と同化し快楽の権化と化した、早苗、諏訪子、そして淫魔の分身たる神奈子自身が	PRINTFORMDW 異形の触手と同化し快楽の権化と化した、早苗、諏訪子、そして淫魔の分身たる神奈子自身が
PRINTFORMDW 『神奈子さまは私に、い～～っぱい犯されてイカされて、孕んで苗床になるんですからぁ☆』	PRINTFORMDW 『神奈子さまは私に、い～～っぱい犯されてイカされて、孕んで苗床になるんですからぁ☆』
PRINTFORMDW 神奈子の中の『触手の快楽に落ちた淫乱な精神』が、またしても具現化し、目の前に現れる。	PRINTFORMDW 神奈子の中の『触手の快楽に落ちた淫乱な精神』が、またしても具現化し、目の前に現れる。
PRINTFORMW 『気持ちイイ事から逃げたい『私』、信仰に縛られた『私』、過去に脅える『ワ・タ・シ』♪』	PRINTFORMW 『気持ちイイ事から逃げたい『私』、信仰に縛られた『私』、過去に脅える『ワ・タ・シ』♪』
PRINTFORMDW 神奈子は、すっかり交配準備完了の子宮だけは死守すべく、両脚を固く閉じて震えている。	PRINTFORMDW 神奈子は、すっかり交配準備完了の子宮だけは死守すべく、両脚を固く閉じて震えている。
PRINTFORMDW %CALLNAME:(TARGET)%は、発情しきった表情で男根を味わっている…。	PRINTFORMDW %CALLNAME:(TARGET)%は、発情しきった表情で男根を味わっている…。
PRINTFORMDW %CALLNAME:(TARGET)%は蛇の様に長い舌を、性器の先端に絡ませた…。	PRINTFORMDW %CALLNAME:(TARGET)%は蛇の様に長い舌を、性器の先端に絡ませた…。
PRINTFORMW 「もうっ！父上のバカー！私の下着と一緒に洗濯しないでって言ったではありませんかー！」	PRINTFORMW 「もうっ！父上のバカー！私の下着と一緒に洗濯しないでって言ったではありませんかー！」
PRINTFORMDW %CALLNAME:(TARGET)%は、発情しきった表情で触手を味わっている…。	PRINTFORMDW %CALLNAME:(TARGET)%は、発情しきった表情で触手を味わっている…。
PRINTFORMDW 『見てください神奈子さまぁ、早苗の体……すっごくエッチにしてもらえたんですよぉ♪』	PRINTFORMDW 『見てください神奈子さまぁ、早苗の体……すっごくエッチにしてもらえたんですよぉ♪』
PRINTFORMDW 神奈子は仲間達に出産が近いことを告げ、産まれた子の名付け親になって欲しいと言ったが	PRINTFORMDW 神奈子は仲間達に出産が近いことを告げ、産まれた子の名付け親になって欲しいと言ったが
PRINTFORMDW その行為は、乳腺の奥底に巣食う卵を転がし、おぞましい異物感を際立たせるだけだった。	PRINTFORMDW その行為は、乳腺の奥底に巣食う卵を転がし、おぞましい異物感を際立たせるだけだった。
PRINTFORMDW 淫蟲の大群は%CALLNAME:(TARGET)%のクリトリスにトドメを刺すべく、	PRINTFORMDW 淫蟲の大群は%CALLNAME:(TARGET)%のクリトリスにトドメを刺すべく、
PRINTFORMDL 神奈子の戦闘関係の素質を強化できます（※バランス調整の為ステータスが弱体化します）	PRINTFORMDL 神奈子の戦闘関係の素質を強化できます（※バランス調整の為ステータスが弱体化します）
PRINTFORMDW %CALLNAME:(TARGET)%は豊満な胸を駆使して性器に奉仕している…。	PRINTFORMDW %CALLNAME:(TARGET)%は豊満な胸を駆使して性器に奉仕している…。
PRINTFORMDW %CALLNAME:(TARGET)%は豊満な胸を駆使して触手に奉仕している…。	PRINTFORMDW %CALLNAME:(TARGET)%は豊満な胸を駆使して触手に奉仕している…。
PRINTFORMW 「や…やだぁ……触手なんて産みたくない！化け物の子供なんて産みたくないぃぃっ！！」	PRINTFORMW 「や…やだぁ……触手なんて産みたくない！化け物の子供なんて産みたくないぃぃっ！！」
PRINTFORMDW やがて生まれてくるであろう、異形の子に恐怖と不快感を抱き、腹を抱えながら震えた。	PRINTFORMDW やがて生まれてくるであろう、異形の子に恐怖と不快感を抱き、腹を抱えながら震えた。
PRINTFORMW 「二柱揃って餌箱の中とは……危険とみて早苗を留守番に置いたのは、まずかったか……」	PRINTFORMW 「二柱揃って餌箱の中とは……危険とみて早苗を留守番に置いたのは、まずかったか……」
PRINTFORMDW 『国譲りの時は命だけは助けてあげたけど……ふふ、ここでもう一度躾してあげるわ』	PRINTFORMDW 『国譲りの時は命だけは助けてあげたけど……ふふ、ここでもう一度躾してあげるわ』
PRINTFORMDW 神奈子は陣痛に苦しみながら呪詛の言葉を吐き、仲間にいっそ殺して欲しいと願ったが	PRINTFORMDW 神奈子は陣痛に苦しみながら呪詛の言葉を吐き、仲間にいっそ殺して欲しいと願ったが
PRINTFORMDL もう一人の主柱「諏訪子」、そして風祝「早苗」を引きつれて異変解決に乗り出した。	PRINTFORMDL もう一人の主柱「諏訪子」、そして風祝「早苗」を引きつれて異変解決に乗り出した。
PRINTFORMDW そのグラマラスな肉体を触手で絡めとり、嗜虐的な笑みを浮かべて舌なめずりした。	PRINTFORMDW そのグラマラスな肉体を触手で絡めとり、嗜虐的な笑みを浮かべて舌なめずりした。
PRINTFORMDW 『早苗は神奈子様の事が大好きですよ♪犯して、穢して、痛めつけたいくらいに☆』	PRINTFORMDW 『早苗は神奈子様の事が大好きですよ♪犯して、穢して、痛めつけたいくらいに☆』
PRINTFORMDW 神奈子は、異形の肉腫と化した乳房を震わせ、言葉にならない声で慈悲をせがんだ。	PRINTFORMDW 神奈子は、異形の肉腫と化した乳房を震わせ、言葉にならない声で慈悲をせがんだ。
PRINTFORMW 「早苗は私に似ていい子だねー。大きくなったら私みたいなデカパイになるんだぞ？」	PRINTFORMW 「早苗は私に似ていい子だねー。大きくなったら私みたいなデカパイになるんだぞ？」
PRINTFORMDW %CALLNAME:(TARGET)%は顔を真っ赤にして触手に抗議している。	PRINTFORMDW %CALLNAME:(TARGET)%は顔を真っ赤にして触手に抗議している。
PRINTFORMW 「散々っぱら身体を弄り倒しておいて『ハイ、サヨウナラ』……とか、ないよねぇ？」	PRINTFORMW 「散々っぱら身体を弄り倒しておいて『ハイ、サヨウナラ』……とか、ないよねぇ？」
PRINTFORMDW 神奈子の全てを吸い尽くそうと、触手を漲らせ、姦濫に絡み合いながら迫ってきた。	PRINTFORMDW 神奈子の全てを吸い尽くそうと、触手を漲らせ、姦濫に絡み合いながら迫ってきた。
PRINTFORMDW まるで神奈子の臭いを嗅ぎつけたかの様に、外法に堕ちた諏訪子が再び姿を現す……	PRINTFORMDW まるで神奈子の臭いを嗅ぎつけたかの様に、外法に堕ちた諏訪子が再び姿を現す……
PRINTFORMDW 『どう？私の新しい力……今度は私が、アンタを征服して犯しつくしてやるわぁ♪』	PRINTFORMDW 『どう？私の新しい力……今度は私が、アンタを征服して犯しつくしてやるわぁ♪』
PRINTFORMDW 仲間達は気の毒そうに、何か諦めたように目を伏せ、背を向ける事しかできない……	PRINTFORMDW 仲間達は気の毒そうに、何か諦めたように目を伏せ、背を向ける事しかできない……
PRINTFORMDW 異常極まりない経験により、神奈子は神としてのプライドをへし折られてしまった。	PRINTFORMDW 異常極まりない経験により、神奈子は神としてのプライドをへし折られてしまった。
PRINTFORMDW その体に宿った膨大な神徳の霊力を、体液と共に全て吸い尽くすつもりなのだ……。	PRINTFORMDW その体に宿った膨大な神徳の霊力を、体液と共に全て吸い尽くすつもりなのだ……。
PRINTFORMDW 『うふふ……私の神奈子さま……早苗がいっぱい気持ちよくしてあげますよ……』	PRINTFORMDW 『うふふ……私の神奈子さま……早苗がいっぱい気持ちよくしてあげますよ……』
PRINTFORMDW 『受け入れて……信仰や神社の事なんて忘れて、一緒に堕ちてしまいましょう☆』	PRINTFORMDW 『受け入れて……信仰や神社の事なんて忘れて、一緒に堕ちてしまいましょう☆』
PRINTFORMW 「……すまない、早苗……お前を救えなかった、不甲斐ない私を許しておくれ……」	PRINTFORMW 「……すまない、早苗……お前を救えなかった、不甲斐ない私を許しておくれ……」
PRINTFORMDW 少女達は気の毒そうに、何か諦めたように目を伏せ、首を横に振るだけだった……	PRINTFORMDW 少女達は気の毒そうに、何か諦めたように目を伏せ、首を横に振るだけだった……
PRINTFORMDW 神奈子の象徴ともいえるオンバシラは、信管のように敏感に開発されてしまった。	PRINTFORMDW 神奈子の象徴ともいえるオンバシラは、信管のように敏感に開発されてしまった。
PRINTFORMDL %CALLNAME:(TARGET)%は何とか力を貯めようとしているが、	PRINTFORMDL %CALLNAME:(TARGET)%は何とか力を貯めようとしているが、
PRINTFORMDW 『やめて？……調子いいわね国津神、最初に手出したのはアンタのくせに……』	PRINTFORMDW 『やめて？……調子いいわね国津神、最初に手出したのはアンタのくせに……』
PRINTFORMW (身体の自由は相変わらず利かないが…ひょっとしてコイツはマゾなのかしら？)	PRINTFORMW (身体の自由は相変わらず利かないが…ひょっとしてコイツはマゾなのかしら？)
PRINTFORMW 『もう抵抗しなくていいんだよ…『私』の気持ちイイ事、全部知ってるんだから』	PRINTFORMW 『もう抵抗しなくていいんだよ…『私』の気持ちイイ事、全部知ってるんだから』
PRINTFORMDW 『……やろうってのね？いいわ、諏訪大戦のリベンジマッチをしましょう……』	PRINTFORMDW 『……やろうってのね？いいわ、諏訪大戦のリベンジマッチをしましょう……』
PRINTFORMW 「すまない、恩に着るよ……何でも聞いてくれ、知ってる事なら何でも教えよう」	PRINTFORMW 「すまない、恩に着るよ……何でも聞いてくれ、知ってる事なら何でも教えよう」
PRINTFORMDW 子宮に着床した子が、もはや手遅れな程に成長してしまった事を悟った神奈子は	PRINTFORMDW 子宮に着床した子が、もはや手遅れな程に成長してしまった事を悟った神奈子は
PRINTFORMW 「くぅ……またしても兵糧攻めか……大戦前から何も学ばないよ、日の本は……」	PRINTFORMW 「くぅ……またしても兵糧攻めか……大戦前から何も学ばないよ、日の本は……」
PRINTFORMDL 触手から逃れようと%CALLNAME:(TARGET)%は身を捩ったが	PRINTFORMDL 触手から逃れようと%CALLNAME:(TARGET)%は身を捩ったが
PRINTFORMDW 涙が一筋、%CALLNAME:(TARGET)%の頬を静かに濡らした。	PRINTFORMDW 涙が一筋、%CALLNAME:(TARGET)%の頬を静かに濡らした。
PRINTFORMDW 『諏訪に落ち延びたアンタを、天津神共に突き出す事だって出来たけど……』	PRINTFORMDW 『諏訪に落ち延びたアンタを、天津神共に突き出す事だって出来たけど……』
PRINTFORMW 「…ちッ！……本物の“おぼこ”を取られたのは、幾百年前だったかねぇ……」	PRINTFORMW 「…ちッ！……本物の“おぼこ”を取られたのは、幾百年前だったかねぇ……」
PRINTFORMW 「んふぅ～～っ、どうだ私の胸はぁ……ロリ体型の蛙じゃ無理だろうからねぇ」	PRINTFORMW 「んふぅ～～っ、どうだ私の胸はぁ……ロリ体型の蛙じゃ無理だろうからねぇ」
PRINTFORMDW 『あら、山の神様じゃないの……あなたも此処にいたのね……どうりで……』	PRINTFORMDW 『あら、山の神様じゃないの……あなたも此処にいたのね……どうりで……』
PRINTFORMDW 『ザマぁないわね神奈子、こんなみっともない神に負けた憶えはないわ……』	PRINTFORMDW 『ザマぁないわね神奈子、こんなみっともない神に負けた憶えはないわ……』
PRINTFORMDL 触手宮を満たす禍々しい瘴気は、神奈子ら神にとって頗る相性が悪いようだ。	PRINTFORMDL 触手宮を満たす禍々しい瘴気は、神奈子ら神にとって頗る相性が悪いようだ。
PRINTFORMDL 神奈子のグラマラスな肢体を絡めとり、張りの良い美肌を汚濁で穢し尽くし、	PRINTFORMDL 神奈子のグラマラスな肢体を絡めとり、張りの良い美肌を汚濁で穢し尽くし、
PRINTFORMDW 先陣を切っていた触手をボロ雑巾の様に引き裂き、跡形もなく蒸発させた……	PRINTFORMDW 先陣を切っていた触手をボロ雑巾の様に引き裂き、跡形もなく蒸発させた……
PRINTFORMDW 嗜虐的な笑みを浮かべて舌なめずりし、その舌を無理矢理唇に押し込んだ。	PRINTFORMDW 嗜虐的な笑みを浮かべて舌なめずりし、その舌を無理矢理唇に押し込んだ。
PRINTFORM 『聞分けのない『私』には、たっぷりと中に注いで、教え込んであげないとねぇ	PRINTFORM 『聞分けのない『私』には、たっぷりと中に注いで、教え込んであげないとねぇ
PRINTFORMW 「どうしても私を仕留めたいようだな……来い、ここで決着をつけてやる！」	PRINTFORMW 「どうしても私を仕留めたいようだな……来い、ここで決着をつけてやる！」
PRINTFORMW 「ちっ！祟り神が何て様だよ！……お前は、そんな玉じゃなかったろうに！」	PRINTFORMW 「ちっ！祟り神が何て様だよ！……お前は、そんな玉じゃなかったろうに！」
PRINTFORMW 「ううッ…ごめんね……ちゃんと産んであげられなくて……ごめんね……ッ」	PRINTFORMW 「ううッ…ごめんね……ちゃんと産んであげられなくて……ごめんね……ッ」
PRINTFORMW 「はぁ…はぁっ…！……(ダメだ、もう一太刀打つまで、倒れ…るな！)」	PRINTFORMW 「はぁ…はぁっ…！……(ダメだ、もう一太刀打つまで、倒れ…るな！)」
PRINTFORMDW 『今の無様なアンタを好きにできるから、これはこれでいい感じよね☆』	PRINTFORMDW 『今の無様なアンタを好きにできるから、これはこれでいい感じよね☆』
PRINTFORMW 「あははー♪鬼ごっこしましょう父上～～！こっこまっでおっいで～～♪」	PRINTFORMW 「あははー♪鬼ごっこしましょう父上～～！こっこまっでおっいで～～♪」
PRINTFORMW 「ばか者！出す前に言わないか！……えぐっ……少し気管に入ったわ……」	PRINTFORMW 「ばか者！出す前に言わないか！……えぐっ……少し気管に入ったわ……」
PRINTFORMDW 艶かしい表情を浮かべたまま、本物の神奈子にまで食指を伸ばし始めた。	PRINTFORMDW 艶かしい表情を浮かべたまま、本物の神奈子にまで食指を伸ばし始めた。
PRINTFORMW (逃げても、隠れてもッ…『私』は追ってくる！……だったらいっそ……)	PRINTFORMW (逃げても、隠れてもッ…『私』は追ってくる！……だったらいっそ……)
PRINTFORMW 「ここで一度わかれるが……いいかい、早苗？無理はするんじゃないよ？」	PRINTFORMW 「ここで一度わかれるが……いいかい、早苗？無理はするんじゃないよ？」
PRINTFORMDW 神奈子は陣痛に苦しみもがき、せめて出産の間は見ないでくれと願った。	PRINTFORMDW 神奈子は陣痛に苦しみもがき、せめて出産の間は見ないでくれと願った。
PRINTFORMW 「うぅぅあぁっ……あぁ……出産なんて……化け物を産むなんてぇぇっ！」	PRINTFORMW 「うぅぅあぁっ……あぁ……出産なんて……化け物を産むなんてぇぇっ！」
PRINTFORMW 「ネズミみたいに、コソコソと……『山坂と湖の権化』が無様なものだよ」	PRINTFORMW 「ネズミみたいに、コソコソと……『山坂と湖の権化』が無様なものだよ」
PRINTFORMW 「『孫子』に『ハンニバル』『大長谷王』に『マリアナ沖海戦』もか……」	PRINTFORMW 「『孫子』に『ハンニバル』『大長谷王』に『マリアナ沖海戦』もか……」
PRINTFORMW 「貴様のアホ面には心底ウンザリさせられる(会ったばかりだけどね)」	PRINTFORMW 「貴様のアホ面には心底ウンザリさせられる(会ったばかりだけどね)」
PRINTFORMW 「我が名はヤサカ！　国津神が一柱、オオクニヌシノミコトの子なり！」	PRINTFORMW 「我が名はヤサカ！　国津神が一柱、オオクニヌシノミコトの子なり！」
PRINTFORMDW 『私が好きでアンタに従っていたと思う？……寝言は寝て言いなさい』	PRINTFORMDW 『私が好きでアンタに従っていたと思う？……寝言は寝て言いなさい』
PRINTFORMW 「えへへー☆　父上といっしょにおふろ♪うっ、れ、しーい、なーー♪」	PRINTFORMW 「えへへー☆　父上といっしょにおふろ♪うっ、れ、しーい、なーー♪」
PRINTFORMW 「触手だからって、好き勝手に陵辱していいわけじゃないんだからな！」	PRINTFORMW 「触手だからって、好き勝手に陵辱していいわけじゃないんだからな！」
PRINTFORMW 「――っくはぁぁッッ！　……く…こんな、所で射精とは……不覚っ！」	PRINTFORMW 「――っくはぁぁッッ！　……く…こんな、所で射精とは……不覚っ！」
PRINTFORMW 「んっぶっ…んむぐぅッ！……げふォッ　えほォッ！……おえぇぇッ…」	PRINTFORMW 「んっぶっ…んむぐぅッ！……げふォッ　えほォッ！……おえぇぇッ…」
PRINTFORMW 「あひゅぅぅぐぅ！……らめっ！……痛いのときもひいの一緒らめぇ！」	PRINTFORMW 「あひゅぅぅぐぅ！……らめっ！……痛いのときもひいの一緒らめぇ！」
PRINTFORMW (あれが、私が望んでいる早苗なのか……私は早苗を、あんな風に……)	PRINTFORMW (あれが、私が望んでいる早苗なのか……私は早苗を、あんな風に……)
PRINTFORMDW ぬらぬらと粘液の光る触手を滾らせながら、主柱である神奈子に迫る。	PRINTFORMDW ぬらぬらと粘液の光る触手を滾らせながら、主柱である神奈子に迫る。
PRINTFORMW 「来い！私の身体が欲しいんだろう？！タダではくれてやらんがなぁ！」	PRINTFORMW 「来い！私の身体が欲しいんだろう？！タダではくれてやらんがなぁ！」
PRINTFORMW 『触手に犯されて中出しされてザーメン飲まされて気持ちよかった……』	PRINTFORMW 『触手に犯されて中出しされてザーメン飲まされて気持ちよかった……』
PRINTFORMW 「は、はやく…産みたい！私の子……おっぱいたくさんあげたいぃっ！」	PRINTFORMW 「は、はやく…産みたい！私の子……おっぱいたくさんあげたいぃっ！」
PRINTFORMDW 神奈子は何処か遠くを見つめながら、壊れたような表情で笑い始めた。	PRINTFORMDW 神奈子は何処か遠くを見つめながら、壊れたような表情で笑い始めた。
PRINTFORMDW 絶頂に身体を無茶苦茶に跳ねさせながらでは出来る訳も無かった…。	PRINTFORMDW 絶頂に身体を無茶苦茶に跳ねさせながらでは出来る訳も無かった…。
PRINTFORMDW 『――本当ハ――コウナル事ヲ――望ンデイタ――クセニ――……』	PRINTFORMDW 『――本当ハ――コウナル事ヲ――望ンデイタ――クセニ――……』
PRINTFORMW 「んん？諏訪子どうした…ナニ扱いてほしい？しょうがないねぇ……」	PRINTFORMW 「んん？諏訪子どうした…ナニ扱いてほしい？しょうがないねぇ……」
PRINTFORMDL 神奈子は顔を白目を剥きながら亀頭を抑え射精を止めようとするが、	PRINTFORMDL 神奈子は顔を白目を剥きながら亀頭を抑え射精を止めようとするが、
PRINTFORMDW 決壊したザーメンの濁流は、指の間から易々と噴出してしまった……	PRINTFORMDW 決壊したザーメンの濁流は、指の間から易々と噴出してしまった……
PRINTFORMW 「ふふふ、どうだ軍神の手は……戦ばかりでガサガサだけどねぇ……」	PRINTFORMW 「ふふふ、どうだ軍神の手は……戦ばかりでガサガサだけどねぇ……」
PRINTFORMDW 『こぉんなに気持ちイイ事を嫌がるなんて、ほんとバカな女よね♪』	PRINTFORMDW 『こぉんなに気持ちイイ事を嫌がるなんて、ほんとバカな女よね♪』
PRINTFORMW 「―――ダメか……もはやコレまで…いっそ楽にしてやるぞ、早苗！」	PRINTFORMW 「―――ダメか……もはやコレまで…いっそ楽にしてやるぞ、早苗！」
PRINTFORMW 「ヒソヒソ……諏訪子はペチャパイ……幼児体型のペド量産装置……」	PRINTFORMW 「ヒソヒソ……諏訪子はペチャパイ……幼児体型のペド量産装置……」
PRINTFORMW 「ぐぅうっ……症状が妊娠に似ている……射精なんてされてないのに」	PRINTFORMW 「ぐぅうっ……症状が妊娠に似ている……射精なんてされてないのに」
PRINTFORMW 「うわあぁぁあッッ！……胸で卵なんか、産みたくないぃぃぃッッ！」	PRINTFORMW 「うわあぁぁあッッ！……胸で卵なんか、産みたくないぃぃぃッッ！」
PRINTFORMW 「ひぃぃいぁぁあ゛っ！……やだ……おっぱいから卵なんてぇえ！！」	PRINTFORMW 「ひぃぃいぁぁあ゛っ！……やだ……おっぱいから卵なんてぇえ！！」
PRINTFORMW 「へうぅっ…うぐうぅっ……身重の上に、見張り無しで寝るのか……」	PRINTFORMW 「へうぅっ…うぐうぅっ……身重の上に、見張り無しで寝るのか……」
PRINTFORMW 「持ち主には悪いが、調(みつぎ)と思って有効に使わせてもらおう」	PRINTFORMW 「持ち主には悪いが、調(みつぎ)と思って有効に使わせてもらおう」
PRINTFORMW 　オナバカかにゃこの射精ショー……無料公開実施中ーーーぅッ！」	PRINTFORMW 　オナバカかにゃこの射精ショー……無料公開実施中ーーーぅッ！」
PRINTFORMDW 『あぁ～ん、逃げちゃダメですよ、もう一人の神奈子さまぁ～☆』	PRINTFORMDW 『あぁ～ん、逃げちゃダメですよ、もう一人の神奈子さまぁ～☆』
PRINTFORMDW 『こぉんなに気持ちイイ事を嫌がるなんて、ほんとバカな女よね♪	PRINTFORMDW 『こぉんなに気持ちイイ事を嫌がるなんて、ほんとバカな女よね♪
PRINTFORMW 『あハッ！見つけたぁ♪……いくら逃げたって、無駄なのにねぇ？』	PRINTFORMW 『あハッ！見つけたぁ♪……いくら逃げたって、無駄なのにねぇ？』
PRINTFORMW 「逃がすか！ここで仕留める！お前を外に出すわけにはいかない！」	PRINTFORMW 「逃がすか！ここで仕留める！お前を外に出すわけにはいかない！」
PRINTFORMW 「黙れ！黙れ黙れ！……お願いだから……それ以上言わないで……」	PRINTFORMW 「黙れ！黙れ黙れ！……お願いだから……それ以上言わないで……」
PRINTFORMW 「ふウゥぐっぁぁあ゛っ！……やだ……卵なんて産みたくない！！」	PRINTFORMW 「ふウゥぐっぁぁあ゛っ！……やだ……卵なんて産みたくない！！」
PRINTFORMW 「うぅうっ…すまない……こんな体じゃ、休まないともたない……」	PRINTFORMW 「うぅうっ…すまない……こんな体じゃ、休まないともたない……」
PRINTFORMW 「うぅ、ぐ…まさか自分のニセモノに辱められるとは……不覚ッ」	PRINTFORMW 「うぅ、ぐ…まさか自分のニセモノに辱められるとは……不覚ッ」
PRINTFORMDW %CALLNAME:(TARGET)%を模した何か『……』	PRINTFORMDW %CALLNAME:(TARGET)%を模した何か『……』
PRINTFORMDW 嗜虐的な笑みを浮かべたまま、その頬を繰り返し左右に張った。	PRINTFORMDW 嗜虐的な笑みを浮かべたまま、その頬を繰り返し左右に張った。
PRINTFORM 「きゃにゃこの危険日子袋っ…たっぷり孕ませザーメンちょうだいぃ	PRINTFORM 「きゃにゃこの危険日子袋っ…たっぷり孕ませザーメンちょうだいぃ
PRINTFORMW 「ふわぁ～…むにゃむにゃ……父上ぇ、いっしょにねんね～……」	PRINTFORMW 「ふわぁ～…むにゃむにゃ……父上ぇ、いっしょにねんね～……」
PRINTFORML 「う、あ…生娘……私は何を……すまない！瘴気にあてられた！」	PRINTFORML 「う、あ…生娘……私は何を……すまない！瘴気にあてられた！」
PRINTFORMDW 暗闇に神奈子の悲鳴と、破裂したような射精音が木霊する……。	PRINTFORMDW 暗闇に神奈子の悲鳴と、破裂したような射精音が木霊する……。
PRINTFORM 「かにゃこはもう、いつでも食べられる準備ができていましゅぅっ…	PRINTFORM 「かにゃこはもう、いつでも食べられる準備ができていましゅぅっ…
PRINTFORMW 「はふぅぅぅん…ここ、だよぉ……おマンコに欲しいんだよぉッ」	PRINTFORMW 「はふぅぅぅん…ここ、だよぉ……おマンコに欲しいんだよぉッ」
PRINTFORMW 「……呆気ないものだな……あの祟り神が、こんな最後とは……」	PRINTFORMW 「……呆気ないものだな……あの祟り神が、こんな最後とは……」
PRINTFORMW 「弾幕を撃つ気はないみたいだし……いったい何なのよ、もう？」	PRINTFORMW 「弾幕を撃つ気はないみたいだし……いったい何なのよ、もう？」
PRINTFORMW 「どうせ紛いもの……後生大事に取っていたわけではないが……」	PRINTFORMW 「どうせ紛いもの……後生大事に取っていたわけではないが……」
PRINTFORMW 「お腹が痛くなったり、寂しくなったら、何時でも私を呼ぶんだ」	PRINTFORMW 「お腹が痛くなったり、寂しくなったら、何時でも私を呼ぶんだ」
PRINTFORMW 「ふっふ～ん、さしもの祟り神も、今回ばかりはお手上げかな？」	PRINTFORMW 「ふっふ～ん、さしもの祟り神も、今回ばかりはお手上げかな？」
PRINTFORMW 「率直な意見を聞かせてくれ……私は、妊娠していると思うか？」	PRINTFORMW 「率直な意見を聞かせてくれ……私は、妊娠していると思うか？」
PRINTFORMW 「そんなッ！……この私が……誰ともわからぬ子をぉぉッッ…！」	PRINTFORMW 「そんなッ！……この私が……誰ともわからぬ子をぉぉッッ…！」
PRINTFORMW 「ふウゥぐっぁぁあ゛っ！……もう、やだ……産みたくない！！」	PRINTFORMW 「ふウゥぐっぁぁあ゛っ！……もう、やだ……産みたくない！！」
PRINTFORMW 「や……やだぁ……化け物の子なんて……産みたくないいぃっ！」	PRINTFORMW 「や……やだぁ……化け物の子なんて……産みたくないいぃっ！」
PRINTFORMW 「――ああぁ、嫌ぁ……出して……だれか、取り出してぇえ！！」	PRINTFORMW 「――ああぁ、嫌ぁ……出して……だれか、取り出してぇえ！！」
PRINTFORMDW 乳腺の奥底に巣食う卵を転がして、異物感と快感を貪っている。	PRINTFORMDW 乳腺の奥底に巣食う卵を転がして、異物感と快感を貪っている。
PRINTFORMW 「おい諏訪子！こちとら手負いなんだ、もう少し歩調をだなぁ…」	PRINTFORMW 「おい諏訪子！こちとら手負いなんだ、もう少し歩調をだなぁ…」
PRINTFORMW 「祟り神に心配されるとはな……気にせずさっさと走るんだよ！」	PRINTFORMW 「祟り神に心配されるとはな……気にせずさっさと走るんだよ！」
PRINTFORMW 「んっふぅ～～～ッ♪後は熱燗があれば言う事ないんだけどねぇ」	PRINTFORMW 「んっふぅ～～～ッ♪後は熱燗があれば言う事ないんだけどねぇ」
PRINTFORM 「かにゃこのお腹あぁ…しょくしゅしゃんに征服されひゃいまひたぁ	PRINTFORM 「かにゃこのお腹あぁ…しょくしゅしゃんに征服されひゃいまひたぁ
PRINTFORMW 「――助けてぇ！誰か取って！お願いコレ外してぇーーッッ！！」	PRINTFORMW 「――助けてぇ！誰か取って！お願いコレ外してぇーーッッ！！」
PRINTFORMW 「おのれ…おのれぇぇ！……こんな、ふざけた罠なんかにぃっ！」	PRINTFORMW 「おのれ…おのれぇぇ！……こんな、ふざけた罠なんかにぃっ！」
PRINTFORMW 「ふぎゃあぁあああがああぁ！！！あひいィィィ―――ッッ！！」	PRINTFORMW 「ふぎゃあぁあああがああぁ！！！あひいィィィ―――ッッ！！」
PRINTFORMW 「信仰の妨げになるものは一つ一つ排除しなくてはなりません」	PRINTFORMW 「信仰の妨げになるものは一つ一つ排除しなくてはなりません」
PRINTFORMW 「フゥー…フゥー……ッ(もう、まともに柄も握れない……)」	PRINTFORMW 「フゥー…フゥー……ッ(もう、まともに柄も握れない……)」
PRINTFORMDL 強烈な一撃によって急所を抉られた神奈子は苦痛に耐え切れず	PRINTFORMDL 強烈な一撃によって急所を抉られた神奈子は苦痛に耐え切れず
PRINTFORM 「かにゃこのデカぱいぃッ淫っ乱でぇ……すぐイッひゃうからぁあ	PRINTFORM 「かにゃこのデカぱいぃッ淫っ乱でぇ……すぐイッひゃうからぁあ
PRINTFORMW 「早苗ぇ！そいつは本当の私じゃない！正気に戻るんだよ！！」	PRINTFORMW 「早苗ぇ！そいつは本当の私じゃない！正気に戻るんだよ！！」
PRINTFORMDW 『穴と言う穴ブチ犯して、使い物にならなくしてやるから☆』	PRINTFORMDW 『穴と言う穴ブチ犯して、使い物にならなくしてやるから☆』
PRINTFORMW 「くっ、来るな……来ないでくれぇッ！……嫌あぁぁアッッ！」	PRINTFORMW 「くっ、来るな……来ないでくれぇッ！……嫌あぁぁアッッ！」
PRINTFORMW 「おい、しっかりしろ！こんな様、早苗に見せられないだろ！」	PRINTFORMW 「おい、しっかりしろ！こんな様、早苗に見せられないだろ！」
PRINTFORMW 「怪我はないか？変な事されなかった？お腹はいたくないか？」	PRINTFORMW 「怪我はないか？変な事されなかった？お腹はいたくないか？」
PRINTFORMDW 『あーうー……ひょっとして、私いいように利用されてる？』	PRINTFORMDW 『あーうー……ひょっとして、私いいように利用されてる？』
PRINTFORMW 「うっぐ…！すまない、早苗……無様な所を見せてしまったな」	PRINTFORMW 「うっぐ…！すまない、早苗……無様な所を見せてしまったな」
PRINTFORMW 「……ふ、ふふふ……身重の軍神なんて、絵にならないんだよ」	PRINTFORMW 「……ふ、ふふふ……身重の軍神なんて、絵にならないんだよ」
PRINTFORMW 「ふウゥぐっぁぁあ゛っ！……やだ……もう産みたくない！！」	PRINTFORMW 「ふウゥぐっぁぁあ゛っ！……やだ……もう産みたくない！！」
PRINTFORMW 「うっ！……くそ、壁に寄りかかる事もできんのか、ここは！」	PRINTFORMW 「うっ！……くそ、壁に寄りかかる事もできんのか、ここは！」
PRINTFORMDL それを信仰獲得の好機と捉えた、守矢神社の主柱「神奈子」は	PRINTFORMDL それを信仰獲得の好機と捉えた、守矢神社の主柱「神奈子」は
PRINTFORMW 「来るがいい化生共……神の荒ぶる御霊を味わわせてくれよう」	PRINTFORMW 「来るがいい化生共……神の荒ぶる御霊を味わわせてくれよう」
PRINTFORM 　ほごぉっ！中で動いてるのっ！おっぱい穿られていぐぅぅぅっ！	PRINTFORM 　ほごぉっ！中で動いてるのっ！おっぱい穿られていぐぅぅぅっ！
PRINTFORMW 「け、けつなら……尻の穴なら、好きにして…イイからっ！」	PRINTFORMW 「け、けつなら……尻の穴なら、好きにして…イイからっ！」
PRINTFORMW 「うわぁぁぁっ！身体が勝手に服を……だめだ、止せぇぇ！」	PRINTFORMW 「うわぁぁぁっ！身体が勝手に服を……だめだ、止せぇぇ！」
PRINTFORMW 「センズリくらい自分でやったらどうだい…服を汚すなよ？」	PRINTFORMW 「センズリくらい自分でやったらどうだい…服を汚すなよ？」
PRINTFORMW 「ロリ体型の蛙なんて忘れて、私のパイオツを崇めるのです」	PRINTFORMW 「ロリ体型の蛙なんて忘れて、私のパイオツを崇めるのです」
PRINTFORMW （はぁ～～ッ…あぁ、だめ！…オンバシラ疼いちゃうぅっっ）	PRINTFORMW （はぁ～～ッ…あぁ、だめ！…オンバシラ疼いちゃうぅっっ）
PRINTFORM 「調(みつぎ)はこれだけか？もっと出るだろう…神の粥だよっ	PRINTFORM 「調(みつぎ)はこれだけか？もっと出るだろう…神の粥だよっ
PRINTFORMW 「ひぐあぁあ？！まさか…種付けされて……嫌あぁぁっ！！」	PRINTFORMW 「ひぐあぁあ？！まさか…種付けされて……嫌あぁぁっ！！」
PRINTFORMW 「逃がしてはくれんか……ならば、取るべき手段は一つ……」	PRINTFORMW 「逃がしてはくれんか……ならば、取るべき手段は一つ……」
PRINTFORMW 「だっ……だめぇ！……こんな状態じゃ……勝てっこない！」	PRINTFORMW 「だっ……だめぇ！……こんな状態じゃ……勝てっこない！」
PRINTFORMW 「黙れ！！そんなはずがあるか！…私は…八坂神奈子はッ！」	PRINTFORMW 「黙れ！！そんなはずがあるか！…私は…八坂神奈子はッ！」
PRINTFORMW 「あの子の記憶の中で、昔のままの諏訪子でいさせてやる！」	PRINTFORMW 「あの子の記憶の中で、昔のままの諏訪子でいさせてやる！」
PRINTFORMW 「しっかりしろ祟り神！そんな様を早苗に見せられるのか！」	PRINTFORMW 「しっかりしろ祟り神！そんな様を早苗に見せられるのか！」
PRINTFORMW 「この八坂神奈子が来たからには、もう心配には及びません」	PRINTFORMW 「この八坂神奈子が来たからには、もう心配には及びません」
PRINTFORMW 「誰か、助けて…すわこ……さなえぇ……父……上ぇぇ……」	PRINTFORMW 「誰か、助けて…すわこ……さなえぇ……父……上ぇぇ……」
PRINTFORMW 「私の子が生まれるんだ……誰か、祝詞をあげておくれよぉ」	PRINTFORMW 「私の子が生まれるんだ……誰か、祝詞をあげておくれよぉ」
PRINTFORMW 「産みたくない！化け物の子なんて産みたくないぃぃぃっ！」	PRINTFORMW 「産みたくない！化け物の子なんて産みたくないぃぃぃっ！」
PRINTFORMW 「うえううあぁッ…あがっ…ハラワタが、破れるうぅっっ！」	PRINTFORMW 「うえううあぁッ…あがっ…ハラワタが、破れるうぅっっ！」
PRINTFORM 　はやくっ、触手服ちょうらいぃっ、もう我慢できにゃいのぉぉ	PRINTFORM 　はやくっ、触手服ちょうらいぃっ、もう我慢できにゃいのぉぉ
PRINTFORMW 「ああぁああああウソだウソだ！！！早苗が死ぬはずが……」	PRINTFORMW 「ああぁああああウソだウソだ！！！早苗が死ぬはずが……」
PRINTFORMW 「さっさと解決しなくては、信仰獲得どころの話ではないぞ」	PRINTFORMW 「さっさと解決しなくては、信仰獲得どころの話ではないぞ」
PRINTFORMDL [1] [剣術習熟]習得　　　※ＨＰ・ＥＰ最大値が減少	PRINTFORMDL [1] [剣術習熟]習得　　　※ＨＰ・ＥＰ最大値が減少
PRINTFORML 「かといって、この体を好き勝手させるつもりはないけどね」	PRINTFORML 「かといって、この体を好き勝手させるつもりはないけどね」
PRINTFORMW 「うぅぐッ……慌てるな、まだ勝機は……有ってくれっ！」	PRINTFORMW 「うぅぐッ……慌てるな、まだ勝機は……有ってくれっ！」
PRINTFORMW 「ううぅぅッ！当たれ！当たれ！！……当たってくれぇ！」	PRINTFORMW 「ううぅぅッ！当たれ！当たれ！！……当たってくれぇ！」
PRINTFORMW 「我が名は八坂……“根の国へ”戻っても忘れぬ事だ……」	PRINTFORMW 「我が名は八坂……“根の国へ”戻っても忘れぬ事だ……」
PRINTFORMW 「……くそっ！くそぉっ！！打って欲しくば呪縛を解け！」	PRINTFORMW 「……くそっ！くそぉっ！！打って欲しくば呪縛を解け！」
PRINTFORMW 「折れっていうのかい？触手にもドＭなヤツがいるんだね」	PRINTFORMW 「折れっていうのかい？触手にもドＭなヤツがいるんだね」
PRINTFORMW 「かなこねー、おっぱいこんなに大きくなったんだよぉ？」	PRINTFORMW 「かなこねー、おっぱいこんなに大きくなったんだよぉ？」
PRINTFORMW 「ううっぅっ！くそっ！このままでは戦線が崩壊するぞ！」	PRINTFORMW 「ううっぅっ！くそっ！このままでは戦線が崩壊するぞ！」
PRINTFORMW 「……ここを出たなら、いつでも相手してあげるから……」	PRINTFORMW 「……ここを出たなら、いつでも相手してあげるから……」
PRINTFORM 「はあッ、はぁッ…初物のくせに、随分と感じていたじゃない	PRINTFORM 「はあッ、はぁッ…初物のくせに、随分と感じていたじゃない
PRINTFORM 「とまんにゃいっ！オンバシラレイプとまんにゃいょぉぉお…	PRINTFORM 「とまんにゃいっ！オンバシラレイプとまんにゃいょぉぉお…
PRINTFORMW 「くっ…はぁっ……んんぅ……やっと、おさまったか……」	PRINTFORMW 「くっ…はぁっ……んんぅ……やっと、おさまったか……」
PRINTFORMW あとテキスト表現ルナティック以上の口上もあるので注意。	PRINTFORMW あとテキスト表現ルナティック以上の口上もあるので注意。
PRINTFORM 「こ、降伏…しゅるからあぁ……だからぁも……あひぃぃああ	PRINTFORM 「こ、降伏…しゅるからあぁ……だからぁも……あひぃぃああ
PRINTFORMW 「くっ…こんな化生にまで頼らなくてはならないとは……」	PRINTFORMW 「くっ…こんな化生にまで頼らなくてはならないとは……」
PRINTFORM 　ミルキュタンク揉まれて…こんにゃ大きくなっひゃったぁぁ	PRINTFORM 　ミルキュタンク揉まれて…こんにゃ大きくなっひゃったぁぁ
PRINTFORMW 「はっ……ひぃぃ…おんばひら…オンバシラにしてェェッ」	PRINTFORMW 「はっ……ひぃぃ…おんばひら…オンバシラにしてェェッ」
PRINTFORM かにゃこの子宮……触手しゃんに種付けしゃれちゃったぁ……	PRINTFORM かにゃこの子宮……触手しゃんに種付けしゃれちゃったぁ……
PRINTFORMW 「――ッ？！…ち、違う！…期待なんてしてないぃっ！！」	PRINTFORMW 「――ッ？！…ち、違う！…期待なんてしてないぃっ！！」
PRINTFORMW 「外法の分際で、神を相手に舐めた真似するじゃあないか」	PRINTFORMW 「外法の分際で、神を相手に舐めた真似するじゃあないか」
PRINTFORMDW 『……国譲り……タケミカヅチ……言いたい事わかる？』	PRINTFORMDW 『……国譲り……タケミカヅチ……言いたい事わかる？』
PRINTFORMW 「そうそう諏訪子、胸を触手に弄られると大きくなるぞ？」	PRINTFORMW 「そうそう諏訪子、胸を触手に弄られると大きくなるぞ？」
PRINTFORMW 「くそぉっ！……胚を直接植え付けられたというのか……」	PRINTFORMW 「くそぉっ！……胚を直接植え付けられたというのか……」
PRINTFORMW 「……へぅうぅぐっ……見て分るだろ、孕まされたよ……」	PRINTFORMW 「……へぅうぅぐっ……見て分るだろ、孕まされたよ……」
PRINTFORMW 「……言い逃れするつもりは無い……私は、孕まされたよ」	PRINTFORMW 「……言い逃れするつもりは無い……私は、孕まされたよ」
PRINTFORMW 「ぐへぇえあぁッ……くそぉっ！私の中で、暴れている！」	PRINTFORMW 「ぐへぇえあぁッ……くそぉっ！私の中で、暴れている！」
PRINTFORMW 「ううアァァッ……だめ、乳房が……母乳でちゃうぅっ！」	PRINTFORMW 「ううアァァッ……だめ、乳房が……母乳でちゃうぅっ！」
PRINTFORMW 「乳首からなんて……いやあぁぁああああああッッ！！！」	PRINTFORMW 「乳首からなんて……いやあぁぁああああああッッ！！！」
PRINTFORMW 「おうぅぐっ……悪いけど、寝ている間見張っていて……」	PRINTFORMW 「おうぅぐっ……悪いけど、寝ている間見張っていて……」
PRINTFORMW 「ぐぅっ！……手負いでなければ、こんな小細工などっ！」	PRINTFORMW 「ぐぅっ！……手負いでなければ、こんな小細工などっ！」
PRINTFORMW 「正直、こんな気持ち悪い所は漁りたくないけどねぇ……」	PRINTFORMW 「正直、こんな気持ち悪い所は漁りたくないけどねぇ……」
PRINTFORMW 「――ッ！！べっ、別に…ウットリなんてしてないぞッ！」	PRINTFORMW 「――ッ！！べっ、別に…ウットリなんてしてないぞッ！」
PRINTFORMW 「憑き物が取れた……厄神のヤツも放り込んでやりたいね」	PRINTFORMW 「憑き物が取れた……厄神のヤツも放り込んでやりたいね」
PRINTFORMW 「中東では、ああいうのに火薬を仕込むと言うじゃないか」	PRINTFORMW 「中東では、ああいうのに火薬を仕込むと言うじゃないか」
PRINTFORMDL 神社の風祝「早苗」を引きつれて異変解決に乗り出した。	PRINTFORMDL 神社の風祝「早苗」を引きつれて異変解決に乗り出した。
PRINTFORMDL もう一人の主柱「諏訪子」と共に異変解決に乗り出した。	PRINTFORMDL もう一人の主柱「諏訪子」と共に異変解決に乗り出した。
PRINTFORMW 「――ひあぁあっ？！やめっ、そんな所に入るなッッ！！」	PRINTFORMW 「――ひあぁあっ？！やめっ、そんな所に入るなッッ！！」
PRINTFORMW 「あぎぃぃっ？！乳房の中で動いて……嫌あぁぁああっ！」	PRINTFORMW 「あぎぃぃっ？！乳房の中で動いて……嫌あぁぁああっ！」
PRINTFORMW 「ぐぅッ…(慌てるな…なんとか動きを止めるんだ！)」	PRINTFORMW 「ぐぅッ…(慌てるな…なんとか動きを止めるんだ！)」
PRINTFORMDW 『どうして？……わからないんですか、神奈子さま？』	PRINTFORMDW 『どうして？……わからないんですか、神奈子さま？』
PRINTFORM 「おにぇがいだからぁ、おっぱいは許ひてくりゃしゃいいぃ	PRINTFORM 「おにぇがいだからぁ、おっぱいは許ひてくりゃしゃいいぃ
PRINTFORM 　いましゃれたらぁ、精しじぇんぶりぇて死んじゃうのぉぉ	PRINTFORM 　いましゃれたらぁ、精しじぇんぶりぇて死んじゃうのぉぉ
PRINTFORMW 「うわぁあアッッダメぇ！！いま中出しダメぇええ！！」	PRINTFORMW 「うわぁあアッッダメぇ！！いま中出しダメぇええ！！」
PRINTFORM 「かにゃこの淫乱マンコっ！犯してめちゃくちゃにしてぇっ	PRINTFORM 「かにゃこの淫乱マンコっ！犯してめちゃくちゃにしてぇっ
PRINTFORMW 「む？！諏訪子ー！私のヨーグルト勝手に食べたな？！」	PRINTFORMW 「む？！諏訪子ー！私のヨーグルト勝手に食べたな？！」
PRINTFORM こうして(触)腕枕されてると……眠くなってきちゃうよぉ	PRINTFORM こうして(触)腕枕されてると……眠くなってきちゃうよぉ
PRINTFORMW 「こら！女の子はもっと大切に扱わなきゃだめだぞ！？」	PRINTFORMW 「こら！女の子はもっと大切に扱わなきゃだめだぞ！？」
PRINTFORMW 「うっぐっ！握りつぶしてや……だめだ…指が勝手に！」	PRINTFORMW 「うっぐっ！握りつぶしてや……だめだ…指が勝手に！」
PRINTFORMW 　とまんにゃい！ザー汁噴射とまんにゃぃぃいっ！……」	PRINTFORMW 　とまんにゃい！ザー汁噴射とまんにゃぃぃいっ！……」
PRINTFORM 「んっほぉおぉぉっ！！オンバシラ射精バカににゃるのぉぉ	PRINTFORM 「んっほぉおぉぉっ！！オンバシラ射精バカににゃるのぉぉ
PRINTFORML 「―――ふぎぃぃあああがア゛ア゛ァァァッッ……！！！	PRINTFORML 「―――ふぎぃぃあああがア゛ア゛ァァァッッ……！！！
PRINTFORMW 「ひくっ！くそ、またオンバシラが……勝手にぃ～～ッ」	PRINTFORMW 「ひくっ！くそ、またオンバシラが……勝手にぃ～～ッ」
PRINTFORMDW 去り際、幽香は相手の触手を盛大に踏みつけていった。	PRINTFORMDW 去り際、幽香は相手の触手を盛大に踏みつけていった。
PRINTFORM 　クリちゃんこすこすひて、きもひよくなりたいんれすぅっ	PRINTFORM 　クリちゃんこすこすひて、きもひよくなりたいんれすぅっ
PRINTFORMW 「やらぁぁ！おっぱい……おっぱいにちょうだいぃぃッ」	PRINTFORMW 「やらぁぁ！おっぱい……おっぱいにちょうだいぃぃッ」
PRINTFORMW (身体が奴らを欲しがってる……いっそ、私も楽に……)	PRINTFORMW (身体が奴らを欲しがってる……いっそ、私も楽に……)
PRINTFORMW 「ここで仕留める！お前を外に出すわけにはいかない！」	PRINTFORMW 「ここで仕留める！お前を外に出すわけにはいかない！」
PRINTFORMW 「諏訪子…早苗ぇ……誰か、助けて……嫌あぁぁッッ！」	PRINTFORMW 「諏訪子…早苗ぇ……誰か、助けて……嫌あぁぁッッ！」
PRINTFORMW 「……八坂の名において、この落とし前はつけさせる！」	PRINTFORMW 「……八坂の名において、この落とし前はつけさせる！」
PRINTFORMW 「……すまない早苗……お前の友達は、救えなかったよ」	PRINTFORMW 「……すまない早苗……お前の友達は、救えなかったよ」
PRINTFORMW 「よぉ～～し、ここらで分かれて、挟み撃ちといくか？」	PRINTFORMW 「よぉ～～し、ここらで分かれて、挟み撃ちといくか？」
PRINTFORMW 「もう大丈夫だぞ早苗！いっしょに連れて行ってやる！」	PRINTFORMW 「もう大丈夫だぞ早苗！いっしょに連れて行ってやる！」
PRINTFORMW 「……力が思ったように入らない……孕んだみたいだな」	PRINTFORMW 「……力が思ったように入らない……孕んだみたいだな」
PRINTFORMW 「うぎいぃぃっっ！いやあぁぁああああああッッ！！！」	PRINTFORMW 「うぎいぃぃっっ！いやあぁぁああああああッッ！！！」
PRINTFORML 「うぅぅうぐっ！……ダメ、だ……殺さ…ないとッッ！」	PRINTFORML 「うぅぅうぐっ！……ダメ、だ……殺さ…ないとッッ！」
PRINTFORMW 「あれは、私の血を……国津神の血を汚したんだ……！」	PRINTFORMW 「あれは、私の血を……国津神の血を汚したんだ……！」
PRINTFORMW 「はあうぅうっ…うぐっ！…乳房の中で…育ってる…！」	PRINTFORMW 「はあうぅうっ…うぐっ！…乳房の中で…育ってる…！」
PRINTFORMW 「……一人で寝るのは危ないが、倒れてからでは遅いか」	PRINTFORMW 「……一人で寝るのは危ないが、倒れてからでは遅いか」
PRINTFORMW 「……怪しい泉に裸の美女……Ｂ級映画じゃないんだよ」	PRINTFORMW 「……怪しい泉に裸の美女……Ｂ級映画じゃないんだよ」
PRINTFORMW 「ううっ、あぁっくそ！……他に着るものはないのかっ」	PRINTFORMW 「ううっ、あぁっくそ！……他に着るものはないのかっ」
PRINTFORM （……なんで私は、これを着せられる事を期待しているんだ	PRINTFORM （……なんで私は、これを着せられる事を期待しているんだ
PRINTFORMW 「も…やめ……膣内射精(なかだし)……ゆるひて……」	PRINTFORMW 「も…やめ……膣内射精(なかだし)……ゆるひて……」
PRINTFORMW 「三人揃って餌箱の中とは、我ながら無様なものだよ！」	PRINTFORMW 「三人揃って餌箱の中とは、我ながら無様なものだよ！」
PRINTFORMW 「だめっ！だめぇぇ全部一編になんて無理ぃぃぃっ！！」	PRINTFORMW 「だめっ！だめぇぇ全部一編になんて無理ぃぃぃっ！！」
PRINTFORMW 「くっ……こんなものでは、猫騙しくらいにしか……」	PRINTFORMW 「くっ……こんなものでは、猫騙しくらいにしか……」
PRINTFORMW 「火力を叩き込む時は躊躇わず、一気に攻めるんだよ」	PRINTFORMW 「火力を叩き込む時は躊躇わず、一気に攻めるんだよ」
PRINTFORMW 「ハッ…ハァッ……(見切れるのか…今の私にっ！)」	PRINTFORMW 「ハッ…ハァッ……(見切れるのか…今の私にっ！)」
PRINTFORMDW パンッ　パンッ　と、乾いた音が暗闇に木霊する……	PRINTFORMDW パンッ　パンッ　と、乾いた音が暗闇に木霊する……
PRINTFORMW 「神奈子、いーっぱいお背中ながしてあげるねぇー？」	PRINTFORMW 「神奈子、いーっぱいお背中ながしてあげるねぇー？」
PRINTFORMW 「ううぅア……あっっ！違うっ！！足が、勝手にぃ！」	PRINTFORMW 「ううぅア……あっっ！違うっ！！足が、勝手にぃ！」
PRINTFORM 「やだぁ……神奈子もうずっと触手といっしょになるのぉ	PRINTFORM 「やだぁ……神奈子もうずっと触手といっしょになるのぉ
PRINTFORMW 「うーん、欠陥住宅か？床板がぐにゃぐにゃだぞ……」	PRINTFORMW 「うーん、欠陥住宅か？床板がぐにゃぐにゃだぞ……」
PRINTFORMW 「わかった！わかったから、もっと優しくしてくれ！」	PRINTFORMW 「わかった！わかったから、もっと優しくしてくれ！」
PRINTFORMW (あへあぁおおオマンコかってにビクビクしちゃぅぅ)	PRINTFORMW (あへあぁおおオマンコかってにビクビクしちゃぅぅ)
PRINTFORMDL ――――どびゅっ！　ブシュゥゥゥッ！！！――――	PRINTFORMDL ――――どびゅっ！　ブシュゥゥゥッ！！！――――
PRINTFORM 「あっ、ァア゛ア゛ぁぁっ…今、エクスパンデッドだめぇ	PRINTFORM 「あっ、ァア゛ア゛ぁぁっ…今、エクスパンデッドだめぇ
PRINTFORM 「かにゃこのエロ子宮、ダボダボ注いで孕ませてぇ～～ッ	PRINTFORM 「かにゃこのエロ子宮、ダボダボ注いで孕ませてぇ～～ッ
PRINTFORMW は「;」を左につけるか消すかしたほうがよいでしょう	PRINTFORMW は「;」を左につけるか消すかしたほうがよいでしょう
PRINTFORM 　かにゃこぉぉおぉっオナバカになっちゃぁったのぉぉ！	PRINTFORM 　かにゃこぉぉおぉっオナバカになっちゃぁったのぉぉ！
PRINTFORMW 「あぐぅッッ……やめて…もう、戦えないからぁッ！」	PRINTFORMW 「あぐぅッッ……やめて…もう、戦えないからぁッ！」
PRINTFORM 　それ以じょ……んうぅっ！！オンバシラを嬲るなぁあっ	PRINTFORM 　それ以じょ……んうぅっ！！オンバシラを嬲るなぁあっ
PRINTFORMW 「ヒギィィッ？！よ、よせ！……入ってくるなあぁ！」	PRINTFORMW 「ヒギィィッ？！よ、よせ！……入ってくるなあぁ！」
PRINTFORMDW 『あぁ～ん、逃げちゃダメですよ神奈子さまぁ～☆』	PRINTFORMDW 『あぁ～ん、逃げちゃダメですよ神奈子さまぁ～☆』
PRINTFORMW (逃げても逃げても追ってくる…ならいっそ私も……)	PRINTFORMW (逃げても逃げても追ってくる…ならいっそ私も……)
PRINTFORMW 「信仰の妨げになる者は、一つ残らず滅してくれる！」	PRINTFORMW 「信仰の妨げになる者は、一つ残らず滅してくれる！」
PRINTFORMDW 『地上の薄汚い国津神共の臭いがすると思ったわ♪』	PRINTFORMDW 『地上の薄汚い国津神共の臭いがすると思ったわ♪』
PRINTFORM 「ひゅご、ひゅごいの、ひゅごいのきひぇましゅぅぅぅっ	PRINTFORM 「ひゅご、ひゅごいの、ひゅごいのきひぇましゅぅぅぅっ
PRINTFORM 「しょんなしゃれたらぁ、おっぱいこわれちゃうのぉぉっ	PRINTFORM 「しょんなしゃれたらぁ、おっぱいこわれちゃうのぉぉっ
PRINTFORMW 「いいかい？早苗……私のいう事を、よ～くお聞き？」	PRINTFORMW 「いいかい？早苗……私のいう事を、よ～くお聞き？」
PRINTFORMW 「無様な所を見せてしまった……この恩は忘れないよ」	PRINTFORMW 「無様な所を見せてしまった……この恩は忘れないよ」
PRINTFORMW 「えっぅぐ！……これはまさか、悪阻――そんなッ！」	PRINTFORMW 「えっぅぐ！……これはまさか、悪阻――そんなッ！」
PRINTFORMW 「後生だから……こんなの嫌だ……嫌なんだよぉっ！」	PRINTFORMW 「後生だから……こんなの嫌だ……嫌なんだよぉっ！」
PRINTFORMW 「あはぁぁッ……ああぁ……おおぅうぅぐぅうっっ！」	PRINTFORMW 「あはぁぁッ……ああぁ……おおぅうぅぐぅうっっ！」
PRINTFORMW 「ううえあがあぁがッ！ひぅうぐうぅぅぅっ！！……」	PRINTFORMW 「ううえあがあぁがッ！ひぅうぐうぅぅぅっ！！……」
PRINTFORMW 「やだ……もう産みたくないぃ……嫌だああああ！！」	PRINTFORMW 「やだ……もう産みたくないぃ……嫌だああああ！！」
PRINTFORMW 「私も、女だったという事か……ははっ、ははは……」	PRINTFORMW 「私も、女だったという事か……ははっ、ははは……」
PRINTFORMW 「産みたくない！こんな所で産みたくないぃぃぃっ！」	PRINTFORMW 「産みたくない！こんな所で産みたくないぃぃぃっ！」
PRINTFORMW 「はあうぅうっ…うぐっ！…腹の中で…育ってる…！」	PRINTFORMW 「はあうぅうっ…うぐっ！…腹の中で…育ってる…！」
PRINTFORMW 「あぁああぁ嫌ぁあ……卵なんか、産みたくないぃ！」	PRINTFORMW 「あぁああぁ嫌ぁあ……卵なんか、産みたくないぃ！」
PRINTFORMW 「ははっ…あぁっ………あはははッ…うっぅぅぅ……」	PRINTFORMW 「ははっ…あぁっ………あはははッ…うっぅぅぅ……」
PRINTFORMW 「このままでは、身体が持たん…はやく休む場所を…」	PRINTFORMW 「このままでは、身体が持たん…はやく休む場所を…」
PRINTFORMW 「わたしは、大丈夫だッ……気にせず先を……ぅッ！」	PRINTFORMW 「わたしは、大丈夫だッ……気にせず先を……ぅッ！」
PRINTFORMW 「『理非なき時は、鼓を鳴らし、攻めて可なり』……」	PRINTFORMW 「『理非なき時は、鼓を鳴らし、攻めて可なり』……」
PRINTFORMW あ、あぁぁ……――？！なに、これ、奥に残って……」	PRINTFORMW あ、あぁぁ……――？！なに、これ、奥に残って……」
PRINTFORMW 「普段なら巣穴ごと吹き飛ばしてやれる所なのに……」	PRINTFORMW 「普段なら巣穴ごと吹き飛ばしてやれる所なのに……」
PRINTFORMDL 豊かな胸の双丘を締め絞り、穴と言う穴を犯し尽くし	PRINTFORMDL 豊かな胸の双丘を締め絞り、穴と言う穴を犯し尽くし
PRINTFORM 　はひぃぃ～～ッ……頼むから耐えて…わらひの体あぁ	PRINTFORM 　はひぃぃ～～ッ……頼むから耐えて…わらひの体あぁ
PRINTFORMW 「あうぅぅッ…ぐうぅ！……我ながら、なんて様だ」	PRINTFORMW 「あうぅぅッ…ぐうぅ！……我ながら、なんて様だ」
PRINTFORMW 「跪け、命乞いをしろ！(大佐かっこいいよねぇ)」	PRINTFORMW 「跪け、命乞いをしろ！(大佐かっこいいよねぇ)」
PRINTFORMW 「普通が悪いわけじゃないケド、華がないよねぇ？」	PRINTFORMW 「普通が悪いわけじゃないケド、華がないよねぇ？」
PRINTFORMW 「オオクニヌシ様…どうか御力を……父上ぇ……ッ」	PRINTFORMW 「オオクニヌシ様…どうか御力を……父上ぇ……ッ」
PRINTFORMW 「跪け、命乞いをしろ！(大佐カッコいいよねぇ)」	PRINTFORMW 「跪け、命乞いをしろ！(大佐カッコいいよねぇ)」
PRINTFORMDW 『堕ちてください……　か　な　こ　さ　ま　☆』	PRINTFORMDW 『堕ちてください……　か　な　こ　さ　ま　☆』
PRINTFORMW 「貴様らを喜ばせるために膨れたわけではないっ！」	PRINTFORMW 「貴様らを喜ばせるために膨れたわけではないっ！」
PRINTFORM (今オンバシラを嬲られたら…本当に、狂ってしまうッ	PRINTFORM (今オンバシラを嬲られたら…本当に、狂ってしまうッ
PRINTFORMW 「っっ！……こっちだ、こっちの穴にしろぉっ！！」	PRINTFORMW 「っっ！……こっちだ、こっちの穴にしろぉっ！！」
PRINTFORM 「も、もうりゃめ…おんばひら、がみゃんれきにゃぃい	PRINTFORM 「も、もうりゃめ…おんばひら、がみゃんれきにゃぃい
PRINTFORM 「んあぁああっ！だめぇっ…オンバシラ…でちゃうぅぅ	PRINTFORM 「んあぁああっ！だめぇっ…オンバシラ…でちゃうぅぅ
PRINTFORMW 　はやく…済ませてっ！落ち着かせなくては……！」	PRINTFORMW 　はやく…済ませてっ！落ち着かせなくては……！」
PRINTFORMW 「ぐひぃっ！あぁ……ダメッ！…射精だめぇっ！！」	PRINTFORMW 「ぐひぃっ！あぁ……ダメッ！…射精だめぇっ！！」
PRINTFORMW 「くぅ！…自分のオンバシラに振り回されるとは！」	PRINTFORMW 「くぅ！…自分のオンバシラに振り回されるとは！」
PRINTFORM 「尻でするのかぁ…ふふ、いいぞ入れても……ぉンッ！	PRINTFORM 「尻でするのかぁ…ふふ、いいぞ入れても……ぉンッ！
PRINTFORM 　早苗は昔から、私のオッパイが好きだったもんなぁ…	PRINTFORM 　早苗は昔から、私のオッパイが好きだったもんなぁ…
PRINTFORMW 「うぅう……本当にこれ、やらなきゃダメなのか？」	PRINTFORMW 「うぅう……本当にこれ、やらなきゃダメなのか？」
PRINTFORM 　グリグリ揉みしだいてぇ、虐めてくりゃひゃいぃぃっ	PRINTFORM 　グリグリ揉みしだいてぇ、虐めてくりゃひゃいぃぃっ
PRINTFORMW 「んんぅぅっ、お尻が…ケツマンコがいいよぉぉ…」	PRINTFORMW 「んんぅぅっ、お尻が…ケツマンコがいいよぉぉ…」
PRINTFORMW 「はっ……ひぃぃ…クリ…クリトリスにしてェェッ」	PRINTFORMW 「はっ……ひぃぃ…クリ…クリトリスにしてェェッ」
PRINTFORMW 「例えそれが……私の写し身であったとしても……」	PRINTFORMW 「例えそれが……私の写し身であったとしても……」
PRINTFORMW 「くっ、ハァッッ……そん、な……こんな所で……」	PRINTFORMW 「くっ、ハァッッ……そん、な……こんな所で……」
PRINTFORMW 「……くっ！　この八坂神奈子が、なんて様だよ！」	PRINTFORMW 「……くっ！　この八坂神奈子が、なんて様だよ！」
PRINTFORMDW 『うっさいわねぇ！調子こくと、ブッ祟るわよ？』	PRINTFORMDW 『うっさいわねぇ！調子こくと、ブッ祟るわよ？』
PRINTFORMW 「うえううあぁッ…あがっ…動か…ないでぇェッ！」	PRINTFORMW 「うえううあぁッ…あがっ…動か…ないでぇェッ！」
PRINTFORMW 「……父上……何故私を、女などに御作りにッ……」	PRINTFORMW 「……父上……何故私を、女などに御作りにッ……」
PRINTFORMW 「誰か、助け……おねがい……もう……殺して……」	PRINTFORMW 「誰か、助け……おねがい……もう……殺して……」
PRINTFORMW 「…吐き気…微熱…目眩に疲労……腹痛も少し……」	PRINTFORMW 「…吐き気…微熱…目眩に疲労……腹痛も少し……」
PRINTFORMW 「やめてえええぇえあががあがあああぁッッ！！！」	PRINTFORMW 「やめてえええぇえあががあがあああぁッッ！！！」
PRINTFORMW 「あぁッ…ああぁっ！！…おっぱい嫌あぁあっっ！」	PRINTFORMW 「あぁッ…ああぁっ！！…おっぱい嫌あぁあっっ！」
PRINTFORM 　産卵アクメ！ミルク噴射といっしょにイキたいのぉっ	PRINTFORM 　産卵アクメ！ミルク噴射といっしょにイキたいのぉっ
PRINTFORMW 「――――はッ！……伏兵中に転寝とは、不覚……」	PRINTFORMW 「――――はッ！……伏兵中に転寝とは、不覚……」
PRINTFORMW 「――！だ、だめだ！何を考えているんだ、私は！」	PRINTFORMW 「――！だ、だめだ！何を考えているんだ、私は！」
PRINTFORMW 「って早苗の持ってたファミコンで言ってたんだよ」	PRINTFORMW 「って早苗の持ってたファミコンで言ってたんだよ」
PRINTFORMW 「―――っうわア゛ァ゛ア゛ぁあああああっっ！！」	PRINTFORMW 「―――っうわア゛ァ゛ア゛ぁあああああっっ！！」
PRINTFORMW 「まさか、信仰を奪われて……そんなバカな！！！」	PRINTFORMW 「まさか、信仰を奪われて……そんなバカな！！！」
PRINTFORMW 「この帽子…！八雲の……スキマ妖怪までもが……」	PRINTFORMW 「この帽子…！八雲の……スキマ妖怪までもが……」
PRINTFORMW 「さぁ、今日もたっぷりエロエロしようねぇ……」	PRINTFORMW 「さぁ、今日もたっぷりエロエロしようねぇ……」
PRINTFORM ？　もてあましているんだ、たっぷり虐めておくれよ	PRINTFORM ？　もてあましているんだ、たっぷり虐めておくれよ
PRINTFORMW （くっ、くそ…！……ギリギリ、踏み潰せない！）	PRINTFORMW （くっ、くそ…！……ギリギリ、踏み潰せない！）
PRINTFORM 「……まぁいいけどさ、ちょっとマニアックだよねぇ	PRINTFORM 「……まぁいいけどさ、ちょっとマニアックだよねぇ
PRINTFORMW 　それ！……きゃっ！？ な、何か飛び散った…」	PRINTFORMW 　それ！……きゃっ！？ な、何か飛び散った…」
PRINTFORMW 「こいつは折るのにコツがいるんだ……エイッ！」	PRINTFORMW 「こいつは折るのにコツがいるんだ……エイッ！」
PRINTFORMW まぁ、それはそれで、嫌いじゃないけどねぇ……」	PRINTFORMW まぁ、それはそれで、嫌いじゃないけどねぇ……」
PRINTFORM 　あぁ～気持ちよかった…次は中にさせて欲しいねぇ	PRINTFORM 　あぁ～気持ちよかった…次は中にさせて欲しいねぇ
PRINTFORMW 「私に手コキをさせるとは大した度胸じゃないの」	PRINTFORMW 「私に手コキをさせるとは大した度胸じゃないの」
PRINTFORM 「も、もぅかにゃこぉっ……おかひくなっちゃうぅぅ	PRINTFORM 「も、もぅかにゃこぉっ……おかひくなっちゃうぅぅ
PRINTFORMW 「―――洩矢諏訪子……もう一度平らげてやる！」	PRINTFORMW 「―――洩矢諏訪子……もう一度平らげてやる！」
PRINTFORMW 「伏撃だと？！化生の分際で、私と同じ戦術を！」	PRINTFORMW 「伏撃だと？！化生の分際で、私と同じ戦術を！」
PRINTFORMW 「―――ッッ……(歯がカタカタと震えている)」	PRINTFORMW 「―――ッッ……(歯がカタカタと震えている)」
PRINTFORMW 「張り切ってるか？あんまり暴れすぎるなよ……」	PRINTFORMW 「張り切ってるか？あんまり暴れすぎるなよ……」
PRINTFORMW 「よくもまぁ、私の前に顔を出せたものだよ……」	PRINTFORMW 「よくもまぁ、私の前に顔を出せたものだよ……」
PRINTFORMW 「悪いけど、他人を助けるほどの余裕はないんだ」	PRINTFORMW 「悪いけど、他人を助けるほどの余裕はないんだ」
PRINTFORMW 「あぁああぁ嫌ぁあ……もう産みたくないぃぃ！」	PRINTFORMW 「あぁああぁ嫌ぁあ……もう産みたくないぃぃ！」
PRINTFORMW 「あハッ……はははっ、まぁたデキちゃったぁ♪」	PRINTFORMW 「あハッ……はははっ、まぁたデキちゃったぁ♪」
PRINTFORMW 「うぎいっぃいぃ！ひぎいぃぃぃぃぃっ！！……」	PRINTFORMW 「うぎいっぃいぃ！ひぎいぃぃぃぃぃっ！！……」
PRINTFORMW 「ひぃっ……胸が張って……まさか……母乳……」	PRINTFORMW 「ひぃっ……胸が張って……まさか……母乳……」
PRINTFORM 　苗床しきゅうっ赤ちゃん出していぐゅぅぅぅうっっ	PRINTFORM 　苗床しきゅうっ赤ちゃん出していぐゅぅぅぅうっっ
PRINTFORM 「やめてえええぇえあががあがあああぁッッ！！！」	PRINTFORM 「やめてえええぇえあががあがあああぁッッ！！！」
PRINTFORMDW 神奈子はうっとりとした表情で乳房を揉みしだき	PRINTFORMDW 神奈子はうっとりとした表情で乳房を揉みしだき
PRINTFORMW 「あぁぁあッ助けて………父上え゛え゛ぇぇッ！」	PRINTFORMW 「あぁぁあッ助けて………父上え゛え゛ぇぇッ！」
PRINTFORMW 「うぐ……休む時ぐらい、動くんじゃないよっ！」	PRINTFORMW 「うぐ……休む時ぐらい、動くんじゃないよっ！」
PRINTFORMW 「ふうああぁぁっ……悪いけど、見張りを頼むよ」	PRINTFORMW 「ふうああぁぁっ……悪いけど、見張りを頼むよ」
PRINTFORMW 「うぅうっ…すまない……頼りにしているよ……」	PRINTFORMW 「うぅうっ…すまない……頼りにしているよ……」
PRINTFORMW 「はぁっ…ふぅぅっ！…ここに居ては、ダメだ！」	PRINTFORMW 「はぁっ…ふぅぅっ！…ここに居ては、ダメだ！」
PRINTFORMW 「帝のヤツがカキ集めたんじゃなかったのか……」	PRINTFORMW 「帝のヤツがカキ集めたんじゃなかったのか……」
PRINTFORMW 「こういう所では、少しでも肌をかくしたいよね」	PRINTFORMW 「こういう所では、少しでも肌をかくしたいよね」
PRINTFORMW 「くっ！――この結果も、何時まで保つか……！」	PRINTFORMW 「くっ！――この結果も、何時まで保つか……！」
PRINTFORMW 「なんだこれは……まるで恐山の霊泉のようだ！」	PRINTFORMW 「なんだこれは……まるで恐山の霊泉のようだ！」
PRINTFORM 　おぉお、おんっばひら……こ…こわりぇちゃ……ッ	PRINTFORM 　おぉお、おんっばひら……こ…こわりぇちゃ……ッ
PRINTFORMW 「―――ああぁあぁ、もう嫌……嫌あぁあっ！！」	PRINTFORMW 「―――ああぁあぁ、もう嫌……嫌あぁあっ！！」
PRINTFORMDW 　―――――――　ドッビュっ！　――――――	PRINTFORMDW 　―――――――　ドッビュっ！　――――――
PRINTFORM 「おごおぉ！！？ おぶぅっ！ おぉっ、んぉおっ…	PRINTFORM 「おごおぉ！！？ おぶぅっ！ おぉっ、んぉおっ…
PRINTFORMW 「バカな！…閻魔までもが堕ちたというのか？！」	PRINTFORMW 「バカな！…閻魔までもが堕ちたというのか？！」
PRINTFORMW 「はっはっはっ……どこへ行こうと言うのだね」	PRINTFORMW 「はっはっはっ……どこへ行こうと言うのだね」
PRINTFORMW 「神祭『エクスパンデッド・オンバシラ』！！」	PRINTFORMW 「神祭『エクスパンデッド・オンバシラ』！！」
PRINTFORMW 「次は耳だ！(一度言ってみたかったんだよ)」	PRINTFORMW 「次は耳だ！(一度言ってみたかったんだよ)」
PRINTFORMW 「くぅぅッ！……こいつらの体液は、媚薬か！」	PRINTFORMW 「くぅぅッ！……こいつらの体液は、媚薬か！」
PRINTFORMW 「うぅ、ああっ！…敵の、目のまえなのにぃ！」	PRINTFORMW 「うぅ、ああっ！…敵の、目のまえなのにぃ！」
PRINTFORMW 「ぐっ！…肛門にねじ込まれては、たまらん！」	PRINTFORMW 「ぐっ！…肛門にねじ込まれては、たまらん！」
PRINTFORMW 「まずいっ！余計な弱点を作ってしまったか！」	PRINTFORMW 「まずいっ！余計な弱点を作ってしまったか！」
PRINTFORM 「かにゃこのスケベ豆ぇ、疼いて治まらないにょぉ	PRINTFORM 「かにゃこのスケベ豆ぇ、疼いて治まらないにょぉ
PRINTFORM 「ストリッパーみたいに、ゆっくり脱いであげるよ	PRINTFORM 「ストリッパーみたいに、ゆっくり脱いであげるよ
PRINTFORMW 「ううぁ……、これは…催眠誘…導……ｚｚｚ」	PRINTFORMW 「ううぁ……、これは…催眠誘…導……ｚｚｚ」
PRINTFORMW 「カナコ…お父上の、およめさんになるのー♪」	PRINTFORMW 「カナコ…お父上の、およめさんになるのー♪」
PRINTFORMW 「ぐぶっうぅう…おおぅぐっ！！(生臭い！)」	PRINTFORMW 「ぐぶっうぅう…おおぅぐっ！！(生臭い！)」
PRINTFORMW 「イタタッ……ばか者が！目を覚ますんだよ！」	PRINTFORMW 「イタタッ……ばか者が！目を覚ますんだよ！」
PRINTFORML 「まったく…ここに居ては坊主も邪淫になるわ」	PRINTFORML 「まったく…ここに居ては坊主も邪淫になるわ」
PRINTFORML 「―――へうぶぅうぁぎゃあぁあああっぁ！！！	PRINTFORML 「―――へうぶぅうぁぎゃあぁあああっぁ！！！
PRINTFORM 「ふっ…ふふ…こっちの穴も、いいもんだな…あッ	PRINTFORM 「ふっ…ふふ…こっちの穴も、いいもんだな…あッ
PRINTFORMW 「いいだろう、枯れるまで付き合ってやる……」	PRINTFORMW 「いいだろう、枯れるまで付き合ってやる……」
PRINTFORM 　いっぱいずぶずぶして、ザー汁絞りとってぇぇ…	PRINTFORM 　いっぱいずぶずぶして、ザー汁絞りとってぇぇ…
PRINTFORM 　お、おひりに、ずっぽりはいっひゃいまひたぁ…	PRINTFORM 　お、おひりに、ずっぽりはいっひゃいまひたぁ…
PRINTFORM 　えっちなかにゃこに、きもちいのちょうだいぃッ	PRINTFORM 　えっちなかにゃこに、きもちいのちょうだいぃッ
PRINTFORM 　意地悪しないでぇ…はやく、挿入ちょうらいぃぃ	PRINTFORM 　意地悪しないでぇ…はやく、挿入ちょうらいぃぃ
PRINTFORMW 「私に酷い事する気か！江口同人みたいに！！」	PRINTFORMW 「私に酷い事する気か！江口同人みたいに！！」
PRINTFORMW 「―――許せ早苗……もはや、お前は救えん！」	PRINTFORMW 「―――許せ早苗……もはや、お前は救えん！」
PRINTFORMW 「ひぃぃっ！……やだ……もう、許してぇ……」	PRINTFORMW 「ひぃぃっ！……やだ……もう、許してぇ……」
PRINTFORMW 「何を言っているんだ早苗ぇ！正気にお戻り！」	PRINTFORMW 「何を言っているんだ早苗ぇ！正気にお戻り！」
PRINTFORMW 「ぁぁあ早苗、なんて事だ……私の巫女が……」	PRINTFORMW 「ぁぁあ早苗、なんて事だ……私の巫女が……」
PRINTFORMW 「諏訪子…早苗……すまない……私はもう……」	PRINTFORMW 「諏訪子…早苗……すまない……私はもう……」
PRINTFORMW 「生まれた子が、処女を破っただとぉ？！……」	PRINTFORMW 「生まれた子が、処女を破っただとぉ？！……」
PRINTFORMW 「この異変の解決も、時間の問題かしらねぇ？」	PRINTFORMW 「この異変の解決も、時間の問題かしらねぇ？」
PRINTFORMW 「はあうぅうっ…うぐっ！…動、くなあぁッ！」	PRINTFORMW 「はあうぅうっ…うぐっ！…動、くなあぁッ！」
PRINTFORMDW ついに母乳を分泌し始めた自分の乳頭を目にし	PRINTFORMDW ついに母乳を分泌し始めた自分の乳頭を目にし
PRINTFORM 　かにゃこの淫乱乳袋、卵産みつけられて感じてる	PRINTFORM 　かにゃこの淫乱乳袋、卵産みつけられて感じてる
PRINTFORMW 「そろそろ寝ないとまずいね、交替で見張ろう」	PRINTFORMW 「そろそろ寝ないとまずいね、交替で見張ろう」
PRINTFORMW 「ふぅっ…ぐ……今の私は、足手まといか……」	PRINTFORMW 「ふぅっ…ぐ……今の私は、足手まといか……」
PRINTFORMW 「石橋は非破壊検査で調べてから渡る主義なの」	PRINTFORMW 「石橋は非破壊検査で調べてから渡る主義なの」
PRINTFORMW 「早苗が借りてきたホラー映画で使ってたわね」	PRINTFORMW 「早苗が借りてきたホラー映画で使ってたわね」
PRINTFORMW 「待っていろ、すぐに湯をわかしてやるからな」	PRINTFORMW 「待っていろ、すぐに湯をわかしてやるからな」
PRINTFORMW 「うえええっ…マズ過ぎて眠気が吹っ飛んだよ」	PRINTFORMW 「うえええっ…マズ過ぎて眠気が吹っ飛んだよ」
PRINTFORM 「？！しまった！これはスライｍ―――イヒィィッ	PRINTFORM 「？！しまった！これはスライｍ―――イヒィィッ
PRINTFORM （で、でも、あんなので滅茶苦茶にされたらぁ……	PRINTFORM （で、でも、あんなので滅茶苦茶にされたらぁ……
PRINTFORMW 「ふぐぅああぁあ？！やめ、やめてええぇえ！」	PRINTFORMW 「ふぐぅああぁあ？！やめ、やめてええぇえ！」
PRINTFORMW 「ぁぁあ…がはぁ……あ、あれ？…身体が……」	PRINTFORMW 「ぁぁあ…がはぁ……あ、あれ？…身体が……」
PRINTFORMW 「……そ、そうだ……奴らはスグには殺さない」	PRINTFORMW 「……そ、そうだ……奴らはスグには殺さない」
PRINTFORMW 「はッ！………集中してるんだ寝てないぞ！」	PRINTFORMW 「はッ！………集中してるんだ寝てないぞ！」
PRINTFORMW 「ハァッ…ハァッ！……これがダメなら……」	PRINTFORMW 「ハァッ…ハァッ！……これがダメなら……」
PRINTFORMW 「国津神が一柱……八坂神奈子！……参る！」	PRINTFORMW 「国津神が一柱……八坂神奈子！……参る！」
PRINTFORMW 「中は、子宮には挿れるなぁアアァッッ！！」	PRINTFORMW 「中は、子宮には挿れるなぁアアァッッ！！」
PRINTFORMW 「得体のしれない化け物を孕むよりましだ！」	PRINTFORMW 「得体のしれない化け物を孕むよりましだ！」
PRINTFORMW 「……？　まだ乾いてないのか、湿っている」	PRINTFORMW 「……？　まだ乾いてないのか、湿っている」
PRINTFORMW 「い、嫌だぁ！……そっちへ行くなあぁ！！」	PRINTFORMW 「い、嫌だぁ！……そっちへ行くなあぁ！！」
PRINTFORMW 「こにょアイスバー、おいひくないろぉぉ？」	PRINTFORMW 「こにょアイスバー、おいひくないろぉぉ？」
PRINTFORM 「はぁっ…あはぁぁああっ…も、辛抱たまらんっ	PRINTFORM 「はぁっ…あはぁぁああっ…も、辛抱たまらんっ
PRINTFORMW 「紛い物とはいえ、痛いものは痛いんだぞ！」	PRINTFORMW 「紛い物とはいえ、痛いものは痛いんだぞ！」
PRINTFORMW (どうして…痛いのに……痛いのにぃ～ッ！)	PRINTFORMW (どうして…痛いのに……痛いのにぃ～ッ！)
PRINTFORMW 「うぐぐぅっ！いい加減にしろ！ばか者が！」	PRINTFORMW 「うぐぐぅっ！いい加減にしろ！ばか者が！」
PRINTFORM 　もっとぉ、神の粥どぴゅどぴゅしゅるにょぉぉ	PRINTFORM 　もっとぉ、神の粥どぴゅどぴゅしゅるにょぉぉ
PRINTFORM 　おにゃにぃイグのぉぉ！とまんらいのぉぉおっ	PRINTFORM 　おにゃにぃイグのぉぉ！とまんらいのぉぉおっ
PRINTFORMDW その場に膝を付いて悶える事しかできない。	PRINTFORMDW その場に膝を付いて悶える事しかできない。
PRINTFORM 　おんばひらぁ……いれひゃへてくらひゃいぃ…	PRINTFORM 　おんばひらぁ……いれひゃへてくらひゃいぃ…
PRINTFORMW 「身体が、勝手にィィッ…イヤアァああッ！」	PRINTFORMW 「身体が、勝手にィィッ…イヤアァああッ！」
PRINTFORM 「はいぃ…かにゃこのデカ乳で奉仕いたしまひゅ	PRINTFORM 「はいぃ…かにゃこのデカ乳で奉仕いたしまひゅ
PRINTFORM 「ご主人様ぁ、どうぞ、おめしあがりくらはいぃ	PRINTFORM 「ご主人様ぁ、どうぞ、おめしあがりくらはいぃ
PRINTFORM 　ぎゅっぽぎゅっぽ！挿入れてくらひゃあぁあい	PRINTFORM 　ぎゅっぽぎゅっぽ！挿入れてくらひゃあぁあい
PRINTFORM 　かにゃこッ！チンポバカになりゅぅぅうぅｘッ	PRINTFORM 　かにゃこッ！チンポバカになりゅぅぅうぅｘッ
PRINTFORM 　クリぐりぐりされるのっしゅごぃぃよぉぉぉッ	PRINTFORM 　クリぐりぐりされるのっしゅごぃぃよぉぉぉッ
PRINTFORMW 「鉄火場で辱めを受けるのは初めてではない」	PRINTFORMW 「鉄火場で辱めを受けるのは初めてではない」
PRINTFORMW 「くっ！…こんな奴らに辱めを受けるとは！」	PRINTFORMW 「くっ！…こんな奴らに辱めを受けるとは！」
PRINTFORMW 「諏訪大戦を思い出す……燃えてきたぞっ！」	PRINTFORMW 「諏訪大戦を思い出す……燃えてきたぞっ！」
PRINTFORMW (私も、あっち側に……そうすれば楽に……)	PRINTFORMW (私も、あっち側に……そうすれば楽に……)
PRINTFORMDW 『泣かなくてもいいんですよ神奈子様……』	PRINTFORMDW 『泣かなくてもいいんですよ神奈子様……』
PRINTFORM 「しゅごいの、しゅごいのきひぇまひゅぅぅぅっ	PRINTFORM 「しゅごいの、しゅごいのきひぇまひゅぅぅぅっ
PRINTFORMW 「悪く思うな……調(みつぎ)だと思うんだ」	PRINTFORMW 「悪く思うな……調(みつぎ)だと思うんだ」
PRINTFORMW 「ケチケチしないで、さっさとよこすんだよ」	PRINTFORMW 「ケチケチしないで、さっさとよこすんだよ」
PRINTFORMW 「へうぅぅぐッ……くぅ、また孕んだか……」	PRINTFORMW 「へうぅぅぐッ……くぅ、また孕んだか……」
PRINTFORMW 「ひっひっふぅ～～！ひっひっふぅ～～～！」	PRINTFORMW 「ひっひっふぅ～～！ひっひっふぅ～～～！」
PRINTFORMW 「……すまない、少し気分がすぐれないんだ」	PRINTFORMW 「……すまない、少し気分がすぐれないんだ」
PRINTFORMW 「えぎぃぃ…ぅうっ……殺さ、なくては……」	PRINTFORMW 「えぎぃぃ…ぅうっ……殺さ、なくては……」
PRINTFORMW 「……今度は、腸(ハラワタ)の中にッ……」	PRINTFORMW 「……今度は、腸(ハラワタ)の中にッ……」
PRINTFORMW 「あっ…あぁぁ…………私……卵産んで……」	PRINTFORMW 「あっ…あぁぁ…………私……卵産んで……」
PRINTFORMDW 神奈子は半狂乱になって乳房を揉みしだくが	PRINTFORMDW 神奈子は半狂乱になって乳房を揉みしだくが
PRINTFORM 「おっぱいで産むなんて、気持ち良さそうだねぇ	PRINTFORM 「おっぱいで産むなんて、気持ち良さそうだねぇ
PRINTFORMW 「卵なんて産みたくない！乳首でなんて……」	PRINTFORMW 「卵なんて産みたくない！乳首でなんて……」
PRINTFORMW 「うぅ～ん、早苗の添い寝が恋しいよぉ……」	PRINTFORMW 「うぅ～ん、早苗の添い寝が恋しいよぉ……」
PRINTFORMW 「おうぅぐっ…少しだけ、休ませてくれ……」	PRINTFORMW 「おうぅぐっ…少しだけ、休ませてくれ……」
PRINTFORMW 「うぅうぅ……結界も、ろくに張れんとは！」	PRINTFORMW 「うぅうぅ……結界も、ろくに張れんとは！」
PRINTFORMW 「すまないね早苗…主柱として恥ずかしいよ」	PRINTFORMW 「すまないね早苗…主柱として恥ずかしいよ」
PRINTFORMW 「ごめんよ早苗…今の私は足手まといだ……」	PRINTFORMW 「ごめんよ早苗…今の私は足手まといだ……」
PRINTFORMW 「ふぐぅぅ……睡眠不足は美容の敵だよ……」	PRINTFORMW 「ふぐぅぅ……睡眠不足は美容の敵だよ……」
PRINTFORMW 「早苗と駐屯地祭に行った時、見たわね……」	PRINTFORMW 「早苗と駐屯地祭に行った時、見たわね……」
PRINTFORMW 「『汚物は、消毒だーー！！』だったかしら」	PRINTFORMW 「『汚物は、消毒だーー！！』だったかしら」
PRINTFORM 「い、今、捕まっちゃったら、ぐちゃぐちゃに…	PRINTFORM 「い、今、捕まっちゃったら、ぐちゃぐちゃに…
PRINTFORMW 「変態!!　変態!!　変態!!　変態!!」	PRINTFORMW 「変態!!　変態!!　変態!!　変態!!」
PRINTFORM 「おぉオンばひらァ、大きくなっひゃうからぁあ	PRINTFORM 「おぉオンばひらァ、大きくなっひゃうからぁあ
PRINTFORMW 「……うぅーん、他に着るものもないし……」	PRINTFORMW 「……うぅーん、他に着るものもないし……」
PRINTFORMW 「風呂って……これはザーメンじゃないか！」	PRINTFORMW 「風呂って……これはザーメンじゃないか！」
PRINTFORMW 「あの祟り神が……諏訪子が……ありえん！」	PRINTFORMW 「あの祟り神が……諏訪子が……ありえん！」
PRINTFORMW 「不覚……これではミイラ取りがミイラだぞ」	PRINTFORMW 「不覚……これではミイラ取りがミイラだぞ」
PRINTFORMW 「我ながら迂闊！……敵の戦力を見誤ったわ」	PRINTFORMW 「我ながら迂闊！……敵の戦力を見誤ったわ」
PRINTFORM 「くぅッ……この体で、逃げ切れるのか……」	PRINTFORM 「くぅッ……この体で、逃げ切れるのか……」
PRINTFORM 「い…今は……退かなくてはぁ……でもぉッッ	PRINTFORM 「い…今は……退かなくてはぁ……でもぉッッ
PRINTFORMW 「見せてあげよう……八坂のイカズチを！」	PRINTFORMW 「見せてあげよう……八坂のイカズチを！」
PRINTFORMW 「いざって時に弾切れは避けたいからねぇ」	PRINTFORMW 「いざって時に弾切れは避けたいからねぇ」
PRINTFORMW 「ひぃぅぐっ！……諏訪子……やめて……」	PRINTFORMW 「ひぃぅぐっ！……諏訪子……やめて……」
PRINTFORM 「今そこイかされたら……くるっちゃうからぁ	PRINTFORM 「今そこイかされたら……くるっちゃうからぁ
PRINTFORMW 「貴様らにくれてやるための穴ではない！」	PRINTFORMW 「貴様らにくれてやるための穴ではない！」
PRINTFORM 「お、オンバシラがエレクトしっぱなしでぇ…	PRINTFORM 「お、オンバシラがエレクトしっぱなしでぇ…
PRINTFORMW 「ちゃんと孕ませてくれなきゃ神罰だぞ？」	PRINTFORMW 「ちゃんと孕ませてくれなきゃ神罰だぞ？」
PRINTFORM 　ロリ体型の蛙なんかよりナイスボディだろう	PRINTFORM 　ロリ体型の蛙なんかよりナイスボディだろう
PRINTFORMW 「うぅぅっ！！……こんなやつらにぃ……」	PRINTFORMW 「うぅぅっ！！……こんなやつらにぃ……」
PRINTFORMW 「や、やめｒ……ンンンーーーーッ！！！」	PRINTFORMW 「や、やめｒ……ンンンーーーーッ！！！」
PRINTFORMW 「くっくっくっ！、どうだぁ、痛かろう？」	PRINTFORMW 「くっくっくっ！、どうだぁ、痛かろう？」
PRINTFORM 　その絶望に染まった表情、ゾクゾクするねぇ	PRINTFORM 　その絶望に染まった表情、ゾクゾクするねぇ
PRINTFORM 　ふふふっ、満足するまで付き合ってもらうぞ	PRINTFORM 　ふふふっ、満足するまで付き合ってもらうぞ
PRINTFORMW 「このっ！いい加減にしろ！ばかものが！」	PRINTFORMW 「このっ！いい加減にしろ！ばかものが！」
PRINTFORM 「んっくぅうう～～～～……はぁ、はぁぁんっ	PRINTFORM 「んっくぅうう～～～～……はぁ、はぁぁんっ
PRINTFORM 「かにゃこ触手しゃんたちの雌奴隷になりッッ	PRINTFORM 「かにゃこ触手しゃんたちの雌奴隷になりッッ
PRINTFORM 　こんにゃのらめぇぇええぇぇぇぇ～～～～っ	PRINTFORM 　こんにゃのらめぇぇええぇぇぇぇ～～～～っ
PRINTFORM 「あ、うぅぅぐ…くそ……何故私はこんな……	PRINTFORM 「あ、うぅぅぐ…くそ……何故私はこんな……
PRINTFORM 　かにゃこのバカマンッ！いっぢゃううぅぅッ	PRINTFORM 　かにゃこのバカマンッ！いっぢゃううぅぅッ
PRINTFORM 　敏ッ感ッおっぱいにぃ……気持ちいのきたぁ	PRINTFORM 　敏ッ感ッおっぱいにぃ……気持ちいのきたぁ
PRINTFORM 　そんなぁっそんなぁあぁああ゛ぁ゛ぁ゛ッッ	PRINTFORM 　そんなぁっそんなぁあぁああ゛ぁ゛ぁ゛ッッ
PRINTFORMW 「抵抗しないから……乱暴しないでぇッッ」	PRINTFORMW 「抵抗しないから……乱暴しないでぇッッ」
PRINTFORMW 「うぅぐっ！……二人とも…どうして……」	PRINTFORMW 「うぅぐっ！……二人とも…どうして……」
PRINTFORMW 「くっ！…どこまでも追ってくるつもりか」	PRINTFORMW 「くっ！…どこまでも追ってくるつもりか」
PRINTFORMW 「―――こんな形で、守矢が終わるとは！」	PRINTFORMW 「―――こんな形で、守矢が終わるとは！」
PRINTFORMW 「うぅぅ……諏訪子…何故そこまで私をッ」	PRINTFORMW 「うぅぅ……諏訪子…何故そこまで私をッ」
PRINTFORMW 「……だめ……こんなの……諦めるしか！」	PRINTFORMW 「……だめ……こんなの……諦めるしか！」
PRINTFORMW 「……“根の国に”たたき返してくれよう」	PRINTFORMW 「……“根の国に”たたき返してくれよう」
PRINTFORMDW 『ケロケロ……神奈子みぃつけたぁ……』	PRINTFORMDW 『ケロケロ……神奈子みぃつけたぁ……』
PRINTFORMW 「守矢諏訪子……その姿、見るに耐えんぞ」	PRINTFORMW 「守矢諏訪子……その姿、見るに耐えんぞ」
PRINTFORMW 「……お前の“最後”は早苗には話さない」	PRINTFORMW 「……お前の“最後”は早苗には話さない」
PRINTFORMW 「お前は、竹林の薬師……その姿は……！」	PRINTFORMW 「お前は、竹林の薬師……その姿は……！」
PRINTFORMW 「――や、やだ…こっちへ来ないで！……」	PRINTFORMW 「――や、やだ…こっちへ来ないで！……」
PRINTFORM 「ううぅぁぁ…見るなぁ……見ないでよぉぉっ	PRINTFORM 「ううぅぁぁ…見るなぁ……見ないでよぉぉっ
PRINTFORMW 「八坂神奈子……この恩は、一生忘れぬ！」	PRINTFORMW 「八坂神奈子……この恩は、一生忘れぬ！」
PRINTFORMW 「大丈夫だよ早苗、私がついているからね」	PRINTFORMW 「大丈夫だよ早苗、私がついているからね」
PRINTFORM 　かにゃこの苗床子宮、種付けされて喜んでる	PRINTFORM 　かにゃこの苗床子宮、種付けされて喜んでる
PRINTFORMW 「あぁあ…大きくなって……もう嫌あぁ！」	PRINTFORMW 「あぁあ…大きくなって……もう嫌あぁ！」
PRINTFORMW 「うっぷっ！…なんだ、この不快感は……」	PRINTFORMW 「うっぷっ！…なんだ、この不快感は……」
PRINTFORMW 「は…ははっ……堕ろして、やったぞ……」	PRINTFORMW 「は…ははっ……堕ろして、やったぞ……」
PRINTFORMW 「あはは……はやく、産まれておいで……」	PRINTFORMW 「あはは……はやく、産まれておいで……」
PRINTFORMW 「は、はやく……出ておいで……私の子！」	PRINTFORMW 「は、はやく……出ておいで……私の子！」
PRINTFORMW 「…うっぐ！……これは、まさか本当に！」	PRINTFORMW 「…うっぐ！……これは、まさか本当に！」
PRINTFORMW 「いぃぃ…嫌あぁ……出てこないでぇッ！」	PRINTFORMW 「いぃぃ…嫌あぁ……出てこないでぇッ！」
PRINTFORMW 「これ以上、……奴らを増やしては……！」	PRINTFORMW 「これ以上、……奴らを増やしては……！」
PRINTFORML 「いいぎぎいぃっ！嫌っ…嫌あぁあぁっ！」	PRINTFORML 「いいぎぎいぃっ！嫌っ…嫌あぁあぁっ！」
PRINTFORML 「殺して…やるっ！……殺してやるぅっ！」	PRINTFORML 「殺して…やるっ！……殺してやるぅっ！」
PRINTFORMW 「いいぎぎいぃっ！嫌っ…嫌あぁあぁっ！」	PRINTFORMW 「いいぎぎいぃっ！嫌っ…嫌あぁあぁっ！」
PRINTFORMW 「――くそっ、蛇や蛙じゃないんだよッ！」	PRINTFORMW 「――くそっ、蛇や蛙じゃないんだよッ！」
PRINTFORMW 「産みたくない！産卵なんてダメぇえっ！」	PRINTFORMW 「産みたくない！産卵なんてダメぇえっ！」
PRINTFORMW 「ああぁあ…胸の中に……卵がぁッッ！！」	PRINTFORMW 「ああぁあ…胸の中に……卵がぁッッ！！」
PRINTFORMW 「こんなのっ嫌！……嫌ああぁぁ…ッッ…」	PRINTFORMW 「こんなのっ嫌！……嫌ああぁぁ…ッッ…」
PRINTFORMW 「一時間したら…起こ…し…………ｚｚｚ」	PRINTFORMW 「一時間したら…起こ…し…………ｚｚｚ」
PRINTFORMW 「何時間かしたら起こすよ、交替で眠ろう」	PRINTFORMW 「何時間かしたら起こすよ、交替で眠ろう」
PRINTFORMW 「早苗がアニメ見ながら叫んでたわね……」	PRINTFORMW 「早苗がアニメ見ながら叫んでたわね……」
PRINTFORMW 「『遊星からの物体Ｘ』だったかしら……」	PRINTFORMW 「『遊星からの物体Ｘ』だったかしら……」
PRINTFORMW 「――これは…ヒヒイロカネじゃないか！」	PRINTFORMW 「――これは…ヒヒイロカネじゃないか！」
PRINTFORMW 「30秒(1ターン)だけ待ってやる！」	PRINTFORMW 「30秒(1ターン)だけ待ってやる！」
PRINTFORMW 「伊達に軍神なんて名乗ってないんだよ」	PRINTFORMW 「伊達に軍神なんて名乗ってないんだよ」
PRINTFORMW 「貴様らにくれてやる体など持たぬわ！」	PRINTFORMW 「貴様らにくれてやる体など持たぬわ！」
PRINTFORMW 「…ううっ……手の震えが、止まらんッ」	PRINTFORMW 「…ううっ……手の震えが、止まらんッ」
PRINTFORMW 「頭が高い、這い蹲ってりゃいいんだよ」	PRINTFORMW 「頭が高い、這い蹲ってりゃいいんだよ」
PRINTFORMW (頭の中が……溶けていくようだ……)」	PRINTFORMW (頭の中が……溶けていくようだ……)」
PRINTFORM 　いっぱい気持ちよくしてクりゃしゃいィィ	PRINTFORM 　いっぱい気持ちよくしてクりゃしゃいィィ
PRINTFORM 　いましゃれたらぁ、イキ死んじゃうのぉぉ	PRINTFORM 　いましゃれたらぁ、イキ死んじゃうのぉぉ
PRINTFORM はらわた、ほじくりまわしてくりゃしゃぃぃ	PRINTFORM はらわた、ほじくりまわしてくりゃしゃぃぃ
PRINTFORM 「かにゃこの淫乱おっぱい、はやく虐めてぇ	PRINTFORM 「かにゃこの淫乱おっぱい、はやく虐めてぇ
PRINTFORMW 「そろそろ注連縄を交換しなくては……」	PRINTFORMW 「そろそろ注連縄を交換しなくては……」
PRINTFORMW 「さぁ信徒の皆さん、下着を脱ぎなさい」	PRINTFORMW 「さぁ信徒の皆さん、下着を脱ぎなさい」
PRINTFORML 「はぁ…あははァッ！観念するんだよ！」	PRINTFORML 「はぁ…あははァッ！観念するんだよ！」
PRINTFORM 「…抵抗したら、それだけ苦しいだけだぞ？	PRINTFORM 「…抵抗したら、それだけ苦しいだけだぞ？
PRINTFORM 　ほら、さっさと生まれたママの姿におなり	PRINTFORM 　ほら、さっさと生まれたママの姿におなり
PRINTFORM 「それでは、続きを楽しませてもらおうねぇ	PRINTFORM 「それでは、続きを楽しませてもらおうねぇ
PRINTFORMW (ううぅっっ！割れ目が焼けるようだ！)	PRINTFORMW (ううぅっっ！割れ目が焼けるようだ！)
PRINTFORMW (初物のクセに！なんて締め付けだよ！)	PRINTFORMW (初物のクセに！なんて締め付けだよ！)
PRINTFORMW (絞り…取られるっ！)2830, 2)	PRINTFORMW (絞り…取られるっ！)2830, 2)
PRINTFORMW 「ひぃいっ！や、もういやあぁぁああ！」	PRINTFORMW 「ひぃいっ！や、もういやあぁぁああ！」
PRINTFORMW 「うああぁ、やめ！…もうやめてぇ！！」	PRINTFORMW 「うああぁ、やめ！…もうやめてぇ！！」
PRINTFORM 「さぁさぁ、遠慮せずにたっぷり出すがいい	PRINTFORM 「さぁさぁ、遠慮せずにたっぷり出すがいい
PRINTFORMW 　はははっ！堪え性ないじゃないかっ！」	PRINTFORMW 　はははっ！堪え性ないじゃないかっ！」
PRINTFORMW はその行の左にある「;」を消しましょう	PRINTFORMW はその行の左にある「;」を消しましょう
PRINTFORMW 「ひぐぉあぁあッ！！……あ、がっ……」	PRINTFORMW 「ひぐぉあぁあッ！！……あ、がっ……」
PRINTFORMDL 猛烈な苦痛が、一撃で神奈子を沈める。	PRINTFORMDL 猛烈な苦痛が、一撃で神奈子を沈める。
PRINTFORM 「ばかな！……見ただけで子宮が…ひぃぃっ	PRINTFORM 「ばかな！……見ただけで子宮が…ひぃぃっ
PRINTFORM 　おなか、たぷたぷになるまでそそがれてっ	PRINTFORM 　おなか、たぷたぷになるまでそそがれてっ
PRINTFORM 　おひんひんっ！わらひ、らめなのぉぉ！！	PRINTFORM 　おひんひんっ！わらひ、らめなのぉぉ！！
PRINTFORM 「おっおんばひらぁ！　もっと…いぢめてぇ	PRINTFORM 「おっおんばひらぁ！　もっと…いぢめてぇ
PRINTFORM 　もっとかにゃこを、いじめてくらひゃいぃ	PRINTFORM 　もっとかにゃこを、いじめてくらひゃいぃ
PRINTFORM 「はやくッ射乳したくてぇぇ疼くんれすぅう	PRINTFORM 「はやくッ射乳したくてぇぇ疼くんれすぅう
PRINTFORM ？！　おぉおぉッ…オンッバシラアァッァッ	PRINTFORM ？！　おぉおぉッ…オンッバシラアァッァッ
PRINTFORM 「種付け、凄…お゛ぉぉぉお゛おんんッッ…	PRINTFORM 「種付け、凄…お゛ぉぉぉお゛おんんッッ…
PRINTFORM 「うあぁぁ服が…(このまま、犯されて……	PRINTFORM 「うあぁぁ服が…(このまま、犯されて……
PRINTFORMW 「ふんっ、この方が返って動きやすいわ」	PRINTFORMW 「ふんっ、この方が返って動きやすいわ」
PRINTFORMW 「あぁああ…やだぁ……もうやめてぇ！」	PRINTFORMW 「あぁああ…やだぁ……もうやめてぇ！」
PRINTFORMW 『あっははは……見つけたよ、『私』…』	PRINTFORMW 『あっははは……見つけたよ、『私』…』
PRINTFORMW 「外の世界でも……この幻想郷でも……」	PRINTFORMW 「外の世界でも……この幻想郷でも……」
PRINTFORMW 「ふふっ…見た顔がいると思ったら……」	PRINTFORMW 「ふふっ…見た顔がいると思ったら……」
PRINTFORMW 「応援を連れて、必ず助けに来るから！」	PRINTFORMW 「応援を連れて、必ず助けに来るから！」
PRINTFORMW 「お前なら、耐えられると信じている！」	PRINTFORMW 「お前なら、耐えられると信じている！」
PRINTFORMW 「悪いね早苗、ちゃんと役立てるからね」	PRINTFORMW 「悪いね早苗、ちゃんと役立てるからね」
PRINTFORMW 「うむ、いい心がけです(外交モード)」	PRINTFORMW 「うむ、いい心がけです(外交モード)」
PRINTFORMW 「言うな諏訪子、今はお前が頼りだ……」	PRINTFORMW 「言うな諏訪子、今はお前が頼りだ……」
PRINTFORMW 「へげあああががっ……あっぁあああ…」	PRINTFORMW 「へげあああががっ……あっぁあああ…」
PRINTFORMW 「……気分が悪い…毒でも盛られたか？」	PRINTFORMW 「……気分が悪い…毒でも盛られたか？」
PRINTFORMW 「出てきちゃ、だめっっ！……嫌ぁ……」	PRINTFORMW 「出てきちゃ、だめっっ！……嫌ぁ……」
PRINTFORM 　かにゃこのケツマンコ、卵抱えて悦んでる	PRINTFORM 　かにゃこのケツマンコ、卵抱えて悦んでる
PRINTFORMW 「まさか……胸に産みつけられた…？！」	PRINTFORMW 「まさか……胸に産みつけられた…？！」
PRINTFORMW 「……今度は、乳房の中にまでぇッ……」	PRINTFORMW 「……今度は、乳房の中にまでぇッ……」
PRINTFORMW 「あぁあ…胸の中で蠢いて……嫌あぁ！」	PRINTFORMW 「あぁあ…胸の中で蠢いて……嫌あぁ！」
PRINTFORMW 「ひぐぅうぁああがあああぁッッ！！！」	PRINTFORMW 「ひぐぅうぁああがあああぁッッ！！！」
PRINTFORMW 「八坂の神風に、なぎ倒されるがいい…」	PRINTFORMW 「八坂の神風に、なぎ倒されるがいい…」
PRINTFORMDW 『ふん、足手まといは置いてくわよ？』	PRINTFORMDW 『ふん、足手まといは置いてくわよ？』
PRINTFORMW 「…もう、余裕がないというのに……！」	PRINTFORMW 「…もう、余裕がないというのに……！」
PRINTFORMW 「くっ…休みたいが、ここは気が向かん」	PRINTFORMW 「くっ…休みたいが、ここは気が向かん」
PRINTFORMW (今は危ないのに…声が出ちゃうぅっ！)	PRINTFORMW (今は危ないのに…声が出ちゃうぅっ！)
PRINTFORMW 「これで身動きできなくするんだね……」	PRINTFORMW 「これで身動きできなくするんだね……」
PRINTFORMW 「もう一杯～～～っ……って古かった？」	PRINTFORMW 「もう一杯～～～っ……って古かった？」
PRINTFORMW 「石橋を渡るなら非破壊検査してからだ」	PRINTFORMW 「石橋を渡るなら非破壊検査してからだ」
PRINTFORMW 　く、くそっ！こんな所で素っ裸とは！」	PRINTFORMW 　く、くそっ！こんな所で素っ裸とは！」
PRINTFORM 　おお、お豆ぇ……痺れが…取れないよぉっ	PRINTFORM 　おお、お豆ぇ……痺れが…取れないよぉっ
PRINTFORM 「びゅーびゅー射精でイッちゃぅのぉぉぉっ	PRINTFORM 「びゅーびゅー射精でイッちゃぅのぉぉぉっ
PRINTFORM 　気持ちよすぎて……立ってられにゃいよぉ	PRINTFORM 　気持ちよすぎて……立ってられにゃいよぉ
PRINTFORM 　奥までっ！どぴゅどぴゅ注がれてるよぉぉ	PRINTFORM 　奥までっ！どぴゅどぴゅ注がれてるよぉぉ
PRINTFORM 　おんばひら…えれくてっとしちゃうのぉぉ	PRINTFORM 　おんばひら…えれくてっとしちゃうのぉぉ
PRINTFORMW 「うぅ……そんな……この髪飾りは……」	PRINTFORMW 「うぅ……そんな……この髪飾りは……」
PRINTFORMDW ここ最近、幻想郷で多発する失踪事件。	PRINTFORMDW ここ最近、幻想郷で多発する失踪事件。
PRINTFORM 　かにゃこおっぱいぃぃりゃめなのぉぉぉっ	PRINTFORM 　かにゃこおっぱいぃぃりゃめなのぉぉぉっ
PRINTFORM 「神奈子の乳首っ奥まで入っちゃってるよぉ	PRINTFORM 「神奈子の乳首っ奥まで入っちゃってるよぉ
PRINTFORMW 「ふふ、私はこっちだぞ、追って来い」	PRINTFORMW 「ふふ、私はこっちだぞ、追って来い」
PRINTFORM 「猪武者だけが兵(ツワモノ)ではない」	PRINTFORM 「猪武者だけが兵(ツワモノ)ではない」
PRINTFORM 「戦う事も…逃げる事もできんのか……」	PRINTFORM 「戦う事も…逃げる事もできんのか……」
PRINTFORMW 「くぅ！……身体がいう事を聞かん！」	PRINTFORMW 「くぅ！……身体がいう事を聞かん！」
PRINTFORMW 「弾幕も戦も派手な方がいいだろう？」	PRINTFORMW 「弾幕も戦も派手な方がいいだろう？」
PRINTFORMW 「神符『神が歩かれた御神渡り』！！」	PRINTFORMW 「神符『神が歩かれた御神渡り』！！」
PRINTFORMW 「オンバシラをもう一本くれてやろう」	PRINTFORMW 「オンバシラをもう一本くれてやろう」
PRINTFORMW 「はぁ……はぁっ……くそ、当たれ！」	PRINTFORMW 「はぁ……はぁっ……くそ、当たれ！」
PRINTFORMW 「化生共め、根の国へ叩き返してやる」	PRINTFORMW 「化生共め、根の国へ叩き返してやる」
PRINTFORMW 「このっ、離せっ！…汚らわしい！！」	PRINTFORMW 「このっ、離せっ！…汚らわしい！！」
PRINTFORM 　な、なんとか力を集中しないと…ひぃぃ	PRINTFORM 　な、なんとか力を集中しないと…ひぃぃ
PRINTFORMW 「くっ、くそぉ！…そこは触るなぁ！」	PRINTFORMW 「くっ、くそぉ！…そこは触るなぁ！」
PRINTFORM 　がぁっがにゃごぉぉのッぉぉんばっひぁ	PRINTFORM 　がぁっがにゃごぉぉのッぉぉんばっひぁ
PRINTFORM 「私の事にもっとヌチョヌチョちょうだい	PRINTFORM 「私の事にもっとヌチョヌチョちょうだい
PRINTFORMW 「お、こんな所にチューペットが……」	PRINTFORMW 「お、こんな所にチューペットが……」
PRINTFORMW 「んっちゅ、んっちゅ…んんんーー？」	PRINTFORMW 「んっちゅ、んっちゅ…んんんーー？」
PRINTFORMW 「うわぁ！…ば、ばか！正気に戻……」	PRINTFORMW 「うわぁ！…ば、ばか！正気に戻……」
PRINTFORM 「ははははぁ、最高に具合がいいぞおぉ…	PRINTFORM 「ははははぁ、最高に具合がいいぞおぉ…
PRINTFORM 　ほら、ほらぁ！もっと腰を振るんだよぉ	PRINTFORM 　ほら、ほらぁ！もっと腰を振るんだよぉ
PRINTFORM 　オナゴ同士というのも、悪くないだろう	PRINTFORM 　オナゴ同士というのも、悪くないだろう
PRINTFORMW 「うぅぅっ、やめろ……やめてくれっ」	PRINTFORMW 「うぅぅっ、やめろ……やめてくれっ」
PRINTFORM 　普段の服より、その方が似合っているぞ	PRINTFORM 　普段の服より、その方が似合っているぞ
PRINTFORM 　常に私のオンバシラを信仰していなさい	PRINTFORM 　常に私のオンバシラを信仰していなさい
PRINTFORMW 「何故、仲間からこんな仕打ちを…！」	PRINTFORMW 「何故、仲間からこんな仕打ちを…！」
PRINTFORM 「ああぁ～～おんばひらビンビンッってぇ	PRINTFORM 「ああぁ～～おんばひらビンビンッってぇ
PRINTFORMW （うぐっあ、我慢……できないぃっ！）	PRINTFORMW （うぐっあ、我慢……できないぃっ！）
PRINTFORM 　この程度で屈服などおっぉおほぉぉんっ	PRINTFORM 　この程度で屈服などおっぉおほぉぉんっ
PRINTFORMW 「よ、よせぇ…おしりで、なんてぇ…」	PRINTFORMW 「よ、よせぇ…おしりで、なんてぇ…」
PRINTFORM 「お、おひりにっ、じゅぼじゅぼされひゃ	PRINTFORM 「お、おひりにっ、じゅぼじゅぼされひゃ
PRINTFORML 「や、やめろぉお…胸はあぁあぁッ！」	PRINTFORML 「や、やめろぉお…胸はあぁあぁッ！」
PRINTFORM 　淫乱おっぱい一杯いぢめてくらひゃいぃ	PRINTFORM 　淫乱おっぱい一杯いぢめてくらひゃいぃ
PRINTFORM 「…じゅぶじゅぶひて、ほしいんれすぅっ	PRINTFORM 「…じゅぶじゅぶひて、ほしいんれすぅっ
PRINTFORM 　おねがいひまふっ、いれてくらさぁいっ	PRINTFORM 　おねがいひまふっ、いれてくらさぁいっ
PRINTFORM 　ひぎいぃぃッ！ダメだ、こんなことおぉ	PRINTFORM 　ひぎいぃぃッ！ダメだ、こんなことおぉ
PRINTFORM 　しゅぐイッぢゃうぅんんぁぁあ゛あ゛っ	PRINTFORM 　しゅぐイッぢゃうぅんんぁぁあ゛あ゛っ
PRINTFORM 　かにゃこのお豆ぇ、悪い子なんれしゅぅ	PRINTFORM 　かにゃこのお豆ぇ、悪い子なんれしゅぅ
PRINTFORM 　だからぁ、もっと御仕置きしてえぇぇッ	PRINTFORM 　だからぁ、もっと御仕置きしてえぇぇッ
PRINTFORMW 「うぅぅ……足りない……切ないよぉ」	PRINTFORMW 「うぅぅ……足りない……切ないよぉ」
PRINTFORMW 「だが、相手がコイツらでは……ッ！」	PRINTFORMW 「だが、相手がコイツらでは……ッ！」
PRINTFORMW 「嫌あア゛ァッッ！もうやめてぇ！！」	PRINTFORMW 「嫌あア゛ァッッ！もうやめてぇ！！」
PRINTFORMW 「ちぃっ…お気に入りの服だったのに」	PRINTFORMW 「ちぃっ…お気に入りの服だったのに」
PRINTFORMW 「私の巫女が……なんて様だよッ…！」	PRINTFORMW 「私の巫女が……なんて様だよッ…！」
PRINTFORMDW 『神奈子さま……みぃつけたぁ……』	PRINTFORMDW 『神奈子さま……みぃつけたぁ……』
PRINTFORMW 「………我が名は……八坂・神奈子！」	PRINTFORMW 「………我が名は……八坂・神奈子！」
PRINTFORMW 「諏訪子……？その姿は……まさか！」	PRINTFORMW 「諏訪子……？その姿は……まさか！」
PRINTFORMDL 『天津神が一柱……八意思兼神……』	PRINTFORMDL 『天津神が一柱……八意思兼神……』
PRINTFORMW 「撤退成功……次は、こうはいかんぞ」	PRINTFORMW 「撤退成功……次は、こうはいかんぞ」
PRINTFORMW 「犯されて孕まされた……それだけだ」	PRINTFORMW 「犯されて孕まされた……それだけだ」
PRINTFORMW 「私を信じるものは救われちゃう……」	PRINTFORMW 「私を信じるものは救われちゃう……」
PRINTFORMW 「あいつらの、一部が……あぁぁッ！」	PRINTFORMW 「あいつらの、一部が……あぁぁッ！」
PRINTFORMW 「――妊娠の初期兆候？……まさかな」	PRINTFORMW 「――妊娠の初期兆候？……まさかな」
PRINTFORMW 「本当に……孕んだのか……私が？！」	PRINTFORMW 「本当に……孕んだのか……私が？！」
PRINTFORM 「化け物なんかに、授乳しゃせられてぇっ	PRINTFORM 「化け物なんかに、授乳しゃせられてぇっ
PRINTFORMDW 【気丈】【プライド高い】を失った。	PRINTFORMDW 【気丈】【プライド高い】を失った。
PRINTFORMW 「ふうああぁぁっ……先に休むよ……」	PRINTFORMW 「ふうああぁぁっ……先に休むよ……」
PRINTFORMW 「くそ……休める場所をつくらねば…」	PRINTFORMW 「くそ……休める場所をつくらねば…」
PRINTFORMDW 『…ちょっと神奈子、大丈夫なの？』	PRINTFORMDW 『…ちょっと神奈子、大丈夫なの？』
PRINTFORMW 「どこかに、休める場所はないか…！」	PRINTFORMW 「どこかに、休める場所はないか…！」
PRINTFORMW 「おっと、『責めて』だったかねぇ？」	PRINTFORMW 「おっと、『責めて』だったかねぇ？」
PRINTFORMW 「ふふっ……背中を流してやろう……」	PRINTFORMW 「ふふっ……背中を流してやろう……」
PRINTFORM 「かにゃこ搾っ乳っ！即イきなのぉぉぉっ	PRINTFORM 「かにゃこ搾っ乳っ！即イきなのぉぉぉっ
PRINTFORML 「え、っちょ！それは服なんかじゃ…」	PRINTFORML 「え、っちょ！それは服なんかじゃ…」
PRINTFORML 　あぁ…あぁああ……これ、内側が…」	PRINTFORML 　あぁ…あぁああ……これ、内側が…」
PRINTFORM 　敏っ感しゅぎて、破裂しちゃうぅぅうっ	PRINTFORM 　敏っ感しゅぎて、破裂しちゃうぅぅうっ
PRINTFORM 　ますます、ギンギンになっちゃったよぉ	PRINTFORM 　ますます、ギンギンになっちゃったよぉ
PRINTFORMW 「こんなものに入るわけ――ひぃ！？」	PRINTFORMW 「こんなものに入るわけ――ひぃ！？」
PRINTFORML 乳房妊娠しゃしぇてくりゃしゃいぃぃっ	PRINTFORML 乳房妊娠しゃしぇてくりゃしゃいぃぃっ
PRINTFORMW 「この守り、そうそう崩せるものか」	PRINTFORMW 「この守り、そうそう崩せるものか」
PRINTFORM 「我が名は八坂！逃げも隠れもせぬ！」	PRINTFORM 「我が名は八坂！逃げも隠れもせぬ！」
PRINTFORMW ……ッは！違う…これは作戦だ！！」	PRINTFORMW ……ッは！違う…これは作戦だ！！」
PRINTFORMW 　(……これ、気持ちいんだよぉ)」	PRINTFORMW 　(……これ、気持ちいんだよぉ)」
PRINTFORMW 「これで……倒れてくれぇっ……！」	PRINTFORMW 「これで……倒れてくれぇっ……！」
PRINTFORMW 「神符『水眼の如き美しき源泉』！」	PRINTFORMW 「神符『水眼の如き美しき源泉』！」
PRINTFORMW 「『マウンテンオブフェイス』！！」	PRINTFORMW 「『マウンテンオブフェイス』！！」
PRINTFORMW 「こういう弾幕も悪くないだろう？」	PRINTFORMW 「こういう弾幕も悪くないだろう？」
PRINTFORMW 「ぅううぅ……(刃こぼれが……)」	PRINTFORMW 「ぅううぅ……(刃こぼれが……)」
PRINTFORMW 「得物の柄を握るのは久しぶりだよ」	PRINTFORMW 「得物の柄を握るのは久しぶりだよ」
PRINTFORMW 「ぐふぅう……(身体が持たん！)」	PRINTFORMW 「ぐふぅう……(身体が持たん！)」
PRINTFORM 　なん…とか……抜けださ……ないとぉ	PRINTFORM 　なん…とか……抜けださ……ないとぉ
PRINTFORMW 「ううぅぐ、早苗……どうして……」	PRINTFORMW 「ううぅぐ、早苗……どうして……」
PRINTFORM 　かにゃこおっぱい、らめえなのぉぉっ	PRINTFORM 　かにゃこおっぱい、らめえなのぉぉっ
PRINTFORMW 「…女裂を辱められるくらいならっ」	PRINTFORMW 「…女裂を辱められるくらいならっ」
PRINTFORM 　にゃかにぃ、にゃかにくりゃしゃぃっ	PRINTFORM 　にゃかにぃ、にゃかにくりゃしゃぃっ
PRINTFORMW 「跡形もなく吹き飛ばしてやる！！」	PRINTFORMW 「跡形もなく吹き飛ばしてやる！！」
PRINTFORML 「ばかものが！目を覚ますんだよ！」	PRINTFORML 「ばかものが！目を覚ますんだよ！」
PRINTFORM 　このオンバシラで、たぁっぷりとなぁ	PRINTFORM 　このオンバシラで、たぁっぷりとなぁ
PRINTFORM 「はははっ！そんなに触手がよかったか	PRINTFORM 「はははっ！そんなに触手がよかったか
PRINTFORMW 「よせ、やめろっ……やめろぉっ！」	PRINTFORMW 「よせ、やめろっ……やめろぉっ！」
PRINTFORM 「ふふっ…、ようやく大人しくなったか	PRINTFORM 「ふふっ…、ようやく大人しくなったか
PRINTFORMW 「ぎひぃっ！！いいぎいいッッ！！」	PRINTFORMW 「ぎひぃっ！！いいぎいいッッ！！」
PRINTFORMW 「ひいいぃぃああっ！もうやだぁ！」	PRINTFORMW 「ひいいぃぃああっ！もうやだぁ！」
PRINTFORM 「出るッ……でるぅ！射精しちゃッ……	PRINTFORM 「出るッ……でるぅ！射精しちゃッ……
PRINTFORM オンバシラ……戻らなくなっちゃったぁ	PRINTFORM オンバシラ……戻らなくなっちゃったぁ
PRINTFORM 　もっろイかせて、ぶっ壊れるまでぇっ	PRINTFORM 　もっろイかせて、ぶっ壊れるまでぇっ
PRINTFORM 　イきまきゅっひゃいまひゅぅぅぅぅっ	PRINTFORM 　イきまきゅっひゃいまひゅぅぅぅぅっ
PRINTFORM 　もっろきもひよくひてくらさぁぁいっ	PRINTFORM 　もっろきもひよくひてくらさぁぁいっ
PRINTFORM 「ひきたくなっ、ひきたくないよぉぉっ	PRINTFORM 「ひきたくなっ、ひきたくないよぉぉっ
PRINTFORM 　おおおっ！おんばひらぁ！いぎいぃい	PRINTFORM 　おおおっ！おんばひらぁ！いぎいぃい
PRINTFORM 　かにゃこぉ、いいこにしゅるからぁっ	PRINTFORM 　かにゃこぉ、いいこにしゅるからぁっ
PRINTFORM 　おまんこっ、こすこすしゃれてぇぇっ	PRINTFORM 　おまんこっ、こすこすしゃれてぇぇっ
PRINTFORM 「ふふっ、まら、いれちゃらめれすよぉ	PRINTFORM 「ふふっ、まら、いれちゃらめれすよぉ
PRINTFORM 　おのりぇぇ……おのりぇぇぇ～～ッッ	PRINTFORM 　おのりぇぇ……おのりぇぇぇ～～ッッ
PRINTFORM 　ふといの、わらッひのっおまんこにぃ	PRINTFORM 　ふといの、わらッひのっおまんこにぃ
PRINTFORM 　淫乱神奈子に、御仕置きくらひゃいっ	PRINTFORM 　淫乱神奈子に、御仕置きくらひゃいっ
PRINTFORM 　かにゃこのぉぉッッミルクタンクぅぅ	PRINTFORM 　かにゃこのぉぉッッミルクタンクぅぅ
PRINTFORM 　はやく……はやくぶち抜いてェェッ！	PRINTFORM 　はやく……はやくぶち抜いてェェッ！
PRINTFORM 　ちんぽ……チンポらめェええぇえ！！	PRINTFORM 　ちんぽ……チンポらめェええぇえ！！
PRINTFORM 　このっ触手のくしぇに焦らすなんてぇ	PRINTFORM 　このっ触手のくしぇに焦らすなんてぇ
PRINTFORM 　なんで、感じてッ？！…いやあぁぁあ	PRINTFORM 　なんで、感じてッ？！…いやあぁぁあ
PRINTFORM 「あ…やめぇ……今、脱がさないでぇ！	PRINTFORM 「あ…やめぇ……今、脱がさないでぇ！
PRINTFORMW 「こんな所でイかされてたまるか！」	PRINTFORMW 「こんな所でイかされてたまるか！」
PRINTFORMW 「ぐハァッ！　ぬ、ぬかったわ……」	PRINTFORMW 「ぐハァッ！　ぬ、ぬかったわ……」
PRINTFORMW 「ぐふうッ！　く、なんて様だ……」	PRINTFORMW 「ぐふうッ！　く、なんて様だ……」
PRINTFORMW 「あぁぁ……早苗、何てことだ……」	PRINTFORMW 「あぁぁ……早苗、何てことだ……」
PRINTFORMW 「私の……娘……奴らとの…ッッ！」	PRINTFORMW 「私の……娘……奴らとの…ッッ！」
PRINTFORMW 「うッ、ぐ！……次は、無理だ……」	PRINTFORMW 「うッ、ぐ！……次は、無理だ……」
PRINTFORM 「ふあぁぁぁぁ！ ひあぁあぁぁぁあん	PRINTFORM 「ふあぁぁぁぁ！ ひあぁあぁぁぁあん
PRINTFORM 　も、もうわらひイってまひゅぅぅぅっ	PRINTFORM 　も、もうわらひイってまひゅぅぅぅっ
PRINTFORM 「じゃないと、わらひ、しゅぐにぃぃっ	PRINTFORM 「じゃないと、わらひ、しゅぐにぃぃっ
PRINTFORML 「くはぁッ？！……ば、バカな……」	PRINTFORML 「くはぁッ？！……ば、バカな……」
PRINTFORMW 「さな…え……さなえーーーー！！」	PRINTFORMW 「さな…え……さなえーーーー！！」
PRINTFORMW 「まさか、諏訪子が……そんなっ！」	PRINTFORMW 「まさか、諏訪子が……そんなっ！」
PRINTFORMW 「大丈夫だよ早苗、私がついている」	PRINTFORMW 「大丈夫だよ早苗、私がついている」
PRINTFORMW 「ふふふ、私の力が必要なようだね」	PRINTFORMW 「ふふふ、私の力が必要なようだね」
PRINTFORMW 「くそぉッ……植えつけられたか！」	PRINTFORMW 「くそぉッ……植えつけられたか！」
PRINTFORMW 「あぁぁあ……今度は、ダメか……」	PRINTFORMW 「あぁぁあ……今度は、ダメか……」
PRINTFORM 「しょくしゅにょ、あかちゃんっっ……	PRINTFORM 「しょくしゅにょ、あかちゃんっっ……
PRINTFORMW 「これ以上、……呪われ子を……！」	PRINTFORMW 「これ以上、……呪われ子を……！」
PRINTFORM 　早く大きくなって…私を孕ませに来て	PRINTFORM 　早く大きくなって…私を孕ませに来て
PRINTFORMW 「あいつらの、卵が……あぁぁッ！」	PRINTFORMW 「あいつらの、卵が……あぁぁッ！」
PRINTFORMW 「ひぃぃッ……助けて…父上ぇっ…」	PRINTFORMW 「ひぃぃッ……助けて…父上ぇっ…」
PRINTFORMW 「少し寝るから、みててくれない？」	PRINTFORMW 「少し寝るから、みててくれない？」
PRINTFORMW 「だめ…だ……眠れる、場所を……」	PRINTFORMW 「だめ…だ……眠れる、場所を……」
PRINTFORMW 「くぅっ！…できるだけ、遠くに！」	PRINTFORMW 「くぅっ！…できるだけ、遠くに！」
PRINTFORMW 「此の地、是より八坂の物なるぞ！」	PRINTFORMW 「此の地、是より八坂の物なるぞ！」
PRINTFORMW 「あぁあっっ…嫌あぁぁあ～～っ！」	PRINTFORMW 「あぁあっっ…嫌あぁぁあ～～っ！」
PRINTFORMW 「特濃白濁風呂とか怪しすぎるわ！」	PRINTFORMW 「特濃白濁風呂とか怪しすぎるわ！」
PRINTFORMW 「早く着替えをみつけなくては…！」	PRINTFORMW 「早く着替えをみつけなくては…！」
PRINTFORMW 「あっち行くんだよ、シッ！シッ！」	PRINTFORMW 「あっち行くんだよ、シッ！シッ！」
PRINTFORML 「うわっ！…くそ、油断も隙も……」	PRINTFORML 「うわっ！…くそ、油断も隙も……」
PRINTFORM 「おひりにょ穴っ…入らないれぇえぇっ	PRINTFORM 「おひりにょ穴っ…入らないれぇえぇっ
PRINTFORM 　おぉお…おっぱい敏感なのぉぉぉっっ	PRINTFORM 　おぉお…おっぱい敏感なのぉぉぉっっ
PRINTFORMW 「……よ、よせ……やめろおっ！！」	PRINTFORMW 「……よ、よせ……やめろおっ！！」
PRINTFORMW 「遠慮しないで行って来るんだよ！」	PRINTFORMW 「遠慮しないで行って来るんだよ！」
PRINTFORM 　ミルク吸い尽くされちゃうぅぅう！！	PRINTFORM 　ミルク吸い尽くされちゃうぅぅう！！
PRINTFORMW 「この帽子……是非曲直庁のッ？！」	PRINTFORMW 「この帽子……是非曲直庁のッ？！」
PRINTFORM 　クリッ！クリトリしゅ壊れちゃうぅぅ	PRINTFORM 　クリッ！クリトリしゅ壊れちゃうぅぅ
PRINTFORMW 「……ぜぇ…ハァ……ひぃ、ぅぅ…」	PRINTFORMW 「……ぜぇ…ハァ……ひぃ、ぅぅ…」
PRINTFORMW 「おお゛ぉん゛ッ……んご、ぅ……」	PRINTFORMW 「おお゛ぉん゛ッ……んご、ぅ……」
PRINTFORMW 「一度言ってみたかったんだよ♪」	PRINTFORMW 「一度言ってみたかったんだよ♪」
PRINTFORMW 「ちょっとやそっとでは壊れんぞ」	PRINTFORMW 「ちょっとやそっとでは壊れんぞ」
PRINTFORM 「くそッ……敵に背を向けるとは！」	PRINTFORM 「くそッ……敵に背を向けるとは！」
PRINTFORMW 「次は耳だ(ふっ、決まったな)」	PRINTFORMW 「次は耳だ(ふっ、決まったな)」
PRINTFORMW 「荒ぶる神の御霊を味わうといい」	PRINTFORMW 「荒ぶる神の御霊を味わうといい」
PRINTFORMW 「来るなッ……来ないでよぉぉ！」	PRINTFORMW 「来るなッ……来ないでよぉぉ！」
PRINTFORMW 「弾薬温存は生き残りの基本だよ」	PRINTFORMW 「弾薬温存は生き残りの基本だよ」
PRINTFORMW 「うぐっ……もう、立てない……」	PRINTFORMW 「うぐっ……もう、立てない……」
PRINTFORM 「だめっ！……女核は触らないでぇっ	PRINTFORM 「だめっ！……女核は触らないでぇっ
PRINTFORM 「だから、はやくクリいじめしてぇっ	PRINTFORM 「だから、はやくクリいじめしてぇっ
PRINTFORMW 「父上の、えっちーーーー！！！」	PRINTFORMW 「父上の、えっちーーーー！！！」
PRINTFORMW 「う、あぁあ……口が勝手に……」	PRINTFORMW 「う、あぁあ……口が勝手に……」
PRINTFORMW 「身体が、勝手に…んひぃぃっ！」	PRINTFORMW 「身体が、勝手に…んひぃぃっ！」
PRINTFORM 　もっともっと感じさせてやろうねぇ	PRINTFORM 　もっともっと感じさせてやろうねぇ
PRINTFORML 「うぅぅ、やめろ……やめろぉ！」	PRINTFORML 「うぅぅ、やめろ……やめろぉ！」
PRINTFORMW 「すまない！瘴気にあてられた！」	PRINTFORMW 「すまない！瘴気にあてられた！」
PRINTFORML 「ひっ！うぐぅぅっ！…くそぅ！」	PRINTFORML 「ひっ！うぐぅぅっ！…くそぅ！」
PRINTFORMW 　本当は期待していたのだろう？」	PRINTFORMW 　本当は期待していたのだろう？」
PRINTFORMW 「うぅぅ…好きにするが良い……」	PRINTFORMW 「うぅぅ…好きにするが良い……」
PRINTFORM 　中出しだけは簡便してあげましょう	PRINTFORM 　中出しだけは簡便してあげましょう
PRINTFORMW 「な、中、いっぱい、出されて…」	PRINTFORMW 「な、中、いっぱい、出されて…」
PRINTFORM 　痛いの気持ちよくにゃってるよぉぉ	PRINTFORM 　痛いの気持ちよくにゃってるよぉぉ
PRINTFORMW 　もっとザー汁ちょうだいっ！！」	PRINTFORMW 　もっとザー汁ちょうだいっ！！」
PRINTFORM 　かにゃこっ、イぐぅっぅぅぅぅぅっ	PRINTFORM 　かにゃこっ、イぐぅっぅぅぅぅぅっ
PRINTFORM 「だ、だめ、なのに、だめなのにぃっ	PRINTFORM 「だ、だめ、なのに、だめなのにぃっ
PRINTFORM 「だ！ダメだ早苗ぇ！そこは尻の……	PRINTFORM 「だ！ダメだ早苗ぇ！そこは尻の……
PRINTFORM 　よせ諏訪子ぉぉお……正気に戻……	PRINTFORM 　よせ諏訪子ぉぉお……正気に戻……
PRINTFORM 　かにゃこはぁっ、めすぶたにぃぃっ	PRINTFORM 　かにゃこはぁっ、めすぶたにぃぃっ
PRINTFORMW 「ふむ、ここは私がひきうけよう」	PRINTFORMW 「ふむ、ここは私がひきうけよう」
PRINTFORM 　いいっ、これ……しゅごしゅぎぃっ	PRINTFORM 　いいっ、これ……しゅごしゅぎぃっ
PRINTFORM 　もっとぉ……もっと奥までぇぇえッ	PRINTFORM 　もっとぉ……もっと奥までぇぇえッ
PRINTFORM 　敏感オンバシラッ壊れちゃううぅぅ	PRINTFORM 　敏感オンバシラッ壊れちゃううぅぅ
PRINTFORM 　オンバシラしごかにゃいれぇえぇッ	PRINTFORM 　オンバシラしごかにゃいれぇえぇッ
PRINTFORM 「他の場所は、どうしてもいいからぁ	PRINTFORM 「他の場所は、どうしてもいいからぁ
PRINTFORM 　こんなにっ……きもちいなんてぇぇ	PRINTFORM 　こんなにっ……きもちいなんてぇぇ
PRINTFORMW 「くっ、触っるな！汚らわしい！」	PRINTFORMW 「くっ、触っるな！汚らわしい！」
PRINTFORMW 「くそ…エロ同人みたいにっっ！」	PRINTFORMW 「くそ…エロ同人みたいにっっ！」
PRINTFORMW 「寝込みを襲われるとは、不覚！」	PRINTFORMW 「寝込みを襲われるとは、不覚！」
PRINTFORMW 「早苗ぇ…どうして、こんな……」	PRINTFORMW 「早苗ぇ…どうして、こんな……」
PRINTFORMW 「――くぅッ！追いつかれたか！」	PRINTFORMW 「――くぅッ！追いつかれたか！」
PRINTFORMW 「うっく……こんな状態じゃ……」	PRINTFORMW 「うっく……こんな状態じゃ……」
PRINTFORMW 「―――ここで、屠らなくては！」	PRINTFORMW 「―――ここで、屠らなくては！」
PRINTFORMW 「……早苗……もう、お休み……」	PRINTFORMW 「……早苗……もう、お休み……」
PRINTFORM （どうして…逃げ切れたのに、身体が	PRINTFORM （どうして…逃げ切れたのに、身体が
PRINTFORM 　これいじょう、イかさにゃいでぇっ	PRINTFORM 　これいじょう、イかさにゃいでぇっ
PRINTFORMW 「っ……！白黒の魔法使い……！」	PRINTFORMW 「っ……！白黒の魔法使い……！」
PRINTFORMW 「あら？麓の巫女じゃないの……」	PRINTFORMW 「あら？麓の巫女じゃないの……」
PRINTFORMW 「……言い逃れするつもりはない」	PRINTFORMW 「……言い逃れするつもりはない」
PRINTFORMW (…BBA臭いっつった奴表出ろ)	PRINTFORMW (…BBA臭いっつった奴表出ろ)
PRINTFORMDW 『もう何も怖くない！ですね！』	PRINTFORMDW 『もう何も怖くない！ですね！』
PRINTFORMDW 『あの時は敵だったでしょう！』	PRINTFORMDW 『あの時は敵だったでしょう！』
PRINTFORM 「バカになっちゃうぅぅぁぁあ゛っ！	PRINTFORM 「バカになっちゃうぅぅぁぁあ゛っ！
PRINTFORM 　大きくなったら…私を孕ませに来て	PRINTFORM 　大きくなったら…私を孕ませに来て
PRINTFORM 「そんにゃ……母乳が出るにゃんてぇ	PRINTFORM 「そんにゃ……母乳が出るにゃんてぇ
PRINTFORM 「あかちゃんに授乳しゃせられてぇっ	PRINTFORM 「あかちゃんに授乳しゃせられてぇっ
PRINTFORMW 「尻穴に産みつけられたか…？！」	PRINTFORMW 「尻穴に産みつけられたか…？！」
PRINTFORMW 「卵を産まされる……私が？……」	PRINTFORMW 「卵を産まされる……私が？……」
PRINTFORM 　アナル卵出していぐゅぅぅぅうっっ	PRINTFORM 　アナル卵出していぐゅぅぅぅうっっ
PRINTFORMW 「だめだ……もう、限……界……」	PRINTFORMW 「だめだ……もう、限……界……」
PRINTFORMW 「ふぁっ……眠いな、少し休もう」	PRINTFORMW 「ふぁっ……眠いな、少し休もう」
PRINTFORMW 「ふふ、伏兵は戦の基本だよねぇ」	PRINTFORMW 「ふふ、伏兵は戦の基本だよねぇ」
PRINTFORMW 「くそっ…何か使えるものは……」	PRINTFORMW 「くそっ…何か使えるものは……」
PRINTFORMW 「このままでは、ジリ貧だぞ…！」	PRINTFORMW 「このままでは、ジリ貧だぞ…！」
PRINTFORMW 「テンション上がってきたよ！！」	PRINTFORMW 「テンション上がってきたよ！！」
PRINTFORMW 「ぐっ！ピンクガスは淫乱だ！」 	PRINTFORMW 「ぐっ！ピンクガスは淫乱だ！」 
PRINTFORM 「ひぎゅぅああ、らめぇえええぇぇっ	PRINTFORM 「ひぎゅぅああ、らめぇえええぇぇっ
PRINTFORM ！！　乳アクメで狂っちゃうのぉぉっ	PRINTFORM ！！　乳アクメで狂っちゃうのぉぉっ
PRINTFORMW 「まさか…植えつけられた……？」	PRINTFORMW 「まさか…植えつけられた……？」
PRINTFORMW 「そ、そうだ…他に手はないんだ」	PRINTFORMW 「そ、そうだ…他に手はないんだ」
PRINTFORML 「なかは…膣内(なか)はダｍ……	PRINTFORML 「なかは…膣内(なか)はダｍ……
PRINTFORM 「ふぎょぉぉおんっ…おぉぉおしりっ	PRINTFORM 「ふぎょぉぉおんっ…おぉぉおしりっ
PRINTFORM 　どんどん気持ちよくなるよほぉぉっ	PRINTFORM 　どんどん気持ちよくなるよほぉぉっ
PRINTFORMW 　んぎぃぃぃ―――――！！！！」	PRINTFORMW 　んぎぃぃぃ―――――！！！！」
PRINTFORMW 「この帽子は、白黒の魔法使い！」	PRINTFORMW 「この帽子は、白黒の魔法使い！」
PRINTFORMDL 神奈子の放った色鮮やかな弾幕が	PRINTFORMDL 神奈子の放った色鮮やかな弾幕が
PRINTFORM 「おのれぇっ！負けるか、この――ッ	PRINTFORM 「おのれぇっ！負けるか、この――ッ
PRINTFORM 　おぉおっっおんばひらりゃめぇえぇ	PRINTFORM 　おぉおっっおんばひらりゃめぇえぇ
PRINTFORM 　雌っ穴あぁぶっ壊れちゃうぅぅぅっ	PRINTFORM 　雌っ穴あぁぶっ壊れちゃうぅぅぅっ
PRINTFORM  おおっおっぱい姦しゅごぃのぉっ！	PRINTFORM  おおっおっぱい姦しゅごぃのぉっ！
PRINTFORM  こりぇぇ、癖ににゃっちゃうよぉぉ	PRINTFORM  こりぇぇ、癖ににゃっちゃうよぉぉ
PRINTFORMW 「八坂の神徳、見せてくれよう」	PRINTFORMW 「八坂の神徳、見せてくれよう」
PRINTFORMW 「もう……後がないんだよぉ！」	PRINTFORMW 「もう……後がないんだよぉ！」
PRINTFORMW 「国津神の力、甘く見るなよ？」	PRINTFORMW 「国津神の力、甘く見るなよ？」
PRINTFORMW 「くそ……狙いが、定まらん！」	PRINTFORMW 「くそ……狙いが、定まらん！」
PRINTFORMW 「当たれ……当たってくれ！！」	PRINTFORMW 「当たれ……当たってくれ！！」
PRINTFORMW 「ぐぅッ……もう、後がない！」	PRINTFORMW 「ぐぅッ……もう、後がない！」
PRINTFORMW 「ううぉおおーーーッッッ！！」	PRINTFORMW 「ううぉおおーーーッッッ！！」
PRINTFORM ！！　も…だめぇ……堪忍してぇぇ	PRINTFORM ！！　も…だめぇ……堪忍してぇぇ
PRINTFORM 「おんばひりゃ、いまりゃめえぇ…	PRINTFORM 「おんばひりゃ、いまりゃめえぇ…
PRINTFORM 「おっぉぉおひり……疼いてるのぉ	PRINTFORM 「おっぉぉおひり……疼いてるのぉ
PRINTFORM 　はやく、しゃく乳ほしいぃよぉぉ	PRINTFORM 　はやく、しゃく乳ほしいぃよぉぉ
PRINTFORM 「はぁぁっっはやぐクリ虐めてぇぇ	PRINTFORM 「はぁぁっっはやぐクリ虐めてぇぇ
PRINTFORMW 「種付けされるよりはマシだ！」	PRINTFORMW 「種付けされるよりはマシだ！」
PRINTFORMW 「頼む、正気に戻ってくれぇ！」	PRINTFORMW 「頼む、正気に戻ってくれぇ！」
PRINTFORML 「っぐぁ……つっ……っうぅ！」	PRINTFORML 「っぐぁ……つっ……っうぅ！」
PRINTFORMW 「よせぇ！もう、やめてぇっ！」	PRINTFORMW 「よせぇ！もう、やめてぇっ！」
PRINTFORM 　にんっしんっ！…かくじつぅ……	PRINTFORM 　にんっしんっ！…かくじつぅ……
PRINTFORM 　処女レイプ癖になっちゃったぁあ	PRINTFORM 　処女レイプ癖になっちゃったぁあ
PRINTFORM 「オンバシラレイプ気持ちいよぉぉ	PRINTFORM 「オンバシラレイプ気持ちいよぉぉ
PRINTFORMW 「――あッ…んうぅ……ぐふっ」	PRINTFORMW 「――あッ…んうぅ……ぐふっ」
PRINTFORML 淫乱聖口上ベースにしたというか	PRINTFORML 淫乱聖口上ベースにしたというか
PRINTFORML 淫語の多くが聖んと被ってます。	PRINTFORML 淫語の多くが聖んと被ってます。
PRINTFORMW 「クはァッ！……も…やめ……」	PRINTFORMW 「クはァッ！……も…やめ……」
PRINTFORM 　こんにゃの我慢れきないのぉぉっ	PRINTFORM 　こんにゃの我慢れきないのぉぉっ
PRINTFORM 　これいじょうっ戦えにゃいからぁ	PRINTFORM 　これいじょうっ戦えにゃいからぁ
PRINTFORM 　へぎゃぁおっぁおぉおあおぁぉっ	PRINTFORM 　へぎゃぁおっぁおぉおあおぁぉっ
PRINTFORM 　ゆるひれくらひゃああぁぁっぁっ	PRINTFORM 　ゆるひれくらひゃああぁぁっぁっ
PRINTFORM 　かにゃこッはぁもぉぉ…おおぉッ	PRINTFORM 　かにゃこッはぁもぉぉ…おおぉッ
PRINTFORM 「はぁあぁふっ、ふふ…そうだなぁ	PRINTFORM 「はぁあぁふっ、ふふ…そうだなぁ
PRINTFORM 「神奈子はオッパイ奴隷なんれすぅ	PRINTFORM 「神奈子はオッパイ奴隷なんれすぅ
PRINTFORM 　よせ、早苗ぇッッ正気にもどれぇ	PRINTFORM 　よせ、早苗ぇッッ正気にもどれぇ
PRINTFORM 「あぁぁダメだ…だめ……なのにぃ	PRINTFORM 「あぁぁダメだ…だめ……なのにぃ
PRINTFORM 　身体がコイツを……欲しがってぇ	PRINTFORM 　身体がコイツを……欲しがってぇ
PRINTFORM 「ろこれもっ、ろこれもいいのぉっ	PRINTFORM 「ろこれもっ、ろこれもいいのぉっ
PRINTFORM 「や、やだぁ……尻穴でなんてぇっ	PRINTFORM 「や、やだぁ……尻穴でなんてぇっ
PRINTFORM 　オンバシラぁイッちゃうのぉぉッ	PRINTFORM 　オンバシラぁイッちゃうのぉぉッ
PRINTFORM 　だめ……だめぇぇぇぇえぇえッッ	PRINTFORM 　だめ……だめぇぇぇぇえぇえッッ
PRINTFORM 「神なのにぃ……軍神なのにぃ……	PRINTFORM 「神なのにぃ……軍神なのにぃ……
PRINTFORM 「へげぇッ…お……おぉんんんぅッ	PRINTFORM 「へげぇッ…お……おぉんんんぅッ
PRINTFORM 「あへぇえああ……も…でにゃいぃ	PRINTFORM 「あへぇえああ……も…でにゃいぃ
PRINTFORMW 「――今すぐ、楽にしてやる！」	PRINTFORMW 「――今すぐ、楽にしてやる！」
PRINTFORMW 「誰か、助けて……父…上……」	PRINTFORMW 「誰か、助けて……父…上……」
PRINTFORMW 「また私は捨てられるのか……」	PRINTFORMW 「また私は捨てられるのか……」
PRINTFORM 　ああぁあ！またあぁぁああぁあが	PRINTFORM 　ああぁあ！またあぁぁああぁあが
PRINTFORM 　こどもにっ、おっぱいすわれてっ	PRINTFORM 　こどもにっ、おっぱいすわれてっ
PRINTFORM 「母乳っ、まらっ、でちゃうぅぅっ	PRINTFORM 「母乳っ、まらっ、でちゃうぅぅっ
PRINTFORM 　おっぱいしぼられちゃぅのぉぉっ	PRINTFORM 　おっぱいしぼられちゃぅのぉぉっ
PRINTFORMW 「フーーッ！フゥーーーッッ！」	PRINTFORMW 「フーーッ！フゥーーーッッ！」
PRINTFORML 「くはぁッ？！……あがっ……」	PRINTFORML 「くはぁッ？！……あがっ……」
PRINTFORMW 「おー、早苗！無事だったか！」	PRINTFORMW 「おー、早苗！無事だったか！」
PRINTFORMW 「また、植えつけられたのか…」	PRINTFORMW 「また、植えつけられたのか…」
PRINTFORM 　出産アクメ待ちきれないよぉぉっ	PRINTFORM 　出産アクメ待ちきれないよぉぉっ
PRINTFORM 「お゛お゛ぉッ……おごおぉんんぅ	PRINTFORM 「お゛お゛ぉッ……おごおぉんんぅ
PRINTFORMW 「ひいぃぅぐぅぅぅぅッッ――」	PRINTFORMW 「ひいぃぅぐぅぅぅぅッッ――」
PRINTFORMW 「……孕んだ……この私が……」	PRINTFORMW 「……孕んだ……この私が……」
PRINTFORM 「えへへ……生まれたての触手……	PRINTFORM 「えへへ……生まれたての触手……
PRINTFORM 　産卵アクメ待ちきれないよぉぉっ	PRINTFORM 　産卵アクメ待ちきれないよぉぉっ
PRINTFORM 「おっぱいの中、卵でこすれてるぅ	PRINTFORM 「おっぱいの中、卵でこすれてるぅ
PRINTFORM 「おっぱい卵っもうでりゅぅぅッッ	PRINTFORM 「おっぱい卵っもうでりゅぅぅッッ
PRINTFORM 　はやぐ……乳首産卵早ぐぅぅぅっ	PRINTFORM 　はやぐ……乳首産卵早ぐぅぅぅっ
PRINTFORM 　おっぱいで卵産んでいぐぅうぅぅ	PRINTFORM 　おっぱいで卵産んでいぐぅうぅぅ
PRINTFORMW 「見張りを、頼…………ｚｚｚ」	PRINTFORMW 「見張りを、頼…………ｚｚｚ」
PRINTFORMW 「少し休むか、先に寝るといい」	PRINTFORMW 「少し休むか、先に寝るといい」
PRINTFORMW 「どこかに、安全な場所は……」	PRINTFORMW 「どこかに、安全な場所は……」
PRINTFORMW 「今見付かったら終わりだ……」	PRINTFORMW 「今見付かったら終わりだ……」
PRINTFORMW 「一寸先は……触手だろうねぇ」	PRINTFORMW 「一寸先は……触手だろうねぇ」
PRINTFORMW 「奇襲が上手くいけばいいが…」	PRINTFORMW 「奇襲が上手くいけばいいが…」
PRINTFORMW 「どこかに…眠れる場所は……」	PRINTFORMW 「どこかに…眠れる場所は……」
PRINTFORMW 「――私だって、マダマダ……」	PRINTFORMW 「――私だって、マダマダ……」
PRINTFORMW 「……んんっ！マズい～～ッ！」	PRINTFORMW 「……んんっ！マズい～～ッ！」
PRINTFORMW 「……ぶふぅぅーーーッッ！！」	PRINTFORMW 「……ぶふぅぅーーーッッ！！」
PRINTFORM 「おぉぉ…おんっばひらがぁ～～ッ	PRINTFORM 「おぉぉ…おんっばひらがぁ～～ッ
PRINTFORM 「かにゃこの敏感アクメポイントぉ	PRINTFORM 「かにゃこの敏感アクメポイントぉ
PRINTFORM 「くそっ！汚らわしい！触るなあぁ	PRINTFORM 「くそっ！汚らわしい！触るなあぁ
PRINTFORM 　かにゃこのっスケベおっぱぃいっ	PRINTFORM 　かにゃこのっスケベおっぱぃいっ
PRINTFORMW 「上からくるぞ、気をつけろ！」	PRINTFORMW 「上からくるぞ、気をつけろ！」
PRINTFORMW 「お代は体で……って事かい？」	PRINTFORMW 「お代は体で……って事かい？」
PRINTFORMW 　ううっっ…動、くなあぁ……」	PRINTFORMW 　ううっっ…動、くなあぁ……」
PRINTFORM 　か、かにゃこの子宮こじあけて…	PRINTFORM 　か、かにゃこの子宮こじあけて…
PRINTFORM 　うウゥ疼く、アソコ疼くよおぉっ	PRINTFORM 　うウゥ疼く、アソコ疼くよおぉっ
PRINTFORMW 「ば、バカな……この帽子！！」	PRINTFORMW 「ば、バカな……この帽子！！」
PRINTFORMDW 結果は惨憺たるものであった。	PRINTFORMDW 結果は惨憺たるものであった。
PRINTFORMDW 奴らの目的は、単純明快―――	PRINTFORMDW 奴らの目的は、単純明快―――
PRINTFORM 「触手なんかに、絶対負けな――ッ	PRINTFORM 「触手なんかに、絶対負けな――ッ
PRINTFORM 　かにゃこのお豆破裂しちゃううぅ	PRINTFORM 　かにゃこのお豆破裂しちゃううぅ
PRINTFORM 「りゃめえぇえぇ！おまんこぉぉっ	PRINTFORM 「りゃめえぇえぇ！おまんこぉぉっ
PRINTFORM  「ほぎぃぃっ！やめ…やめてぇぇ	PRINTFORM  「ほぎぃぃっ！やめ…やめてぇぇ
PRINTFORMW 「くそッ…指が震えて……！」	PRINTFORMW 「くそッ…指が震えて……！」
PRINTFORM 　もう、めちゃくちゃにしてぇ…	PRINTFORM 　もう、めちゃくちゃにしてぇ…
PRINTFORMW 「うぐぅっ……汚らわしい！」	PRINTFORMW 「うぐぅっ……汚らわしい！」
PRINTFORMW 「は、放せ！ このぉぉっ！」	PRINTFORMW 「は、放せ！ このぉぉっ！」
PRINTFORMW 「嫌だ……あんな奴らにぃ！」	PRINTFORMW 「嫌だ……あんな奴らにぃ！」
PRINTFORMW 「軍神の名は伊達ではないぞ」	PRINTFORMW 「軍神の名は伊達ではないぞ」
PRINTFORMW 「父上……どうか、お力を！」	PRINTFORMW 「父上……どうか、お力を！」
PRINTFORM （くぅぅ……身体が疼いてしまう	PRINTFORM （くぅぅ……身体が疼いてしまう
PRINTFORM 　集中にゃんて出来にゃいよぉぉ	PRINTFORM 　集中にゃんて出来にゃいよぉぉ
PRINTFORMW 「逃げる隙は、あるはずだ…」	PRINTFORMW 「逃げる隙は、あるはずだ…」
PRINTFORMW 「――うっ……うぅぅっ……」	PRINTFORMW 「――うっ……うぅぅっ……」
PRINTFORMW 「もう、抵抗しないから……」	PRINTFORMW 「もう、抵抗しないから……」
PRINTFORM 「いま、おひりりゃめえなのぉぉ	PRINTFORM 「いま、おひりりゃめえなのぉぉ
PRINTFORM 　しょこだけは、やめてぇぇえっ	PRINTFORM 　しょこだけは、やめてぇぇえっ
PRINTFORM 　胸は、敏感だから……だめぇっ	PRINTFORM 　胸は、敏感だから……だめぇっ
PRINTFORM 「おおぉお豆、いまりゃめえぇ…	PRINTFORM 「おおぉお豆、いまりゃめえぇ…
PRINTFORMW 「くっ！そんな所に触るな！」	PRINTFORMW 「くっ！そんな所に触るな！」
PRINTFORMW 「よせ、よせぇええッッ！！」	PRINTFORMW 「よせ、よせぇええッッ！！」
PRINTFORMW 「お、オマンコはやめて……」	PRINTFORMW 「お、オマンコはやめて……」
PRINTFORM 　がにゃごぉおおぉっばいいんっ	PRINTFORM 　がにゃごぉおおぉっばいいんっ
PRINTFORM 　神の粥どっぷどっぷしたいのぉ	PRINTFORM 　神の粥どっぷどっぷしたいのぉ
PRINTFORM いっぱいイぢめてくりゃひゃいぃ	PRINTFORM いっぱいイぢめてくりゃひゃいぃ
PRINTFORM 「おちんちんもう我慢できにゃぃ	PRINTFORM 「おちんちんもう我慢できにゃぃ
PRINTFORM 「お豆ぴくぴとまりゃないのぉっ	PRINTFORM 「お豆ぴくぴとまりゃないのぉっ
PRINTFORM 　ぬっちゅぅ…蛇みひゃいらろぉ	PRINTFORM 　ぬっちゅぅ…蛇みひゃいらろぉ
PRINTFORMW 「しまった！これは暗示か！」	PRINTFORMW 「しまった！これは暗示か！」
PRINTFORMW 「ゼェ～～ッ　ハァ～～ッ！」	PRINTFORMW 「ゼェ～～ッ　ハァ～～ッ！」
PRINTFORMW 「初物か……ふふ、案ずるな」	PRINTFORMW 「初物か……ふふ、案ずるな」
PRINTFORMW 「頼む……やめて、くれ……」	PRINTFORMW 「頼む……やめて、くれ……」
PRINTFORMDW 某坊主『ヘックしゅんっ！』	PRINTFORMDW 某坊主『ヘックしゅんっ！』
PRINTFORM ？　ほら、こうやって服を触れば	PRINTFORM ？　ほら、こうやって服を触れば
PRINTFORM 　中にっザーメンりゃめぇええぇ	PRINTFORM 　中にっザーメンりゃめぇええぇ
PRINTFORM 　おんばひらアクメくりゅぅぅっ	PRINTFORM 　おんばひらアクメくりゅぅぅっ
PRINTFORMW 「えぐぉア゛ハァッ――！！」	PRINTFORMW 「えぐぉア゛ハァッ――！！」
PRINTFORM 　もっとエッチちょうらいぃいっ	PRINTFORM 　もっとエッチちょうらいぃいっ
PRINTFORM 　ひゅごいのまひゃきひゃぅぅっ	PRINTFORM 　ひゅごいのまひゃきひゃぅぅっ
PRINTFORM 「ゆるひれっ、ゆるひれぇぇぇっ	PRINTFORM 「ゆるひれっ、ゆるひれぇぇぇっ
PRINTFORM 　きもひよく、なっれきてぇっ…	PRINTFORM 　きもひよく、なっれきてぇっ…
PRINTFORM 「ひゅごい、ひゅごいのおおぉっ	PRINTFORM 「ひゅごい、ひゅごいのおおぉっ
PRINTFORM 　こすれて、きもひいいれすぅっ	PRINTFORM 　こすれて、きもひいいれすぅっ
PRINTFORM 「も……がまんれきまひぇぇえん	PRINTFORM 「も……がまんれきまひぇぇえん
PRINTFORM 　いっぱいいじめてくらさぁいっ	PRINTFORM 　いっぱいいじめてくらさぁいっ
PRINTFORMW 「八坂の名も地に落ちた……」	PRINTFORMW 「八坂の名も地に落ちた……」
PRINTFORM ？！　乳首コリコリきもちいぃぃ	PRINTFORM ？！　乳首コリコリきもちいぃぃ
PRINTFORM 　引き千切るくらいにぃぃぃッッ	PRINTFORM 　引き千切るくらいにぃぃぃッッ
PRINTFORM 「こっ…ここっにもおお゛ぉぉッ	PRINTFORM 「こっ…ここっにもおお゛ぉぉッ
PRINTFORM 　もっとぉぉっもっと絞ってぇぇ	PRINTFORM 　もっとぉぉっもっと絞ってぇぇ
PRINTFORM 「クリこりこりいいにょぉぉぉっ	PRINTFORM 「クリこりこりいいにょぉぉぉっ
PRINTFORM 「かにゃこの体ぶち抜いてぇッッ	PRINTFORM 「かにゃこの体ぶち抜いてぇッッ
PRINTFORM 　おっぱぃ！　おっぱいらめぇ！	PRINTFORM 　おっぱぃ！　おっぱいらめぇ！
PRINTFORM 　オンバシラッ爆発しちゃうぅぅ	PRINTFORM 　オンバシラッ爆発しちゃうぅぅ
PRINTFORM 　おっぱいぃぃ揉まにゃいれぇえ	PRINTFORM 　おっぱいぃぃ揉まにゃいれぇえ
PRINTFORM 「ク、クリじゃ、なひゃあぁぁん	PRINTFORM 「ク、クリじゃ、なひゃあぁぁん
PRINTFORM 「おご……おご……あぁぁぁッッ	PRINTFORM 「おご……おご……あぁぁぁッッ
PRINTFORMW 「全力でお返ししてやろう！」	PRINTFORMW 「全力でお返ししてやろう！」
PRINTFORMW 「どうやら黒幕のようだねぇ」	PRINTFORMW 「どうやら黒幕のようだねぇ」
PRINTFORMW 「ああぁあぁぁぁんっ！！！」	PRINTFORMW 「ああぁあぁぁぁんっ！！！」
PRINTFORM 　イっちゃい、まひゅうぅぅぅっ	PRINTFORM 　イっちゃい、まひゅうぅぅぅっ
PRINTFORM 　わらひっ、イっちゃあぁぁぁっ	PRINTFORM 　わらひっ、イっちゃあぁぁぁっ
PRINTFORM 　乳袋ビュービューしちゃぅぅっ	PRINTFORM 　乳袋ビュービューしちゃぅぅっ
PRINTFORMW 「おい、しっかりするんだ！」	PRINTFORMW 「おい、しっかりするんだ！」
PRINTFORMW 「昔を思い出すなぁ諏訪子♪」	PRINTFORMW 「昔を思い出すなぁ諏訪子♪」
PRINTFORMW 「――はぁ……うっぐぅ……」	PRINTFORMW 「――はぁ……うっぐぅ……」
PRINTFORMW 「すまない、恩に着るよ……」	PRINTFORMW 「すまない、恩に着るよ……」
PRINTFORMW 「さて、これからどうするか」	PRINTFORMW 「さて、これからどうするか」
PRINTFORMW 「――でねー？それでねー？」	PRINTFORMW 「――でねー？それでねー？」
PRINTFORMDW 『――神奈子…さま……？』	PRINTFORMDW 『――神奈子…さま……？』
PRINTFORM 「はやく…はやく産まれておいで	PRINTFORM 「はやく…はやく産まれておいで
PRINTFORMW 「父上……お助けください！」	PRINTFORMW 「父上……お助けください！」
PRINTFORMW 「出て…くるな……嫌ぁ……」	PRINTFORMW 「出て…くるな……嫌ぁ……」
PRINTFORM 　しょくしゅしゃん産みにゃがら	PRINTFORM 　しょくしゅしゃん産みにゃがら
PRINTFORM 　産道犯しゃれてイぎゅぅぅっっ	PRINTFORM 　産道犯しゃれてイぎゅぅぅっっ
PRINTFORM 　はやぐ……産卵したいよぉぉっ	PRINTFORM 　はやぐ……産卵したいよぉぉっ
PRINTFORM 　産卵ケツアクメいぎゅうぅぅっ	PRINTFORM 　産卵ケツアクメいぎゅうぅぅっ
PRINTFORM おっぱいに産み付けされたゃった	PRINTFORM おっぱいに産み付けされたゃった
PRINTFORM 「ひいいぎゅぅッ…ぅうぅん～～	PRINTFORM 「ひいいぎゅぅッ…ぅうぅん～～
PRINTFORM 「産む時は…射乳と一緒にかねぇ	PRINTFORM 「産む時は…射乳と一緒にかねぇ
PRINTFORM 　おっぱい卵出りゅぅぅぅうっっ	PRINTFORM 　おっぱい卵出りゅぅぅぅうっっ
PRINTFORMW 「体制を…立て直さないと…」	PRINTFORMW 「体制を…立て直さないと…」
PRINTFORMW 「ぅぐっ……何とか隙を……」	PRINTFORMW 「ぅぐっ……何とか隙を……」
PRINTFORMW 「使えるものは何でも使うぞ」	PRINTFORMW 「使えるものは何でも使うぞ」
PRINTFORMW 「うわっ！！くそ……離せ！」	PRINTFORMW 「うわっ！！くそ……離せ！」
PRINTFORMW 「私も余裕がないのでな……」	PRINTFORMW 「私も余裕がないのでな……」
PRINTFORM 　もっひょ淫ッ乱っ！にぃぃぃっ	PRINTFORM 　もっひょ淫ッ乱っ！にぃぃぃっ
PRINTFORM 　かにゃこの、お、おまんこぉ…	PRINTFORM 　かにゃこの、お、おまんこぉ…
PRINTFORM 　イキっぱなしでイグぅぅぅうっ	PRINTFORM 　イキっぱなしでイグぅぅぅうっ
PRINTFORM 「ひぎゅっ、らめ…らめぇぇぇっ	PRINTFORM 「ひぎゅっ、らめ…らめぇぇぇっ
PRINTFORMW 「自販機？……こんな所に？」	PRINTFORMW 「自販機？……こんな所に？」
PRINTFORMW 「おおぉご…おふぁぁあがッ」	PRINTFORMW 「おおぉご…おふぁぁあがッ」
PRINTFORMW 「何でも試してみるものさ…」	PRINTFORMW 「何でも試してみるものさ…」
PRINTFORM 「かにゃっこの、ウンチ穴あぁっ	PRINTFORM 「かにゃっこの、ウンチ穴あぁっ
PRINTFORM 　どっくどくはいってくりゅうぅ	PRINTFORM 　どっくどくはいってくりゅうぅ
PRINTFORM 　おっぱい壊れちゃうぅぅぅうっ	PRINTFORM 　おっぱい壊れちゃうぅぅぅうっ
PRINTFORMW 「幻想郷は一体どうなるのだ」	PRINTFORMW 「幻想郷は一体どうなるのだ」
PRINTFORMW 「まさか、命連寺の坊主まで」	PRINTFORMW 「まさか、命連寺の坊主まで」
PRINTFORM 　かにゃこ雌竿敏感にゃのぉぉぉ	PRINTFORM 　かにゃこ雌竿敏感にゃのぉぉぉ
PRINTFORM 　おおっおまんこりゃめてえぇえ	PRINTFORM 　おおっおまんこりゃめてえぇえ
PRINTFORM 「も…しゃからいましぇんからぁ	PRINTFORM 「も…しゃからいましぇんからぁ
PRINTFORMW 許ひて、くりゃひゃいぃ……」	PRINTFORMW 許ひて、くりゃひゃいぃ……」
PRINTFORML 「―――ヒッ……ァ゛おっ…」	PRINTFORML 「―――ヒッ……ァ゛おっ…」
PRINTFORM 「かにゃこの淫乱おっぱいマンコ	PRINTFORM 「かにゃこの淫乱おっぱいマンコ
PRINTFORM  おっぱいレイプ許してぇぇっ！	PRINTFORM  おっぱいレイプ許してぇぇっ！
PRINTFORM 「かにゃこのドＭおっぱいマンコ	PRINTFORM 「かにゃこのドＭおっぱいマンコ
PRINTFORM 　中でぐじゅぐじゅかき回してぇ	PRINTFORM 　中でぐじゅぐじゅかき回してぇ
PRINTFORML 乳房破壊してくりゃしゃぃぃっ	PRINTFORML 乳房破壊してくりゃしゃぃぃっ
PRINTFORMW 「残弾管理は戦場の鉄則だ」	PRINTFORMW 「残弾管理は戦場の鉄則だ」
PRINTFORM 　こ、これいじょう、だめぇ…	PRINTFORM 　こ、これいじょう、だめぇ…
PRINTFORM 「……もう……走れない……」	PRINTFORM 「……もう……走れない……」
PRINTFORMW 「本当にやれるの…か…？」	PRINTFORMW 「本当にやれるの…か…？」
PRINTFORMW 「頼む……離れてくれぇ！」	PRINTFORMW 「頼む……離れてくれぇ！」
PRINTFORMW 「身体が……重いッ……！」	PRINTFORMW 「身体が……重いッ……！」
PRINTFORMW 「焦らずじっくりといこう」	PRINTFORMW 「焦らずじっくりといこう」
PRINTFORMW 「一太刀に全てをかける！」	PRINTFORMW 「一太刀に全てをかける！」
PRINTFORMW 「どうした、打ってこい！」	PRINTFORMW 「どうした、打ってこい！」
PRINTFORM 「この！はなｓ…あひぃぃッッ	PRINTFORM 「この！はなｓ…あひぃぃッッ
PRINTFORMW 「このままじゃまずい…！」	PRINTFORMW 「このままじゃまずい…！」
PRINTFORM 「気を、集中させて…ひぎゅう	PRINTFORM 「気を、集中させて…ひぎゅう
PRINTFORM 「これ以上っ戦えにゃいのぉぉ	PRINTFORM 「これ以上っ戦えにゃいのぉぉ
PRINTFORM 　疼いて…我慢できにゃいぃぃ	PRINTFORM 　疼いて…我慢できにゃいぃぃ
PRINTFORMW 「今、アナルはダメだっ！」	PRINTFORMW 「今、アナルはダメだっ！」
PRINTFORM 　えっちなこと大好きなのぉ…	PRINTFORM 　えっちなこと大好きなのぉ…
PRINTFORM 　もう我慢できにゃいのぉぉッ	PRINTFORM 　もう我慢できにゃいのぉぉッ
PRINTFORM 　マンコがまんできにゃいのぉ	PRINTFORM 　マンコがまんできにゃいのぉ
PRINTFORM 「手荒れでガサガサだけどねぇ	PRINTFORM 「手荒れでガサガサだけどねぇ
PRINTFORM 　ろうら、わらひの舌使いは…	PRINTFORM 　ろうら、わらひの舌使いは…
PRINTFORM 　もっと……もっともっとぉ！	PRINTFORM 　もっと……もっともっとぉ！
PRINTFORM 「ま、私も嫌いじゃないけどね	PRINTFORM 「ま、私も嫌いじゃないけどね
PRINTFORMW 「よ、よせ！何をするか！」	PRINTFORMW 「よ、よせ！何をするか！」
PRINTFORM 「ひぎゃぁあぃいぃっ痛いいぃ	PRINTFORM 「ひぎゃぁあぃいぃっ痛いいぃ
PRINTFORM 　気持ちいいのぉぉぉおぉっっ	PRINTFORM 　気持ちいいのぉぉぉおぉっっ
PRINTFORM 　どうしようもないドＭだねぇ	PRINTFORM 　どうしようもないドＭだねぇ
PRINTFORM 「膣内射精しゃれちゃったぁ…	PRINTFORM 「膣内射精しゃれちゃったぁ…
PRINTFORM 　処女マンコは何度ヤっても…	PRINTFORM 　処女マンコは何度ヤっても…
PRINTFORMW 「うっ、くあっ……にがっ」	PRINTFORMW 「うっ、くあっ……にがっ」
PRINTFORMW 「うぁ……、どろって……」	PRINTFORMW 「うぁ……、どろって……」
PRINTFORM 「よーし、もう一発いこうかぁ	PRINTFORM 「よーし、もう一発いこうかぁ
PRINTFORML 　しゃしぇいしゅごぃのぉぉ	PRINTFORML 　しゃしぇいしゅごぃのぉぉ
PRINTFORM 　イきながらイっきゅ～～～っ	PRINTFORM 　イきながらイっきゅ～～～っ
PRINTFORM 　きもひっ、よしゅぎれぇぇっ	PRINTFORM 　きもひっ、よしゅぎれぇぇっ
PRINTFORM 「ほ、ほひくなってぇううぅっ	PRINTFORM 「ほ、ほひくなってぇううぅっ
PRINTFORM 　いっぱい虐めれくらしゃあっ	PRINTFORM 　いっぱい虐めれくらしゃあっ
PRINTFORM 「か、かにゃこのぉおちんちん	PRINTFORM 「か、かにゃこのぉおちんちん
PRINTFORM 「おちんぽっにゅるにゅるぅぅ	PRINTFORM 「おちんぽっにゅるにゅるぅぅ
PRINTFORM 　おんにゃのこどおしぃ好きぃ	PRINTFORM 　おんにゃのこどおしぃ好きぃ
PRINTFORM 　もっひょぉぉ肛虐っしてぇぇ	PRINTFORM 　もっひょぉぉ肛虐っしてぇぇ
PRINTFORM 　い、いじわるしにゃいれよぉ	PRINTFORM 　い、いじわるしにゃいれよぉ
PRINTFORM 　はやくぅきもちいのしてよぉ	PRINTFORM 　はやくぅきもちいのしてよぉ
PRINTFORM 　おくまれぇごりごりっってぇ	PRINTFORM 　おくまれぇごりごりっってぇ
PRINTFORM 「ご、ご主人様、お情けをぉ…	PRINTFORM 「ご、ご主人様、お情けをぉ…
PRINTFORM 　ケツマンコにちょうだいぃっ	PRINTFORM 　ケツマンコにちょうだいぃっ
PRINTFORM 　ひゃぁいぃぃいぃんんんッッ	PRINTFORM 　ひゃぁいぃぃいぃんんんッッ
PRINTFORM 「先っぽぉ敏感なのぉぉおッッ	PRINTFORM 「先っぽぉ敏感なのぉぉおッッ
PRINTFORM 　おっぱい、きもひいぃよぉぉ	PRINTFORM 　おっぱい、きもひいぃよぉぉ
PRINTFORM 「きもひっ！よしゅぎてぇえっ	PRINTFORM 「きもひっ！よしゅぎてぇえっ
PRINTFORM 「ほぎゃぁっ…ぉ゛お゛ぉぉっ	PRINTFORM 「ほぎゃぁっ…ぉ゛お゛ぉぉっ
PRINTFORM 「お゛ッん゛ん゛んぅぅぅッッ	PRINTFORM 「お゛ッん゛ん゛んぅぅぅッッ
PRINTFORM 　もっとごしごししてェェッ！	PRINTFORM 　もっとごしごししてェェッ！
PRINTFORM 　…そこじゃ…ないのにぃぃっ	PRINTFORM 　…そこじゃ…ないのにぃぃっ
PRINTFORM 　おオンバひラがぁぁあっ！！	PRINTFORM 　おオンバひラがぁぁあっ！！
PRINTFORM 　強すぎてぇぇ破裂しちゃぅっ	PRINTFORM 　強すぎてぇぇ破裂しちゃぅっ
PRINTFORM 　クリっ、クリらめえぇぅぅっ	PRINTFORM 　クリっ、クリらめえぇぅぅっ
PRINTFORM 　まんこ虐めしゅごいぃぃぃっ	PRINTFORM 　まんこ虐めしゅごいぃぃぃっ
PRINTFORM 「ひゃぁあああらめぇええッッ	PRINTFORM 「ひゃぁあああらめぇええッッ
PRINTFORM 　お願いだからやめてぇぇえぇ	PRINTFORM 　お願いだからやめてぇぇえぇ
PRINTFORMW (あぁ……いっそ私も……)	PRINTFORMW (あぁ……いっそ私も……)
PRINTFORMW 「早苗……その姿は……！」	PRINTFORMW 「早苗……その姿は……！」
PRINTFORMW 「必ず助けに戻ってくる！」	PRINTFORMW 「必ず助けに戻ってくる！」
PRINTFORM 「イっ……イっ、くぅぅぅぅっ	PRINTFORM 「イっ……イっ、くぅぅぅぅっ
PRINTFORMW 「くっ……これは、酷いな」	PRINTFORMW 「くっ……これは、酷いな」
PRINTFORMW 「ははっ、白黒の魔法使い」	PRINTFORMW 「ははっ、白黒の魔法使い」
PRINTFORMW 「くふっ…！諏訪子か……」	PRINTFORMW 「くふっ…！諏訪子か……」
PRINTFORMW 「昔を思い出すなぁ諏訪子」	PRINTFORMW 「昔を思い出すなぁ諏訪子」
PRINTFORMW 「さぁ、これを飲みなさい」	PRINTFORMW 「さぁ、これを飲みなさい」
PRINTFORM 「産まれるっもう産まれるうぅ	PRINTFORM 「産まれるっもう産まれるうぅ
PRINTFORM 　はやぐ……産みたいよぉぉっ	PRINTFORM 　はやぐ……産みたいよぉぉっ
PRINTFORM 「うまれちゃうぅぅ～～～ッッ	PRINTFORM 「うまれちゃうぅぅ～～～ッッ
PRINTFORM 「ミルクタンクぶっ壊れるぅっ	PRINTFORM 「ミルクタンクぶっ壊れるぅっ
PRINTFORMW 「ぐはあぁああがっ……ッ」	PRINTFORMW 「ぐはあぁああがっ……ッ」
PRINTFORM 　おっぱいあげりゅなんてぇぇ	PRINTFORM 　おっぱいあげりゅなんてぇぇ
PRINTFORM 　出産絶頂経験＋１～～～ッッ	PRINTFORM 　出産絶頂経験＋１～～～ッッ
PRINTFORM 　産卵絶頂経験＋１～～～ッッ	PRINTFORM 　産卵絶頂経験＋１～～～ッッ
PRINTFORMW 「――へ…蛇みたいに……」	PRINTFORMW 「――へ…蛇みたいに……」
PRINTFORM 「あへえぇあぁっ……あぁんっ	PRINTFORM 「あへえぇあぁっ……あぁんっ
PRINTFORM 　ちくびっ産卵っしゅごぃいｘ	PRINTFORM 　ちくびっ産卵っしゅごぃいｘ
PRINTFORMW 「――ぁ……意…識が……」	PRINTFORMW 「――ぁ……意…識が……」
PRINTFORMW 「ぅうッ、目眩がする……」	PRINTFORMW 「ぅうッ、目眩がする……」
PRINTFORMW 「今なら一人で寝ても……」	PRINTFORMW 「今なら一人で寝ても……」
PRINTFORMW 「今見付かるわけには……」	PRINTFORMW 「今見付かるわけには……」
PRINTFORMW 「ふぐッ…はぁ…はぁッ…」	PRINTFORMW 「ふぐッ…はぁ…はぁッ…」
PRINTFORM 　ぜんぶおかしゃてりゅぅぅっ	PRINTFORM 　ぜんぶおかしゃてりゅぅぅっ
PRINTFORML 「うっ!けほっ、えほっ！」	PRINTFORML 「うっ!けほっ、えほっ！」
PRINTFORM 「なんだ、これは……からだが	PRINTFORM 「なんだ、これは……からだが
PRINTFORM 　ああぁあっ、切ないよぉぉっ	PRINTFORM 　ああぁあっ、切ないよぉぉっ
PRINTFORM 「ひいぃぃやあぁぁああんんっ	PRINTFORM 「ひいぃぃやあぁぁああんんっ
PRINTFORM 　おっぱい絞り強すぎぃぃっ！	PRINTFORM 　おっぱい絞り強すぎぃぃっ！
PRINTFORM 　ミルクなくなっちゃぅぅぅっ	PRINTFORM 　ミルクなくなっちゃぅぅぅっ
PRINTFORM 　く、クリ…気持ちよすぎてぇ	PRINTFORM 　く、クリ…気持ちよすぎてぇ
PRINTFORMW 「他にも犠牲者が……くっ」	PRINTFORMW 「他にも犠牲者が……くっ」
PRINTFORM 「しまったっ！これは触手――	PRINTFORM 「しまったっ！これは触手――
PRINTFORM 　おお、おひりぃいりゃめぇえ	PRINTFORM 　おお、おひりぃいりゃめぇえ
PRINTFORM 　おっぱい虐めにゃいでぇえぇ	PRINTFORM 　おっぱい虐めにゃいでぇえぇ
PRINTFORM 　あ゛ぁあっんああぁあぁっっ	PRINTFORM 　あ゛ぁあっんああぁあぁっっ
PRINTFORM  ご、ごめんにゃ、しゃいぃぃ	PRINTFORM  ご、ごめんにゃ、しゃいぃぃ
PRINTFORMW 「やめ、アアア゛ア゛ァッ」	PRINTFORMW 「やめ、アアア゛ア゛ァッ」
PRINTFORMW 「ひぐぁあぁがあああ！！」	PRINTFORMW 「ひぐぁあぁがあああ！！」
PRINTFORM  きもちっ…きぼちぃいぃっ！	PRINTFORM  きもちっ…きぼちぃいぃっ！
PRINTFORM  もっとおっぱい犯してぇぇっ	PRINTFORM  もっとおっぱい犯してぇぇっ
PRINTFORM 　中にぃっ！一杯種付けしてぇ	PRINTFORM 　中にぃっ！一杯種付けしてぇ
PRINTFORM 「前に出て私が受けよう……	PRINTFORM 「前に出て私が受けよう……
PRINTFORMW 「ちぃっ！ぬかったわ！」	PRINTFORMW 「ちぃっ！ぬかったわ！」
PRINTFORMW 「逃げる場所など無いぞ」	PRINTFORMW 「逃げる場所など無いぞ」
PRINTFORMW 「倒れろぉぉぉッッ！！」	PRINTFORMW 「倒れろぉぉぉッッ！！」
PRINTFORMW 「『バルス』ッッッ！！」	PRINTFORMW 「『バルス』ッッッ！！」
PRINTFORMW 「頼む……倒れてくれ！」	PRINTFORMW 「頼む……倒れてくれ！」
PRINTFORMW 「ばらばらにしてくれる」	PRINTFORMW 「ばらばらにしてくれる」
PRINTFORM 　も…いやぁあぁぁあんんっ	PRINTFORM 　も…いやぁあぁぁあんんっ
PRINTFORM 「くはぁぅっ…はなしぇぇえ	PRINTFORM 「くはぁぅっ…はなしぇぇえ
PRINTFORM 「やめぇ…やめへぇぇえぇっ	PRINTFORM 「やめぇ…やめへぇぇえぇっ
PRINTFORM 「ア゛ァ～…ア゛ァ゛ァ～～	PRINTFORM 「ア゛ァ～…ア゛ァ゛ァ～～
PRINTFORM 「ち、ちから、ためないとぉ	PRINTFORM 「ち、ちから、ためないとぉ
PRINTFORM 　このままひゃ、わたしぃ…	PRINTFORM 　このままひゃ、わたしぃ…
PRINTFORM 「こんにゃのぉ…無理ぃぃい	PRINTFORM 「こんにゃのぉ…無理ぃぃい
PRINTFORM 　かにゃこもうらめぇえぇっ	PRINTFORM 　かにゃこもうらめぇえぇっ
PRINTFORMW 「だから……命だけはッ」	PRINTFORMW 「だから……命だけはッ」
PRINTFORM 　もうっ…らめえぇぇ～～っ	PRINTFORM 　もうっ…らめえぇぇ～～っ
PRINTFORMW 「そっちはダメだっ！！」	PRINTFORMW 「そっちはダメだっ！！」
PRINTFORM かにゃこの雌竿弄り倒してぇ	PRINTFORM かにゃこの雌竿弄り倒してぇ
PRINTFORM 　にゃかにちょうだいぃぃっ	PRINTFORM 　にゃかにちょうだいぃぃっ
PRINTFORM 　むはぁ……私の舌はどうだ	PRINTFORM 　むはぁ……私の舌はどうだ
PRINTFORM 　かえって気持ちいいだろう	PRINTFORM 　かえって気持ちいいだろう
PRINTFORM 　私の胸は具合がいいだろう	PRINTFORM 　私の胸は具合がいいだろう
PRINTFORM ？　自慢じゃないが得意技だ	PRINTFORM ？　自慢じゃないが得意技だ
PRINTFORM 　蛇みたいだろう…んちゅっ	PRINTFORM 　蛇みたいだろう…んちゅっ
PRINTFORMW 「正気に戻れ、ばか者！」	PRINTFORMW 「正気に戻れ、ばか者！」
PRINTFORM 「はぁっ　ふぅっ　はぁぁん	PRINTFORM 「はぁっ　ふぅっ　はぁぁん
PRINTFORMW 「痛いのは初めだけだ！」	PRINTFORMW 「痛いのは初めだけだ！」
PRINTFORMW 「もう、辛抱たまらん！」	PRINTFORMW 「もう、辛抱たまらん！」
PRINTFORM 　中々の名器じゃあないかぁ	PRINTFORM 　中々の名器じゃあないかぁ
PRINTFORM 　それ触っちゃらめええぇぇ	PRINTFORM 　それ触っちゃらめええぇぇ
PRINTFORM 「そんなに仕置きが欲しいか	PRINTFORM 「そんなに仕置きが欲しいか
PRINTFORM 　たっぷり楽しませておくれ	PRINTFORM 　たっぷり楽しませておくれ
PRINTFORM ？！　ほおぉおごぉ～～～っ	PRINTFORM ？！　ほおぉおごぉ～～～っ
PRINTFORM 　このマンコきもいいよぉぉ	PRINTFORM 　このマンコきもいいよぉぉ
PRINTFORM 　せめて外にぃぃぎぃいぃっ	PRINTFORM 　せめて外にぃぃぎぃいぃっ
PRINTFORM 　しゅぐいイっちゃううぅぅ	PRINTFORM 　しゅぐいイっちゃううぅぅ
PRINTFORM 　ミミズ千匹しゅごぃぃぃ…	PRINTFORM 　ミミズ千匹しゅごぃぃぃ…
PRINTFORM 「もう、元に戻れないよぉぉ	PRINTFORM 「もう、元に戻れないよぉぉ
PRINTFORML 「んっ、くぅぅ……ひっ！	PRINTFORML 「んっ、くぅぅ……ひっ！
PRINTFORM 　疼ッ！んあ゛あぁぃッッ！	PRINTFORM 　疼ッ！んあ゛あぁぃッッ！
PRINTFORM 　ンひゃぁァい゛い゛ィッッ	PRINTFORM 　ンひゃぁァい゛い゛ィッッ
PRINTFORM 　んあ…あ゛あ゛ぁぁぁっっ	PRINTFORM 　んあ…あ゛あ゛ぁぁぁっっ
PRINTFORM 　そんな締め付けられたらぁ	PRINTFORM 　そんな締め付けられたらぁ
PRINTFORM 　しゅぐ射精しひゃうぅぅっ	PRINTFORM 　しゅぐ射精しひゃうぅぅっ
PRINTFORM 　こりぇぇ…ふとっしゅぎぃ	PRINTFORM 　こりぇぇ…ふとっしゅぎぃ
PRINTFORM 　尻あにゃ奴隷なんしゅぅぅ	PRINTFORM 　尻あにゃ奴隷なんしゅぅぅ
PRINTFORM 　上手くなったなぁ早苗ぇぇ	PRINTFORM 　上手くなったなぁ早苗ぇぇ
PRINTFORM 　淫乱乳袋いぎゅぅぅぅッッ	PRINTFORM 　淫乱乳袋いぎゅぅぅぅッッ
PRINTFORM 　歯を立てて吸うなぁあッ！	PRINTFORM 　歯を立てて吸うなぁあッ！
PRINTFORM 　むにむにされたらけれぇっ	PRINTFORM 　むにむにされたらけれぇっ
PRINTFORM 　何をするんだ諏訪子おぉッ	PRINTFORM 　何をするんだ諏訪子おぉッ
PRINTFORM 　おまんこしゅごいぃぃぃぃ	PRINTFORM 　おまんこしゅごいぃぃぃぃ
PRINTFORM 「もっと……もっとしてえぇ	PRINTFORM 「もっと……もっとしてえぇ
PRINTFORM 「かにゃこの、ケツ穴にぃっ	PRINTFORM 「かにゃこの、ケツ穴にぃっ
PRINTFORM 　デカちちきもちいよぉぉッ	PRINTFORM 　デカちちきもちいよぉぉッ
PRINTFORM 　しょくしゅのくしぇにぃぃ	PRINTFORM 　しょくしゅのくしぇにぃぃ
PRINTFORM 「お゛お゛ぉっほぉぉぉぉっ	PRINTFORM 「お゛お゛ぉっほぉぉぉぉっ
PRINTFORM 　かにゃこのおぢんぼぉぉッ	PRINTFORM 　かにゃこのおぢんぼぉぉッ
PRINTFORM 　まんこ……いぎゅぅぅぅっ	PRINTFORM 　まんこ……いぎゅぅぅぅっ
PRINTFORM 　しゅぐイッちゃうのぉぉっ	PRINTFORM 　しゅぐイッちゃうのぉぉっ
PRINTFORM 　おっぱいイぎゅうぅぅぅっ	PRINTFORM 　おっぱいイぎゅうぅぅぅっ
PRINTFORM 　イきたくなってりゅぅぅぅ	PRINTFORM 　イきたくなってりゅぅぅぅ
PRINTFORM 「あぁあぁらめ……らめぇ…	PRINTFORM 「あぁあぁらめ……らめぇ…
PRINTFORM 　わらひ……わらひぃぃぃっ	PRINTFORM 　わらひ……わらひぃぃぃっ
PRINTFORM びんかんしゅぎるの、にぃっ	PRINTFORM びんかんしゅぎるの、にぃっ
PRINTFORM 　中は…中はらめなのぉぉっ	PRINTFORM 　中は…中はらめなのぉぉっ
PRINTFORM 　いぎゅああぁああッッ？！	PRINTFORM 　いぎゅああぁああッッ？！
PRINTFORM 　あひやぁぁア゛ア゛ぁッッ	PRINTFORM 　あひやぁぁア゛ア゛ぁッッ
PRINTFORM 「これ…しゅごしゅぎてぇっ	PRINTFORM 「これ…しゅごしゅぎてぇっ
PRINTFORMW 「く…屈するものかぁ！」	PRINTFORMW 「く…屈するものかぁ！」
PRINTFORM 「も……やめてく…れ……」	PRINTFORM 「も……やめてく…れ……」
PRINTFORMW くッ、今当たったら……」	PRINTFORMW くッ、今当たったら……」
PRINTFORM 「まずい……このままじゃぁ	PRINTFORM 「まずい……このままじゃぁ
PRINTFORMW 「くっ、追いつかれた！」	PRINTFORMW 「くっ、追いつかれた！」
PRINTFORMW 早く、終わらせないと！」	PRINTFORMW 早く、終わらせないと！」
PRINTFORMW 「な！……これは一体！」	PRINTFORMW 「な！……これは一体！」
PRINTFORMW 「……ッッ……許せッ！」	PRINTFORMW 「……ッッ……許せッ！」
PRINTFORMW 「いま少し耐えてくれ！」	PRINTFORMW 「いま少し耐えてくれ！」
PRINTFORM 「あ―――ああっぁあ゛あ゛	PRINTFORM 「あ―――ああっぁあ゛あ゛
PRINTFORM 　しゅごいのきまひゅぅぅっ	PRINTFORM 　しゅごいのきまひゅぅぅっ
PRINTFORMW 「やはり、お前も居たか」	PRINTFORMW 「やはり、お前も居たか」
PRINTFORMW 「悪く思うな諏訪子……」	PRINTFORMW 「悪く思うな諏訪子……」
PRINTFORMW 「ゆっくり…慌てずにな」	PRINTFORMW 「ゆっくり…慌てずにな」
PRINTFORMW 「……また体に種を……」	PRINTFORMW 「……また体に種を……」
PRINTFORM 「かにゃこ苗床だ～い好きぃ	PRINTFORM 「かにゃこ苗床だ～い好きぃ
PRINTFORM 「ほぉおぉっ……おごおぉっ	PRINTFORM 「ほぉおぉっ……おごおぉっ
PRINTFORM 「へえあぁぁがッ…ああぁん	PRINTFORM 「へえあぁぁがッ…ああぁん
PRINTFORM 　出産アクメいぎゅうぅぅっ	PRINTFORM 　出産アクメいぎゅうぅぅっ
PRINTFORM 　かにゃこ出産しゅきぃぃっ	PRINTFORM 　かにゃこ出産しゅきぃぃっ
PRINTFORM 「元気、な……赤ちゃん……	PRINTFORM 「元気、な……赤ちゃん……
PRINTFORM また、産み付けされたゃった	PRINTFORM また、産み付けされたゃった
PRINTFORM 「はやく…はやく出ておいで	PRINTFORM 「はやく…はやく出ておいで
PRINTFORM 　かにゃこ産卵しゅきぃぃっ	PRINTFORM 　かにゃこ産卵しゅきぃぃっ
PRINTFORM 　乳腺、卵でこりこりってぇ	PRINTFORM 　乳腺、卵でこりこりってぇ
PRINTFORMW 「そろそろ…限界か……」	PRINTFORMW 「そろそろ…限界か……」
PRINTFORMW 「すまない、限界だ……」	PRINTFORMW 「すまない、限界だ……」
PRINTFORMW 「く……急がなくては！」	PRINTFORMW 「く……急がなくては！」
PRINTFORMW 　やっと…一息つけるな」	PRINTFORMW 　やっと…一息つけるな」
PRINTFORMW 「……疼きが引いていく」	PRINTFORMW 「……疼きが引いていく」
PRINTFORML くっ、きもちわるい……」	PRINTFORML くっ、きもちわるい……」
PRINTFORMW 「あ、危なかった……！」	PRINTFORMW 「あ、危なかった……！」
PRINTFORM 　おひり…おひり熱ゅぃいぃ	PRINTFORM 　おひり…おひり熱ゅぃいぃ
PRINTFORM 　こわされ…ちゃったぁ……	PRINTFORM 　こわされ…ちゃったぁ……
PRINTFORM 　エレクトしちゃいまひたぁ	PRINTFORM 　エレクトしちゃいまひたぁ
PRINTFORM 　お豆ぃぇいじめにゃいでぇ	PRINTFORM 　お豆ぃぇいじめにゃいでぇ
PRINTFORM 　オンバヒラアクメ来りゅ！	PRINTFORM 　オンバヒラアクメ来りゅ！
PRINTFORM 　おおんばひら虐めらめえぇ	PRINTFORM 　おおんばひら虐めらめえぇ
PRINTFORM 　す、すぐイッっちゃうぅぅ	PRINTFORM 　す、すぐイッっちゃうぅぅ
PRINTFORMW 「怪しすぎるだろうが！」	PRINTFORMW 「怪しすぎるだろうが！」
PRINTFORM 　おおぉぉっおちんぽ穴ぁあ	PRINTFORM 　おおぉぉっおちんぽ穴ぁあ
PRINTFORM 　だりぇか、たすけてぇえっ	PRINTFORM 　だりぇか、たすけてぇえっ
PRINTFORMW 「赤いリボン……まさか」	PRINTFORMW 「赤いリボン……まさか」
PRINTFORMW 「麓の巫女までもが……」	PRINTFORMW 「麓の巫女までもが……」
PRINTFORM 「りゃめっ！りゃめぇぇえっ	PRINTFORM 「りゃめっ！りゃめぇぇえっ
PRINTFORM 　おおぉぉおひりいぃぃっっ	PRINTFORM 　おおぉぉおひりいぃぃっっ
PRINTFORM 「ひぎゅぅぅぐおっぱいぃぃ	PRINTFORM 「ひぎゅぅぅぐおっぱいぃぃ
PRINTFORM 「ほええあぁぁぁお豆ぇえぇ	PRINTFORM 「ほええあぁぁぁお豆ぇえぇ
PRINTFORM 　これ以ッ…上……イぐのぉ	PRINTFORM 　これ以ッ…上……イぐのぉ
PRINTFORMW 「かかってくるがいい」	PRINTFORMW 「かかってくるがいい」
PRINTFORM 「こ、これ以上されると…	PRINTFORM 「こ、これ以上されると…
PRINTFORM 「時には引く事も肝心だ」	PRINTFORM 「時には引く事も肝心だ」
PRINTFORM 「はぁ～…はあぁぁ～…ッ	PRINTFORM 「はぁ～…はあぁぁ～…ッ
PRINTFORM （戦う事も……逃げる事も	PRINTFORM （戦う事も……逃げる事も
PRINTFORMW 「風穴を開けてやる！」	PRINTFORMW 「風穴を開けてやる！」
PRINTFORMW 「小手調べといこうか」	PRINTFORMW 「小手調べといこうか」
PRINTFORMW 「うぅッ……残弾が！」	PRINTFORMW 「うぅッ……残弾が！」
PRINTFORMW 「出し惜しみは無しだ」	PRINTFORMW 「出し惜しみは無しだ」
PRINTFORMW 「倒れろぉぉぉっ！！」	PRINTFORMW 「倒れろぉぉぉっ！！」
PRINTFORMW 「父上…お助けを…ッ」	PRINTFORMW 「父上…お助けを…ッ」
PRINTFORMW 「もう斃れてくれぇ！」	PRINTFORMW 「もう斃れてくれぇ！」
PRINTFORM ！　今、感じちゃ……ダメ	PRINTFORM ！　今、感じちゃ……ダメ
PRINTFORM 　しょこらめにゃのぉぉっ	PRINTFORM 　しょこらめにゃのぉぉっ
PRINTFORM 「あっやめ……んんぅうっ	PRINTFORM 「あっやめ……んんぅうっ
PRINTFORM 「ふひゃぁいぃいおひりっ	PRINTFORM 「ふひゃぁいぃいおひりっ
PRINTFORM 「おみゃんしにゃいでぇっ	PRINTFORM 「おみゃんしにゃいでぇっ
PRINTFORM 「今はおまんこ休ませてぇ	PRINTFORM 「今はおまんこ休ませてぇ
PRINTFORM 「かにゃこのウンチあな…	PRINTFORM 「かにゃこのウンチあな…
PRINTFORM っひぃぃぎうゆぅがぉおご	PRINTFORM っひぃぃぎうゆぅがぉおご
PRINTFORM 「いいぎょぉおごおあがぉ	PRINTFORM 「いいぎょぉおごおあがぉ
PRINTFORM 「どうだ、私のパイオツは	PRINTFORM 「どうだ、私のパイオツは
PRINTFORM 「どう？私の自慢のカラダ	PRINTFORM 「どう？私の自慢のカラダ
PRINTFORML 「ふふふ、諦めろ……」	PRINTFORML 「ふふふ、諦めろ……」
PRINTFORM 「お前はもう、私のものだ	PRINTFORM 「お前はもう、私のものだ
PRINTFORM 　すぐ気持ちよくしてやる	PRINTFORM 　すぐ気持ちよくしてやる
PRINTFORM 「聞分けのない不信仰者め	PRINTFORM 「聞分けのない不信仰者め
PRINTFORM 「イッた…ばかりなのにぃ	PRINTFORM 「イッた…ばかりなのにぃ
PRINTFORM 　こいつは半端ではないぞ	PRINTFORM 　こいつは半端ではないぞ
PRINTFORM 「んひぃぃぃぃぃぃぃッッ	PRINTFORM 「んひぃぃぃぃぃぃぃッッ
PRINTFORM 　最高に気持ちイよねぇ…	PRINTFORM 　最高に気持ちイよねぇ…
PRINTFORM 　おんばひら射精でりゅっ	PRINTFORM 　おんばひら射精でりゅっ
PRINTFORM 　粥漬けにしちゃうのぉぉ	PRINTFORM 　粥漬けにしちゃうのぉぉ
PRINTFORM 「第二ラウンド開始～～ッ	PRINTFORM 「第二ラウンド開始～～ッ
PRINTFORMW 「…うぅ…ぁ、が……」	PRINTFORMW 「…うぅ…ぁ、が……」
PRINTFORM 「ゆ、指が、止まらな……	PRINTFORM 「ゆ、指が、止まらな……
PRINTFORMW 「こふっ、ぐぅぅっ！」	PRINTFORMW 「こふっ、ぐぅぅっ！」
PRINTFORM 「イグッまたぁイグぅぅ！	PRINTFORM 「イグッまたぁイグぅぅ！
PRINTFORM 　ごほうびえっひがぁぁっ	PRINTFORM 　ごほうびえっひがぁぁっ
PRINTFORM 「降っ参…しましゅからぁ	PRINTFORM 「降っ参…しましゅからぁ
PRINTFORM 　きもひよしゅぎれぇぇっ	PRINTFORM 　きもひよしゅぎれぇぇっ
PRINTFORM 　まひゃひくぅぅぅぅぅっ	PRINTFORM 　まひゃひくぅぅぅぅぅっ
PRINTFORM 「イっへる、の、にぃぃっ	PRINTFORM 「イっへる、の、にぃぃっ
PRINTFORM 　やめてぇ～～～～～～っ	PRINTFORM 　やめてぇ～～～～～～っ
PRINTFORM 　孕みたくなっちゃぅぅっ	PRINTFORM 　孕みたくなっちゃぅぅっ
PRINTFORM 「ひぃいぅ…やめろぉぉッ	PRINTFORM 「ひぃいぅ…やめろぉぉッ
PRINTFORM 　やさしくぅぅぅ～～～っ	PRINTFORM 　やさしくぅぅぅ～～～っ
PRINTFORM 「ひ、うぅぅぅぅ～～～っ	PRINTFORM 「ひ、うぅぅぅぅ～～～っ
PRINTFORM 　くしぇになるのぉぉっ…	PRINTFORM 　くしぇになるのぉぉっ…
PRINTFORM 「お、おしりっ、やめぇ…	PRINTFORM 「お、おしりっ、やめぇ…
PRINTFORM 　触手ッなんかにぃぃっ！	PRINTFORM 　触手ッなんかにぃぃっ！
PRINTFORM 　おっぱいらめえぇぇえっ	PRINTFORM 　おっぱいらめえぇぇえっ
PRINTFORM 「おっぱいしゅごいぃぃっ	PRINTFORM 「おっぱいしゅごいぃぃっ
PRINTFORM 　催眠じゅつなんかにぃぃ	PRINTFORM 　催眠じゅつなんかにぃぃ
PRINTFORM 　んッ！ア゛ア゛ァ～～ッ	PRINTFORM 　んッ！ア゛ア゛ァ～～ッ
PRINTFORMW 「あぁ…もうだめだ…」	PRINTFORMW 「あぁ…もうだめだ…」
PRINTFORM 「我慢……できないよぉ…	PRINTFORM 「我慢……できないよぉ…
PRINTFORMW 「何、ちょろいもんさ」	PRINTFORMW 「何、ちょろいもんさ」
PRINTFORM しゅごいのちょおらいぃっ	PRINTFORM しゅごいのちょおらいぃっ
PRINTFORM 　ケツマンコ貫いてぇぇぇ	PRINTFORM 　ケツマンコ貫いてぇぇぇ
PRINTFORM 　ガバガバにしてぇぇぇっ	PRINTFORM 　ガバガバにしてぇぇぇっ
PRINTFORM 「かにゃこのドＭ乳首ぃッ	PRINTFORM 「かにゃこのドＭ乳首ぃッ
PRINTFORM 　おっぱいのっ穴にもぉぉ	PRINTFORM 　おっぱいのっ穴にもぉぉ
PRINTFORM 　もっと強く揉んでぇぇッ	PRINTFORM 　もっと強く揉んでぇぇッ
PRINTFORM 　おっぱいもっとしてぇぇ	PRINTFORM 　おっぱいもっとしてぇぇ
PRINTFORM 　わた…しの……弱点んッ	PRINTFORM 　わた…しの……弱点んッ
PRINTFORM 「はあぁッ……んんんぅ～	PRINTFORM 「はあぁッ……んんんぅ～
PRINTFORM 　串刺しにしてぇぇッッ！	PRINTFORM 　串刺しにしてぇぇッッ！
PRINTFORM 　いきなりにゃんてぇぇっ	PRINTFORM 　いきなりにゃんてぇぇっ
PRINTFORM 「ゆるひてくりゃはいぃっ	PRINTFORM 「ゆるひてくりゃはいぃっ
PRINTFORM 「あ゛ぁ゛ッぁぁぁあっっ	PRINTFORM 「あ゛ぁ゛ッぁぁぁあっっ
PRINTFORM 　ア゛ッッううぁああ゛ッ	PRINTFORM 　ア゛ッッううぁああ゛ッ
PRINTFORM 「ひいぃぃうぅぅうんッッ	PRINTFORM 「ひいぃぃうぅぅうんッッ
PRINTFORM 　くりくりもっとらめぇっ	PRINTFORM 　くりくりもっとらめぇっ
PRINTFORM 　すぐにっ、すぐにぃぃっ	PRINTFORM 　すぐにっ、すぐにぃぃっ
PRINTFORM 　中は……中は許してぇっ	PRINTFORM 　中は……中は許してぇっ
PRINTFORM 　中は……嫌なのにぃ……	PRINTFORM 　中は……嫌なのにぃ……
PRINTFORM 　奥……に、当たって……	PRINTFORM 　奥……に、当たって……
PRINTFORM 「ぐはぁあ？！…が……」	PRINTFORM 「ぐはぁあ？！…が……」
PRINTFORM 「ああぁあ……あはは……	PRINTFORM 「ああぁあ……あはは……
PRINTFORM 「やめ……もうやめれぇえ	PRINTFORM 「やめ……もうやめれぇえ
PRINTFORMW 「―――ッがはぁ？！」	PRINTFORMW 「―――ッがはぁ？！」
PRINTFORMW 「うぅ……ｚｚｚ……」	PRINTFORMW 「うぅ……ｚｚｚ……」
PRINTFORMW 「八坂の風が吹く……」	PRINTFORMW 「八坂の風が吹く……」
PRINTFORM 「はぁ～～んぅッだめぇぇ	PRINTFORM 「はぁ～～んぅッだめぇぇ
PRINTFORM 　まらっ、イきゅぅぅぅっ	PRINTFORM 　まらっ、イきゅぅぅぅっ
PRINTFORM 　とまりゃにゃいぃぃぃっ	PRINTFORM 　とまりゃにゃいぃぃぃっ
PRINTFORM 「ひ、ひぎゅぅぅぅううっ	PRINTFORM 「ひ、ひぎゅぅぅぅううっ
PRINTFORM 　イっひゃいまひゅぅぅっ	PRINTFORM 　イっひゃいまひゅぅぅっ
PRINTFORM 　降参しましゅからぁぁあ	PRINTFORM 　降参しましゅからぁぁあ
PRINTFORM 「も、アクメゆるひてぇえ	PRINTFORM 「も、アクメゆるひてぇえ
PRINTFORM 　きひゃいましゅぅぅぅっ	PRINTFORM 　きひゃいましゅぅぅぅっ
PRINTFORM 　まひゃイきまひゅぅぅっ	PRINTFORM 　まひゃイきまひゅぅぅっ
PRINTFORMW 「ん、んん～～～っ！」	PRINTFORMW 「ん、んん～～～っ！」
PRINTFORM 「こ、こぼれてりゅのおぉ	PRINTFORM 「こ、こぼれてりゅのおぉ
PRINTFORMW 「なっ……麓の巫女！」	PRINTFORMW 「なっ……麓の巫女！」
PRINTFORMDW 『――かな…こ……』	PRINTFORMDW 『――かな…こ……』
PRINTFORM また、種付けされたゃった	PRINTFORM また、種付けされたゃった
PRINTFORM 「ふふっ、大きくなってる	PRINTFORM 「ふふっ、大きくなってる
PRINTFORM 「んひゆぅぅぅぅぁあがっ	PRINTFORM 「んひゆぅぅぅぅぁあがっ
PRINTFORM 「んぐぅぅうぅっぁぁあが	PRINTFORM 「んぐぅぅうぅっぁぁあが
PRINTFORM 「あはぁっ、乳首産卵ん～	PRINTFORM 「あはぁっ、乳首産卵ん～
PRINTFORM 　うんんぐうぅぅぅうッッ	PRINTFORM 　うんんぐうぅぅぅうッッ
PRINTFORMW 「ハァ…ハァッ……！」	PRINTFORMW 「ハァ…ハァッ……！」
PRINTFORMW 「どんどん行くよー！」	PRINTFORMW 「どんどん行くよー！」
PRINTFORMW 「……ふぅ…はぁ…っ」	PRINTFORMW 「……ふぅ…はぁ…っ」
PRINTFORM 　いま、襲われたらぁ～～	PRINTFORM 　いま、襲われたらぁ～～
PRINTFORMW 「ふおぉぉぉッッ！！」	PRINTFORMW 「ふおぉぉぉッッ！！」
PRINTFORM 「体の……中にぃぃ～～ッ	PRINTFORM 「体の……中にぃぃ～～ッ
PRINTFORM 　イグのとまんなぃぃいっ	PRINTFORM 　イグのとまんなぃぃいっ
PRINTFORM 「乳汁吸わないれぇえッッ	PRINTFORM 「乳汁吸わないれぇえッッ
PRINTFORM 「はぁ～…はぁ～～～ッッ	PRINTFORM 「はぁ～…はぁ～～～ッッ
PRINTFORM 　あは、だめ…なのにぃい	PRINTFORM 　あは、だめ…なのにぃい
PRINTFORM 　おっぱいらめえぇえぇっ	PRINTFORM 　おっぱいらめえぇえぇっ
PRINTFORM 　や、やめでえ゛ぇええっ	PRINTFORM 　や、やめでえ゛ぇええっ
PRINTFORMW 「まだ、望みはある！」	PRINTFORMW 「まだ、望みはある！」
PRINTFORMDL [0] 素質変化無し	PRINTFORMDL [0] 素質変化無し
PRINTFORM 　あひゃぁぁあひいいぃぃ	PRINTFORM 　あひゃぁぁあひいいぃぃ
PRINTFORM 「んえああぁあぁぎいぃぃ	PRINTFORM 「んえああぁあぁぎいぃぃ
PRINTFORMW 「うぎゃぁああがッッ」	PRINTFORMW 「うぎゃぁああがッッ」
PRINTFORMW 今は……らめぇ……」	PRINTFORMW 今は……らめぇ……」
PRINTFORM 「アァアッ…やめてぇぇ	PRINTFORM 「アァアッ…やめてぇぇ
PRINTFORMW 「貫けぇぇえぇッ！」	PRINTFORMW 「貫けぇぇえぇッ！」
PRINTFORMW 「火力を叩き込む！」	PRINTFORMW 「火力を叩き込む！」
PRINTFORMW 「叩き割ってやる！」	PRINTFORMW 「叩き割ってやる！」
PRINTFORM 　いま……らめぇぇえッ	PRINTFORM 　いま……らめぇぇえッ
PRINTFORM 「いっ……んっくぅぅッ	PRINTFORM 「いっ……んっくぅぅッ
PRINTFORM 　降伏っしましゅからぁ	PRINTFORM 　降伏っしましゅからぁ
PRINTFORM 「へえあぁぎゅぅぃひぃ	PRINTFORM 「へえあぁぎゅぅぃひぃ
PRINTFORM 「ぉほぉぎょぉおぉご…	PRINTFORM 「ぉほぉぎょぉおぉご…
PRINTFORM 　まるで蛇みたいだろう	PRINTFORM 　まるで蛇みたいだろう
PRINTFORM 　どうだ？…きもちいか	PRINTFORM 　どうだ？…きもちいか
PRINTFORM 「好きにしていいんだぞ	PRINTFORM 「好きにしていいんだぞ
PRINTFORMW 「うぅぅっ…くっ！」	PRINTFORMW 「うぅぅっ…くっ！」
PRINTFORMW 「えへへ～、父上～」	PRINTFORMW 「えへへ～、父上～」
PRINTFORMW 「よ、よせ馬鹿者！」	PRINTFORMW 「よ、よせ馬鹿者！」
PRINTFORML 「……私は何を……」	PRINTFORML 「……私は何を……」
PRINTFORM 　次は私のオンバシラだ	PRINTFORM 　次は私のオンバシラだ
PRINTFORM 「次は私のオンバシラだ	PRINTFORM 「次は私のオンバシラだ
PRINTFORM 「そんな格好で誘ってぇ	PRINTFORM 「そんな格好で誘ってぇ
PRINTFORM 　クセになりそうだよぉ	PRINTFORM 　クセになりそうだよぉ
PRINTFORM 　あひぃぃいぁあぁぁっ	PRINTFORM 　あひぃぃいぁあぁぁっ
PRINTFORM 「ふぅ～～スッキリした	PRINTFORM 「ふぅ～～スッキリした
PRINTFORMW 　ひぃぃうぅっ……」	PRINTFORMW 　ひぃぃうぅっ……」
PRINTFORM 「ひぃいっ……あひぃぃ	PRINTFORM 「ひぃいっ……あひぃぃ
PRINTFORM 　処女マンコいいよぉぉ	PRINTFORM 　処女マンコいいよぉぉ
PRINTFORM 「ひぐぅうあああひぃぃ	PRINTFORM 「ひぐぅうあああひぃぃ
PRINTFORM 「くぶッ…んんむぅぅッ	PRINTFORM 「くぶッ…んんむぅぅッ
PRINTFORM 「これで握ると……ほら	PRINTFORM 「これで握ると……ほら
PRINTFORM 　刺激ッ強すぎてぇぇっ	PRINTFORM 　刺激ッ強すぎてぇぇっ
PRINTFORM 　いっそ殺して…あ゛ッ	PRINTFORM 　いっそ殺して…あ゛ッ
PRINTFORM 　あひゃうぅうぅあうっ	PRINTFORM 　あひゃうぅうぅあうっ
PRINTFORM 　色ボケかニャ子にぃっ	PRINTFORM 　色ボケかニャ子にぃっ
PRINTFORM 　ましたぁぁああアッッ	PRINTFORM 　ましたぁぁああアッッ
PRINTFORM 　もぅ……アクメ許ひっ	PRINTFORM 　もぅ……アクメ許ひっ
PRINTFORM 　イっへまひゅぅぅぅっ	PRINTFORM 　イっへまひゅぅぅぅっ
PRINTFORM もうゆるひれえぇえぇっ	PRINTFORM もうゆるひれえぇえぇっ
PRINTFORM 「イきにゃがらぁぁぁっ	PRINTFORM 「イきにゃがらぁぁぁっ
PRINTFORM 　まひゃイきゅぅぅぅっ	PRINTFORM 　まひゃイきゅぅぅぅっ
PRINTFORM 　あ゛～～～～～～～っ	PRINTFORM 　あ゛～～～～～～～っ
PRINTFORM 　イっきまくってぅぅっ	PRINTFORM 　イっきまくってぅぅっ
PRINTFORM 「こ、これすごくてぇ…	PRINTFORM 「こ、これすごくてぇ…
PRINTFORM 　きもひいのもっとぉっ	PRINTFORM 　きもひいのもっとぉっ
PRINTFORM 　きゅんきゅんらめぇっ	PRINTFORM 　きゅんきゅんらめぇっ
PRINTFORM 「ああぁあ！も…だめぇ	PRINTFORM 「ああぁあ！も…だめぇ
PRINTFORM 動かさないでくれぇぇっ	PRINTFORM 動かさないでくれぇぇっ
PRINTFORM 「はぅぅぅッ……つぅぅ	PRINTFORM 「はぅぅぅッ……つぅぅ
PRINTFORM らめぇぇぇぇぇ～～～っ	PRINTFORM らめぇぇぇぇぇ～～～っ
PRINTFORM 　ああぁあああああんっ	PRINTFORM 　ああぁあああああんっ
PRINTFORM 「ばっ！バカ諏訪子ぉ！	PRINTFORM 「ばっ！バカ諏訪子ぉ！
PRINTFORM 　ふあぁっちちうえぇッ	PRINTFORM 　ふあぁっちちうえぇッ
PRINTFORM 　も、ぬるぬるれすねぇ	PRINTFORM 　も、ぬるぬるれすねぇ
PRINTFORM 　ッんひッぃいぃっ！！	PRINTFORM 　ッんひッぃいぃっ！！
PRINTFORM 　やめ……やめてぇぇッ	PRINTFORM 　やめ……やめてぇぇッ
PRINTFORM 　らめ、らめぇぇぇぇっ	PRINTFORM 　らめ、らめぇぇぇぇっ
PRINTFORM 「も、もぉ…だめぇぇッ	PRINTFORM 「も、もぉ…だめぇぇッ
PRINTFORM 　きもひよくひてぇぇっ	PRINTFORM 　きもひよくひてぇぇっ
PRINTFORM 　おっぱいいいのぉぉっ	PRINTFORM 　おっぱいいいのぉぉっ
PRINTFORM 「んっ……はぁぁあんっ	PRINTFORM 「んっ……はぁぁあんっ
PRINTFORM 　おんばひらきたぁぁっ	PRINTFORM 　おんばひらきたぁぁっ
PRINTFORM 　お豆ッ、お豆ぇぇッッ	PRINTFORM 　お豆ッ、お豆ぇぇッッ
PRINTFORM 　気持ちよくしてぇええ	PRINTFORM 　気持ちよくしてぇええ
PRINTFORM 「あッんんぅぅううぅ～	PRINTFORM 「あッんんぅぅううぅ～
PRINTFORM 　ヤり殺してぇぇッッ！	PRINTFORM 　ヤり殺してぇぇッッ！
PRINTFORM 「ひゃぁ…あひっぃいっ	PRINTFORM 「ひゃぁ…あひっぃいっ
PRINTFORM 　ば、バカにするなあぁ	PRINTFORM 　ば、バカにするなあぁ
PRINTFORM 　おっぱいらめぇぇえっ	PRINTFORM 　おっぱいらめぇぇえっ
PRINTFORM 「こすこすらめえぇえっ	PRINTFORM 「こすこすらめえぇえっ
PRINTFORM 「いれにゃいれぇぇえっ	PRINTFORM 「いれにゃいれぇぇえっ
PRINTFORM 「奥まで……届いて……	PRINTFORM 「奥まで……届いて……
PRINTFORM 　ダメなのに、身体がぁ	PRINTFORM 　ダメなのに、身体がぁ
PRINTFORM 「そ、それは、だめだッ	PRINTFORM 「そ、それは、だめだッ
PRINTFORMW 「や……やめて……」	PRINTFORMW 「や……やめて……」
PRINTFORMW 「はぁぁんんぅ……」	PRINTFORMW 「はぁぁんんぅ……」
PRINTFORMW 「ハァッ…ハァッ…」	PRINTFORMW 「ハァッ…ハァッ…」
PRINTFORM 　とまりゃにゃいぃぃっ	PRINTFORM 　とまりゃにゃいぃぃっ
PRINTFORM イっちゃいまひゅぅぅっ	PRINTFORM イっちゃいまひゅぅぅっ
PRINTFORM 「ひああぁあぁぁぁぁっ	PRINTFORM 「ひああぁあぁぁぁぁっ
PRINTFORM 「っあぁあぁぁぁーっ…	PRINTFORM 「っあぁあぁぁぁーっ…
PRINTFORM 「みる、くっ、れっ……	PRINTFORM 「みる、くっ、れっ……
PRINTFORMW 「―――ッッ！！！」	PRINTFORMW 「―――ッッ！！！」
PRINTFORMW 「これは……酷い！」	PRINTFORMW 「これは……酷い！」
PRINTFORMW 「――ッッ！！！！」	PRINTFORMW 「――ッッ！！！！」
PRINTFORMW 「諏訪子じゃないか」	PRINTFORMW 「諏訪子じゃないか」
PRINTFORMW 「許せ、早苗ッッ！」	PRINTFORMW 「許せ、早苗ッッ！」
PRINTFORMW 「……気をつけてな」	PRINTFORMW 「……気をつけてな」
PRINTFORM おおおぅうんんんっ……	PRINTFORM おおおぅうんんんっ……
PRINTFORMW 「う…、気分が……」	PRINTFORMW 「う…、気分が……」
PRINTFORM 　触手授乳らめぇえぇっ	PRINTFORM 　触手授乳らめぇえぇっ
PRINTFORM 　おっぱいらめぇええっ	PRINTFORM 　おっぱいらめぇええっ
PRINTFORM 「へうぅぅううぅぎいぃ	PRINTFORM 「へうぅぅううぅぎいぃ
PRINTFORM 　ばけもにょなんかにぃ	PRINTFORM 　ばけもにょなんかにぃ
PRINTFORM 　子孫繁栄ばんじゃいっ	PRINTFORM 　子孫繁栄ばんじゃいっ
PRINTFORM 「今度はお尻の穴ぁ～～	PRINTFORM 「今度はお尻の穴ぁ～～
PRINTFORM 　おおお、おっぱいぃぃ	PRINTFORM 　おおお、おっぱいぃぃ
PRINTFORMW 「あ…んんんんっっ」	PRINTFORMW 「あ…んんんんっっ」
PRINTFORM 「今…触手が来たらぁっ	PRINTFORM 「今…触手が来たらぁっ
PRINTFORMW 「Ｍ２火炎放射器か」	PRINTFORMW 「Ｍ２火炎放射器か」
PRINTFORMW 「むっ、これは……」	PRINTFORMW 「むっ、これは……」
PRINTFORMW 「退けい、化生共！」	PRINTFORMW 「退けい、化生共！」
PRINTFORMW 「生き返ったよ……」	PRINTFORMW 「生き返ったよ……」
PRINTFORMW 「？………ひぃ！！」	PRINTFORMW 「？………ひぃ！！」
PRINTFORM 　ぜんぶしょくしゅうぅ	PRINTFORM 　ぜんぶしょくしゅうぅ
PRINTFORMW 「――しまったっ！」	PRINTFORMW 「――しまったっ！」
PRINTFORM 「あひぃぃいぎゅぅうぅ	PRINTFORM 「あひぃぃいぎゅぅうぅ
PRINTFORM 「ぅぅああぁ……あんっ	PRINTFORM 「ぅぅああぁ……あんっ
PRINTFORM 「やぁあぁやめえぇぇっ	PRINTFORM 「やぁあぁやめえぇぇっ
PRINTFORM 　あっあぁぁぁぁんぅっ	PRINTFORM 　あっあぁぁぁぁんぅっ
PRINTFORM 　これ…これだよぉぉっ	PRINTFORM 　これ…これだよぉぉっ
PRINTFORM 　しまった！あぁぁぁあ	PRINTFORM 　しまった！あぁぁぁあ
PRINTFORMW 「わ、私は嫌だよ！」	PRINTFORMW 「わ、私は嫌だよ！」
PRINTFORM 　おひり熱ゅいぃぃいっ	PRINTFORM 　おひり熱ゅいぃぃいっ
PRINTFORM 「かにゃこおっぱいっっ	PRINTFORM 「かにゃこおっぱいっっ
PRINTFORM 　もっと、敏っ感にぃぃ	PRINTFORM 　もっと、敏っ感にぃぃ
PRINTFORM 　クリトリスらめぇえっ	PRINTFORM 　クリトリスらめぇえっ
PRINTFORM 　お豆、虐めたらぁぁあ	PRINTFORM 　お豆、虐めたらぁぁあ
PRINTFORM 　神奈子のっメス穴っ！	PRINTFORM 　神奈子のっメス穴っ！
PRINTFORM 「ンンンーーっっ！！！	PRINTFORM 「ンンンーーっっ！！！
PRINTFORM 　ふぎょぉぉぉぉぉおっ	PRINTFORM 　ふぎょぉぉぉぉぉおっ
PRINTFORM 「こ、こにょざーめんっ	PRINTFORM 「こ、こにょざーめんっ
PRINTFORM 　媚薬が……あひいぃい	PRINTFORM 　媚薬が……あひいぃい
PRINTFORMW 「これは数珠か……」	PRINTFORMW 「これは数珠か……」
PRINTFORM  んひゃあぁああぃいぃ	PRINTFORM  んひゃあぁああぃいぃ
PRINTFORM 「んにゃア゛ア゛アァァ	PRINTFORM 「んにゃア゛ア゛アァァ
PRINTFORM 「ふぎょぉあおおぉああ	PRINTFORM 「ふぎょぉあおおぉああ
PRINTFORM 「ふぎいぁぁあがああっ	PRINTFORM 「ふぎいぁぁあがああっ
PRINTFORM 「手遅れになる前に」	PRINTFORM 「手遅れになる前に」
PRINTFORM 　今はっ退かないとぉ	PRINTFORM 　今はっ退かないとぉ
PRINTFORMW 「戦に情けは無用」	PRINTFORMW 「戦に情けは無用」
PRINTFORMW 「私に触れるな！」	PRINTFORMW 「私に触れるな！」
PRINTFORMW 「刈り取ってやる」	PRINTFORMW 「刈り取ってやる」
PRINTFORMW 「頭が高い、跪け」	PRINTFORMW 「頭が高い、跪け」
PRINTFORMW ！　このぉっ！…」	PRINTFORMW ！　このぉっ！…」
PRINTFORM 「ひいいぃんんんんッ	PRINTFORM 「ひいいぃんんんんッ
PRINTFORM 　ぁあ゛あ゛あぁぁっ	PRINTFORM 　ぁあ゛あ゛あぁぁっ
PRINTFORM 「いみゃらめぇぇぇっ	PRINTFORM 「いみゃらめぇぇぇっ
PRINTFORM 「もぅ…もうらめぇえ	PRINTFORM 「もぅ…もうらめぇえ
PRINTFORMW 「きゃーーー！！」	PRINTFORMW 「きゃーーー！！」
PRINTFORM 　ぷはぁっ……レロッ	PRINTFORM 　ぷはぁっ……レロッ
PRINTFORM 「えへへ～……ちゅっ	PRINTFORM 「えへへ～……ちゅっ
PRINTFORM 　しょくしゅ美味し…	PRINTFORM 　しょくしゅ美味し…
PRINTFORM 「―――ひぃぃいんッ	PRINTFORM 「―――ひぃぃいんッ
PRINTFORM 「まだまだ足らないよ	PRINTFORM 「まだまだ足らないよ
PRINTFORML 「はぁ～～はひぃ」	PRINTFORML 「はぁ～～はひぃ」
PRINTFORM 「可愛がってやるぞぉ	PRINTFORM 「可愛がってやるぞぉ
PRINTFORM 「イくっ、イくぅぅっ	PRINTFORM 「イくっ、イくぅぅっ
PRINTFORM 「私は神様だからねぇ	PRINTFORM 「私は神様だからねぇ
PRINTFORM 　うごかにゃいれえぇ	PRINTFORM 　うごかにゃいれえぇ
PRINTFORM 　マンコこしゅれてぇ	PRINTFORM 　マンコこしゅれてぇ
PRINTFORMW 「う、あ…中に…」	PRINTFORMW 「う、あ…中に…」
PRINTFORM 　も…犯さにゃいでぇ	PRINTFORM 　も…犯さにゃいでぇ
PRINTFORM 　ああっあぁあんんっ	PRINTFORM 　ああっあぁあんんっ
PRINTFORM 「へっぐぅ…んふぅ～	PRINTFORM 「へっぐぅ…んふぅ～
PRINTFORM 　まらイきゅぅぅぅっ	PRINTFORM 　まらイきゅぅぅぅっ
PRINTFORM 「とまんにゃいぃぃ！	PRINTFORM 「とまんにゃいぃぃ！
PRINTFORMW 「っかふ、ぁ……」	PRINTFORMW 「っかふ、ぁ……」
PRINTFORM 　へえアアアァアッッ	PRINTFORM 　へえアアアァアッッ
PRINTFORM 「っっっあ～～～～～	PRINTFORM 「っっっあ～～～～～
PRINTFORM 「やあぁあらめえぇっ	PRINTFORM 「やあぁあらめえぇっ
PRINTFORM 　こうひゃんしましゅ	PRINTFORM 　こうひゃんしましゅ
PRINTFORM 　はひぃぃぃぃぃっ！	PRINTFORM 　はひぃぃぃぃぃっ！
PRINTFORM 「アァア゛～～～～～	PRINTFORM 「アァア゛～～～～～
PRINTFORM 　これりゃめぇぇぇっ	PRINTFORM 　これりゃめぇぇぇっ
PRINTFORM 「あはあぁぁぁぁんっ	PRINTFORM 「あはあぁぁぁぁんっ
PRINTFORM 　っひ、ひ～～～～っ	PRINTFORM 　っひ、ひ～～～～っ
PRINTFORM 　それらなのぉ～～っ	PRINTFORM 　それらなのぉ～～っ
PRINTFORM 「おねがいひますぅっ	PRINTFORM 「おねがいひますぅっ
PRINTFORM 「だめ……だめぇえぇ	PRINTFORM 「だめ……だめぇえぇ
PRINTFORM 　おぉっんばひらぁぁ	PRINTFORM 　おぉっんばひらぁぁ
PRINTFORM 　我慢…できらいいｘ	PRINTFORM 　我慢…できらいいｘ
PRINTFORM 「んっ、あんぅぅうっ	PRINTFORM 「んっ、あんぅぅうっ
PRINTFORM 　おひりっ、ひゅごっ	PRINTFORM 　おひりっ、ひゅごっ
PRINTFORM 　んんぅうひぃぃぃッ	PRINTFORM 　んんぅうひぃぃぃッ
PRINTFORM 　ひいうっぅううっっ	PRINTFORM 　ひいうっぅううっっ
PRINTFORM 「嫌っ…嫌あぁぁあッ	PRINTFORM 「嫌っ…嫌あぁぁあッ
PRINTFORM 　イ゛っぐゅぅぅぅっ	PRINTFORM 　イ゛っぐゅぅぅぅっ
PRINTFORM 　こんな所で…あんっ	PRINTFORM 　こんな所で…あんっ
PRINTFORM 　体…かってにぃぃっ	PRINTFORM 　体…かってにぃぃっ
PRINTFORM 　わたしのかりゃだぁ	PRINTFORM 　わたしのかりゃだぁ
PRINTFORM 「ひゃあぁあッらめぇ	PRINTFORM 「ひゃあぁあッらめぇ
PRINTFORM 「こんなところでぇっ	PRINTFORM 「こんなところでぇっ
PRINTFORM 「ふざけてる場合かぁ	PRINTFORM 「ふざけてる場合かぁ
PRINTFORM 　しゅぐにぃぃぃぃっ	PRINTFORM 　しゅぐにぃぃぃぃっ
PRINTFORM 　ああぁああいいいぐ	PRINTFORM 　ああぁああいいいぐ
PRINTFORM 「身も……心も………	PRINTFORM 「身も……心も………
PRINTFORMW 「も……もう無理」	PRINTFORMW 「も……もう無理」
PRINTFORM 　はやくちょうだいっ	PRINTFORM 　はやくちょうだいっ
PRINTFORM 　ひりのあにゃぁあっ	PRINTFORM 　ひりのあにゃぁあっ
PRINTFORM 　おほぉぉぉぉぉっっ	PRINTFORM 　おほぉぉぉぉぉっっ
PRINTFORM 「かにゃこのケツ穴ぁ	PRINTFORM 「かにゃこのケツ穴ぁ
PRINTFORM 　ち、乳首ぃぃぃッッ	PRINTFORM 　ち、乳首ぃぃぃッッ
PRINTFORM 「んうぅぅうーーっっ	PRINTFORM 「んうぅぅうーーっっ
PRINTFORM 「あひア゛ア゛ァァッ	PRINTFORM 「あひア゛ア゛ァァッ
PRINTFORM 「ひゃッあ゛あぁんっ	PRINTFORM 「ひゃッあ゛あぁんっ
PRINTFORM 　淫乱メス竿ぉぉぉっ	PRINTFORM 　淫乱メス竿ぉぉぉっ
PRINTFORM 　あぎゃひぃぃイ゛っ	PRINTFORM 　あぎゃひぃぃイ゛っ
PRINTFORM 　おごがぁ……んがっ	PRINTFORM 　おごがぁ……んがっ
PRINTFORM 「やッ、ああぁんんっ	PRINTFORM 「やッ、ああぁんんっ
PRINTFORM 　じらさないでえぇえ	PRINTFORM 　じらさないでえぇえ
PRINTFORM 　挿入きたぁぁああッ	PRINTFORM 　挿入きたぁぁああッ
PRINTFORM 　敏ッ感すぎるからぁ	PRINTFORM 　敏ッ感すぎるからぁ
PRINTFORM 「ひぃぃいぃんんんっ	PRINTFORM 「ひぃぃいぃんんんっ
PRINTFORM 　おちんぼアクメぇぇ	PRINTFORM 　おちんぼアクメぇぇ
PRINTFORM 「おげえ゛ぇ゛え゛っ	PRINTFORM 「おげえ゛ぇ゛え゛っ
PRINTFORM 「どんどん気持ちよく	PRINTFORM 「どんどん気持ちよく
PRINTFORM 「あ゛あ゛あぁぁぁっ	PRINTFORM 「あ゛あ゛あぁぁぁっ
PRINTFORM 「ひぃぃいいんんっっ	PRINTFORM 「ひぃぃいいんんっっ
PRINTFORM 　な、中はゆるし……	PRINTFORM 　な、中はゆるし……
PRINTFORM 　しゅぐイっちゃ……	PRINTFORM 　しゅぐイっちゃ……
PRINTFORMW 「……しまった！」	PRINTFORMW 「……しまった！」
PRINTFORMW 「今の私には……」	PRINTFORMW 「今の私には……」
PRINTFORM 「見られてるにぃ……	PRINTFORM 「見られてるにぃ……
PRINTFORM 　ゆるひれぇぇぇぇっ	PRINTFORM 　ゆるひれぇぇぇぇっ
PRINTFORM 　イぎまぐるのぉぉっ	PRINTFORM 　イぎまぐるのぉぉっ
PRINTFORM 「えひぃぃあぁああっ	PRINTFORM 「えひぃぃあぁああっ
PRINTFORM 　いってりゅからぁっ	PRINTFORM 　いってりゅからぁっ
PRINTFORM 　んあ゛あ゛ぁぁッッ	PRINTFORM 　んあ゛あ゛ぁぁッッ
PRINTFORM 　これしゅごいぃぃっ	PRINTFORM 　これしゅごいぃぃっ
PRINTFORM 　やあぁぁあぁぁんっ	PRINTFORM 　やあぁぁあぁぁんっ
PRINTFORM 　イきまひゅうぅぅっ	PRINTFORM 　イきまひゅうぅぅっ
PRINTFORM ふにゃああぁぁぁぁん	PRINTFORM ふにゃああぁぁぁぁん
PRINTFORM 　しゅわないでぇえっ	PRINTFORM 　しゅわないでぇえっ
PRINTFORM 　らめっ、ら―――っ	PRINTFORM 　らめっ、ら―――っ
PRINTFORMW 「背中は任せた！」	PRINTFORMW 「背中は任せた！」
PRINTFORMW 「……悪く思うな」	PRINTFORMW 「……悪く思うな」
PRINTFORM 　触手しゃん産めるよ	PRINTFORM 　触手しゃん産めるよ
PRINTFORM 　ううぶぅぅぅうッッ	PRINTFORM 　ううぶぅぅぅうッッ
PRINTFORMW 「はっ…うぅぅっ」	PRINTFORMW 「はっ…うぅぅっ」
PRINTFORM 　も…らめぇえぇえッ	PRINTFORM 　も…らめぇえぇえッ
PRINTFORM 「らめぇえなのにぃッ	PRINTFORM 「らめぇえなのにぃッ
PRINTFORM 　おっぱい吸われてっ	PRINTFORM 　おっぱい吸われてっ
PRINTFORM 　イっちゃうぅぅぅっ	PRINTFORM 　イっちゃうぅぅぅっ
PRINTFORMW 「うぅひぃっ…！」	PRINTFORMW 「うぅひぃっ…！」
PRINTFORMW 「ひぃぃぃ？！！」	PRINTFORMW 「ひぃぃぃ？！！」
PRINTFORM んうぅうぅううぅ……	PRINTFORM んうぅうぅううぅ……
PRINTFORMW 「失せよ、化生共」	PRINTFORMW 「失せよ、化生共」
PRINTFORMW 「……汚らわしい」	PRINTFORMW 「……汚らわしい」
PRINTFORMW 「うぅ……ぐ……」	PRINTFORMW 「うぅ……ぐ……」
PRINTFORMW 「戦況は不利か…」	PRINTFORMW 「戦況は不利か…」
PRINTFORMW 「今、何かが……」	PRINTFORMW 「今、何かが……」
PRINTFORM 　めちゃくちゃにぃぃ	PRINTFORM 　めちゃくちゃにぃぃ
PRINTFORM 　きもぢ…よすぎぃぃ	PRINTFORM 　きもぢ…よすぎぃぃ
PRINTFORM 　あちゅくなってぇっ	PRINTFORM 　あちゅくなってぇっ
PRINTFORM 　からだ、疼いてぇえ	PRINTFORM 　からだ、疼いてぇえ
PRINTFORM 　んほぉぉぉおぉっっ	PRINTFORM 　んほぉぉぉおぉっっ
PRINTFORM 「ひゅぎぃいぃぃッッ	PRINTFORM 「ひゅぎぃいぃぃッッ
PRINTFORM 　おっぱいらめぇぇえ	PRINTFORM 　おっぱいらめぇぇえ
PRINTFORM 「やぁぁやめてぇっ！	PRINTFORM 「やぁぁやめてぇっ！
PRINTFORM 　イキ死んじゃうぅぅ	PRINTFORM 　イキ死んじゃうぅぅ
PRINTFORM 　まんこらめぇぇぇっ	PRINTFORM 　まんこらめぇぇぇっ
PRINTFORM 「！！――ひいんぅっ	PRINTFORM 「！！――ひいんぅっ
PRINTFORM 　また、敏感にぃぃっ	PRINTFORM 　また、敏感にぃぃっ
PRINTFORM 「なくなっちゃうぅ！	PRINTFORM 「なくなっちゃうぅ！
PRINTFORM 　りゃめぇぇぇ～～っ	PRINTFORM 　りゃめぇぇぇ～～っ
PRINTFORM 「へあぁあがががぁが	PRINTFORM 「へあぁあがががぁが
PRINTFORMW 「ダメ……か……」	PRINTFORMW 「ダメ……か……」
PRINTFORM 　ひぃいぃぃ～～ッッ	PRINTFORM 　ひぃいぃぃ～～ッッ
PRINTFORM 「んひょぉおほぉぉぉ	PRINTFORM 「んひょぉおほぉぉぉ
PRINTFORMW 「八坂の風よ！」	PRINTFORMW 「八坂の風よ！」
PRINTFORMW 「死ねぇぇッ！」	PRINTFORMW 「死ねぇぇッ！」
PRINTFORM 「ひゃぁあぁいぃっ	PRINTFORM 「ひゃぁあぁいぃっ
PRINTFORM 　この、このぉぉっ	PRINTFORM 　この、このぉぉっ
PRINTFORM 「おごおぉぉぅうぅ	PRINTFORM 「おごおぉぉぅうぅ
PRINTFORM 「ズコバコらめぇえ	PRINTFORM 「ズコバコらめぇえ
PRINTFORM 「おんっんぐうっぅ	PRINTFORM 「おんっんぐうっぅ
PRINTFORM うぶゅぅうひゅぃぃ	PRINTFORM うぶゅぅうひゅぃぃ
PRINTFORM 「へええあぁあひぃ	PRINTFORM 「へええあぁあひぃ
PRINTFORM 「触手しゃん好きぃ	PRINTFORM 「触手しゃん好きぃ
PRINTFORM 「はぁぁあぁんんっ	PRINTFORM 「はぁぁあぁんんっ
PRINTFORMW 「ぐうぅぅッ！」	PRINTFORMW 「ぐうぅぅッ！」
PRINTFORMW 「だめ…だ……」	PRINTFORMW 「だめ…だ……」
PRINTFORM 「ひいぃぃいぃんっ	PRINTFORM 「ひいぃぃいぃんっ
PRINTFORM 　いたいぃ……のが	PRINTFORM 　いたいぃ……のが
PRINTFORM 　イっちゃぅぅぅっ	PRINTFORM 　イっちゃぅぅぅっ
PRINTFORM 　このマンコすごっ	PRINTFORM 　このマンコすごっ
PRINTFORM 　外に神の粥出して	PRINTFORM 　外に神の粥出して
PRINTFORMW 「う、くっ…！」	PRINTFORMW 「う、くっ…！」
PRINTFORM 　やめてええぇぇっ	PRINTFORM 　やめてええぇぇっ
PRINTFORM 「んひぃぃ～～ッッ	PRINTFORM 「んひぃぃ～～ッッ
PRINTFORM 　れきにゃいぃっ！	PRINTFORM 　れきにゃいぃっ！
PRINTFORM 　イっひゃぅうぅッ	PRINTFORM 　イっひゃぅうぅッ
PRINTFORM 　ひくぅぅぅぅぅっ	PRINTFORM 　ひくぅぅぅぅぅっ
PRINTFORM 「ひゅいぎぃぃいぃ	PRINTFORM 「ひゅいぎぃぃいぃ
PRINTFORM 　伏しましゅぅぅう	PRINTFORM 　伏しましゅぅぅう
PRINTFORM 　イっひゃいぅぅっ	PRINTFORM 　イっひゃいぅぅっ
PRINTFORM 「えっひなわらひっ	PRINTFORM 「えっひなわらひっ
PRINTFORM 　ゆるひれぇぇぇっ	PRINTFORM 　ゆるひれぇぇぇっ
PRINTFORM 　もうやらぁぁぁっ	PRINTFORM 　もうやらぁぁぁっ
PRINTFORM 「あ゛～～～～～っ	PRINTFORM 「あ゛～～～～～っ
PRINTFORM 　そ…そこおっ……	PRINTFORM 　そ…そこおっ……
PRINTFORM 　しゅごいのおぉっ	PRINTFORM 　しゅごいのおぉっ
PRINTFORM 　破裂しちゃうぅぅ	PRINTFORM 　破裂しちゃうぅぅ
PRINTFORM 　っひ、っっっひっ	PRINTFORM 　っひ、っっっひっ
PRINTFORM 　これ、んんうあッ	PRINTFORM 　これ、んんうあッ
PRINTFORM 　おほぉぉぉっぅっ	PRINTFORM 　おほぉぉぉっぅっ
PRINTFORM 　あふぅぅぅんんっ	PRINTFORM 　あふぅぅぅんんっ
PRINTFORM 　こつこつされてっ	PRINTFORM 　こつこつされてっ
PRINTFORM 「ご主人様あぁ～～	PRINTFORM 「ご主人様あぁ～～
PRINTFORM 　我慢……できない	PRINTFORM 　我慢……できない
PRINTFORM 　おひりぃぃぃッッ	PRINTFORM 　おひりぃぃぃッッ
PRINTFORM 「おひりのあなぁぁ	PRINTFORM 「おひりのあなぁぁ
PRINTFORM 「ひゃぎゅぅぅうぅ	PRINTFORM 「ひゃぎゅぅぅうぅ
PRINTFORM 「んあぁぁーーッッ	PRINTFORM 「んあぁぁーーッッ
PRINTFORM 「あひゃあぁぁぁっ	PRINTFORM 「あひゃあぁぁぁっ
PRINTFORM 　おっぱいいィィっ	PRINTFORM 　おっぱいいィィっ
PRINTFORM 　これしゅきぃぃっ	PRINTFORM 　これしゅきぃぃっ
PRINTFORM 　あひぃぃいんッッ	PRINTFORM 　あひぃぃいんッッ
PRINTFORM 　せつないのッ……	PRINTFORM 　せつないのッ……
PRINTFORM 「へぎゅぅぅぅぅッ	PRINTFORM 「へぎゅぅぅぅぅッ
PRINTFORM 　おっぱいはぁぁっ	PRINTFORM 　おっぱいはぁぁっ
PRINTFORM 「ふぎゅぅぅぅうぁ	PRINTFORM 「ふぎゅぅぅぅうぁ
PRINTFORM 「へえあああがぁっ	PRINTFORM 「へえあああがぁっ
PRINTFORM 　お豆ゆるしてぇっ	PRINTFORM 　お豆ゆるしてぇっ
PRINTFORM 「ひゃぁあやめ……	PRINTFORM 「ひゃぁあやめ……
PRINTFORM 　あひぃぃぃぃんっ	PRINTFORM 　あひぃぃぃぃんっ
PRINTFORM 「やぁあやめぇぇっ	PRINTFORM 「やぁあやめぇぇっ
PRINTFORM 「んひぃぃぃぃッッ	PRINTFORM 「んひぃぃぃぃッッ
PRINTFORM 　そこらッめぇぇ…	PRINTFORM 　そこらッめぇぇ…
PRINTFORM 　そんにゃあぁ……	PRINTFORM 　そんにゃあぁ……
PRINTFORMW 「ひぁあぁ！？」	PRINTFORMW 「ひぁあぁ！？」
PRINTFORM 「ひぎゅぅぅうぅっ	PRINTFORM 「ひぎゅぅぅうぅっ
PRINTFORM 　肌が直接うぅっん	PRINTFORM 　肌が直接うぅっん
PRINTFORMW 「……なんだと」	PRINTFORMW 「……なんだと」
PRINTFORM 　イっれるのにぃっ	PRINTFORM 　イっれるのにぃっ
PRINTFORM 「イっへるのぉぉっ	PRINTFORM 「イっへるのぉぉっ
PRINTFORM 　ゆるひてぇぇえっ	PRINTFORM 　ゆるひてぇぇえっ
PRINTFORM 　きまったるからぁ	PRINTFORM 　きまったるからぁ
PRINTFORM 「あへあぁあぁぁぁ	PRINTFORM 「あへあぁあぁぁぁ
PRINTFORM 　あひぃぃいぃぃい	PRINTFORM 　あひぃぃいぃぃい
PRINTFORM 　～～～～～～～っ	PRINTFORM 　～～～～～～～っ
PRINTFORM 　イきまひたぁぁっ	PRINTFORM 　イきまひたぁぁっ
PRINTFORM 　ああぁあぁぁぁっ	PRINTFORM 　ああぁあぁぁぁっ
PRINTFORM 「ひぎゅぅぅううあ	PRINTFORM 「ひぎゅぅぅううあ
PRINTFORM 　イグの休ませ……	PRINTFORM 　イグの休ませ……
PRINTFORM 「れ、れもおぉぉっ	PRINTFORM 「れ、れもおぉぉっ
PRINTFORM 　イっちゃうぅぅっ	PRINTFORM 　イっちゃうぅぅっ
PRINTFORM 「ひあああぁぁぁん	PRINTFORM 「ひあああぁぁぁん
PRINTFORM 　うぅぅ～～～～っ	PRINTFORM 　うぅぅ～～～～っ
PRINTFORM 　もっろゆっくりぃ	PRINTFORM 　もっろゆっくりぃ
PRINTFORMW 「――許せっ！」	PRINTFORMW 「――許せっ！」
PRINTFORMDW 『……コロス』	PRINTFORMDW 『……コロス』
PRINTFORM 　またうまれうぅっ	PRINTFORM 　またうまれうぅっ
PRINTFORM 　乳射精アクメッッ	PRINTFORM 　乳射精アクメッッ
PRINTFORM 　イぎゅぅぅうぅぅ	PRINTFORM 　イぎゅぅぅうぅぅ
PRINTFORM 　うまっれりゅぅっ	PRINTFORM 　うまっれりゅぅっ
PRINTFORM 　授乳らめぇえぇっ	PRINTFORM 　授乳らめぇえぇっ
PRINTFORM 　アナル産卵好きぃ	PRINTFORM 　アナル産卵好きぃ
PRINTFORM 「へぎゃあぁがっっ	PRINTFORM 「へぎゃあぁがっっ
PRINTFORM 「ひゃぁああんんっ	PRINTFORM 「ひゃぁああんんっ
PRINTFORM 「ひいぃいあいぃい	PRINTFORM 「ひいぃいあいぃい
PRINTFORML 「うわっ！！？」	PRINTFORML 「うわっ！！？」
PRINTFORM 　んぎゅあうああう	PRINTFORM 　んぎゅあうああう
PRINTFORM 　れきないのぉぉっ	PRINTFORM 　れきないのぉぉっ
PRINTFORM 「ほぎょぉぉぉっっ	PRINTFORM 「ほぎょぉぉぉっっ
PRINTFORM 　らめえぇぇえっっ	PRINTFORM 　らめえぇぇえっっ
PRINTFORM 「ひぃぃぃぅぅッッ	PRINTFORM 「ひぃぃぃぅぅッッ
PRINTFORM 　あがっ…あははぁ	PRINTFORM 　あがっ…あははぁ
PRINTFORM 「中で暴れないでぇ	PRINTFORM 「中で暴れないでぇ
PRINTFORM 　ひぃぃいぃイぐっ	PRINTFORM 　ひぃぃいぃイぐっ
PRINTFORM 「…ひぃ…ぃぃ……	PRINTFORM 「…ひぃ…ぃぃ……
PRINTFORMW 「ぐはっ……！」	PRINTFORMW 「ぐはっ……！」
PRINTFORMW 「けええぃっ！」	PRINTFORMW 「けええぃっ！」
PRINTFORM 「ふうぐぉぉおぉが	PRINTFORM 「ふうぐぉぉおぉが
PRINTFORM 　焼けるみたいにぃ	PRINTFORM 　焼けるみたいにぃ
PRINTFORM 「ひいぃあぁあっっ	PRINTFORM 「ひいぃあぁあっっ
PRINTFORM 　んひぃぃいいぃっ	PRINTFORM 　んひぃぃいいぃっ
PRINTFORM 「んほぉぉおぉぉっ	PRINTFORM 「んほぉぉおぉぉっ
PRINTFORM 　爆発しちゃぅぅっ	PRINTFORM 　爆発しちゃぅぅっ
PRINTFORM 「逆っっ流してぇえ	PRINTFORM 「逆っっ流してぇえ
PRINTFORM 　おんばひらにぃぃ	PRINTFORM 　おんばひらにぃぃ
PRINTFORM 「ひうぅうぅぅぅっ	PRINTFORM 「ひうぅうぅぅぅっ
PRINTFORM 　きもちわるぃぃぃ	PRINTFORM 　きもちわるぃぃぃ
PRINTFORM 「んんんぁぁぁあぅ	PRINTFORM 「んんんぁぁぁあぅ
PRINTFORM 「ぐひぃぃぃぎいっ	PRINTFORM 「ぐひぃぃぃぎいっ
PRINTFORM 「んぎゅぅううぐぅ	PRINTFORM 「んぎゅぅううぐぅ
PRINTFORM  ひっ…あひぃぃッ	PRINTFORM  ひっ…あひぃぃッ
PRINTFORMW い、今は……」	PRINTFORMW い、今は……」
PRINTFORM 「打って来い！」	PRINTFORM 「打って来い！」
PRINTFORM 「へえうぅぅっぐ	PRINTFORM 「へえうぅぅっぐ
PRINTFORMW 「小手調べだ」	PRINTFORMW 「小手調べだ」
PRINTFORMW 「離れろぉ！」	PRINTFORMW 「離れろぉ！」
PRINTFORM 「んおぉぉぉごっ	PRINTFORM 「んおぉぉぉごっ
PRINTFORM 「ハァ、ハァ……	PRINTFORM 「ハァ、ハァ……
PRINTFORM 　そこらめえぇぇ	PRINTFORM 　そこらめえぇぇ
PRINTFORM 「ああぁへぇぇ…	PRINTFORM 「ああぁへぇぇ…
PRINTFORM 　いひぃぃいぃっ	PRINTFORM 　いひぃぃいぃっ
PRINTFORM 「もう、だめ……	PRINTFORM 「もう、だめ……
PRINTFORM 「ひゃぁあぃいぃ	PRINTFORM 「ひゃぁあぃいぃ
PRINTFORM んぼおおほぉおご	PRINTFORM んぼおおほぉおご
PRINTFORM おんっんんんうぅ	PRINTFORM おんっんんんうぅ
PRINTFORMW 「踏めって？」	PRINTFORMW 「踏めって？」
PRINTFORM 　どうだ私の舌は	PRINTFORM 　どうだ私の舌は
PRINTFORM 「良い心がけです	PRINTFORM 「良い心がけです
PRINTFORM 　ミミズ千匹ぃぃ	PRINTFORM 　ミミズ千匹ぃぃ
PRINTFORM 「へえあぁぃいっ	PRINTFORM 「へえあぁぃいっ
PRINTFORM 　あひぃぃぃぃっ	PRINTFORM 　あひぃぃぃぃっ
PRINTFORM 「あぎぃい～～っ	PRINTFORM 「あぎぃい～～っ
PRINTFORM 「んぎいぃ～～っ	PRINTFORM 「んぎいぃ～～っ
PRINTFORM 「ふぅっ、はぁ…	PRINTFORM 「ふぅっ、はぁ…
PRINTFORM 　またやろうねっ	PRINTFORM 　またやろうねっ
PRINTFORM 　あ゛～～～～～	PRINTFORM 　あ゛～～～～～
PRINTFORM 　ひぃぃぃぃんっ	PRINTFORM 　ひぃぃぃぃんっ
PRINTFORM 　まひゃぁぁぁぁ	PRINTFORM 　まひゃぁぁぁぁ
PRINTFORM 「ひゃぁあいっぎ	PRINTFORM 「ひゃぁあいっぎ
PRINTFORM 「も、もぅやめぇ	PRINTFORM 「も、もぅやめぇ
PRINTFORM 「くりゅぅぅぅっ	PRINTFORM 「くりゅぅぅぅっ
PRINTFORM 　も…ゆるひてぇ	PRINTFORM 　も…ゆるひてぇ
PRINTFORM 「イきゅぅぅぅっ	PRINTFORM 「イきゅぅぅぅっ
PRINTFORM 「ゆっ、ゆるひっ	PRINTFORM 「ゆっ、ゆるひっ
PRINTFORM 　まらきゅぅぅっ	PRINTFORM 　まらきゅぅぅっ
PRINTFORM 　イっひゃぅぅっ	PRINTFORM 　イっひゃぅぅっ
PRINTFORM 　らめなのにぃっ	PRINTFORM 　らめなのにぃっ
PRINTFORM 　ひっひゃゅぅっ	PRINTFORM 　ひっひゃゅぅっ
PRINTFORM 「ゆるひれぇぇっ	PRINTFORM 「ゆるひれぇぇっ
PRINTFORM 　おあぁぁああっ	PRINTFORM 　おあぁぁああっ
PRINTFORM 「イっ、きゅぅっ	PRINTFORM 「イっ、きゅぅっ
PRINTFORM 「は、はげ、ひっ	PRINTFORM 「は、はげ、ひっ
PRINTFORM 　おんばひらぁっ	PRINTFORM 　おんばひらぁっ
PRINTFORM 　そんなに…腰っ	PRINTFORM 　そんなに…腰っ
PRINTFORM 「あひゃぁぃぃッ	PRINTFORM 「あひゃぁぃぃッ
PRINTFORM 「嫌…嫌あぁぁっ	PRINTFORM 「嫌…嫌あぁぁっ
PRINTFORM 「あひいいぅぅッ	PRINTFORM 「あひいいぅぅッ
PRINTFORM 「ああぁぁぁんっ	PRINTFORM 「ああぁぁぁんっ
PRINTFORM 　！　ひぅぅう…	PRINTFORM 　！　ひぅぅう…
PRINTFORM 　しゅぐにぃぃっ	PRINTFORM 　しゅぐにぃぃっ
PRINTFORM 「あぁそんなぁあ	PRINTFORM 「あぁそんなぁあ
PRINTFORM 　このわらひがぁ	PRINTFORM 　このわらひがぁ
PRINTFORM 「へううぅうあっ	PRINTFORM 「へううぅうあっ
PRINTFORM 　きもひよくぅっ	PRINTFORM 　きもひよくぅっ
PRINTFORM 「ばッ！バカぁ！	PRINTFORM 「ばッ！バカぁ！
PRINTFORM 「きゃあああんっ	PRINTFORM 「きゃあああんっ
PRINTFORM 　ふああぁぁぁっ	PRINTFORM 　ふああぁぁぁっ
PRINTFORM 「しゅごいぃぃっ	PRINTFORM 「しゅごいぃぃっ
PRINTFORM 　ひろがってぇぇ	PRINTFORM 　ひろがってぇぇ
PRINTFORM 「あひいぃぃいっ	PRINTFORM 「あひいぃぃいっ
PRINTFORM もっと虐めてぇッ	PRINTFORM もっと虐めてぇッ
PRINTFORM 「いいきゅゅぅっ	PRINTFORM 「いいきゅゅぅっ
PRINTFORM 「うひぃぁあぁっ	PRINTFORM 「うひぃぁあぁっ
PRINTFORM 「しゅごいてぇえ	PRINTFORM 「しゅごいてぇえ
PRINTFORM 「おひぃぃぃッッ	PRINTFORM 「おひぃぃぃッッ
PRINTFORM 「はぅぅうあぁっ	PRINTFORM 「はぅぅうあぁっ
PRINTFORM 　えぐられてぇっ	PRINTFORM 　えぐられてぇっ
PRINTFORM 「そこ、ちがっ…	PRINTFORM 「そこ、ちがっ…
PRINTFORM 　あああんんんっ	PRINTFORM 　あああんんんっ
PRINTFORM 「ひゃあぁぃいぃ	PRINTFORM 「ひゃあぁぃいぃ
PRINTFORM 　おっぱいらめぇ	PRINTFORM 　おっぱいらめぇ
PRINTFORM 　ンア゛ァァ～ッ	PRINTFORM 　ンア゛ァァ～ッ
PRINTFORM 「ひいぃぃぃいっ	PRINTFORM 「ひいぃぃぃいっ
PRINTFORM 　お…おっぱぃぃ	PRINTFORM 　お…おっぱぃぃ
PRINTFORM 「ひんんんんっっ	PRINTFORM 「ひんんんんっっ
PRINTFORMW 「ひぃぃッ！」	PRINTFORMW 「ひぃぃッ！」
PRINTFORMW 「へたくそめ」	PRINTFORMW 「へたくそめ」
PRINTFORM 「ふぅうぅッ…」	PRINTFORM 「ふぅうぅッ…」
PRINTFORMW 「しま……！」	PRINTFORMW 「しま……！」
PRINTFORMW 「……ッ！？」	PRINTFORMW 「……ッ！？」
PRINTFORMW 『…あらっ♪』	PRINTFORMW 『…あらっ♪』
PRINTFORMW 「……すまん」	PRINTFORMW 「……すまん」
PRINTFORMW 「他愛も無い」	PRINTFORMW 「他愛も無い」
PRINTFORM 　あ゛～～～～っ	PRINTFORM 　あ゛～～～～っ
PRINTFORM 　いっへるかりゃ	PRINTFORM 　いっへるかりゃ
PRINTFORM 　も、らめぇえぇ	PRINTFORM 　も、らめぇえぇ
PRINTFORM 　たしゅけてぇぇ	PRINTFORM 　たしゅけてぇぇ
PRINTFORM 「きゃひぃぃぃっ	PRINTFORM 「きゃひぃぃぃっ
PRINTFORM 「ひぃあぁぁぁっ	PRINTFORM 「ひぃあぁぁぁっ
PRINTFORM 「おごぉおぉぉっ	PRINTFORM 「おごぉおぉぉっ
PRINTFORM 「ひああぁぁぁん	PRINTFORM 「ひああぁぁぁん
PRINTFORM 　イかひゃれぇっ	PRINTFORM 　イかひゃれぇっ
PRINTFORM 「これいじょうっ	PRINTFORM 「これいじょうっ
PRINTFORM 「ふあぁあぁぁっ	PRINTFORM 「ふあぁあぁぁっ
PRINTFORM 　イきまひゅうっ	PRINTFORM 　イきまひゅうっ
PRINTFORM 　あぁぁ～～～っ	PRINTFORM 　あぁぁ～～～っ
PRINTFORM 「で、でちゃ……	PRINTFORM 「で、でちゃ……
PRINTFORM はぁ……はぁ……	PRINTFORM はぁ……はぁ……
PRINTFORM 　うまれうぅぅっ	PRINTFORM 　うまれうぅぅっ
PRINTFORM 　うまれりゅっっ	PRINTFORM 　うまれりゅっっ
PRINTFORM 「苗床かにゃこっ	PRINTFORM 「苗床かにゃこっ
PRINTFORM 　～～～～～～っ	PRINTFORM 　～～～～～～っ
PRINTFORM 「んひぃぃぃ～～	PRINTFORM 「んひぃぃぃ～～
PRINTFORM 「ほごぉぉぉっっ	PRINTFORM 「ほごぉぉぉっっ
PRINTFORM 　待ち遠しいねぇ	PRINTFORM 　待ち遠しいねぇ
PRINTFORM はぁ……ひぃ……	PRINTFORM はぁ……ひぃ……
PRINTFORM 「んんぅうッッ…	PRINTFORM 「んんぅうッッ…
PRINTFORMW 「……zzz」	PRINTFORMW 「……zzz」
PRINTFORML 「――?!ッ」	PRINTFORML 「――?!ッ」
PRINTFORMW 「ッ……！！」	PRINTFORMW 「ッ……！！」
PRINTFORM 「ひゅあうあぁあ	PRINTFORM 「ひゅあうあぁあ
PRINTFORM 「あたまおかしく	PRINTFORM 「あたまおかしく
PRINTFORM 　なっちゃあぁあ	PRINTFORM 　なっちゃあぁあ
PRINTFORM 　んあうああぁあ	PRINTFORM 　んあうああぁあ
PRINTFORM 　ああんんんぅっ	PRINTFORM 　ああんんんぅっ
PRINTFORM 　たす…け…ッッ	PRINTFORM 　たす…け…ッッ
PRINTFORM 　こ、こりぇえぇ	PRINTFORM 　こ、こりぇえぇ
PRINTFORM 　んぐぅぅうあっ	PRINTFORM 　んぐぅぅうあっ
PRINTFORM 　もっ、耐えられ	PRINTFORM 　もっ、耐えられ
PRINTFORM 「んほぉぉぉぉお	PRINTFORM 「んほぉぉぉぉお
PRINTFORM 　こ、これは……	PRINTFORM 　こ、これは……
PRINTFORM 　身体が疼いてぇ	PRINTFORM 　身体が疼いてぇ
PRINTFORM 「んぎぃいぃぃ！	PRINTFORM 「んぎぃいぃぃ！
PRINTFORM 「あぁ、あひぃぃ	PRINTFORM 「あぁ、あひぃぃ
PRINTFORM 　おんばひら……	PRINTFORM 　おんばひら……
PRINTFORM 　おぉ、んんうぅ	PRINTFORM 　おぉ、んんうぅ
PRINTFORM 　あヒィィィッッ	PRINTFORM 　あヒィィィッッ
PRINTFORM 「あぁあはは…	PRINTFORM 「あぁあはは…
PRINTFORM 　も……だめぇ	PRINTFORM 　も……だめぇ
PRINTFORMW 「…………」	PRINTFORMW 「…………」
PRINTFORMW 「あまいぞ」	PRINTFORMW 「あまいぞ」
PRINTFORMW 「見切った」	PRINTFORMW 「見切った」
PRINTFORM 「ひぅうぅぅっ	PRINTFORM 「ひぅうぅぅっ
PRINTFORM 　おほぉぉぉぉ	PRINTFORM 　おほぉぉぉぉ
PRINTFORM 「ひぃぃぃぃっ	PRINTFORM 「ひぃぃぃぃっ
PRINTFORM 　あ゛～～～～	PRINTFORM 　あ゛～～～～
PRINTFORM 　んおぉぉあぁ	PRINTFORM 　んおぉぉあぁ
PRINTFORM 　あついのぉっ	PRINTFORM 　あついのぉっ
PRINTFORM 　ひっふぅ～～	PRINTFORM 　ひっふぅ～～
PRINTFORM 　…んぐうぅぶ	PRINTFORM 　…んぐうぅぶ
PRINTFORM 　むふぅあ…っ	PRINTFORM 　むふぅあ…っ
PRINTFORMW 　ちゅぽっ」	PRINTFORMW 　ちゅぽっ」
PRINTFORM 　ほれほれ～～	PRINTFORM 　ほれほれ～～
PRINTFORM 「んふぅ～～…	PRINTFORM 「んふぅ～～…
PRINTFORM 　もう、らめぇ	PRINTFORM 　もう、らめぇ
PRINTFORMW ？好き者め」	PRINTFORMW ？好き者め」
PRINTFORM 「んひぃぃいぃ	PRINTFORM 「んひぃぃいぃ
PRINTFORM 「へえあぁぁっ	PRINTFORM 「へえあぁぁっ
PRINTFORM 「ほひぃぃぃっ	PRINTFORM 「ほひぃぃぃっ
PRINTFORM 「も、やめぇっ	PRINTFORM 「も、やめぇっ
PRINTFORM 　ほひぃぃぃっ	PRINTFORM 　ほひぃぃぃっ
PRINTFORMW レロォ……」	PRINTFORMW レロォ……」
PRINTFORM 　ひっちゃうぅ	PRINTFORM 　ひっちゃうぅ
PRINTFORM 「っっっっっぁ	PRINTFORM 「っっっっっぁ
PRINTFORM 「んあぁあッ！	PRINTFORM 「んあぁあッ！
PRINTFORM 「イっひゃうっ	PRINTFORM 「イっひゃうっ
PRINTFORM 　らめなのにっ	PRINTFORM 　らめなのにっ
PRINTFORM 　とまらにゃっ	PRINTFORM 　とまらにゃっ
PRINTFORM 　んん～～～っ	PRINTFORM 　んん～～～っ
PRINTFORM 　よくれぇぇっ	PRINTFORM 　よくれぇぇっ
PRINTFORM 　あつくれぇっ	PRINTFORM 　あつくれぇっ
PRINTFORMW 「まだだ！」	PRINTFORMW 「まだだ！」
PRINTFORM 　かにゃこぉっ	PRINTFORM 　かにゃこぉっ
PRINTFORM 　らめぇぇぇっ	PRINTFORM 　らめぇぇぇっ
PRINTFORM 「イっひゃふっ	PRINTFORM 「イっひゃふっ
PRINTFORM 「あぎゅうぅぅ	PRINTFORM 「あぎゅうぅぅ
PRINTFORM 「きひゃあぁぁ	PRINTFORM 「きひゃあぁぁ
PRINTFORM 「っひぅぅぅっ	PRINTFORM 「っひぅぅぅっ
PRINTFORM 「かにゃこぉっ	PRINTFORM 「かにゃこぉっ
PRINTFORM 「まらぁぁぁっ	PRINTFORM 「まらぁぁぁっ
PRINTFORM 「ひあぁぁぁぁ	PRINTFORM 「ひあぁぁぁぁ
PRINTFORM 　ひあぁぁぁっ	PRINTFORM 　ひあぁぁぁっ
PRINTFORM 　イくぅぅぅっ	PRINTFORM 　イくぅぅぅっ
PRINTFORM 「ひいいぃいっ	PRINTFORM 「ひいいぃいっ
PRINTFORM 　あひぃぃんっ	PRINTFORM 　あひぃぃんっ
PRINTFORM 「ひくぅぅぅっ	PRINTFORM 「ひくぅぅぅっ
PRINTFORM 「へごおぉぉっ	PRINTFORM 「へごおぉぉっ
PRINTFORM 　イきながらっ	PRINTFORM 　イきながらっ
PRINTFORM 　こんにゃのっ	PRINTFORM 　こんにゃのっ
PRINTFORM 「ふあぁぁぁっ	PRINTFORM 「ふあぁぁぁっ
PRINTFORM 「ひゃぁぁぁっ	PRINTFORM 「ひゃぁぁぁっ
PRINTFORM 　んうぅぅぅっ	PRINTFORM 　んうぅぅぅっ
PRINTFORM 　からだ、がぁ	PRINTFORM 　からだ、がぁ
PRINTFORM 　がまんひれっ	PRINTFORM 　がまんひれっ
PRINTFORM 　もっとぉぉっ	PRINTFORM 　もっとぉぉっ
PRINTFORM 　あふあぁぁぁ	PRINTFORM 　あふあぁぁぁ
PRINTFORM 「へあぁぁっっ	PRINTFORM 「へあぁぁっっ
PRINTFORM 「かりゃだがっ	PRINTFORM 「かりゃだがっ
PRINTFORM 　勝手にぃぃっ	PRINTFORM 　勝手にぃぃっ
PRINTFORM 　んひゃぁうぅ	PRINTFORM 　んひゃぁうぅ
PRINTFORM 　らめえぇえっ	PRINTFORM 　らめえぇえっ
PRINTFORM 　しょんなぁっ	PRINTFORM 　しょんなぁっ
PRINTFORM 「…ふあぁぁ…	PRINTFORM 「…ふあぁぁ…
PRINTFORM 「んあぁぁぁっ	PRINTFORM 「んあぁぁぁっ
PRINTFORM 「はあぁ～～ッ	PRINTFORM 「はあぁ～～ッ
PRINTFORM 「私……もうっ	PRINTFORM 「私……もうっ
PRINTFORM 　ケツマンコッ	PRINTFORM 　ケツマンコッ
PRINTFORM 「んほぉぉぉっ	PRINTFORM 「んほぉぉぉっ
PRINTFORM 「あぁんんぅっ	PRINTFORM 「あぁんんぅっ
PRINTFORM 　ひゃぃいぃぎ	PRINTFORM 　ひゃぃいぃぎ
PRINTFORM 「くひいぃぃっ	PRINTFORM 「くひいぃぃっ
PRINTFORM 「ぃぃいイぐっ	PRINTFORM 「ぃぃいイぐっ
PRINTFORM 　お尻らめぇえ	PRINTFORM 　お尻らめぇえ
PRINTFORM 「…ひゃああん	PRINTFORM 「…ひゃああん
PRINTFORM 「あがぁあがっ	PRINTFORM 「あがぁあがっ
PRINTFORM 　このままじゃ	PRINTFORM 　このままじゃ
PRINTFORMW 「させん！」	PRINTFORMW 「させん！」
PRINTFORM 　イきまくって	PRINTFORM 　イきまくって
PRINTFORM 「～～～～～っ	PRINTFORM 「～～～～～っ
PRINTFORM 　～～～～～っ	PRINTFORM 　～～～～～っ
PRINTFORM 　ひっ、ひぃっ	PRINTFORM 　ひっ、ひぃっ
PRINTFORM 「ぅ……ぁ……	PRINTFORM 「ぅ……ぁ……
PRINTFORM 「イきまひゅっ	PRINTFORM 「イきまひゅっ
PRINTFORM 　こ、降参……	PRINTFORM 　こ、降参……
PRINTFORM 　しゃれたらっ	PRINTFORM 　しゃれたらっ
PRINTFORM 　こわれぇぇっ	PRINTFORM 　こわれぇぇっ
PRINTFORM 「きもひいいの	PRINTFORM 「きもひいいの
PRINTFORM 「あはぁぁぁっ	PRINTFORM 「あはぁぁぁっ
PRINTFORM 　ま、まひゃっ	PRINTFORM 　ま、まひゃっ
PRINTFORM 　―――――っ	PRINTFORM 　―――――っ
PRINTFORM 「ま、まひゃっ	PRINTFORM 「ま、まひゃっ
PRINTFORMW 「くっ…！」	PRINTFORMW 「くっ…！」
PRINTFORM 「あはぁ～～ッ	PRINTFORM 「あはぁ～～ッ
PRINTFORM 「ひぃぎゅぅぅ	PRINTFORM 「ひぃぎゅぅぅ
PRINTFORM 「んひぃぃいっ	PRINTFORM 「んひぃぃいっ
PRINTFORM 「あへえあぁっ	PRINTFORM 「あへえあぁっ
PRINTFORM 　おおぉ、んぅ	PRINTFORM 　おおぉ、んぅ
PRINTFORM 　やめれぇえっ	PRINTFORM 　やめれぇえっ
PRINTFORM 「ひうぅぃい～	PRINTFORM 「ひうぅぃい～
PRINTFORM 　うまれりゅっ	PRINTFORM 　うまれりゅっ
PRINTFORM 「ひぃいぅうぅ	PRINTFORM 「ひぃいぅうぅ
PRINTFORM 　内臓で擦れて	PRINTFORM 　内臓で擦れて
PRINTFORM 「あっあぁあッ	PRINTFORM 「あっあぁあッ
PRINTFORM 「あびぃぃ～～	PRINTFORM 「あびぃぃ～～
PRINTFORM 「い゛ひぃぃい	PRINTFORM 「い゛ひぃぃい
PRINTFORM 「ひっ、ぐうぅ	PRINTFORM 「ひっ、ぐうぅ
PRINTFORM 「ひぃいああぁ	PRINTFORM 「ひぃいああぁ
PRINTFORM 　これぇええっ	PRINTFORM 　これぇええっ
PRINTFORML 「キモッ！」	PRINTFORML 「キモッ！」
PRINTFORM 　らめええぇっ	PRINTFORM 　らめええぇっ
PRINTFORM 「は、はなせぇ	PRINTFORM 「は、はなせぇ
PRINTFORM 　やめてぇえぇ	PRINTFORM 　やめてぇえぇ
PRINTFORM 「んひぃぃぃっ	PRINTFORM 「んひぃぃぃっ
PRINTFORM 「へえあぁ……	PRINTFORM 「へえあぁ……
PRINTFORM 　もぅ、だめぇ	PRINTFORM 　もぅ、だめぇ
PRINTFORM 　おぎゅううぅ	PRINTFORM 　おぎゅううぅ
PRINTFORM 　死んじゃうぅ	PRINTFORM 　死んじゃうぅ
PRINTFORM 　おんばひらぁ	PRINTFORM 　おんばひらぁ
PRINTFORM 「んぅうぅぅっ	PRINTFORM 「んぅうぅぅっ
PRINTFORM 　…おごぉおっ	PRINTFORM 　…おごぉおっ
PRINTFORM 　これ媚薬……	PRINTFORM 　これ媚薬……
PRINTFORMW 「女は度胸」	PRINTFORMW 「女は度胸」
PRINTFORM 　おっぱいっっ	PRINTFORM 　おっぱいっっ
PRINTFORM 　弱いのにぃぃ	PRINTFORM 　弱いのにぃぃ
PRINTFORM 「あぁあっらめ	PRINTFORM 「あぁあっらめ
PRINTFORM 　ひいぃあぁっ	PRINTFORM 　ひいぃあぁっ
PRINTFORM ！！　んひっっ	PRINTFORM ！！　んひっっ
PRINTFORM 　うぅぎひぃぃ	PRINTFORM 　うぅぎひぃぃ
PRINTFORMW 「アアッ！」	PRINTFORMW 「アアッ！」
PRINTFORM  「はひぃぃっ	PRINTFORM  「はひぃぃっ
PRINTFORM 「く…ふぅ…	PRINTFORM 「く…ふぅ…
PRINTFORMW 「そこだ」	PRINTFORMW 「そこだ」
PRINTFORMW 「はっ！」	PRINTFORMW 「はっ！」
PRINTFORM 　ためてぇっ	PRINTFORM 　ためてぇっ
PRINTFORMDW 『……』	PRINTFORMDW 『……』
PRINTFORM 「んんぅうっ	PRINTFORM 「んんぅうっ
PRINTFORM 「ふぃぃいっ	PRINTFORM 「ふぃぃいっ
PRINTFORM 「からだぁっ	PRINTFORM 「からだぁっ
PRINTFORM 　切な過ぎて	PRINTFORM 　切な過ぎて
PRINTFORM 「ひぃい～～	PRINTFORM 「ひぃい～～
PRINTFORM 「やらぁああ	PRINTFORM 「やらぁああ
PRINTFORM 「ほひぃぃぃ	PRINTFORM 「ほひぃぃぃ
PRINTFORM 「ふひぃぃっ	PRINTFORM 「ふひぃぃっ
PRINTFORM 　んっちゅっ	PRINTFORM 　んっちゅっ
PRINTFORM 「ふあははっ	PRINTFORM 「ふあははっ
PRINTFORM 　むぅぅぐっ	PRINTFORM 　むぅぅぐっ
PRINTFORM 「ひひひっ…	PRINTFORM 「ひひひっ…
PRINTFORM 「はぁ～～っ	PRINTFORM 「はぁ～～っ
PRINTFORM 　～～～～っ	PRINTFORM 　～～～～っ
PRINTFORM 「ふぅ…はぁ	PRINTFORM 「ふぅ…はぁ
PRINTFORM 「ふひぃぃぃ	PRINTFORM 「ふひぃぃぃ
PRINTFORM 　くりゅぅう	PRINTFORM 　くりゅぅう
PRINTFORM 「っはひぃ…	PRINTFORM 「っはひぃ…
PRINTFORM 「はあぁぁあ	PRINTFORM 「はあぁぁあ
PRINTFORM 「んんぁあっ	PRINTFORM 「んんぁあっ
PRINTFORM へひぃッ……	PRINTFORM へひぃッ……
PRINTFORM 「へあぁあぁ	PRINTFORM 「へあぁあぁ
PRINTFORM あひぃぃぃっ	PRINTFORM あひぃぃぃっ
PRINTFORM 　かにゃこっ	PRINTFORM 　かにゃこっ
PRINTFORM 　～～～～～	PRINTFORM 　～～～～～
PRINTFORM 「んほおぉ～	PRINTFORM 「んほおぉ～
PRINTFORM あ～～～～～	PRINTFORM あ～～～～～
PRINTFORM 　とまらにゃ	PRINTFORM 　とまらにゃ
PRINTFORMW 「ぐっ！」	PRINTFORMW 「ぐっ！」
PRINTFORM 「ちょうらい	PRINTFORM 「ちょうらい
PRINTFORM 「もっろぉっ	PRINTFORM 「もっろぉっ
PRINTFORM 　イきまふっ	PRINTFORM 　イきまふっ
PRINTFORM 「ゆるひれっ	PRINTFORM 「ゆるひれっ
PRINTFORM 「イっへるっ	PRINTFORM 「イっへるっ
PRINTFORM 　ゆるひれっ	PRINTFORM 　ゆるひれっ
PRINTFORM 　イっひゃっ	PRINTFORM 　イっひゃっ
PRINTFORM 　イき狂うっ	PRINTFORM 　イき狂うっ
PRINTFORM 　おごあっっ	PRINTFORM 　おごあっっ
PRINTFORM 　イっへるっ	PRINTFORM 　イっへるっ
PRINTFORM 「ふあぁ……	PRINTFORM 「ふあぁ……
PRINTFORM 「ひあぁぁっ	PRINTFORM 「ひあぁぁっ
PRINTFORM 「れ、れひゃ	PRINTFORM 「れ、れひゃ
PRINTFORM 　れひゃうぅ	PRINTFORM 　れひゃうぅ
PRINTFORM 　しょんなっ	PRINTFORM 　しょんなっ
PRINTFORM 　おのれぇ…	PRINTFORM 　おのれぇ…
PRINTFORM 　ひゃぃぃぅ	PRINTFORM 　ひゃぃぃぅ
PRINTFORM 「やめ…てぇ	PRINTFORM 「やめ…てぇ
PRINTFORM 　お゛んぅ…	PRINTFORM 　お゛んぅ…
PRINTFORM 　ま、まらっ	PRINTFORM 　ま、まらっ
PRINTFORM 　うごいひゃ	PRINTFORM 　うごいひゃ
PRINTFORM 「あ～～～～	PRINTFORM 「あ～～～～
PRINTFORM 　おっぱひっ	PRINTFORM 　おっぱひっ
PRINTFORM 「おっぱひっ	PRINTFORM 「おっぱひっ
PRINTFORM 「ふあぁぁっ	PRINTFORM 「ふあぁぁっ
PRINTFORM 　ずぼずぼっ	PRINTFORM 　ずぼずぼっ
PRINTFORM 「まんこっ！	PRINTFORM 「まんこっ！
PRINTFORM 　あぁッんッ	PRINTFORM 　あぁッんッ
PRINTFORM 　いじめれっ	PRINTFORM 　いじめれっ
PRINTFORM 「もっとっっ	PRINTFORM 「もっとっっ
PRINTFORM 「もっとッッ	PRINTFORM 「もっとッッ
PRINTFORM 「いいのぉっ	PRINTFORM 「いいのぉっ
PRINTFORM 　んがぁあが	PRINTFORM 　んがぁあが
PRINTFORM 「アアァんッ	PRINTFORM 「アアァんッ
PRINTFORM 「貫いて……	PRINTFORM 「貫いて……
PRINTFORM 　イかせてっ	PRINTFORM 　イかせてっ
PRINTFORM 　おひりぃっ	PRINTFORM 　おひりぃっ
PRINTFORM 「乳アクメッ	PRINTFORM 「乳アクメッ
PRINTFORM 「あ゛ッ！！	PRINTFORM 「あ゛ッ！！
PRINTFORM 　苦゛し゛っ	PRINTFORM 　苦゛し゛っ
PRINTFORM 　のにっ……	PRINTFORM 　のにっ……
PRINTFORM 　い、いまっ	PRINTFORM 　い、いまっ
PRINTFORM へうぅうあッ	PRINTFORM へうぅうあッ
PRINTFORM 「あ、ぁぁッ	PRINTFORM 「あ、ぁぁッ
PRINTFORM 「ふ、服が…	PRINTFORM 「ふ、服が…
PRINTFORMW 「勝機！」	PRINTFORMW 「勝機！」
PRINTFORM 「あ゛～～っ	PRINTFORM 「あ゛～～っ
PRINTFORM 「はへぇぇっ	PRINTFORM 「はへぇぇっ
PRINTFORM 　ひいぃぃぃ	PRINTFORM 　ひいぃぃぃ
PRINTFORM 「わらひぃっ	PRINTFORM 「わらひぃっ
PRINTFORM 「んおぉぉっ	PRINTFORM 「んおぉぉっ
PRINTFORM 　おぉおッッ	PRINTFORM 　おぉおッッ
PRINTFORM 「は、ひ……	PRINTFORM 「は、ひ……
PRINTFORM 「イっらぁっ	PRINTFORM 「イっらぁっ
PRINTFORM 「ま、まらっ	PRINTFORM 「ま、まらっ
PRINTFORM 「ま、ひゃっ	PRINTFORM 「ま、ひゃっ
PRINTFORM 　イきゅぅっ	PRINTFORM 　イきゅぅっ
PRINTFORM 　あ～～～っ	PRINTFORM 　あ～～～っ
PRINTFORM 　はひゃんっ	PRINTFORM 　はひゃんっ
PRINTFORM 「イっひゃっ	PRINTFORM 「イっひゃっ
PRINTFORM 「イっ、くっ	PRINTFORM 「イっ、くっ
PRINTFORM 「～～～～っ	PRINTFORM 「～～～～っ
PRINTFORM 「うあぁぁぁ	PRINTFORM 「うあぁぁぁ
PRINTFORM 「……ひ……	PRINTFORM 「……ひ……
PRINTFORM 　っっっっぁ	PRINTFORM 　っっっっぁ
PRINTFORM 「ま、またっ	PRINTFORM 「ま、またっ
PRINTFORM 「らめぇえっ	PRINTFORM 「らめぇえっ
PRINTFORM 「あはぁ……	PRINTFORM 「あはぁ……
PRINTFORM 「あっ、また	PRINTFORM 「あっ、また
PRINTFORM 　授乳してッ	PRINTFORM 　授乳してッ
PRINTFORM 「んいぃっ、	PRINTFORM 「んいぃっ、
PRINTFORM 　あつくてぇ	PRINTFORM 　あつくてぇ
PRINTFORM 「こにょなか	PRINTFORM 「こにょなか
PRINTFORM 「おぉ…あぁ	PRINTFORM 「おぉ…あぁ
PRINTFORM 　やらあぁあ	PRINTFORM 　やらあぁあ
PRINTFORM 「だりぇかぁ	PRINTFORM 「だりぇかぁ
PRINTFORM 　ああぁあっ	PRINTFORM 　ああぁあっ
PRINTFORM 「ひぃいぃっ	PRINTFORM 「ひぃいぃっ
PRINTFORM 「へえあぁ…	PRINTFORM 「へえあぁ…
PRINTFORM 　あひぃっ…	PRINTFORM 　あひぃっ…
PRINTFORM 　はひぃぃっ	PRINTFORM 　はひぃぃっ
PRINTFORM 　おひりぃぃ	PRINTFORM 　おひりぃぃ
PRINTFORM 「あひぃぃっ	PRINTFORM 「あひぃぃっ
PRINTFORM 「ほへぁあぁ	PRINTFORM 「ほへぁあぁ
PRINTFORM  「んぎひぃ	PRINTFORM  「んぎひぃ
PRINTFORM  「ほぎぃっ	PRINTFORM  「ほぎぃっ
PRINTFORMW 「閃！」	PRINTFORMW 「閃！」
PRINTFORMW ！！！」	PRINTFORMW ！！！」
PRINTFORM 「あ゛ぁっ	PRINTFORM 「あ゛ぁっ
PRINTFORM 　ちからっ	PRINTFORM 　ちからっ
PRINTFORM 　むりぃっ	PRINTFORM 　むりぃっ
PRINTFORM 「うぅあっ	PRINTFORM 「うぅあっ
PRINTFORM 「うぅぅっ	PRINTFORM 「うぅぅっ
PRINTFORM 　ぷはぁあ	PRINTFORM 　ぷはぁあ
PRINTFORM 「へぉおっ	PRINTFORM 「へぉおっ
PRINTFORM 　むちゅっ	PRINTFORM 　むちゅっ
PRINTFORM 「むちゅっ	PRINTFORM 「むちゅっ
PRINTFORM 　むぐぅっ	PRINTFORM 　むぐぅっ
PRINTFORM 　ぐちゅっ	PRINTFORM 　ぐちゅっ
PRINTFORM 「ぷはぁ…	PRINTFORM 「ぷはぁ…
PRINTFORM 　美味し…	PRINTFORM 　美味し…
PRINTFORM 「くっぷ…	PRINTFORM 「くっぷ…
PRINTFORM 「ふひひひ	PRINTFORM 「ふひひひ
PRINTFORM 「ふふふっ	PRINTFORM 「ふふふっ
PRINTFORMW 「……」	PRINTFORMW 「……」
PRINTFORM 「案ずるな	PRINTFORM 「案ずるな
PRINTFORM 「ひぐぅっ	PRINTFORM 「ひぐぅっ
PRINTFORM 「好き者め	PRINTFORM 「好き者め
PRINTFORM 「はははっ	PRINTFORM 「はははっ
PRINTFORM 「くくくっ	PRINTFORM 「くくくっ
PRINTFORM 「ふひぃっ	PRINTFORM 「ふひぃっ
PRINTFORM 「ぁぁぁ…	PRINTFORM 「ぁぁぁ…
PRINTFORM 「へひぃぃ	PRINTFORM 「へひぃぃ
PRINTFORM 「へえあぁ	PRINTFORM 「へえあぁ
PRINTFORM 　あひぃぃ	PRINTFORM 　あひぃぃ
PRINTFORM 「あぁ……	PRINTFORM 「あぁ……
PRINTFORM 「あははぁ	PRINTFORM 「あははぁ
PRINTFORM 「～～～っ	PRINTFORM 「～～～っ
PRINTFORM 「からだぁ	PRINTFORM 「からだぁ
PRINTFORM 　ゆびがっ	PRINTFORM 　ゆびがっ
PRINTFORM 「ふあぁっ	PRINTFORM 「ふあぁっ
PRINTFORM 　ひゃぁっ	PRINTFORM 　ひゃぁっ
PRINTFORM 　きもひっ	PRINTFORM 　きもひっ
PRINTFORM 　からだっ	PRINTFORM 　からだっ
PRINTFORM 「イぅッッ	PRINTFORM 「イぅッッ
PRINTFORM 　ひあぁっ	PRINTFORM 　ひあぁっ
PRINTFORM 「ひぃんっ	PRINTFORM 「ひぃんっ
PRINTFORM 「イきゅっ	PRINTFORM 「イきゅっ
PRINTFORM 「イきゅぅ	PRINTFORM 「イきゅぅ
PRINTFORM 　わらひぃ	PRINTFORM 　わらひぃ
PRINTFORM 「っっっぁ	PRINTFORM 「っっっぁ
PRINTFORM 「わらひっ	PRINTFORM 「わらひっ
PRINTFORM 　めぇぇっ	PRINTFORM 　めぇぇっ
PRINTFORM 「イっへっ	PRINTFORM 「イっへっ
PRINTFORM 　りゃ、め	PRINTFORM 　りゃ、め
PRINTFORM 　ゆるひて	PRINTFORM 　ゆるひて
PRINTFORM 「らめぇぇ	PRINTFORM 「らめぇぇ
PRINTFORM 「んあぁっ	PRINTFORM 「んあぁっ
PRINTFORM 　あぁぁあ	PRINTFORM 　あぁぁあ
PRINTFORM 　おっき…	PRINTFORM 　おっき…
PRINTFORM 　ら、らめ	PRINTFORM 　ら、らめ
PRINTFORM 　もっろっ	PRINTFORM 　もっろっ
PRINTFORM 「くッあぁ	PRINTFORM 「くッあぁ
PRINTFORM 　やめぇ…	PRINTFORM 　やめぇ…
PRINTFORM 「んあぁ…	PRINTFORM 「んあぁ…
PRINTFORM 　あひゅぅ	PRINTFORM 　あひゅぅ
PRINTFORM 　わらひっ	PRINTFORM 　わらひっ
PRINTFORM 「やぁぁあ	PRINTFORM 「やぁぁあ
PRINTFORM 「…はうぅ	PRINTFORM 「…はうぅ
PRINTFORM 「あぁッッ	PRINTFORM 「あぁッッ
PRINTFORM 「はぁ～～	PRINTFORM 「はぁ～～
PRINTFORM 　おひりっ	PRINTFORM 　おひりっ
PRINTFORM 「はぁぁぁ	PRINTFORM 「はぁぁぁ
PRINTFORM 「イぎゅっ	PRINTFORM 「イぎゅっ
PRINTFORM 　犯してッ	PRINTFORM 　犯してッ
PRINTFORM 　まんこっ	PRINTFORM 　まんこっ
PRINTFORM 　はぁんっ	PRINTFORM 　はぁんっ
PRINTFORM 「ひゃぁっ	PRINTFORM 「ひゃぁっ
PRINTFORM 「イっれっ	PRINTFORM 「イっれっ
PRINTFORM 　アクみぇ	PRINTFORM 　アクみぇ
PRINTFORM 　こりぇっ	PRINTFORM 　こりぇっ
PRINTFORM 「まひゃっ	PRINTFORM 「まひゃっ
PRINTFORM 　らめぇっ	PRINTFORM 　らめぇっ
PRINTFORM 「ぁ―――	PRINTFORM 「ぁ―――
PRINTFORM ……ぇぁぁ	PRINTFORM ……ぇぁぁ
PRINTFORM 「あひぃっ	PRINTFORM 「あひぃっ
PRINTFORM 　はひぃっ	PRINTFORM 　はひぃっ
PRINTFORM 「……ひぅ	PRINTFORM 「……ひぅ
PRINTFORM 「はひぃっ	PRINTFORM 「はひぃっ
PRINTFORM 「ひぎぅっ	PRINTFORM 「ひぎぅっ
PRINTFORM 　にゃにっ	PRINTFORM 　にゃにっ
PRINTFORM 「ひぃぃっ	PRINTFORM 「ひぃぃっ
PRINTFORM 　あひゅっ	PRINTFORM 　あひゅっ
PRINTFORM 　うぎぃひ	PRINTFORM 　うぎぃひ
PRINTFORM 　にゃいぃ	PRINTFORM 　にゃいぃ
PRINTFORM 「あぁぁが	PRINTFORM 「あぁぁが
PRINTFORM 　やめぇえ	PRINTFORM 　やめぇえ
PRINTFORM 「はぁ…	PRINTFORM 「はぁ…
PRINTFORM 「あぁは	PRINTFORM 「あぁは
PRINTFORM 「はひっ	PRINTFORM 「はひっ
PRINTFORM 　ひうっ	PRINTFORM 　ひうっ
PRINTFORMW ！！」	PRINTFORMW ！！」
PRINTFORM 「っひっ	PRINTFORM 「っひっ
PRINTFORM 「んんっ	PRINTFORM 「んんっ
PRINTFORM 「なかっ	PRINTFORM 「なかっ
PRINTFORM 「んむぅ	PRINTFORM 「んむぅ
PRINTFORM 「れろっ	PRINTFORM 「れろっ
PRINTFORM 　んむっ	PRINTFORM 　んむっ
PRINTFORM 　ほらっ	PRINTFORM 　ほらっ
PRINTFORM 「んぶっ	PRINTFORM 「んぶっ
PRINTFORM 　くぷっ	PRINTFORM 　くぷっ
PRINTFORM 「ふふふ	PRINTFORM 「ふふふ
PRINTFORM 「んむっ	PRINTFORM 「んむっ
PRINTFORM 　ちゅく	PRINTFORM 　ちゅく
PRINTFORM 「ほほぅ	PRINTFORM 「ほほぅ
PRINTFORM 　らめっ	PRINTFORM 　らめっ
PRINTFORMW ……」	PRINTFORMW ……」
PRINTFORM 　らめぇ	PRINTFORM 　らめぇ
PRINTFORM 「あぁぁ	PRINTFORM 「あぁぁ
PRINTFORM 「ひぎょ	PRINTFORM 「ひぎょ
PRINTFORM なかにぃ	PRINTFORM なかにぃ
PRINTFORM 「外にぃ	PRINTFORM 「外にぃ
PRINTFORM 　もっと	PRINTFORM 　もっと
PRINTFORM 「ひぅっ	PRINTFORM 「ひぅっ
PRINTFORM 「がまん	PRINTFORM 「がまん
PRINTFORM 　降っっ	PRINTFORM 　降っっ
PRINTFORM 　いまっ	PRINTFORM 　いまっ
PRINTFORM 「イくっ	PRINTFORM 「イくっ
PRINTFORM 「イくぅ	PRINTFORM 「イくぅ
PRINTFORM またぁっ	PRINTFORM またぁっ
PRINTFORM 「ああぁ	PRINTFORM 「ああぁ
PRINTFORM 「ら、め	PRINTFORM 「ら、め
PRINTFORM 　ひんっ	PRINTFORM 　ひんっ
PRINTFORM 　あうっ	PRINTFORM 　あうっ
PRINTFORM 　しゅっ	PRINTFORM 　しゅっ
PRINTFORM 「んぁっ	PRINTFORM 「んぁっ
PRINTFORM 「ア゛ッ	PRINTFORM 「ア゛ッ
PRINTFORM 　い゛ッ	PRINTFORM 　い゛ッ
PRINTFORM 　ふあっ	PRINTFORM 　ふあっ
PRINTFORM 「らめっ	PRINTFORM 「らめっ
PRINTFORM 　そこっ	PRINTFORM 　そこっ
PRINTFORM 「おくっ	PRINTFORM 「おくっ
PRINTFORM 　しょっ	PRINTFORM 　しょっ
PRINTFORM 「ひくっ	PRINTFORM 「ひくっ
PRINTFORM 　きれっ	PRINTFORM 　きれっ
PRINTFORM 「んあっ	PRINTFORM 「んあっ
PRINTFORM 　きたっ	PRINTFORM 　きたっ
PRINTFORM 「ふぅッ	PRINTFORM 「ふぅッ
PRINTFORM 　こ、わ	PRINTFORM 　こ、わ
PRINTFORM 　イぐっ	PRINTFORM 　イぐっ
PRINTFORM 　あひぃ	PRINTFORM 　あひぃ
PRINTFORM 　ひぃぃ	PRINTFORM 　ひぃぃ
PRINTFORM 　イって	PRINTFORM 　イって
PRINTFORM 　アクメ	PRINTFORM 　アクメ
PRINTFORM 「まらっ	PRINTFORM 「まらっ
PRINTFORM 　くるっ	PRINTFORM 　くるっ
PRINTFORM 「あひっ	PRINTFORM 「あひっ
PRINTFORM 　ひあっ	PRINTFORM 　ひあっ
PRINTFORM 　すごっ	PRINTFORM 　すごっ
PRINTFORM 「っぁ…	PRINTFORM 「っぁ…
PRINTFORM 　くぅっ	PRINTFORM 　くぅっ
PRINTFORM 　まらっ	PRINTFORM 　まらっ
PRINTFORM 「あっ、	PRINTFORM 「あっ、
PRINTFORM 　動いた	PRINTFORM 　動いた
PRINTFORM 「へぶっ	PRINTFORM 「へぶっ
PRINTFORM 「やめっ	PRINTFORM 「やめっ
PRINTFORM 　ぅぅん	PRINTFORM 　ぅぅん
PRINTFORM 「―――	PRINTFORM 「―――
PRINTFORM ／／／／	PRINTFORM ／／／／
PRINTFORM 「からだ	PRINTFORM 「からだ
PRINTFORM 　りゃめ	PRINTFORM 　りゃめ
PRINTFORM 　あひゅ	PRINTFORM 　あひゅ
PRINTFORM 　しょこ	PRINTFORM 　しょこ
PRINTFORM 　ぜんぶ	PRINTFORM 　ぜんぶ
PRINTFORM 　あひっ	PRINTFORM 　あひっ
PRINTFORM 「お豆っ	PRINTFORM 「お豆っ
PRINTFORM 「んぎっ	PRINTFORM 「んぎっ
PRINTFORM 　ひぃぅ	PRINTFORM 　ひぃぅ
PRINTFORM 「しぬっ	PRINTFORM 「しぬっ
PRINTFORM 「へあぁ	PRINTFORM 「へあぁ
PRINTFORM 「はぁ～	PRINTFORM 「はぁ～
PRINTFORM 「ひんっ	PRINTFORM 「ひんっ
PRINTFORM 　んぉっ	PRINTFORM 　んぉっ
PRINTFORM 　クリっ	PRINTFORM 　クリっ
﻿PRINTFORM 「はぁ	PRINTFORM 「はぁ
PRINTFORM 「……	PRINTFORM 「……
PRINTFORM 「ふぁ	PRINTFORM 「ふぁ
PRINTFORMW ！）	PRINTFORMW ！）
PRINTFORMW ！」	PRINTFORMW ！」
PRINTFORM 「ちっ	PRINTFORM 「ちっ
PRINTFORM 「もっ	PRINTFORM 「もっ
PRINTFORMW ？」	PRINTFORMW ？」
PRINTFORM 「ほっ	PRINTFORM 「ほっ
PRINTFORM 　らめ	PRINTFORM 　らめ
PRINTFORM 　手が	PRINTFORM 　手が
PRINTFORM 「ゆっ	PRINTFORM 「ゆっ
PRINTFORM 「らっ	PRINTFORM 「らっ
PRINTFORM 　もっ	PRINTFORM 　もっ
PRINTFORM 　うぁ	PRINTFORM 　うぁ
PRINTFORM 　すご	PRINTFORM 　すご
PRINTFORM 「あっ	PRINTFORM 「あっ
PRINTFORM 　やっ	PRINTFORM 　やっ
PRINTFORM 「んぅ	PRINTFORM 「んぅ
PRINTFORMW 　」	PRINTFORMW 　」
PRINTFORM 「ひッ	PRINTFORM 「ひッ
PRINTFORM すごっ	PRINTFORM すごっ
PRINTFORM なかっ	PRINTFORM なかっ
PRINTFORM 　ぐっ	PRINTFORM 　ぐっ
PRINTFORM 　あっ	PRINTFORM 　あっ
PRINTFORM はぁっ	PRINTFORM はぁっ
PRINTFORMW )」	PRINTFORMW )」
PRINTFORM 「わら	PRINTFORM 「わら
PRINTFORM 「ひっ	PRINTFORM 「ひっ
PRINTFORM 　くぅ	PRINTFORM 　くぅ
PRINTFORM 　ひっ	PRINTFORM 　ひっ
PRINTFORM 　は…	PRINTFORM 　は…
PRINTFORM 「んっ	PRINTFORM 「んっ
PRINTFORM 　にゃ	PRINTFORM 　にゃ
PRINTFORM 　やら	PRINTFORM 　やら
PRINTFORM 　へげ	PRINTFORM 　へげ
PRINTFORMW 」	PRINTFORMW 」
PRINTFORM はぁ	PRINTFORM はぁ
PRINTFORMW ）	PRINTFORMW ）
PRINTFORMW )	PRINTFORMW )
PRINTFORM 「ら	PRINTFORM 「ら
PRINTFORM 「ぁ	PRINTFORM 「ぁ
PRINTFORM あっ	PRINTFORM あっ
PRINTFORML 」	PRINTFORML 」
PRINTFORM 　あ	PRINTFORM 　あ
PRINTFORMW 』	PRINTFORMW 』
PRINTFORM 　も	PRINTFORM 　も
PRINTFORM 「あ	PRINTFORM 「あ
PRINTFORMW 　	PRINTFORMW 　
PRINTFORM ！」	PRINTFORM ！」
PRINTFORMDL 	PRINTFORMDL 
PRINTFORM …	PRINTFORM …
PRINTFORML 	PRINTFORML 
PRINTFORMW 	PRINTFORMW 
PRINTFORM 	PRINTFORM 
PRINTL	PRINTL
