//口上:

PRINTFORMDW 一回休みになった仲間達と白濁液に塗れ床に転がっている不幸な%CALLNAME:(FLAG:10)%と%CALLNAME:(FLAG:11)%の為にも絶対に解決してやる！	PRINTFORMDW 一回休みになった仲間達と白濁液に塗れ床に転がっている不幸な%CALLNAME:(FLAG:10)%と%CALLNAME:(FLAG:11)%の為にも絶対に解決してやる！
PRINTL ************************************************************************************	PRINTL ************************************************************************************
PRINTFORMDW それどころか、床から生えたぬめったミミズ達がサニーの足に巻きつきはじめる感覚にサニーは鳥肌と引きつった悲鳴を立てるとあわててそれを振りほどいた。	PRINTFORMDW それどころか、床から生えたぬめったミミズ達がサニーの足に巻きつきはじめる感覚にサニーは鳥肌と引きつった悲鳴を立てるとあわててそれを振りほどいた。
PRINTFORMDW これで%CALLNAME:(FLAG:10)%と%CALLNAME:(FLAG:11)%を助けられるとサニーは確信し、迷宮へ再び足を踏み入れた…	PRINTFORMDW これで%CALLNAME:(FLAG:10)%と%CALLNAME:(FLAG:11)%を助けられるとサニーは確信し、迷宮へ再び足を踏み入れた…
PRINTCOLORW(RGBCOLOR(0, 191, 255), "『神隠しにあった人を一番多く見つけた人が今日の夕飯のメニューを決められるってどうかしら？』")	PRINTCOLORW(RGBCOLOR(0, 191, 255), "『神隠しにあった人を一番多く見つけた人が今日の夕飯のメニューを決められるってどうかしら？』")
PRINTFORMDW 必死の抵抗も空しく、%CALLNAME:(FLAG:10)%と%CALLNAME:(FLAG:11)%は敵に拘束され、激しい凌辱を受けている	PRINTFORMDW 必死の抵抗も空しく、%CALLNAME:(FLAG:10)%と%CALLNAME:(FLAG:11)%は敵に拘束され、激しい凌辱を受けている
PRINTCOLORW(RGBCOLOR(255, 239, 133), "『いい加減にこの料理やめてよよスター！私達があいつらに何されたか忘れちゃったの！？』")	PRINTCOLORW(RGBCOLOR(255, 239, 133), "『いい加減にこの料理やめてよよスター！私達があいつらに何されたか忘れちゃったの！？』")
PRINTFORMDW 歯がみするサニーに、%CALLNAME:(FLAG:10)%と%CALLNAME:(FLAG:11)%が覚悟を決めたように話しかける	PRINTFORMDW 歯がみするサニーに、%CALLNAME:(FLAG:10)%と%CALLNAME:(FLAG:11)%が覚悟を決めたように話しかける
PRINTFORMDW 妖精の自分が異変解決に参加できる！嬉しくて仕方がないサニーははしゃぎながら案内をするが迷宮のあった場所で途方にくれることになる	PRINTFORMDW 妖精の自分が異変解決に参加できる！嬉しくて仕方がないサニーははしゃぎながら案内をするが迷宮のあった場所で途方にくれることになる
PRINTCOLORW(RGBCOLOR(255, 239, 133), "『ねえ、二人とも。今回の異変っていつになったら解決するのかしら？』")	PRINTCOLORW(RGBCOLOR(255, 239, 133), "『ねえ、二人とも。今回の異変っていつになったら解決するのかしら？』")
PRINTFORMW それに驚いた野うさぎが逃げ出すのに気づいた「それ」はさらに数本の触手を生やすと野うさぎを捕らえ体内へと引きずり込んだ。	PRINTFORMW それに驚いた野うさぎが逃げ出すのに気づいた「それ」はさらに数本の触手を生やすと野うさぎを捕らえ体内へと引きずり込んだ。
PRINTFORMDW 二人が近くにいないだけでなく、さっきまで使っていた愛用の道具と可愛がる予定だったクワガタもいない事に気づくサニー。	PRINTFORMDW 二人が近くにいないだけでなく、さっきまで使っていた愛用の道具と可愛がる予定だったクワガタもいない事に気づくサニー。
PRINTCOLORW(RGBCOLOR(255, 239, 133), "『待って！同じことやって私達酷い目にあった気がするわ！』")	PRINTCOLORW(RGBCOLOR(255, 239, 133), "『待って！同じことやって私達酷い目にあった気がするわ！』")
PRINTFORMDL 本能的に危機を感じたサニーはなんとしてでも触手を自分の体内から引き抜こうとするが絡みついた触手がそれを許さない	PRINTFORMDL 本能的に危機を感じたサニーはなんとしてでも触手を自分の体内から引き抜こうとするが絡みついた触手がそれを許さない
PRINTFORMDW 慌てて座り込みどこかに虫取り網と虫かごがないか探し始める彼女の手足をチャンスとばかりに触手が巻きつきはじめた。	PRINTFORMDW 慌てて座り込みどこかに虫取り網と虫かごがないか探し始める彼女の手足をチャンスとばかりに触手が巻きつきはじめた。
PRINTFORMDW なんとか逃げ出したサニーは、自分があった恐ろしいこと、これが異変の原因だと自分が見つけたんだと言ってまわった。	PRINTFORMDW なんとか逃げ出したサニーは、自分があった恐ろしいこと、これが異変の原因だと自分が見つけたんだと言ってまわった。
PRINTFORMDW 数本の触手がサニーの手足に巻きつき自由を完全に封じると残りの触手がサニーを食い尽くすべく一斉に襲い掛かった！	PRINTFORMDW 数本の触手がサニーの手足に巻きつき自由を完全に封じると残りの触手がサニーを食い尽くすべく一斉に襲い掛かった！
PRINTCOLORW(RGBCOLOR(0, 191, 255), "『面白そう！それじゃあまずは神隠しが多い場所で調査ね！』")	PRINTCOLORW(RGBCOLOR(0, 191, 255), "『面白そう！それじゃあまずは神隠しが多い場所で調査ね！』")
PRINTFORMW 心が折れるまで少女を陵辱し、じっくりと時間をかけて生命力を全て啜り上げる欲求にいてもたってもいられなかった。	PRINTFORMW 心が折れるまで少女を陵辱し、じっくりと時間をかけて生命力を全て啜り上げる欲求にいてもたってもいられなかった。
PRINTFORMW 誰が最初に神隠しにあった人を探せるか競争ね、とよーいドンで三人仲良く別の方向へと飛び立ってしばらくしての事…	PRINTFORMW 誰が最初に神隠しにあった人を探せるか競争ね、とよーいドンで三人仲良く別の方向へと飛び立ってしばらくしての事…
PRINTFORMDW なんとか逃げ出したサニーは、しばらくの間は娘のことを気にかけてはいたものの数日後にはすっかり忘れてしまった	PRINTFORMDW なんとか逃げ出したサニーは、しばらくの間は娘のことを気にかけてはいたものの数日後にはすっかり忘れてしまった
PRINTFORMDW そのことに気付いた%ARGS:0%は、ちゃんと帰って来るのよー！と言い残し、出口へと向かって駆け出した……	PRINTFORMDW そのことに気付いた%ARGS:0%は、ちゃんと帰って来るのよー！と言い残し、出口へと向かって駆け出した……
PRINTFORMDW ズルリと引き抜かれた触手の先端と自らの膣口からドロリとこぼれるゼリー状の液体をサニーは呆然と見つめている	PRINTFORMDW ズルリと引き抜かれた触手の先端と自らの膣口からドロリとこぼれるゼリー状の液体をサニーは呆然と見つめている
PRINTCOLORW(RGBCOLOR(255, 239, 133), "『でもどんどん神隠しの被害者増えてるみたいよ？』")	PRINTCOLORW(RGBCOLOR(255, 239, 133), "『でもどんどん神隠しの被害者増えてるみたいよ？』")
PRINTFORMDW 背後から聞こえてくる二人のどこか非難の色の混じった悲鳴など微塵も気にせずサニーは全力で出口へと走った……	PRINTFORMDW 背後から聞こえてくる二人のどこか非難の色の混じった悲鳴など微塵も気にせずサニーは全力で出口へと走った……
PRINTFORMDW 戦力の半分近くを失った気もするがガーディアンを撃破したサニーはこの調子なら自分達で異変解決も夢じゃない！	PRINTFORMDW 戦力の半分近くを失った気もするがガーディアンを撃破したサニーはこの調子なら自分達で異変解決も夢じゃない！
PRINTFORMDW 自慢だとか勝利だとか言っている場合ではないと、三人は悲鳴をあげながら賑やかに出口へ向かって駆け出した……	PRINTFORMDW 自慢だとか勝利だとか言っている場合ではないと、三人は悲鳴をあげながら賑やかに出口へ向かって駆け出した……
PRINTFORMW そしてそんなある日、神隠しにあった人を探そすために三人は神隠しが多いという場所へと遊びに行ったのだった。	PRINTFORMW そしてそんなある日、神隠しにあった人を探そすために三人は神隠しが多いという場所へと遊びに行ったのだった。
PRINTFORMDL 泣き叫び暴れるサニーの割れ目をを押し広げ貫いている触手は激しく前後しながら徐々にその太さを増していく…	PRINTFORMDL 泣き叫び暴れるサニーの割れ目をを押し広げ貫いている触手は激しく前後しながら徐々にその太さを増していく…
PRINTFORMDW 何本もの触手がサニーの反応を悦ぶかのように数度脈打つと小さな体を完全に捕らえるべく一気に襲い掛かった！	PRINTFORMDW 何本もの触手がサニーの反応を悦ぶかのように数度脈打つと小さな体を完全に捕らえるべく一気に襲い掛かった！
PRINTFORMDW 悲鳴をあげてサニーは慌ててそれを振りほどきその場を離れやっと自分が危険な状況にあることを理解し始めた。	PRINTFORMDW 悲鳴をあげてサニーは慌ててそれを振りほどきその場を離れやっと自分が危険な状況にあることを理解し始めた。
PRINTFORMDW ──今ならこの魔物は私たちの事しか見えていないはずだから、%ARGS:0%だけなら逃げられるはずだ──	PRINTFORMDW ──今ならこの魔物は私たちの事しか見えていないはずだから、%ARGS:0%だけなら逃げられるはずだ──
PRINTFORMW 眩しいほどの笑顔で虫取り網をもって蝶を追い回す羽の生えたツインテールを赤いリボンで作った八重歯の少女。	PRINTFORMW 眩しいほどの笑顔で虫取り網をもって蝶を追い回す羽の生えたツインテールを赤いリボンで作った八重歯の少女。
PRINTCOLORW(RGBCOLOR(0, 191, 255), "『さあ？そのうち霊夢さんが解決するんじゃない？』")	PRINTCOLORW(RGBCOLOR(0, 191, 255), "『さあ？そのうち霊夢さんが解決するんじゃない？』")
PRINTFORMDL 触手が激しく脈打つ度に結合部から鮮やかな破瓜血がまざった白濁液がこぼれ、地面へとぽたぽたと滴った	PRINTFORMDL 触手が激しく脈打つ度に結合部から鮮やかな破瓜血がまざった白濁液がこぼれ、地面へとぽたぽたと滴った
PRINTFORMDL 甲高い長い悲鳴は何度も何度も繰り返されるが次第に触手の壁に阻まれ細くくぐもったものとなっていく…	PRINTFORMDL 甲高い長い悲鳴は何度も何度も繰り返されるが次第に触手の壁に阻まれ細くくぐもったものとなっていく…
PRINTFORMDW 今では姿を消す人数に負けず劣らず、生還する人数も増えていることも彼女達の興味を少しも引かなかった	PRINTFORMDW 今では姿を消す人数に負けず劣らず、生還する人数も増えていることも彼女達の興味を少しも引かなかった
PRINTFORMDW 今では姿を消す人数に負けず劣らず、生還する人数も増えていることもサニーの興味を少しも引かなかった	PRINTFORMDW 今では姿を消す人数に負けず劣らず、生還する人数も増えていることもサニーの興味を少しも引かなかった
PRINTFORMW 「それ」の中を必死に彷徨い、恐怖し、悲鳴をあげ、ささやかな無駄な抵抗を繰り返す少女が欲しかった。	PRINTFORMW 「それ」の中を必死に彷徨い、恐怖し、悲鳴をあげ、ささやかな無駄な抵抗を繰り返す少女が欲しかった。
PRINTFORMDW 瞳の光の消えたサニーの抵抗はみるみるうちに弱々しいものとなりやがてピクリとも動かなくなった……	PRINTFORMDW 瞳の光の消えたサニーの抵抗はみるみるうちに弱々しいものとなりやがてピクリとも動かなくなった……
PRINTFORMDW サニーを嬲る邪魔をする者がいなくなったことを悟った触手が今まで以上の勢いでサニーの身体に迫る…	PRINTFORMDW サニーを嬲る邪魔をする者がいなくなったことを悟った触手が今まで以上の勢いでサニーの身体に迫る…
PRINTFORMDL そんなサニーの事など少しも気にも留めず異形の生物はマイペースに膣口を押し広げ這い出そうと暴れる	PRINTFORMDL そんなサニーの事など少しも気にも留めず異形の生物はマイペースに膣口を押し広げ這い出そうと暴れる
PRINTFORMDL 触手の塊はサニーの脚を、腕を、首を、身体を、顔に次々と粘っこい水音を立てながら次々と巻きつき、	PRINTFORMDL 触手の塊はサニーの脚を、腕を、首を、身体を、顔に次々と粘っこい水音を立てながら次々と巻きつき、
PRINTFORMDL あっという間にサニーの肌は覆い尽くされたにも関わらずそれでも押し寄せる触手の勢いは止まらない。	PRINTFORMDL あっという間にサニーの肌は覆い尽くされたにも関わらずそれでも押し寄せる触手の勢いは止まらない。
PRINTFORMDL どことなく賑やかなくぐもった叫びを背中に受けながらも%CALLNAME:1%は逃げることにした	PRINTFORMDL どことなく賑やかなくぐもった叫びを背中に受けながらも%CALLNAME:1%は逃げることにした
PRINTCOLORW(RGBCOLOR(0, 191, 255), "『ねえ、ただ調査するだけじゃつまらないわ』")	PRINTCOLORW(RGBCOLOR(0, 191, 255), "『ねえ、ただ調査するだけじゃつまらないわ』")
PRINTFORMDW 彼女を歓迎するかのようにそのいくつかから触手をもった生物が産まれ、プラント自身も触手を伸ばす…	PRINTFORMDW 彼女を歓迎するかのようにそのいくつかから触手をもった生物が産まれ、プラント自身も触手を伸ばす…
PRINTFORMDL サニーは一度目を覚ましたもののこれは夢だと自分に言い聞かせるように呟き続けながら意識を失った	PRINTFORMDL サニーは一度目を覚ましたもののこれは夢だと自分に言い聞かせるように呟き続けながら意識を失った
PRINTFORMDL だが、彼女が泣き出すより早く、突き入れられた触手は容赦なく血の滴る彼女の膣を蹂躙しはじめた…	PRINTFORMDL だが、彼女が泣き出すより早く、突き入れられた触手は容赦なく血の滴る彼女の膣を蹂躙しはじめた…
PRINTFORMDW マユの隙間から僅かに覗いていた彼女の羽も、ゆっくりとマユの中へと引き込まれ、見えなくなった…	PRINTFORMDW マユの隙間から僅かに覗いていた彼女の羽も、ゆっくりとマユの中へと引き込まれ、見えなくなった…
PRINTFORMDL 薄暗い触手蠢く迷宮内とは思えないような幸せそうな寝顔を浮かべていたサニーが痛みに悲鳴を上げた	PRINTFORMDL 薄暗い触手蠢く迷宮内とは思えないような幸せそうな寝顔を浮かべていたサニーが痛みに悲鳴を上げた
PRINTFORMDW そのミミズのようなものは彼女の腕を捕らえようと身を唸らせるのでサニーは慌てて腕を引っ込めた。	PRINTFORMDW そのミミズのようなものは彼女の腕を捕らえようと身を唸らせるのでサニーは慌てて腕を引っ込めた。
PRINTFORMDW 巧妙に隠匿されていた忌まわしい迷宮も、唯一の生還者であるサニーの情報を元に瞬く間に発見された	PRINTFORMDW 巧妙に隠匿されていた忌まわしい迷宮も、唯一の生還者であるサニーの情報を元に瞬く間に発見された
PRINTFORMDW そう思ったのも束の間、まるで迷宮自体が意思を持っているかのように、出口が音を立てて閉じ始めた	PRINTFORMDW そう思ったのも束の間、まるで迷宮自体が意思を持っているかのように、出口が音を立てて閉じ始めた
PRINTFORMDW 外にでたら絶対に遊びに行くからと悲鳴混じりに答える二人を置いて、サニーは出口へと走った……	PRINTFORMDW 外にでたら絶対に遊びに行くからと悲鳴混じりに答える二人を置いて、サニーは出口へと走った……
PRINTFORMDW 酷いなあと思いながらサニーが自分の部屋から出るなり鼻を突く生臭い臭いにサニーは眉をひそめた	PRINTFORMDW 酷いなあと思いながらサニーが自分の部屋から出るなり鼻を突く生臭い臭いにサニーは眉をひそめた
PRINTCOLORW(RGBCOLOR(0, 191, 255), "『はい、今日もタコヤキと蠢くサラダよ』")	PRINTCOLORW(RGBCOLOR(0, 191, 255), "『はい、今日もタコヤキと蠢くサラダよ』")
PRINTFORMDW そのことに気付いたサニーは、ラッキーと胸の中で小躍りしながら出口へと向かって駆け出した……	PRINTFORMDW そのことに気付いたサニーは、ラッキーと胸の中で小躍りしながら出口へと向かって駆け出した……
PRINTFORMDW 色々と怖い目やエッチな目や嫌な思いもしたけれども、もうそんなことも二度と起こらないだろう。	PRINTFORMDW 色々と怖い目やエッチな目や嫌な思いもしたけれども、もうそんなことも二度と起こらないだろう。
PRINTFORMDW サニーはそんな危険な異変には関わりたくないと今日も楽しくルナとスターと遊びまわるのであった	PRINTFORMDW サニーはそんな危険な異変には関わりたくないと今日も楽しくルナとスターと遊びまわるのであった
PRINTFORMDW サニーは首をかしげながら、家路に着くが、家に着いたときにはそんな出来事など完全に忘れていた	PRINTFORMDW サニーは首をかしげながら、家路に着くが、家に着いたときにはそんな出来事など完全に忘れていた
PRINTFORMDL 呑み込まれているサニーの救出を諦めた%CALLNAME:1%はこの場を離れることにした…	PRINTFORMDL 呑み込まれているサニーの救出を諦めた%CALLNAME:1%はこの場を離れることにした…
PRINTFORML 「そんな…無理よ無理！霊夢さんがやられちゃうような異変なんて私じゃどうしょうもないわよ！」	PRINTFORML 「そんな…無理よ無理！霊夢さんがやられちゃうような異変なんて私じゃどうしょうもないわよ！」
PRINTFORMDW サニーをリーダーに擁する妖精一味は雄たけびをあげながら迷宮の奥深くへと雪崩れ込んでいった	PRINTFORMDW サニーをリーダーに擁する妖精一味は雄たけびをあげながら迷宮の奥深くへと雪崩れ込んでいった
PRINTFORMDW そのことが一部の正義感の強い人妖の耳にも入りサニーは迷宮への道案内を頼まれることになった	PRINTFORMDW そのことが一部の正義感の強い人妖の耳にも入りサニーは迷宮への道案内を頼まれることになった
PRINTFORMDW %ARGS:0%が通ってきたはずの出入り口は既に無く、迷宮は影も形も無くなっていたのだ…	PRINTFORMDW %ARGS:0%が通ってきたはずの出入り口は既に無く、迷宮は影も形も無くなっていたのだ…
PRINTFORMDW サニーは多分見つからないだろうと半分諦めながらも辺りを見回し、信じられないことに気づいた	PRINTFORMDW サニーは多分見つからないだろうと半分諦めながらも辺りを見回し、信じられないことに気づいた
PRINTFORMDW 出入り口は閉じてしまったようだが、もう二度とここには近づかないし関係ないという結論に至る	PRINTFORMDW 出入り口は閉じてしまったようだが、もう二度とここには近づかないし関係ないという結論に至る
PRINTFORMDW 次に彼女達がこの迷宮のことを思い出すのはおそらく異変が解決したという噂が耳に入る頃だろう	PRINTFORMDW 次に彼女達がこの迷宮のことを思い出すのはおそらく異変が解決したという噂が耳に入る頃だろう
PRINTFORML 「これをいっぱい集めて持って帰ればこれを使って私も異変解決できちゃったりして…ふふふ…」	PRINTFORML 「これをいっぱい集めて持って帰ればこれを使って私も異変解決できちゃったりして…ふふふ…」
PRINTFORMDW こうして最初の犠牲者候補、サニーミルクは何も分からないまま不気味な迷宮を彷徨い始めた…	PRINTFORMDW こうして最初の犠牲者候補、サニーミルクは何も分からないまま不気味な迷宮を彷徨い始めた…
PRINTFORMDW 地面に倒れ、断末魔の悲鳴をあげながら悶えていたガーディアンは、やがて完全に動きを止める	PRINTFORMDW 地面に倒れ、断末魔の悲鳴をあげながら悶えていたガーディアンは、やがて完全に動きを止める
PRINTFORMDW 先ほど待ってあった出入り口が閉じているどころか、迷宮があった形跡すらのこっていないのだ	PRINTFORMDW 先ほど待ってあった出入り口が閉じているどころか、迷宮があった形跡すらのこっていないのだ
PRINTFORMDW 出入り口が閉じているどころか、そこには何の変哲もない空間がただ広がっているだけだった…	PRINTFORMDW 出入り口が閉じているどころか、そこには何の変哲もない空間がただ広がっているだけだった…
PRINTFORMDW 自分達と同じようにガーディアンを倒して脱出してきたという少女が少しずつ現れていることも	PRINTFORMDW 自分達と同じようにガーディアンを倒して脱出してきたという少女が少しずつ現れていることも
PRINTFORMW 「それ」が倒される間際に切り離した体の一部がかつてと変わらぬ力をついに取り戻したのだ。	PRINTFORMW 「それ」が倒される間際に切り離した体の一部がかつてと変わらぬ力をついに取り戻したのだ。
PRINTFORML 「%CALLNAME:(ARG:2)%が捕まったのに勝てるわけないわ！撤収よ！撤収！」	PRINTFORML 「%CALLNAME:(ARG:2)%が捕まったのに勝てるわけないわ！撤収よ！撤収！」
PRINTFORMDL サニーは自分が捨てられそうなことを察したのか、モンスターの内部で激しくもがき始めた！	PRINTFORMDL サニーは自分が捨てられそうなことを察したのか、モンスターの内部で激しくもがき始めた！
PRINTFORMDW 突然、まるで全身を包み込むように動きを変えた触手の群れを前に引きつった悲鳴をあげた。	PRINTFORMDW 突然、まるで全身を包み込むように動きを変えた触手の群れを前に引きつった悲鳴をあげた。
PRINTFORMDW そしてついにはサニーの身体があった場所に胎動する触手のマユのようなものだけが残さた。	PRINTFORMDW そしてついにはサニーの身体があった場所に胎動する触手のマユのようなものだけが残さた。
PRINTFORML 「妖怪退治の御神体候補でもこれだけ強そうならあの鏡とかはもっとヤバイものだったのよね」	PRINTFORML 「妖怪退治の御神体候補でもこれだけ強そうならあの鏡とかはもっとヤバイものだったのよね」
PRINTFORMDL サニーはお腹を殴ろうと拳を振り上げたが、しばらくすると渋々といった様子で手を下ろした	PRINTFORMDL サニーはお腹を殴ろうと拳を振り上げたが、しばらくすると渋々といった様子で手を下ろした
PRINTFORMW 「よく分からないけどとにかくここに居続けるのはあまりよくなさそうね。お日様見えないし」	PRINTFORMW 「よく分からないけどとにかくここに居続けるのはあまりよくなさそうね。お日様見えないし」
PRINTFORMW サニーは上機嫌で出口も分からない迷宮の奥だか出口だか分からない場所目指して歩き始めた…	PRINTFORMW サニーは上機嫌で出口も分からない迷宮の奥だか出口だか分からない場所目指して歩き始めた…
PRINTFORMDW いつもの平和な日常、賑やかな遊び、神隠しがおきているなんて噂も彼女達には関係なかった	PRINTFORMDW いつもの平和な日常、賑やかな遊び、神隠しがおきているなんて噂も彼女達には関係なかった
PRINTFORMDW 必死の呼びかけもあって、かつての大戦争の時のように多くの仲間が面白半分で集まったのだ	PRINTFORMDW 必死の呼びかけもあって、かつての大戦争の時のように多くの仲間が面白半分で集まったのだ
PRINTFORMDW {DAY}日振りの外の空気に、%ARGS:0%%TACHI()%は安堵の溜息を漏らす	PRINTFORMDW {DAY}日振りの外の空気に、%ARGS:0%%TACHI()%は安堵の溜息を漏らす
PRINTFORMDW 自分と同じようにガーディアンを倒して脱出してきたという少女が少しずつ現れていることも	PRINTFORMDW 自分と同じようにガーディアンを倒して脱出してきたという少女が少しずつ現れていることも
PRINTFORMW 空高く舞い上がった蝶を恨めしそうに見上げる少女の背後へと触手を忍び寄らせたのだった…	PRINTFORMW 空高く舞い上がった蝶を恨めしそうに見上げる少女の背後へと触手を忍び寄らせたのだった…
PRINTFORMDL 悲痛なくぐもった叫びを背中に受けながらも%CALLNAME:1%は逃げることにした	PRINTFORMDL 悲痛なくぐもった叫びを背中に受けながらも%CALLNAME:1%は逃げることにした
PRINTFORMDW 目の前には懐かしい娘達と大量の粘液に塗れ虚ろな瞳で床に横たわるルナとスターがいた…	PRINTFORMDW 目の前には懐かしい娘達と大量の粘液に塗れ虚ろな瞳で床に横たわるルナとスターがいた…
PRINTFORMDW ──今なら敵はあの二人に夢中になっている　　自分だけなら逃げられるのではないか──	PRINTFORMDW ──今なら敵はあの二人に夢中になっている　　自分だけなら逃げられるのではないか──
PRINTFORMDW {DAY}日振りの外の空気をサニーは思い切り吸い込むと幸せそうなため息を吐き出した	PRINTFORMDW {DAY}日振りの外の空気をサニーは思い切り吸い込むと幸せそうなため息を吐き出した
PRINTFORMDW %ARGS:0%%TACHI()%の攻撃が、ついにガーディアンの巨大な目玉を貫いた	PRINTFORMDW %ARGS:0%%TACHI()%の攻撃が、ついにガーディアンの巨大な目玉を貫いた
PRINTFORMDW それから暫くして、サニーは迷宮のことなど完全に忘れて今日も遊びに夢中になっている。	PRINTFORMDW それから暫くして、サニーは迷宮のことなど完全に忘れて今日も遊びに夢中になっている。
PRINTFORMW しかし「それ」の身体は別の世界にいるかのように動物にも人間にも届くことはなかった…	PRINTFORMW しかし「それ」の身体は別の世界にいるかのように動物にも人間にも届くことはなかった…
PRINTFORMW 今度は前回とは違い世界が自分に馴染む感覚に全身を震わせ大地から一本の触手を伸ばす。	PRINTFORMW 今度は前回とは違い世界が自分に馴染む感覚に全身を震わせ大地から一本の触手を伸ばす。
PRINTFORMW 少なくとも、人里の人間の殆どが人里の外に行きたがらなくなる程度の時間は過ぎていた。	PRINTFORMW 少なくとも、人里の人間の殆どが人里の外に行きたがらなくなる程度の時間は過ぎていた。
PRINTFORMDL 未だに眠っている彼女の涙の代わりのようにぽつっぽつっと鮮血が滴り落ちていった……	PRINTFORMDL 未だに眠っている彼女の涙の代わりのようにぽつっぽつっと鮮血が滴り落ちていった……
PRINTFORMDL サニーは両手で武器を握ると悲鳴のような叫び声をあげながら力いっぱい武器を振るった	PRINTFORMDL サニーは両手で武器を握ると悲鳴のような叫び声をあげながら力いっぱい武器を振るった
PRINTFORMDW 今まで以上に激しく抵抗する彼女の反応を面白がるように触手はサニーを陵辱し続ける…	PRINTFORMDW 今まで以上に激しく抵抗する彼女の反応を面白がるように触手はサニーを陵辱し続ける…
PRINTFORML 「ちょっとだけ、目が覚めたらいつもの硬い床にいるかもしれないって期待していたのに」	PRINTFORML 「ちょっとだけ、目が覚めたらいつもの硬い床にいるかもしれないって期待していたのに」
PRINTFORMDW 必死にサニーはもがくがその度に肉壁と服とが擦れた部分が溶けて肌が晒されてゆく……	PRINTFORMDW 必死にサニーはもがくがその度に肉壁と服とが擦れた部分が溶けて肌が晒されてゆく……
PRINTFORMDL 肉壁で蠢いていた何本もの触手がうるさいと言わんばかりにサニーの口へと押し込まれた	PRINTFORMDL 肉壁で蠢いていた何本もの触手がうるさいと言わんばかりにサニーの口へと押し込まれた
PRINTFORML 「魔理沙さんが持ってたものに似てる気がするけどもしかしてやられちゃったのかしら？」	PRINTFORML 「魔理沙さんが持ってたものに似てる気がするけどもしかしてやられちゃったのかしら？」
PRINTFORMW 「あーー！私の虫取り網！？虫かご！？どこいっちゃったの！？クワガタ捕まえたのに！」	PRINTFORMW 「あーー！私の虫取り網！？虫かご！？どこいっちゃったの！？クワガタ捕まえたのに！」
PRINTFORMDW 10回以上の一回休みを経験しすっかり迷宮での出来事がトラウマになってしまったルナ	PRINTFORMDW 10回以上の一回休みを経験しすっかり迷宮での出来事がトラウマになってしまったルナ
PRINTFORMW 「あつっ、あつっ…ごっくん。そうだ！なら私達でこの異変を解決しちゃいましょうよ！」	PRINTFORMW 「あつっ、あつっ…ごっくん。そうだ！なら私達でこの異変を解決しちゃいましょうよ！」
PRINTCOLORW(RGBCOLOR(255, 239, 133), "『なら違う…のかなぁ…』")	PRINTCOLORW(RGBCOLOR(255, 239, 133), "『なら違う…のかなぁ…』")
PRINTFORMDW それから暫くして、三人は迷宮のことなど完全に忘れて今日も遊びに夢中になっている。	PRINTFORMDW それから暫くして、三人は迷宮のことなど完全に忘れて今日も遊びに夢中になっている。
PRINTFORMW 光の三妖精も例に漏れず異変に関わろうと毎日あれこれと頭と体をフル回転させていた。	PRINTFORMW 光の三妖精も例に漏れず異変に関わろうと毎日あれこれと頭と体をフル回転させていた。
PRINTFORML 原作でサニーちゃんが深刻に追い詰められるシーンがないからかなんだか誰てめえ状態！	PRINTFORML 原作でサニーちゃんが深刻に追い詰められるシーンがないからかなんだか誰てめえ状態！
PRINTFORMDL サニーは寝言とは思えないほど早口で瞳に涙を浮かべ悪夢の主に許しを請いている……	PRINTFORMDL サニーは寝言とは思えないほど早口で瞳に涙を浮かべ悪夢の主に許しを請いている……
PRINTFORMDL 肉壁で蠢いていた何本もの触手が伸び、しゅるしゅるとサニーの全身に絡みつき始めた	PRINTFORMDL 肉壁で蠢いていた何本もの触手が伸び、しゅるしゅるとサニーの全身に絡みつき始めた
PRINTFORMDW サニーが壁から伸びる一本の巨大なミミズのようなものを掴もうと手を伸ばすや否や、	PRINTFORMDW サニーが壁から伸びる一本の巨大なミミズのようなものを掴もうと手を伸ばすや否や、
PRINTFORMDW ああ、そっか。なら大丈夫ね。二人ともありがとう！と元気よく二人に手を振るサニー	PRINTFORMDW ああ、そっか。なら大丈夫ね。二人ともありがとう！と元気よく二人に手を振るサニー
PRINTFORMDL 力なく両手足を投げ出し触手に陵辱されているサニーの体は触手に貪られるている間	PRINTFORMDL 力なく両手足を投げ出し触手に陵辱されているサニーの体は触手に貪られるている間
PRINTFORMDW 体が柔らかく生暖かい何かにぶつかるたびに元気な悲鳴をあげたことは覚えている…	PRINTFORMDW 体が柔らかく生暖かい何かにぶつかるたびに元気な悲鳴をあげたことは覚えている…
PRINTFORMDW 少しだけ深刻な表情になるサニーだが、すぐにいつもの自信満々な笑顔を取り戻す。	PRINTFORMDW 少しだけ深刻な表情になるサニーだが、すぐにいつもの自信満々な笑顔を取り戻す。
PRINTFORMDW 薄暗い部屋のあちこちに妖精を核としたバイオプラントが所狭しとあるではないか…	PRINTFORMDW 薄暗い部屋のあちこちに妖精を核としたバイオプラントが所狭しとあるではないか…
PRINTFORMW 生贄が捧げられなくなれば老若男女問わず襲い村ごと自らの栄養として取り込んだ。	PRINTFORMW 生贄が捧げられなくなれば老若男女問わず襲い村ごと自らの栄養として取り込んだ。
PRINTFORMDL サニーはビクビクしながら悩ましげに身体をくねらせるがそれでも眠っている……	PRINTFORMDL サニーはビクビクしながら悩ましげに身体をくねらせるがそれでも眠っている……
PRINTFORMDL サニーの目が一度うっすらと開き、自分の下半身へと視線を向けたように思えたが	PRINTFORMDL サニーの目が一度うっすらと開き、自分の下半身へと視線を向けたように思えたが
PRINTFORML 「気持ち悪い！お腹のなか気持ち悪い！ああぁ……お腹のなかに……ナカ……に…」	PRINTFORML 「気持ち悪い！お腹のなか気持ち悪い！ああぁ……お腹のなかに……ナカ……に…」
PRINTFORMDW 必死にサニーがもがく度に肉壁と服とが擦れた部分が溶けて肌が晒されてゆく……	PRINTFORMDW 必死にサニーがもがく度に肉壁と服とが擦れた部分が溶けて肌が晒されてゆく……
PRINTFORML 「妖怪退治のご利益ある御神体の実力、見せてもらうからね。次点の御神体だけど」	PRINTFORML 「妖怪退治のご利益ある御神体の実力、見せてもらうからね。次点の御神体だけど」
PRINTFORML 「ミルク！ミルクとお砂糖ないの！？このままじゃ苦くて飲めたもんじゃないわ！」	PRINTFORML 「ミルク！ミルクとお砂糖ないの！？このままじゃ苦くて飲めたもんじゃないわ！」
PRINTFORML 「すごい！このスイッチ押すと音がなって光るの！外に出れたら宝物入れ行きね！」	PRINTFORML 「すごい！このスイッチ押すと音がなって光るの！外に出れたら宝物入れ行きね！」
PRINTFORMDW 出口を見つけたものの、そこを守る魔物は強く、サニーの力ではどうしようもない	PRINTFORMDW 出口を見つけたものの、そこを守る魔物は強く、サニーの力ではどうしようもない
PRINTFORMDW 大冒険の末にあまり口にしたくない食材を大量に抱えてケロリと帰ってきたスター	PRINTFORMDW 大冒険の末にあまり口にしたくない食材を大量に抱えてケロリと帰ってきたスター
PRINTCOLORW(RGBCOLOR(255, 239, 133), "『…違ったっけ？』")	PRINTCOLORW(RGBCOLOR(255, 239, 133), "『…違ったっけ？』")
PRINTFORMDW 嘘つきの汚名を払拭しようと必死に出入り口を探すもそれすら見つかりそうにない	PRINTFORMDW 嘘つきの汚名を払拭しようと必死に出入り口を探すもそれすら見つかりそうにない
PRINTFORMDW このままじゃ閉じ込められちゃう！とサニーは慌てて出口目掛けて駆け出した……	PRINTFORMDW このままじゃ閉じ込められちゃう！とサニーは慌てて出口目掛けて駆け出した……
PRINTFORMDW 光の三妖精の絶妙な連携によって、ついにガーディアンの巨大な目玉が光を失った	PRINTFORMDW 光の三妖精の絶妙な連携によって、ついにガーディアンの巨大な目玉が光を失った
PRINTFORMDL サニーは処女膜を引きちぎり胎内を目指す触手を前にしても抵抗できずにいる…	PRINTFORMDL サニーは処女膜を引きちぎり胎内を目指す触手を前にしても抵抗できずにいる…
PRINTFORMDW サニーは自分の下半身を強引に押し広げる異物の感覚に顔を一気に青ざめさせた	PRINTFORMDW サニーは自分の下半身を強引に押し広げる異物の感覚に顔を一気に青ざめさせた
PRINTFORMDL 自分の下半身に突き刺さった触手を信じられないといった様子で見つめるサニー	PRINTFORMDL 自分の下半身に突き刺さった触手を信じられないといった様子で見つめるサニー
PRINTFORMDL サニーは膨らみきった腹部をブツブツと何かを呟きながらずっとさすっている…	PRINTFORMDL サニーは膨らみきった腹部をブツブツと何かを呟きながらずっとさすっている…
PRINTFORMDL サニーは虚ろな瞳で大きく膨らんだ腹部を痛みをごまかすようにさすっている…	PRINTFORMDL サニーは虚ろな瞳で大きく膨らんだ腹部を痛みをごまかすようにさすっている…
PRINTFORML 「魔理沙さんが持ってたものに似てる気がするけどもしかしてやられちゃった…」	PRINTFORML 「魔理沙さんが持ってたものに似てる気がするけどもしかしてやられちゃった…」
PRINTFORML 「妖精は怪我しても大丈夫だからって雑に使っていいもんじゃないんだからね！」	PRINTFORML 「妖精は怪我しても大丈夫だからって雑に使っていいもんじゃないんだからね！」
PRINTFORMDW それは名案ね！と二人が呆然とするほどあっさりとその提案を受け入れるサニー	PRINTFORMDW それは名案ね！と二人が呆然とするほどあっさりとその提案を受け入れるサニー
PRINTFORMDW あれからかなりの月日が過ぎたが、未だに自分以外の生還者は見つかっていない	PRINTFORMDW あれからかなりの月日が過ぎたが、未だに自分以外の生還者は見つかっていない
PRINTFORMDW この素晴らしい勝利を他の少女達にも伝えようと三人が拳を振り上げるも束の間	PRINTFORMDW この素晴らしい勝利を他の少女達にも伝えようと三人が拳を振り上げるも束の間
PRINTFORMDL サニーは夢でよほど恐ろしい目に合っているのか寝言を叫びながら暴れ始めた	PRINTFORMDL サニーは夢でよほど恐ろしい目に合っているのか寝言を叫びながら暴れ始めた
PRINTFORMDW 下半身にこびり付いた生暖かさの不快感にサニーは乾いた笑いをこぼした……	PRINTFORMDW 下半身にこびり付いた生暖かさの不快感にサニーは乾いた笑いをこぼした……
PRINTFORMDL いや、サニーの全身を揉みしだく肉壁の勢いは衰えを少しもみせていない……	PRINTFORMDL いや、サニーの全身を揉みしだく肉壁の勢いは衰えを少しもみせていない……
PRINTFORML 「外に出たらお祝いにクッキーと紅茶をご馳走してもらっても…ダメですか？」	PRINTFORML 「外に出たらお祝いにクッキーと紅茶をご馳走してもらっても…ダメですか？」
PRINTFORML 「壁から生えてる触手にたまにおいしそうな形のものがあるのよね。罠かしら」	PRINTFORML 「壁から生えてる触手にたまにおいしそうな形のものがあるのよね。罠かしら」
PRINTFORML 「キモイキモイキモイ！あんた達みたいなキモイだけの虫は好きじゃないの！」	PRINTFORML 「キモイキモイキモイ！あんた達みたいなキモイだけの虫は好きじゃないの！」
PRINTFORMW 「そうと分かれば証拠にこの壁にはえてるうねうねの一本でも持って帰って…」	PRINTFORMW 「そうと分かれば証拠にこの壁にはえてるうねうねの一本でも持って帰って…」
PRINTFORMDW 出口を見つけたものの、そこを守る魔物は強く、自分達ではどうしようもない	PRINTFORMDW 出口を見つけたものの、そこを守る魔物は強く、自分達ではどうしようもない
PRINTFORMDW 今度は数多くの仲間が居る！妖精の力が弱いなら数の暴力で押し切ればいい！	PRINTFORMDW 今度は数多くの仲間が居る！妖精の力が弱いなら数の暴力で押し切ればいい！
PRINTFORMDW 彼女が状況を理解しようと周囲を見回すなり、恐怖に引きつった悲鳴を上げた	PRINTFORMDW 彼女が状況を理解しようと周囲を見回すなり、恐怖に引きつった悲鳴を上げた
PRINTFORMDW 自分達の勝利を確信した三人はお互いに抱き合い、小躍りしながら喜びあう！	PRINTFORMDW 自分達の勝利を確信した三人はお互いに抱き合い、小躍りしながら喜びあう！
PRINTFORMDW まるで迷宮自体が意思を持っているかのように、出口が音を立てて閉じ始めた	PRINTFORMDW まるで迷宮自体が意思を持っているかのように、出口が音を立てて閉じ始めた
PRINTFORMDW おそらく異変が解決したという噂が耳に入る頃になれば異変のことを思い出し	PRINTFORMDW おそらく異変が解決したという噂が耳に入る頃になれば異変のことを思い出し
PRINTFORMW 「それ」が完全に人間に忘れ去られさらにどれほどの時が立ったのだろうか？	PRINTFORMW 「それ」が完全に人間に忘れ去られさらにどれほどの時が立ったのだろうか？
PRINTFORMW 久しぶりの肉の味に「それ」は興奮し、世界に触れられる喜びに涙すらした。	PRINTFORMW 久しぶりの肉の味に「それ」は興奮し、世界に触れられる喜びに涙すらした。
PRINTFORMW そんな異変だ異変だと騒ぎになればお祭好きの妖精が黙っているわけもなく、	PRINTFORMW そんな異変だ異変だと騒ぎになればお祭好きの妖精が黙っているわけもなく、
PRINTFORMW 出会った人に片っ端から神隠しにあったか聞いていこうと結論をだしたサニー	PRINTFORMW 出会った人に片っ端から神隠しにあったか聞いていこうと結論をだしたサニー
PRINTFORMDW まるで現実に目をそむけるかのすぐに深い眠りへと意識を沈めていった……	PRINTFORMDW まるで現実に目をそむけるかのすぐに深い眠りへと意識を沈めていった……
PRINTFORMDL ぐったりとしているサニーの股間と触手の隙間から白濁液がこぼれていく…	PRINTFORMDL ぐったりとしているサニーの股間と触手の隙間から白濁液がこぼれていく…
PRINTFORMDL 光の屈折で集められた強い光が大切な部分を隠してはいるが恥ずかしそうだ	PRINTFORMDL 光の屈折で集められた強い光が大切な部分を隠してはいるが恥ずかしそうだ
PRINTFORML 「はぁ…まさか服をこんなにありがたく感じる日が来るとは思わなかったわ」	PRINTFORML 「はぁ…まさか服をこんなにありがたく感じる日が来るとは思わなかったわ」
PRINTFORMDW 10秒ほど考え込んだ彼女はひらめいたとぽんっと拳で手のひらを叩いた。	PRINTFORMDW 10秒ほど考え込んだ彼女はひらめいたとぽんっと拳で手のひらを叩いた。
PRINTFORMDW 以上が彼女達が薄暗い洞窟の中で後悔するほんの数分前の出来事である……	PRINTFORMDW 以上が彼女達が薄暗い洞窟の中で後悔するほんの数分前の出来事である……
PRINTFORML （至近距離でぶんなぐって速攻で終わらせれば怖い目あわないわよね…？）	PRINTFORML （至近距離でぶんなぐって速攻で終わらせれば怖い目あわないわよね…？）
PRINTFORML 「不意打ちにだまし討ち、卑怯な事はお手の物！サニー様の急所狙いよ！」	PRINTFORML 「不意打ちにだまし討ち、卑怯な事はお手の物！サニー様の急所狙いよ！」
PRINTFORMDL サニーは肉壁をひっかいたりかみついたり思いつく限りの抵抗をしている	PRINTFORMDL サニーは肉壁をひっかいたりかみついたり思いつく限りの抵抗をしている
PRINTFORMDL サニーは耳を覆いたくなるような悲痛な悲鳴をあげ必死に抵抗を始めた！	PRINTFORMDL サニーは耳を覆いたくなるような悲痛な悲鳴をあげ必死に抵抗を始めた！
PRINTFORMDL サニーの表情があっというまにぐしゃりと子供のような泣き顔に変わる。	PRINTFORMDL サニーの表情があっというまにぐしゃりと子供のような泣き顔に変わる。
PRINTFORMDL サニーはボロボロ泣きながら自分の下腹部で脈動する触手を見つめている	PRINTFORMDL サニーはボロボロ泣きながら自分の下腹部で脈動する触手を見つめている
PRINTFORMDL そう判断した%CALLNAME:1%はサニーを置いていくことにした	PRINTFORMDL そう判断した%CALLNAME:1%はサニーを置いていくことにした
PRINTFORML 「うまく使えばパワーアップが出来ると思うけど…どうつかえばいいやら」	PRINTFORML 「うまく使えばパワーアップが出来ると思うけど…どうつかえばいいやら」
PRINTFORML 「な、なにかしら…なぜかリリーホワイトとの例の事件を思い出したわ…」	PRINTFORML 「な、なにかしら…なぜかリリーホワイトとの例の事件を思い出したわ…」
PRINTFORML 「…か、考えないわよ！どこからどうやって作られたお茶かなんて絶対！」	PRINTFORML 「…か、考えないわよ！どこからどうやって作られたお茶かなんて絶対！」
PRINTFORMDL サニーが突然叫び声をあげ腹部を押えながら地面を転がりまわり始めた！	PRINTFORMDL サニーが突然叫び声をあげ腹部を押えながら地面を転がりまわり始めた！
PRINTFORMDL サニーはめちゃくちゃに自分の腹部を拳で叩きながら痛い痛いと叫んだ！	PRINTFORMDL サニーはめちゃくちゃに自分の腹部を拳で叩きながら痛い痛いと叫んだ！
PRINTFORMDW 涙目でイヤイヤと首を振るサニーの全身に次々と触手が絡み付いてゆく…	PRINTFORMDW 涙目でイヤイヤと首を振るサニーの全身に次々と触手が絡み付いてゆく…
PRINTFORML 「妖怪だかなんだかよくわかんないものに追い回されるのは慣れないわね」	PRINTFORML 「妖怪だかなんだかよくわかんないものに追い回されるのは慣れないわね」
PRINTFORML 「長い棒って持つとついつい振り回したくなるのよね！とりゃ！てやっ！」	PRINTFORML 「長い棒って持つとついつい振り回したくなるのよね！とりゃ！てやっ！」
PRINTFORML 「痛いー…勝手に人の体使ってるんだからせめて大人しくしなさいよー！」	PRINTFORML 「痛いー…勝手に人の体使ってるんだからせめて大人しくしなさいよー！」
PRINTFORML 「こんな場所にある泉のクセにおいしいわー♪ちょっと持って帰ろうかな」	PRINTFORML 「こんな場所にある泉のクセにおいしいわー♪ちょっと持って帰ろうかな」
PRINTFORML 「この水を使えばすっごいおいしいお酒が造れそう！…え？あれ？泉は？」	PRINTFORML 「この水を使えばすっごいおいしいお酒が造れそう！…え？あれ？泉は？」
PRINTFORML 「巫女がやられたなら私達が異変を解決するしかないわね！ふっふっふ…」	PRINTFORML 「巫女がやられたなら私達が異変を解決するしかないわね！ふっふっふ…」
PRINTFORML 「ここでやられたのは妖精でうっぷんを晴らす方法とか本に書いたヤツ！」	PRINTFORML 「ここでやられたのは妖精でうっぷんを晴らす方法とか本に書いたヤツ！」
PRINTFORMDW 歯がみするサニーに、捕らえられた娘達が覚悟を決めたように話しかける	PRINTFORMDW 歯がみするサニーに、捕らえられた娘達が覚悟を決めたように話しかける
PRINTFORMDW ──私達が囮になっている間に、なんとか脱出し助けを呼んで欲しい──	PRINTFORMDW ──私達が囮になっている間に、なんとか脱出し助けを呼んで欲しい──
PRINTFORMDW 迷宮は逃がした獲物が余計なことをする前に消してしまおうと忍び寄る…	PRINTFORMDW 迷宮は逃がした獲物が余計なことをする前に消してしまおうと忍び寄る…
PRINTFORMDW サニーは騒がしく悲鳴をあげながら必死で出口に向かって駆け出した……	PRINTFORMDW サニーは騒がしく悲鳴をあげながら必死で出口に向かって駆け出した……
PRINTFORMW 妖精のその少女を準備運動には丁度いい相手だと「それ」は認識すると、	PRINTFORMW 妖精のその少女を準備運動には丁度いい相手だと「それ」は認識すると、
PRINTFORMDL サニーは悲痛な悲鳴をあげながら暴れると触手に思い切りかみついた！	PRINTFORMDL サニーは悲痛な悲鳴をあげながら暴れると触手に思い切りかみついた！
PRINTFORMDL サニーはもう一度抵抗を試みようとしたがすぐに抑え込まれてしまった	PRINTFORMDL サニーはもう一度抵抗を試みようとしたがすぐに抑え込まれてしまった
PRINTFORMDL 啜り泣くサニーの喉はすぐに悲鳴をあげるために使われることになった	PRINTFORMDL 啜り泣くサニーの喉はすぐに悲鳴をあげるために使われることになった
PRINTFORMDL そう思った%CALLNAME:1%はサニーを連れて行くことにした	PRINTFORMDL そう思った%CALLNAME:1%はサニーを連れて行くことにした
PRINTFORML 「アリスさんごめんなさい。こんな状況だから盾に使わせてもらいます」	PRINTFORML 「アリスさんごめんなさい。こんな状況だから盾に使わせてもらいます」
PRINTFORML 「うええ…このままじゃ苦いわ…。お茶なら苦くても平気なんだけど…」	PRINTFORML 「うええ…このままじゃ苦いわ…。お茶なら苦くても平気なんだけど…」
PRINTFORMDL 腹部を押さえ丸くなったサニーはビクビクと激しく痙攣を続けている…	PRINTFORMDL 腹部を押さえ丸くなったサニーはビクビクと激しく痙攣を続けている…
PRINTFORMDL サニーは泳いだり沈んだりのんびりしたりと全力で入浴を楽しんでいる	PRINTFORMDL サニーは泳いだり沈んだりのんびりしたりと全力で入浴を楽しんでいる
PRINTFORML 「ふぇええん…！どうしてこんなに酷い目に遭わなきゃいけないの！？」	PRINTFORML 「ふぇええん…！どうしてこんなに酷い目に遭わなきゃいけないの！？」
PRINTFORML 「まだもうちょっと頑張れるような、今すぐにでも着替えたいような…」	PRINTFORML 「まだもうちょっと頑張れるような、今すぐにでも着替えたいような…」
PRINTFORML 「うう、自分の匂いが気になるほど汚れるなんて女の子として最低ね…」	PRINTFORML 「うう、自分の匂いが気になるほど汚れるなんて女の子として最低ね…」
PRINTFORML 「いやぁあ！？ちょ、ちょっと誰か…引きずりこまれ……やだぁああ！」	PRINTFORML 「いやぁあ！？ちょ、ちょっと誰か…引きずりこまれ……やだぁああ！」
PRINTFORML 「この火が出る機械があればチルノも一瞬で水に…なんて冗談よ冗談！」	PRINTFORML 「この火が出る機械があればチルノも一瞬で水に…なんて冗談よ冗談！」
PRINTFORMDL サニーは楽しそうにどこかで拾った棒のようなものを振り回している。	PRINTFORMDL サニーは楽しそうにどこかで拾った棒のようなものを振り回している。
PRINTFORML 「今は水遊びしてる場合じゃない事くらい私でもわかるけど…うずうず」	PRINTFORML 「今は水遊びしてる場合じゃない事くらい私でもわかるけど…うずうず」
PRINTFORML 「のわあぁあ！？あっぶないわね！壁くらいしっかりつくりなさいよ！」	PRINTFORML 「のわあぁあ！？あっぶないわね！壁くらいしっかりつくりなさいよ！」
PRINTFORMDW ルナとスターはサニーを置いてどこかへ出かけてしまったのだろうか？	PRINTFORMDW ルナとスターはサニーを置いてどこかへ出かけてしまったのだろうか？
PRINTFORMDW ──どうせ二人ともすぐに復活するしほっといてもいいじゃない！──	PRINTFORMDW ──どうせ二人ともすぐに復活するしほっといてもいいじゃない！──
PRINTFORMDW なんとか逃げ出したサニーは、それから集められるだけの仲間を集めた	PRINTFORMDW なんとか逃げ出したサニーは、それから集められるだけの仲間を集めた
PRINTFORMW だが、「それ」はついに人と神と妖怪の手によって倒されてしまった…	PRINTFORMW だが、「それ」はついに人と神と妖怪の手によって倒されてしまった…
PRINTFORMW そして何も出来ないまま「それ」は絶望したまま静かに眠りについた…	PRINTFORMW そして何も出来ないまま「それ」は絶望したまま静かに眠りについた…
PRINTFORMW 興奮気味の「それ」の近くを一人の不幸な少女が元気よく駆けていく…	PRINTFORMW 興奮気味の「それ」の近くを一人の不幸な少女が元気よく駆けていく…
PRINTFORML 「んー…？とりあえずお守りみたいにもってればいいのかしらこれ？」	PRINTFORML 「んー…？とりあえずお守りみたいにもってればいいのかしらこれ？」
PRINTFORML 「……産まないで、妊娠しないですめばそれが一番だったんだけどな」	PRINTFORML 「……産まないで、妊娠しないですめばそれが一番だったんだけどな」
PRINTFORML 「ここに来てから一回休みになったほうがマシな目にばかりあうわ…」	PRINTFORML 「ここに来てから一回休みになったほうがマシな目にばかりあうわ…」
PRINTFORMDL サニーは突然姿を消したかと思うと軽い足音が遠くへと消えていった	PRINTFORMDL サニーは突然姿を消したかと思うと軽い足音が遠くへと消えていった
PRINTFORML 「しょうがないでしょ！私が前にでてもどうしょうもないじゃない！」	PRINTFORML 「しょうがないでしょ！私が前にでてもどうしょうもないじゃない！」
PRINTFORML 「ひいいい！？危ないわね…なんで壁のクセに襲ってくんのよお…！」	PRINTFORML 「ひいいい！？危ないわね…なんで壁のクセに襲ってくんのよお…！」
PRINTFORML 「ここでやられたの妖精でうっぷんはらせって言ってた人っぽいわね」	PRINTFORML 「ここでやられたの妖精でうっぷんはらせって言ってた人っぽいわね」
PRINTFORMDL サニーはぎゃーぎゃー騒いだかと思うと触手に思い切りかみついた！	PRINTFORMDL サニーはぎゃーぎゃー騒いだかと思うと触手に思い切りかみついた！
PRINTFORML 「ま、まって！寝坊したのは悪かったって思ってるから離してーー！」	PRINTFORML 「ま、まって！寝坊したのは悪かったって思ってるから離してーー！」
PRINTFORMDL サニーは身の危険を感じてかモンスターの内部で激しく暴れ始めた！	PRINTFORMDL サニーは身の危険を感じてかモンスターの内部で激しく暴れ始めた！
PRINTFORML 「ルナが拾ってきた本にでてたわこれ！汚物を消毒する機械でしょ？」	PRINTFORML 「ルナが拾ってきた本にでてたわこれ！汚物を消毒する機械でしょ？」
PRINTFORMW 「異変解決に妖精が一役買って妖精の地位向上が狙えるってことよ！」	PRINTFORMW 「異変解決に妖精が一役買って妖精の地位向上が狙えるってことよ！」
PRINTFORMDW ──私達が囮になっている間に、お母さんだけでも逃げて欲しい──	PRINTFORMDW ──私達が囮になっている間に、お母さんだけでも逃げて欲しい──
PRINTFORMW 「むむむ！このベタベタはもしかして…ということはこの辺りに…？」	PRINTFORMW 「むむむ！このベタベタはもしかして…ということはこの辺りに…？」
PRINTFORMW そんな噂が人里で広まり始めてどの程度の時間がたったのだろうか？	PRINTFORMW そんな噂が人里で広まり始めてどの程度の時間がたったのだろうか？
PRINTFORMW どう考えても言いだしっぺのスターが圧倒的に有利な気がするとか…	PRINTFORMW どう考えても言いだしっぺのスターが圧倒的に有利な気がするとか…
PRINTFORMDL サニーは子宮を欲望で満たそうとする触手を前に何も出来ずにいる	PRINTFORMDL サニーは子宮を欲望で満たそうとする触手を前に何も出来ずにいる
PRINTFORMDL 身動きが取れなくなったサニーの顔は涙と粘液でぐちゃぐちゃだ…	PRINTFORMDL 身動きが取れなくなったサニーの顔は涙と粘液でぐちゃぐちゃだ…
PRINTFORML 「置いてかないで！ほんとに食べられちゃう！聞えないの！ねえ！」	PRINTFORML 「置いてかないで！ほんとに食べられちゃう！聞えないの！ねえ！」
PRINTFORMDL ぐったりと力なく床に横たわるサニーを連れながらの探索は難しい	PRINTFORMDL ぐったりと力なく床に横たわるサニーを連れながらの探索は難しい
PRINTFORML 「どうしてこんな強力なスペルカードが…うう、考えるのやめやめ」	PRINTFORML 「どうしてこんな強力なスペルカードが…うう、考えるのやめやめ」
PRINTFORMDL サニーは頭を抱えると目を大きく見開きボロボロと涙を流し始めた	PRINTFORMDL サニーは頭を抱えると目を大きく見開きボロボロと涙を流し始めた
PRINTFORML 「おいしい！なにこれすごい…ってあら？なんでもうないのよー！」	PRINTFORML 「おいしい！なにこれすごい…ってあら？なんでもうないのよー！」
PRINTFORML 「きゃああああああ！キモイ寄るなくんなこないで…ぁぁああ！？」	PRINTFORML 「きゃああああああ！キモイ寄るなくんなこないで…ぁぁああ！？」
PRINTFORML 「きっとこの人も私なんかよりよっぽど強かったんだろうなぁ……」	PRINTFORML 「きっとこの人も私なんかよりよっぽど強かったんだろうなぁ……」
PRINTFORMDL ぐったりと力なく床に横たわるサニーをこれ以上連れてはいけない	PRINTFORMDL ぐったりと力なく床に横たわるサニーをこれ以上連れてはいけない
PRINTFORML 「このサニー様としたことがちょっと元気なくしちゃってたたわ！」	PRINTFORML 「このサニー様としたことがちょっと元気なくしちゃってたたわ！」
PRINTFORML 「うええ…こんな場所に、ひゃ！？ここにもねばねばがついてる！」	PRINTFORML 「うええ…こんな場所に、ひゃ！？ここにもねばねばがついてる！」
PRINTFORMDW 神社の巨木で今日も光の三妖精は優雅に朝食に舌鼓を打っていた。	PRINTFORMDW 神社の巨木で今日も光の三妖精は優雅に朝食に舌鼓を打っていた。
PRINTFORMDW サニーは今日も一人で迷宮の出入り口を探してあちこちを駆け回る	PRINTFORMDW サニーは今日も一人で迷宮の出入り口を探してあちこちを駆け回る
PRINTFORMDW 獣すら通らないような寂れた場所に、赤いリボンだけが残された…	PRINTFORMDW 獣すら通らないような寂れた場所に、赤いリボンだけが残された…
PRINTFORMDW 彼女はよもや自分が被害者の一人目だとは夢にも思ってはいない…	PRINTFORMDW 彼女はよもや自分が被害者の一人目だとは夢にも思ってはいない…
PRINTFORMW その無防備な彼女の背中は忍び寄る気配に気づくはずもなかった…	PRINTFORMW その無防備な彼女の背中は忍び寄る気配に気づくはずもなかった…
PRINTFORML 仕方ないよね可愛い女の子は触手に襲われるのがお約束なんだから	PRINTFORML 仕方ないよね可愛い女の子は触手に襲われるのがお約束なんだから
PRINTFORML 「スペルカードなら！もう倒れてよお！ダイレクトサンライト！」	PRINTFORML 「スペルカードなら！もう倒れてよお！ダイレクトサンライト！」
PRINTFORML （もしこれでも倒せなかったら…やめやめそんなこと考えるの！）	PRINTFORML （もしこれでも倒せなかったら…やめやめそんなこと考えるの！）
PRINTFORML 「三妖精の頭脳の私はこんな計画的な攻撃だってしちゃうのよ！」	PRINTFORML 「三妖精の頭脳の私はこんな計画的な攻撃だってしちゃうのよ！」
PRINTFORMDL サニーは肩で息をしながら振るえる腕で武器をしっかりと構えた	PRINTFORMDL サニーは肩で息をしながら振るえる腕で武器をしっかりと構えた
PRINTFORMDL サニーは太股を這い上がる触手の感触に引きつった悲鳴をあげた	PRINTFORMDL サニーは太股を這い上がる触手の感触に引きつった悲鳴をあげた
PRINTFORMDL サニーは虚ろな瞳で自分の下腹部で脈動する触手を見つめている	PRINTFORMDL サニーは虚ろな瞳で自分の下腹部で脈動する触手を見つめている
PRINTFORML 「この調子で倒していけばそのうち怖いのいなくなるかしら…？」	PRINTFORML 「この調子で倒していけばそのうち怖いのいなくなるかしら…？」
PRINTFORML 「どうしよう…このままじゃお腹の中の生き物がでてきちゃう…」	PRINTFORML 「どうしよう…このままじゃお腹の中の生き物がでてきちゃう…」
PRINTFORML 「やっと産まれそうねー。これで楽になれると思うと清々するわ」	PRINTFORML 「やっと産まれそうねー。これで楽になれると思うと清々するわ」
PRINTFORMDL ぐったりとしたまま触手になすがままにされていたサニーだが、	PRINTFORMDL ぐったりとしたまま触手になすがままにされていたサニーだが、
PRINTFORML 「ものすごく長い時間ここにいるようなそれほどでもないような」	PRINTFORML 「ものすごく長い時間ここにいるようなそれほどでもないような」
PRINTFORML 「むしむし、もう下手なことして怖い目にあうのはまっぴらだわ」	PRINTFORML 「むしむし、もう下手なことして怖い目にあうのはまっぴらだわ」
PRINTFORML 「や、やめてリリー！私が悪かったわ！謝るから！ひぃいい……」	PRINTFORML 「や、やめてリリー！私が悪かったわ！謝るから！ひぃいい……」
PRINTFORML 「あら、起こしてくれてありがとう。って言うわけないでしょ！」	PRINTFORML 「あら、起こしてくれてありがとう。って言うわけないでしょ！」
PRINTFORMDL 身動きが取れなくなったサニーは声を張り上げ身をよじっている	PRINTFORMDL 身動きが取れなくなったサニーは声を張り上げ身をよじっている
PRINTFORML 「私達妖精は食べなくても大丈夫だけど他の人はお腹すくわよね」	PRINTFORML 「私達妖精は食べなくても大丈夫だけど他の人はお腹すくわよね」
PRINTFORML 「わぁ、火が出る道具なのね！料理には…ちょっと使いづらそう」	PRINTFORML 「わぁ、火が出る道具なのね！料理には…ちょっと使いづらそう」
PRINTFORML 「随分と強力なスペルカードね。すごい人が落としたのねきっと」	PRINTFORML 「随分と強力なスペルカードね。すごい人が落としたのねきっと」
PRINTFORML 「お茶請けはどこに…さすがにそこまでサービスよくはないのね」	PRINTFORML 「お茶請けはどこに…さすがにそこまでサービスよくはないのね」
PRINTFORML 「そろそろ何でもいいから体を隠すものがみつからないかしら…」	PRINTFORML 「そろそろ何でもいいから体を隠すものがみつからないかしら…」
PRINTFORML 「妖精使いが荒すぎるわ！こんななら一人のほうがマシよマシ！」	PRINTFORML 「妖精使いが荒すぎるわ！こんななら一人のほうがマシよマシ！」
PRINTFORML 「ひんやり気持ちいい～♪ちょっと泳いじゃおうっと、ふふっ♪」	PRINTFORML 「ひんやり気持ちいい～♪ちょっと泳いじゃおうっと、ふふっ♪」
PRINTFORMW 「俄然やる気でてきたわ！ご飯食べ終わったら準備して出発よ！」	PRINTFORMW 「俄然やる気でてきたわ！ご飯食べ終わったら準備して出発よ！」
PRINTFORMDW それから暫くして、神隠しに会う人が突然増える事件が発生した	PRINTFORMDW それから暫くして、神隠しに会う人が突然増える事件が発生した
PRINTFORMDW そう思ってふと後ろを振り返った所で、サニーは驚愕に包まれた	PRINTFORMDW そう思ってふと後ろを振り返った所で、サニーは驚愕に包まれた
PRINTFORMDL 　耳まで真っ赤にしたサニーは内股気味で必死に駆け出した！	PRINTFORMDL 　耳まで真っ赤にしたサニーは内股気味で必死に駆け出した！
PRINTFORML 「また裸にされて酷いことされちゃうの…？やだ…そんなの…」	PRINTFORML 「また裸にされて酷いことされちゃうの…？やだ…そんなの…」
PRINTFORMDL サニーは状況が飲み込みきれないようで目を白黒させている。	PRINTFORMDL サニーは状況が飲み込みきれないようで目を白黒させている。
PRINTFORML 「こんな場所で寝てるなんてルナったら何やってるのかしら…」	PRINTFORML 「こんな場所で寝てるなんてルナったら何やってるのかしら…」
PRINTFORML 「恥ずかしい…着替えがあるのにどうして私はこんな格好で…」	PRINTFORML 「恥ずかしい…着替えがあるのにどうして私はこんな格好で…」
PRINTFORML 「落としているつもりでもあちこちにぬるぬるがついてるわね」	PRINTFORML 「落としているつもりでもあちこちにぬるぬるがついてるわね」
PRINTFORML 「うふふふ、今の私はどんな敵にだって負ける気がしないわ！」	PRINTFORML 「うふふふ、今の私はどんな敵にだって負ける気がしないわ！」
PRINTFORML 「私なんておいしくないし栄養もないんだから！吐き出せー！」	PRINTFORML 「私なんておいしくないし栄養もないんだから！吐き出せー！」
PRINTFORML 「ちょっとちょっと！もう捕まってるのみてわかんないの！？」	PRINTFORML 「ちょっとちょっと！もう捕まってるのみてわかんないの！？」
PRINTFORML 「ふふーん、逃げることに関しては右に出るものはいないのよ」	PRINTFORML 「ふふーん、逃げることに関しては右に出るものはいないのよ」
PRINTFORML 「子供なら親の言うことは聞くものなのよ！よく知らないけど」	PRINTFORML 「子供なら親の言うことは聞くものなのよ！よく知らないけど」
PRINTFORML 「気合入ってきた！絶対にこんな場所から出てやるんだから！」	PRINTFORML 「気合入ってきた！絶対にこんな場所から出てやるんだから！」
PRINTFORMDW そんなある日、サニーが朝遅く目覚めると家が妙に静かだった	PRINTFORMDW そんなある日、サニーが朝遅く目覚めると家が妙に静かだった
PRINTFORMDW そう思ってふと後ろを振り返った所で、三人は驚愕に包まれた	PRINTFORMDW そう思ってふと後ろを振り返った所で、三人は驚愕に包まれた
PRINTFORMDW 「私も生還したのよ！」なんて酔っ払って豪語するのだろう…	PRINTFORMDW 「私も生還したのよ！」なんて酔っ払って豪語するのだろう…
PRINTFORMW それから100年？1000年？それともそれ以上だろうか？	PRINTFORMW それから100年？1000年？それともそれ以上だろうか？
PRINTFORMDL サニーが手を掲げると四方八方に細いレーザーが放たれる！	PRINTFORMDL サニーが手を掲げると四方八方に細いレーザーが放たれる！
PRINTFORMDL サニーが掲げた両手から頼りない極太レーザーが放たれた！	PRINTFORMDL サニーが掲げた両手から頼りない極太レーザーが放たれた！
PRINTFORMDL 必死に抵抗するサニーの手足から力強さが感じられない……	PRINTFORMDL 必死に抵抗するサニーの手足から力強さが感じられない……
PRINTFORMDL サニーは太ももを這い上がる触手の気配に慌てて前を隠した	PRINTFORMDL サニーは太ももを這い上がる触手の気配に慌てて前を隠した
PRINTFORMDL サニーは言葉にならない声をあげ全身を痙攣させている……	PRINTFORMDL サニーは言葉にならない声をあげ全身を痙攣させている……
PRINTFORML 「御神体一軍がよかったとか贅沢言ってる場合じゃないわね」	PRINTFORML 「御神体一軍がよかったとか贅沢言ってる場合じゃないわね」
PRINTFORML 「…むー、よくわかんないけど持っておいて損はなさそうね」	PRINTFORML 「…むー、よくわかんないけど持っておいて損はなさそうね」
PRINTFORML 「おなかの中気持ち悪い！ひっ、またぬちゅぬちゅって…！」	PRINTFORML 「おなかの中気持ち悪い！ひっ、またぬちゅぬちゅって…！」
PRINTFORMDL 憔悴しきったサニーからはいつもの元気が感じられない……	PRINTFORMDL 憔悴しきったサニーからはいつもの元気が感じられない……
PRINTFORML 「もうこのにょろにょろ達とも長い付き合いのきがするわ…」	PRINTFORML 「もうこのにょろにょろ達とも長い付き合いのきがするわ…」
PRINTFORML 「アンタといたら助かるより先に私が酷い目にあっちゃう！」	PRINTFORML 「アンタといたら助かるより先に私が酷い目にあっちゃう！」
PRINTFORML 「嫌なヤツだとおもっていたけどこうなっちゃうと可哀想ね」	PRINTFORML 「嫌なヤツだとおもっていたけどこうなっちゃうと可哀想ね」
PRINTFORML (このまま身を任せればエッチなことしてもらえるのよね…)	PRINTFORML (このまま身を任せればエッチなことしてもらえるのよね…)
PRINTFORML (冷静になるのよサニー、チャンスは絶対くるわ…絶対……)	PRINTFORML (冷静になるのよサニー、チャンスは絶対くるわ…絶対……)
PRINTFORML 「この絶妙に隠れてほしいところが隠れない感じが最悪ね…」	PRINTFORML 「この絶妙に隠れてほしいところが隠れない感じが最悪ね…」
PRINTFORML 「ぎゃっ！？…ひええ…これは落ちたらオシマイだったわね」	PRINTFORML 「ぎゃっ！？…ひええ…これは落ちたらオシマイだったわね」
PRINTFORMW 「今、大切なのはこの異変に私が参加していること！そして」	PRINTFORMW 「今、大切なのはこの異変に私が参加していること！そして」
PRINTFORMDW タコヤキを口の中にほうりいれ、熱さにわたわたするサニー	PRINTFORMDW タコヤキを口の中にほうりいれ、熱さにわたわたするサニー
PRINTFORMDW サニーの攻撃が、ついにガーディアンの巨大な目玉を貫いた	PRINTFORMDW サニーの攻撃が、ついにガーディアンの巨大な目玉を貫いた
PRINTFORMDW {DAY}日振りの外の空気に、三人は安堵の溜息を漏らす	PRINTFORMDW {DAY}日振りの外の空気に、三人は安堵の溜息を漏らす
PRINTFORMDW これで出口は確保できた。　あとはとっとと逃げるだけ──	PRINTFORMDW これで出口は確保できた。　あとはとっとと逃げるだけ──
PRINTFORMW 「それ」は確かに強く、暴力的で、圧倒的なだったはずだ。	PRINTFORMW 「それ」は確かに強く、暴力的で、圧倒的なだったはずだ。
PRINTFORMW 「それ」が求める肉は単純なたんぱく質などではなかった。	PRINTFORMW 「それ」が求める肉は単純なたんぱく質などではなかった。
PRINTFORMDL 弱々しく伸びたサニーの手から細いレーザーが放たれた！	PRINTFORMDL 弱々しく伸びたサニーの手から細いレーザーが放たれた！
PRINTFORMDL それなりの密度の弾幕がサニーを中心に綺麗に広がった！	PRINTFORMDL それなりの密度の弾幕がサニーを中心に綺麗に広がった！
PRINTFORMDL サニーが手を掲げると無数の極太レーザーが発射される！	PRINTFORMDL サニーが手を掲げると無数の極太レーザーが発射される！
PRINTFORML 「ひっ…やああ！死んじゃう！痛すぎて死んじゃうよぉ！」	PRINTFORML 「ひっ…やああ！死んじゃう！痛すぎて死んじゃうよぉ！」
PRINTFORML 「あ、あれ…どうして私捕まって…や、やだ！離してよ！」	PRINTFORML 「あ、あれ…どうして私捕まって…や、やだ！離してよ！」
PRINTFORMW 「お願い助けて！助けてよ！あ…や、やだ……やめて……」	PRINTFORMW 「お願い助けて！助けてよ！あ…や、やだ……やめて……」
PRINTFORML 「あいつらに襲われてもこれだけ強力なら役に立つわね！」	PRINTFORML 「あいつらに襲われてもこれだけ強力なら役に立つわね！」
PRINTFORML 「誰の落し物かわからないけど有効に使わせてもらうわよ」	PRINTFORML 「誰の落し物かわからないけど有効に使わせてもらうわよ」
PRINTFORML 「むむむむ…これは上手に使えば強力な武器になるかも？」	PRINTFORML 「むむむむ…これは上手に使えば強力な武器になるかも？」
PRINTFORML 「すごく綺麗…見ているだけで嫌なことが忘れられそう…」	PRINTFORML 「すごく綺麗…見ているだけで嫌なことが忘れられそう…」
PRINTFORML 「素敵な宝石ね…これなら何時間眺めていても飽きないわ」	PRINTFORML 「素敵な宝石ね…これなら何時間眺めていても飽きないわ」
PRINTFORML 「変な形…ご飯炊くのに使うヤツになんとなく似てるわね」	PRINTFORML 「変な形…ご飯炊くのに使うヤツになんとなく似てるわね」
PRINTFORML 「お酒があるってだけでこんな場所でも心が洗われるわ…」	PRINTFORML 「お酒があるってだけでこんな場所でも心が洗われるわ…」
PRINTFORML 「……この二日酔いみたいな感じ…ううん、そんなはずは」	PRINTFORML 「……この二日酔いみたいな感じ…ううん、そんなはずは」
PRINTFORML 「大人しく育てて大人しく産んでぱぱっとやっつけて……」	PRINTFORML 「大人しく育てて大人しく産んでぱぱっとやっつけて……」
PRINTFORML 「ふぁあ…なんかボーっとして身も心も洗われるようね…」	PRINTFORML 「ふぁあ…なんかボーっとして身も心も洗われるようね…」
PRINTFORML 「やぁん……スターったら酔ってるにょ？…にゃむにゃむ」	PRINTFORML 「やぁん……スターったら酔ってるにょ？…にゃむにゃむ」
PRINTFORMDL サニーは自身に近づく危機になど少しも気づく様子はない	PRINTFORMDL サニーは自身に近づく危機になど少しも気づく様子はない
PRINTFORML 「親切にベッドに運んでくれるって雰囲気じゃないわね…」	PRINTFORML 「親切にベッドに運んでくれるって雰囲気じゃないわね…」
PRINTFORML 「わぁ…綺麗な宝石…持ってかえって部屋に飾ろうっと♪」	PRINTFORML 「わぁ…綺麗な宝石…持ってかえって部屋に飾ろうっと♪」
PRINTFORML 「うう、何かお腹に大きい生き物がいて時々暴れる感じ…」	PRINTFORML 「うう、何かお腹に大きい生き物がいて時々暴れる感じ…」
PRINTFORML 「どこかの部屋の出入り口を塞いで篭城すれば安全かも？」	PRINTFORML 「どこかの部屋の出入り口を塞いで篭城すれば安全かも？」
PRINTFORML 「まあ魔理沙さんのことだからどうせ生きてるだろうけど」	PRINTFORML 「まあ魔理沙さんのことだからどうせ生きてるだろうけど」
PRINTFORMDW 確かに先程からあの魔物は殆どこちらに手を出してこない	PRINTFORMDW 確かに先程からあの魔物は殆どこちらに手を出してこない
PRINTFORMDW よくわかんないけどとりあえず出口は見つけられたようだ	PRINTFORMDW よくわかんないけどとりあえず出口は見つけられたようだ
PRINTFORMDW 「あれ？たしかにこの辺りから出てきたんだけどなあ…」	PRINTFORMDW 「あれ？たしかにこの辺りから出てきたんだけどなあ…」
PRINTFORMDW サニーはしょんぼりしながら懐かしい家路へと足を向けた	PRINTFORMDW サニーはしょんぼりしながら懐かしい家路へと足を向けた
PRINTFORMW そもそもどうやって神隠しにあった人を見分けるのかとか	PRINTFORMW そもそもどうやって神隠しにあった人を見分けるのかとか
PRINTFORMDL サニーが手を掲げると四方八方にレーザーが放たれる！	PRINTFORMDL サニーが手を掲げると四方八方にレーザーが放たれる！
PRINTFORML 「大人しくなって！きらめけ！ダイアモンドッリング！」	PRINTFORML 「大人しくなって！きらめけ！ダイアモンドッリング！」
PRINTFORML 「こいつがあればどんな相手にも負ける気がしないわ！」	PRINTFORML 「こいつがあればどんな相手にも負ける気がしないわ！」
PRINTFORML 「しっかり狙って丁寧に振り回せばあたるものなのよ！」	PRINTFORML 「しっかり狙って丁寧に振り回せばあたるものなのよ！」
PRINTFORML (このまま身を任せればなにもわかんなくなって楽に…)	PRINTFORML (このまま身を任せればなにもわかんなくなって楽に…)
PRINTFORML 「だずげでぇ！だずげでぇぇ……ぃやだぁぁあ゛あ゛！」	PRINTFORML 「だずげでぇ！だずげでぇぇ……ぃやだぁぁあ゛あ゛！」
PRINTFORML 「うえええ…ひどい…どうしてこんなことすんのよお…」	PRINTFORML 「うえええ…ひどい…どうしてこんなことすんのよお…」
PRINTFORML 「目を開いて寝てるなんてスターは抜け目がないわね…」	PRINTFORML 「目を開いて寝てるなんてスターは抜け目がないわね…」
PRINTFORML 「妖精は御気楽だなんて言うけれど…これは無理よ無理」	PRINTFORML 「妖精は御気楽だなんて言うけれど…これは無理よ無理」
PRINTFORML 「とりあえず全力で相手に投げつければいいのかしら…」	PRINTFORML 「とりあえず全力で相手に投げつければいいのかしら…」
PRINTFORMDL 痙攣がおさまる頃には彼女の意識は完全に飛んでいた…	PRINTFORMDL 痙攣がおさまる頃には彼女の意識は完全に飛んでいた…
PRINTFORML 「はぁ…変なのいっぱい入れられた心労だったのかしら」	PRINTFORML 「はぁ…変なのいっぱい入れられた心労だったのかしら」
PRINTFORML 「なんだかまだ全身に何か絡み付いてる気がするわ……」	PRINTFORML 「なんだかまだ全身に何か絡み付いてる気がするわ……」
PRINTFORML 「もうなんでもいいから着替えになるもの出てきてよぉ」	PRINTFORML 「もうなんでもいいから着替えになるもの出てきてよぉ」
PRINTFORML 「こんなボロボロな服を無理に着る必要もないわよね…」	PRINTFORML 「こんなボロボロな服を無理に着る必要もないわよね…」
PRINTFORML 「妖精だからって使い捨てようとしてるのバレバレよ！」	PRINTFORML 「妖精だからって使い捨てようとしてるのバレバレよ！」
PRINTFORML 「だとしたら私でどうこうできることじゃないのかも…」	PRINTFORML 「だとしたら私でどうこうできることじゃないのかも…」
PRINTFORML 「この新必殺技、また戦争があったら役に立ちそうね！」	PRINTFORML 「この新必殺技、また戦争があったら役に立ちそうね！」
PRINTFORML 「今にみてなさい！ギャフンと言わせてやるんだから！」	PRINTFORML 「今にみてなさい！ギャフンと言わせてやるんだから！」
PRINTFORML 「絶対にアンタの赤ちゃんなんて作らせないんだから！」	PRINTFORML 「絶対にアンタの赤ちゃんなんて作らせないんだから！」
PRINTFORML 「うう…これは自分の力で何とかしないとヤバそうね…」	PRINTFORML 「うう…これは自分の力で何とかしないとヤバそうね…」
PRINTFORML 「いつでもどこでもお酒の味は変わらないわ！うふふ♪」	PRINTFORML 「いつでもどこでもお酒の味は変わらないわ！うふふ♪」
PRINTFORML 「体の中にヘンなものたくさんいれられたからかしら…」	PRINTFORML 「体の中にヘンなものたくさんいれられたからかしら…」
PRINTFORML 「ああもう、助かってもこれじゃ生きた心地がしないわ」	PRINTFORML 「ああもう、助かってもこれじゃ生きた心地がしないわ」
PRINTFORML 「なんかだるいわねー…歳かしら？ってそれはないわね」	PRINTFORML 「なんかだるいわねー…歳かしら？ってそれはないわね」
PRINTFORML 「今は武器より宝物よりお酒よりも着替えよ着替えー！」	PRINTFORML 「今は武器より宝物よりお酒よりも着替えよ着替えー！」
PRINTFORML 「うー、実害はなくても気持ちのいいものじゃないわね」	PRINTFORML 「うー、実害はなくても気持ちのいいものじゃないわね」
PRINTFORML 「すごーい！瞬間移動しちゃったの！？ねえ見た見た？」	PRINTFORML 「すごーい！瞬間移動しちゃったの！？ねえ見た見た？」
PRINTFORMDW そんな中で、%ARGS:0%はふとある事に気付いた	PRINTFORMDW そんな中で、%ARGS:0%はふとある事に気付いた
PRINTFORML パルスィ、依玖さん、上海、半霊、霊夢口上、雛ちゃん	PRINTFORML パルスィ、依玖さん、上海、半霊、霊夢口上、雛ちゃん
PRINTFORML ※オープニングとエンディングが一人旅時に変化します	PRINTFORML ※オープニングとエンディングが一人旅時に変化します
PRINTFORMDL 　サニーは珍しく深刻な顔で自分の体を抱いている…	PRINTFORMDL 　サニーは珍しく深刻な顔で自分の体を抱いている…
PRINTFORMDL 　サニーは耳まで真っ赤にして自分の体を庇っている	PRINTFORMDL 　サニーは耳まで真っ赤にして自分の体を庇っている
PRINTFORMDL サニーは泣きじゃくりながら武器を撃ち続けている！	PRINTFORMDL サニーは泣きじゃくりながら武器を撃ち続けている！
PRINTFORML 「それっ！化物だってここを殴られたら痛いでしょ？」	PRINTFORML 「それっ！化物だってここを殴られたら痛いでしょ？」
PRINTFORMDL サニーは瞳に涙を浮かべながらチャンスを伺っている	PRINTFORMDL サニーは瞳に涙を浮かべながらチャンスを伺っている
PRINTFORMDL サニーはぶつぶつと何かを呟いて気を紛らわしている	PRINTFORMDL サニーはぶつぶつと何かを呟いて気を紛らわしている
PRINTFORML 「ダメよダメ！絶対にそこだけはダメなんだから！！」	PRINTFORML 「ダメよダメ！絶対にそこだけはダメなんだから！！」
PRINTFORML 「あんたなんかに絶対にはじめてはあげないわよ！！」	PRINTFORML 「あんたなんかに絶対にはじめてはあげないわよ！！」
PRINTFORMDL 初めてを死守しようとサニーは必死に抵抗している！	PRINTFORMDL 初めてを死守しようとサニーは必死に抵抗している！
PRINTFORML 「あ……これって…コイツの赤ちゃんできちゃうの？」	PRINTFORML 「あ……これって…コイツの赤ちゃんできちゃうの？」
PRINTFORMDL サニーはヨダレを垂らしながら力なく笑い始めた……	PRINTFORMDL サニーはヨダレを垂らしながら力なく笑い始めた……
PRINTFORML 「下着までボロボロ…早く替えの服みつけなくちゃ…」	PRINTFORML 「下着までボロボロ…早く替えの服みつけなくちゃ…」
PRINTFORML 「ふえぇん…せめて服に困らない生活に戻りたいわ…」	PRINTFORML 「ふえぇん…せめて服に困らない生活に戻りたいわ…」
PRINTFORML 「はーはー…走ったらなんか興奮してきちゃった……」	PRINTFORML 「はーはー…走ったらなんか興奮してきちゃった……」
PRINTFORML (ま、まさかみんな私を置いてにげちゃった……！？)	PRINTFORML (ま、まさかみんな私を置いてにげちゃった……！？)
PRINTFORML 「ないよりはずっとずっとマシだけど…心許ないわね」	PRINTFORML 「ないよりはずっとずっとマシだけど…心許ないわね」
PRINTFORML 「どうしてあつあつのお茶がこんな場所にあるのよ…」	PRINTFORML 「どうしてあつあつのお茶がこんな場所にあるのよ…」
PRINTFORML 「もうやだぁ！おなかの中でずっと何かが動いてて…」	PRINTFORML 「もうやだぁ！おなかの中でずっと何かが動いてて…」
PRINTFORML 「動いてる…動いてる…外に出ようって暴れてる……」	PRINTFORML 「動いてる…動いてる…外に出ようって暴れてる……」
PRINTFORMDL サニーはふらふらと立ち上がりまだボーっとしている	PRINTFORMDL サニーはふらふらと立ち上がりまだボーっとしている
PRINTFORMDL サニーは膝を抱えてしばらくめそめそと泣いていた…	PRINTFORMDL サニーは膝を抱えてしばらくめそめそと泣いていた…
PRINTFORML 「……くしゅぐったいわよぉ…んんっ…もー…zzz」	PRINTFORML 「……くしゅぐったいわよぉ…んんっ…もー…zzz」
PRINTFORML 「魅せてあげる！きらめけ！ダイアモンドッリング！」	PRINTFORML 「魅せてあげる！きらめけ！ダイアモンドッリング！」
PRINTFORML 「はぁっ…はぁっ…さすがに今回はひやっとしたわ…」	PRINTFORML 「はぁっ…はぁっ…さすがに今回はひやっとしたわ…」
PRINTFORML 「このお酒はどんな味かしら？おいしいわねきっと！」	PRINTFORML 「このお酒はどんな味かしら？おいしいわねきっと！」
PRINTFORML 「うう……少しでも動けるうちに逃げるのよサニー…」	PRINTFORML 「うう……少しでも動けるうちに逃げるのよサニー…」
PRINTFORML 「とりあえず探索して情報を集めるのが賢い方法よね」	PRINTFORML 「とりあえず探索して情報を集めるのが賢い方法よね」
PRINTFORML 「壁にうねうね障子もにょろり、歩く姿は触手のよう」	PRINTFORML 「壁にうねうね障子もにょろり、歩く姿は触手のよう」
PRINTFORML 「ぎゃーてーぎゃーてー♪縁日にまた行きたいてー♪」	PRINTFORML 「ぎゃーてーぎゃーてー♪縁日にまた行きたいてー♪」
PRINTFORML 「ここら辺に散らばってるの、アリスさんのものよね」	PRINTFORML 「ここら辺に散らばってるの、アリスさんのものよね」
PRINTFORMDW 見上げると空のかわりに触手がのた打ち回る天井が…	PRINTFORMDW 見上げると空のかわりに触手がのた打ち回る天井が…
PRINTFORMDW サニーは腕を組みしばらくの間難しい顔で考え込む…	PRINTFORMDW サニーは腕を組みしばらくの間難しい顔で考え込む…
PRINTFORMW これから自分に襲い掛かることなど少しも知らずに……	PRINTFORMW これから自分に襲い掛かることなど少しも知らずに……
PRINTFORMDW ──自分達は大丈夫、半分はこちら側なのだから──	PRINTFORMDW ──自分達は大丈夫、半分はこちら側なのだから──
PRINTFORMDW こうしてまた一つ新しい苗床が完成するのであった…	PRINTFORMDW こうしてまた一つ新しい苗床が完成するのであった…
PRINTFORMW サニーミルクは獣道を歩きながら途方に暮れていた。	PRINTFORMW サニーミルクは獣道を歩きながら途方に暮れていた。
PRINTFORML 攻撃、被ダメと使用する機会の多いコマンドは多めに	PRINTFORML 攻撃、被ダメと使用する機会の多いコマンドは多めに
PRINTFORML 「無理無理！これ以上近くにいたらやられちゃう！」	PRINTFORML 「無理無理！これ以上近くにいたらやられちゃう！」
PRINTFORML 「スペルカード発動ｯ！アグレッシブサンライト！」	PRINTFORML 「スペルカード発動ｯ！アグレッシブサンライト！」
PRINTFORML 「いっけえ！サンシャインッ！ブラストオーー！！」	PRINTFORML 「いっけえ！サンシャインッ！ブラストオーー！！」
PRINTFORML 「突き刺され！サンッシャインニードルウーー！！」	PRINTFORML 「突き刺され！サンッシャインニードルウーー！！」
PRINTFORML 「両手で持てば威力は単純に１＋１じゃないのよ！」	PRINTFORML 「両手で持てば威力は単純に１＋１じゃないのよ！」
PRINTFORML 「相乗効果で１×１になるってこと教えてあげる！」	PRINTFORML 「相乗効果で１×１になるってこと教えてあげる！」
PRINTFORML 「サニーパンチ！サニーキック！サニーアッパー！」	PRINTFORML 「サニーパンチ！サニーキック！サニーアッパー！」
PRINTFORML 「助けて！誰か助けて！ヤダ！食べられたくない！」	PRINTFORML 「助けて！誰か助けて！ヤダ！食べられたくない！」
PRINTFORMDL サニーはメチャクチャに手足を振り回し暴れている	PRINTFORMDL サニーはメチャクチャに手足を振り回し暴れている
PRINTFORML 「ヘンなとこばっかさわんないで！このロリコン！」	PRINTFORML 「ヘンなとこばっかさわんないで！このロリコン！」
PRINTFORML 「いやっ！こんな格好してたらまた襲われちゃう！」	PRINTFORML 「いやっ！こんな格好してたらまた襲われちゃう！」
PRINTFORMDL サニーの口からはよだれとうめき声がとまらない…	PRINTFORMDL サニーの口からはよだれとうめき声がとまらない…
PRINTFORMW 「やだ！食べられたくない！見捨てないでえええ！」	PRINTFORMW 「やだ！食べられたくない！見捨てないでえええ！」
PRINTFORML 「スターはいいわね、どこに何がいるかわかって…」	PRINTFORML 「スターはいいわね、どこに何がいるかわかって…」
PRINTFORMDL 虚ろな瞳で横たわっているサニーを放っておけない	PRINTFORMDL 虚ろな瞳で横たわっているサニーを放っておけない
PRINTFORML 「これって確か霊夢さんがよく使ってるヤツよね？」	PRINTFORML 「これって確か霊夢さんがよく使ってるヤツよね？」
PRINTFORML 「メルヘンチックだけど意外と戦闘でも使えそう！」	PRINTFORML 「メルヘンチックだけど意外と戦闘でも使えそう！」
PRINTFORML 「…アリスさんの人形だと思うけど、私の形してる」	PRINTFORML 「…アリスさんの人形だと思うけど、私の形してる」
PRINTFORML 「うーん、ご利益とか言われてもよくわかんないわ」	PRINTFORML 「うーん、ご利益とか言われてもよくわかんないわ」
PRINTFORML 「うう、いつまでここを探索しないといけないの…」	PRINTFORML 「うう、いつまでここを探索しないといけないの…」
PRINTFORML 「何かに襲われたらあっというまに裸にされそう…」	PRINTFORML 「何かに襲われたらあっというまに裸にされそう…」
PRINTFORML (な、なんなのよ今度はー！？息するの我慢我慢…)	PRINTFORML (な、なんなのよ今度はー！？息するの我慢我慢…)
PRINTFORML 「むにゃっ！？ぁぁっ…おっこちちゃうぅーっ……」	PRINTFORML 「むにゃっ！？ぁぁっ…おっこちちゃうぅーっ……」
PRINTFORMDL サニーは瞳に涙を浮かべ悪夢にうなされている……	PRINTFORMDL サニーは瞳に涙を浮かべ悪夢にうなされている……
PRINTFORMW 	「復活したらいつものベッドに戻れるかなあ……」	PRINTFORMW 	「復活したらいつものベッドに戻れるかなあ……」
PRINTFORML 「どうして人間も妖怪も化物もミルクミルクって！」	PRINTFORML 「どうして人間も妖怪も化物もミルクミルクって！」
PRINTFORML 「ぎゃー！なんてことしようとしてんのよエッチ!」	PRINTFORML 「ぎゃー！なんてことしようとしてんのよエッチ!」
PRINTFORML 「なんでえっちなことばっかりやりたがるのよー！」	PRINTFORML 「なんでえっちなことばっかりやりたがるのよー！」
PRINTFORML 「ちょっと！こんな格好で動き回れって言うの！？」	PRINTFORML 「ちょっと！こんな格好で動き回れって言うの！？」
PRINTFORML 「うわーん！これじゃまだ下着姿のほうがマシよ！」	PRINTFORML 「うわーん！これじゃまだ下着姿のほうがマシよ！」
PRINTFORML 「覚えてなさいよ！そのうち浄化してやんだから！」	PRINTFORML 「覚えてなさいよ！そのうち浄化してやんだから！」
PRINTFORML 「ぎゃー！これってもう体のかなり奥じゃない！？」	PRINTFORML 「ぎゃー！これってもう体のかなり奥じゃない！？」
PRINTFORML 「ちょっとー！見捨てるとかさすがに酷くない！？」	PRINTFORML 「ちょっとー！見捨てるとかさすがに酷くない！？」
PRINTFORML 「わわわわわ！？なんかすごいのみつけちゃった！」	PRINTFORML 「わわわわわ！？なんかすごいのみつけちゃった！」
PRINTFORML 「着替えのストックがあるとすごく安心するわねー」	PRINTFORML 「着替えのストックがあるとすごく安心するわねー」
PRINTFORML 「妖精なのに妊娠したとか……妊娠しちゃった！？」	PRINTFORML 「妖精なのに妊娠したとか……妊娠しちゃった！？」
PRINTFORML 「恥ずかしい…こんな格好で歩く必要ないような…」	PRINTFORML 「恥ずかしい…こんな格好で歩く必要ないような…」
PRINTFORML 「ちょっとスリリングすぎるのが玉に致命傷よねー」	PRINTFORML 「ちょっとスリリングすぎるのが玉に致命傷よねー」
PRINTFORML 「ざまあみろ！とはこんな状況だし言わないけど…」	PRINTFORML 「ざまあみろ！とはこんな状況だし言わないけど…」
PRINTFORMW 「うーん、持って帰るのは無理そうね。ていうか…」	PRINTFORMW 「うーん、持って帰るのは無理そうね。ていうか…」
PRINTFORMW 「料理に罪はないわ。ほら、冷める前に食べましょ」	PRINTFORMW 「料理に罪はないわ。ほら、冷める前に食べましょ」
PRINTFORMDW このままでは自分達が脱出ができなくなってしまう	PRINTFORMDW このままでは自分達が脱出ができなくなってしまう
PRINTFORMW 「それ」は毎月、少女を生贄として要求していた。	PRINTFORMW 「それ」は毎月、少女を生贄として要求していた。
PRINTFORML ※嫌な事が重なるとサニーちゃんが弱気になります	PRINTFORML ※嫌な事が重なるとサニーちゃんが弱気になります
PRINTFORML 「ごめんなさいごめんなさい許してください……」	PRINTFORML 「ごめんなさいごめんなさい許してください……」
PRINTFORMDL 痛みとわずかの快感に時たま小さな悲鳴を上げた	PRINTFORMDL 痛みとわずかの快感に時たま小さな悲鳴を上げた
PRINTFORMDL サニーが両手から弱々しいレーザーを数本放った	PRINTFORMDL サニーが両手から弱々しいレーザーを数本放った
PRINTFORML 「このくらいの出力ならまだまだあつかえるわ！」	PRINTFORML 「このくらいの出力ならまだまだあつかえるわ！」
PRINTFORML 「これ以上怪我したくなかったらあっちいって！」	PRINTFORML 「これ以上怪我したくなかったらあっちいって！」
PRINTFORML 「食べられて一回休みなんて絶対にイヤあああ！」	PRINTFORML 「食べられて一回休みなんて絶対にイヤあああ！」
PRINTFORML 「私なんておいしくないのにどうしてなのよぉ！」	PRINTFORML 「私なんておいしくないのにどうしてなのよぉ！」
PRINTFORML 「痛い痛い痛い！抜いて！はやくそれ抜いてぇ！」	PRINTFORML 「痛い痛い痛い！抜いて！はやくそれ抜いてぇ！」
PRINTFORML 「ひゃあっ！今は私に触っちゃダメなんだから！」	PRINTFORML 「ひゃあっ！今は私に触っちゃダメなんだから！」
PRINTFORML 「よろしくねー！大人数ならきっと逃げれるわ！」	PRINTFORML 「よろしくねー！大人数ならきっと逃げれるわ！」
PRINTFORML 「上手にはきこなせばもっと機敏にうごけそうね」	PRINTFORML 「上手にはきこなせばもっと機敏にうごけそうね」
PRINTFORML 「着替えのストックがあるとすごく安心するわね」	PRINTFORML 「着替えのストックがあるとすごく安心するわね」
PRINTFORMDL サニーはお腹を濁った瞳でぼんやりと眺めている	PRINTFORMDL サニーはお腹を濁った瞳でぼんやりと眺めている
PRINTFORML 「はぁ…ベタベタしてないって素晴らしいわね！」	PRINTFORML 「はぁ…ベタベタしてないって素晴らしいわね！」
PRINTFORMDL サニーはふらつく足取りで必死に逃げ出した……	PRINTFORMDL サニーはふらつく足取りで必死に逃げ出した……
PRINTFORML 「ベタベタが多すぎてもうどうしょうもないわ…」	PRINTFORML 「ベタベタが多すぎてもうどうしょうもないわ…」
PRINTFORML 「残念、あなたの欲しがってる服はもうないのよ」	PRINTFORML 「残念、あなたの欲しがってる服はもうないのよ」
PRINTFORML 「ぎゃっ！？……う、うわぁ落ちなくてよかった」	PRINTFORML 「ぎゃっ！？……う、うわぁ落ちなくてよかった」
PRINTFORMDL サニーは怯えた眼で惨劇の痕に目をやっている…	PRINTFORMDL サニーは怯えた眼で惨劇の痕に目をやっている…
PRINTFORML 「家ならパパッと直せるけどこんな場所じゃ……」	PRINTFORML 「家ならパパッと直せるけどこんな場所じゃ……」
PRINTFORML 「うええ…なにかお腹の中に張り付いたような…」	PRINTFORML 「うええ…なにかお腹の中に張り付いたような…」
PRINTFORML 「こうなったらまだ動く頭を駆使するのよサニー」	PRINTFORML 「こうなったらまだ動く頭を駆使するのよサニー」
PRINTFORML 「こっちを見てない今がチャンス！撤退よ撤退！」	PRINTFORML 「こっちを見てない今がチャンス！撤退よ撤退！」
PRINTFORML 「だせー！こらー！噛むぞー！引っかくわよー！」	PRINTFORML 「だせー！こらー！噛むぞー！引っかくわよー！」
PRINTFORML 「ひぃい！ちょ、ちょっとほんとにまずいって！」	PRINTFORML 「ひぃい！ちょ、ちょっとほんとにまずいって！」
PRINTFORML 「さすがにこのかくれんぼはスリリング過ぎよね」	PRINTFORML 「さすがにこのかくれんぼはスリリング過ぎよね」
PRINTFORML 「これって弾幕がかってにでるのね！すごーい！」	PRINTFORML 「これって弾幕がかってにでるのね！すごーい！」
PRINTFORML 「ふふふ、なんだか急に強くなった気がするわ！」	PRINTFORML 「ふふふ、なんだか急に強くなった気がするわ！」
PRINTFORML 「これが宝探しだったら間違いなく私の優勝ね！」	PRINTFORML 「これが宝探しだったら間違いなく私の優勝ね！」
PRINTFORML 「わー！これ面白い！自由自在に動かせるのね！」	PRINTFORML 「わー！これ面白い！自由自在に動かせるのね！」
PRINTFORML 「もう服がボロボロ。そろそろ着替え時かしら？」	PRINTFORML 「もう服がボロボロ。そろそろ着替え時かしら？」
PRINTFORML 「…もしかしてこの変なにおい私からしてるの？」	PRINTFORML 「…もしかしてこの変なにおい私からしてるの？」
PRINTFORML 「こんな状況じゃなければお風呂か水浴びしたい」	PRINTFORML 「こんな状況じゃなければお風呂か水浴びしたい」
PRINTFORML 「そろそろ日光を浴びないと元気なくなりそう…」	PRINTFORML 「そろそろ日光を浴びないと元気なくなりそう…」
PRINTFORML 「ぎゃー！服吐き出せー！やめてー！話きけー！」	PRINTFORML 「ぎゃー！服吐き出せー！やめてー！話きけー！」
PRINTFORML 「ぎゃあ！は、早く出ないとひぃい！？やめっ…」	PRINTFORML 「ぎゃあ！は、早く出ないとひぃい！？やめっ…」
PRINTFORMDW 俯けば足元を掬おうと波打つ触手だらけの床が…	PRINTFORMDW 俯けば足元を掬おうと波打つ触手だらけの床が…
PRINTFORMDW 三人はもやもやを胸に家へと向かって足を進めた	PRINTFORMDW 三人はもやもやを胸に家へと向かって足を進めた
PRINTFORML 「お願いですから今は見逃してくださいよー！」	PRINTFORML 「お願いですから今は見逃してくださいよー！」
PRINTFORMDL サニーはメチャクチャに小さな弾をばら撒いた	PRINTFORMDL サニーはメチャクチャに小さな弾をばら撒いた
PRINTFORML （これならきっとあたるし…大丈夫……よね？）	PRINTFORML （これならきっとあたるし…大丈夫……よね？）
PRINTFORML 「もうあっちいって！ダイレクトサンライト！」	PRINTFORML 「もうあっちいって！ダイレクトサンライト！」
PRINTFORML (弾切れが怖くて全力なんてだせないわよ……)	PRINTFORML (弾切れが怖くて全力なんてだせないわよ……)
PRINTFORML 「どいつもこいつもやられちゃえばいいのよ！」	PRINTFORML 「どいつもこいつもやられちゃえばいいのよ！」
PRINTFORMDL サニーは武器を必死な形相で撃ち続けている！	PRINTFORMDL サニーは武器を必死な形相で撃ち続けている！
PRINTFORML (あれ……この武器こんなに重かったっけ……)	PRINTFORML (あれ……この武器こんなに重かったっけ……)
PRINTFORML 「こうなったら身体ごと当たって砕けてやる！」	PRINTFORML 「こうなったら身体ごと当たって砕けてやる！」
PRINTFORML 「やっぱり妖精じゃどうしょうもないのね……」	PRINTFORML 「やっぱり妖精じゃどうしょうもないのね……」
PRINTFORML 「あ…あはは……体の中でビクビクしてる……」	PRINTFORML 「あ…あはは……体の中でビクビクしてる……」
PRINTFORML 「痛い痛い！押し広げて入ってこないでよぉ！」	PRINTFORML 「痛い痛い！押し広げて入ってこないでよぉ！」
PRINTFORML 「ちょ、ちょっとシャレになってないわよ！？」	PRINTFORML 「ちょ、ちょっとシャレになってないわよ！？」
PRINTFORMDL サニーの瞳から大粒の涙がこぼれ続けている…	PRINTFORMDL サニーの瞳から大粒の涙がこぼれ続けている…
PRINTFORML 「ふえええぇえん！もうヤダあ！帰りたいよお！	PRINTFORML 「ふえええぇえん！もうヤダあ！帰りたいよお！
PRINTFORML 「……はぁ…はぁ…こんなに必死になるなんて」	PRINTFORML 「……はぁ…はぁ…こんなに必死になるなんて」
PRINTFORML 「たとえ無事に逃げれたとしても夢に見そう…」	PRINTFORML 「たとえ無事に逃げれたとしても夢に見そう…」
PRINTFORML 「うう…か弱い妖精なので守ってくださいよ？」	PRINTFORML 「うう…か弱い妖精なので守ってくださいよ？」
PRINTFORML 「んー…いまいち使い方がわからないわねコレ」	PRINTFORML 「んー…いまいち使い方がわからないわねコレ」
PRINTFORML 「奴らをバッサバッサ気持ちよくきれそうね！」	PRINTFORML 「奴らをバッサバッサ気持ちよくきれそうね！」
PRINTFORML 「何か…何か状況をよくするものはないの……」	PRINTFORML 「何か…何か状況をよくするものはないの……」
PRINTFORML 「イヤな出来事の記憶も洗い流せればいいのに」	PRINTFORML 「イヤな出来事の記憶も洗い流せればいいのに」
PRINTFORML 「安全に寝れる場所を急いでみつけなくちゃ…」	PRINTFORML 「安全に寝れる場所を急いでみつけなくちゃ…」
PRINTFORML 「痛い！死んじゃう！痛い痛い痛い痛い！！」」	PRINTFORML 「痛い！死んじゃう！痛い痛い痛い痛い！！」」
PRINTFORML (自分でいじってでも気持ちよくなりたい……)	PRINTFORML (自分でいじってでも気持ちよくなりたい……)
PRINTFORML 「普段ならこの程度の汚れはきにしないけど…」	PRINTFORML 「普段ならこの程度の汚れはきにしないけど…」
PRINTFORML 「こんな場所にある泉のクセにおいしいわよね」	PRINTFORML 「こんな場所にある泉のクセにおいしいわよね」
PRINTFORMDL サニーは転がりまわりながら寝言を叫んでいる	PRINTFORMDL サニーは転がりまわりながら寝言を叫んでいる
PRINTFORML 「これだけ近づけばガンガン攻撃できるわね！」	PRINTFORML 「これだけ近づけばガンガン攻撃できるわね！」
PRINTFORML 「妖精だと思ってなめたら後悔するんだから！」	PRINTFORML 「妖精だと思ってなめたら後悔するんだから！」
PRINTFORML 「男の子みたいだけどチャンバラもお手の物！」	PRINTFORML 「男の子みたいだけどチャンバラもお手の物！」
PRINTFORML 「狙うならもっと大人にしなさいよロリコン！」	PRINTFORML 「狙うならもっと大人にしなさいよロリコン！」
PRINTFORML 「気持ちいいっ気持ちいいっ気持ちいいのおっ」	PRINTFORML 「気持ちいいっ気持ちいいっ気持ちいいのおっ」
PRINTFORML 「ひぃっ！？何かがお腹の中で動いてるっ！？」	PRINTFORML 「ひぃっ！？何かがお腹の中で動いてるっ！？」
PRINTFORML 「ちょっとー！これアンタ達はほどけるの！？」	PRINTFORML 「ちょっとー！これアンタ達はほどけるの！？」
PRINTFORML 「私だってさすがにこれは楽しめないわよー！」	PRINTFORML 「私だってさすがにこれは楽しめないわよー！」
PRINTFORML 「しょ、触手！？なんかぐるぐるしてるけど…」	PRINTFORML 「しょ、触手！？なんかぐるぐるしてるけど…」
PRINTFORML 「ひっく…どうしよう……お腹がヘンなの……」	PRINTFORML 「ひっく…どうしよう……お腹がヘンなの……」
PRINTFORMDL サニーは定期的に膨らんだお腹をさすっている	PRINTFORMDL サニーは定期的に膨らんだお腹をさすっている
PRINTFORML 「…もう、満足したらとっとと出て行ってよね」	PRINTFORML 「…もう、満足したらとっとと出て行ってよね」
PRINTFORML 「うう、結局お日様の見える場所じゃないのね」	PRINTFORML 「うう、結局お日様の見える場所じゃないのね」
PRINTFORMDL どうやらサニーは元気を取り戻してきたようだ	PRINTFORMDL どうやらサニーは元気を取り戻してきたようだ
PRINTFORML 「早く日当たりのいい場所でお昼寝したいなー」	PRINTFORML 「早く日当たりのいい場所でお昼寝したいなー」
PRINTFORML 「服は破くものじゃないのに酷いことするわね」	PRINTFORML 「服は破くものじゃないのに酷いことするわね」
PRINTFORML 「そろそろお風呂に入ってさっぱりしたいなあ」	PRINTFORML 「そろそろお風呂に入ってさっぱりしたいなあ」
PRINTFORML 「話のネタもつきそう…これは切実な問題よ！」	PRINTFORML 「話のネタもつきそう…これは切実な問題よ！」
PRINTFORML 「なんで行っちゃうのよー！もうしらないっ！」	PRINTFORML 「なんで行っちゃうのよー！もうしらないっ！」
PRINTFORML 「もう、油断も隙もあったもんじゃないわね…」	PRINTFORML 「もう、油断も隙もあったもんじゃないわね…」
PRINTFORML 「まさかアリスさんが…ってそんなわけないか」	PRINTFORML 「まさかアリスさんが…ってそんなわけないか」
PRINTFORMDW 横を向けば獲物を求め蠢く触手が生えた壁が…	PRINTFORMDW 横を向けば獲物を求め蠢く触手が生えた壁が…
PRINTFORMDW ルナー…ルナー……と声が虚しくこだまする。	PRINTFORMDW ルナー…ルナー……と声が虚しくこだまする。
PRINTFORMDW 今まで三人で同じ夢でも見ていたのだろうか？	PRINTFORMDW 今まで三人で同じ夢でも見ていたのだろうか？
PRINTFORML (とにかく自分の身をまもらなくちゃ……！)	PRINTFORML (とにかく自分の身をまもらなくちゃ……！)
PRINTFORMDL サニーはビクビクしながら攻撃に備えている	PRINTFORMDL サニーはビクビクしながら攻撃に備えている
PRINTFORML 「このままじゃ本当におかしくなっちゃう…」	PRINTFORML 「このままじゃ本当におかしくなっちゃう…」
PRINTFORML 「酷い目に会う前に逃げたほうがいいわよ！」	PRINTFORML 「酷い目に会う前に逃げたほうがいいわよ！」
PRINTFORML 「いっけえ！フェイタルフラーーーッシュ！」	PRINTFORML 「いっけえ！フェイタルフラーーーッシュ！」
PRINTFORMDL サニーはメチャクチャに武器を振り回した！	PRINTFORMDL サニーはメチャクチャに武器を振り回した！
PRINTFORML サニーは涙目でめちゃくちゃに攻撃を放った！	PRINTFORML サニーは涙目でめちゃくちゃに攻撃を放った！
PRINTFORML 「この新必殺技、次の戦闘に使うんだから…」	PRINTFORML 「この新必殺技、次の戦闘に使うんだから…」
PRINTFORML 「そのエッチなうねうね、叩ききってやる！」	PRINTFORML 「そのエッチなうねうね、叩ききってやる！」
PRINTFORMDL サニーは弱々しくぬめる肉壁に指をかけた…	PRINTFORMDL サニーは弱々しくぬめる肉壁に指をかけた…
PRINTFORML (って何考えてるの私！早くにげないと…！)	PRINTFORML (って何考えてるの私！早くにげないと…！)
PRINTFORML 「もう怖いのやだ！吐いて！早く吐いてえ！」	PRINTFORML 「もう怖いのやだ！吐いて！早く吐いてえ！」
PRINTFORML 「どうしてそんなことばっかりするのよー！」	PRINTFORML 「どうしてそんなことばっかりするのよー！」
PRINTFORMW 「目が覚めたら…この夢もおしまいよね…？」	PRINTFORMW 「目が覚めたら…この夢もおしまいよね…？」
PRINTFORML 「赤ちゃんいらない！赤ちゃんほしくない！」	PRINTFORML 「赤ちゃんいらない！赤ちゃんほしくない！」
PRINTFORML 「そっちは残像！これ以上無駄だし諦めて！」	PRINTFORML 「そっちは残像！これ以上無駄だし諦めて！」
PRINTFORML 「や、やばっ！どうして襲われてるのよ！？」	PRINTFORML 「や、やばっ！どうして襲われてるのよ！？」
PRINTFORML 「はぁ、もう変なことされるのはまっぴらよ」	PRINTFORML 「はぁ、もう変なことされるのはまっぴらよ」
PRINTFORML 「……ちょ、ちょっと！見捨てていく気！？」	PRINTFORML 「……ちょ、ちょっと！見捨てていく気！？」
PRINTFORML 「うう…何かあったら助けてよね？絶対よ？」	PRINTFORML 「うう…何かあったら助けてよね？絶対よ？」
PRINTFORML 「お、これはあの有名な魔法陣ってやつね！」	PRINTFORML 「お、これはあの有名な魔法陣ってやつね！」
PRINTFORML 「私自身を私が身代わりに使えっていうの？」	PRINTFORML 「私自身を私が身代わりに使えっていうの？」
PRINTFORML 「随分と働きものねえ…疲れないのかしら？」	PRINTFORML 「随分と働きものねえ…疲れないのかしら？」
PRINTFORML 「さきっちょだけだからセーフよね、うん！」	PRINTFORML 「さきっちょだけだからセーフよね、うん！」
PRINTFORML 「お風呂くらいしか楽しみがないわねここ…」	PRINTFORML 「お風呂くらいしか楽しみがないわねここ…」
PRINTFORML 「また日当たりのいい場所でお昼寝したい…」	PRINTFORML 「また日当たりのいい場所でお昼寝したい…」
PRINTFORML 「外に出たらやりたいこと、いっぱいあるわ」	PRINTFORML 「外に出たらやりたいこと、いっぱいあるわ」
PRINTFORML 「早く取り出さないと手遅れになっちゃう…」	PRINTFORML 「早く取り出さないと手遅れになっちゃう…」
PRINTFORML (なんでもいいからだれか気持ちよくして…)	PRINTFORML (なんでもいいからだれか気持ちよくして…)
PRINTFORML 「着替えさえあればすぐにでも着替えるのに」	PRINTFORML 「着替えさえあればすぐにでも着替えるのに」
PRINTFORML 「とにかく着替えを見つけないと危ないわ！」	PRINTFORML 「とにかく着替えを見つけないと危ないわ！」
PRINTFORML 「お風呂にでも入らないと気が滅入っちゃう」	PRINTFORML 「お風呂にでも入らないと気が滅入っちゃう」
PRINTFORML 「話のネタもつきそう…これは切実な問題よ」	PRINTFORML 「話のネタもつきそう…これは切実な問題よ」
PRINTFORML 「んー…今日の目覚ましは刺激的ね…zzz」	PRINTFORML 「んー…今日の目覚ましは刺激的ね…zzz」
PRINTFORML 「私達光の三妖精は逃げ足には自信があるの」	PRINTFORML 「私達光の三妖精は逃げ足には自信があるの」
PRINTFORML 「二回から目薬をすれば岩をも砕くだっけ？」	PRINTFORML 「二回から目薬をすれば岩をも砕くだっけ？」
PRINTFORML 「だめーっ！私なんて美味しくないわよー！」	PRINTFORML 「だめーっ！私なんて美味しくないわよー！」
PRINTFORML 「ちょ、ちょっとシャレになってないわよ！」	PRINTFORML 「ちょ、ちょっとシャレになってないわよ！」
PRINTFORML 「いたたたた！大きい何かが今ズルッって…」	PRINTFORML 「いたたたた！大きい何かが今ズルッって…」
PRINTFORML (手足すら動かせないなんて大ピンチかも…)	PRINTFORML (手足すら動かせないなんて大ピンチかも…)
PRINTFORML 「何かあったら助けてよね？じゃっまたね！」	PRINTFORML 「何かあったら助けてよね？じゃっまたね！」
PRINTFORML 「かわいいー！これアリスさんの人形よね！」	PRINTFORML 「かわいいー！これアリスさんの人形よね！」
PRINTFORML 「うぐぐ……お腹が重くて動きづらいわ……」	PRINTFORML 「うぐぐ……お腹が重くて動きづらいわ……」
PRINTFORML 「よし！あんまりへこたれていてもダメね！」	PRINTFORML 「よし！あんまりへこたれていてもダメね！」
PRINTFORML 「一体誰がこんな洞窟を作ったのかしらねー」	PRINTFORML 「一体誰がこんな洞窟を作ったのかしらねー」
PRINTFORML 「しっし！もう二度とくるんじゃないわよ！」	PRINTFORML 「しっし！もう二度とくるんじゃないわよ！」
PRINTFORMW 「まあそんなことはこの際どうでもいいわ！」	PRINTFORMW 「まあそんなことはこの際どうでもいいわ！」
PRINTFORMDW そんな中で、サニーはふとある事に気付いた	PRINTFORMDW そんな中で、サニーはふとある事に気付いた
PRINTFORMDW このままでは脱出ができなくなってしまう！	PRINTFORMDW このままでは脱出ができなくなってしまう！
PRINTFORML 以上の口上を参考にさせていただきました。	PRINTFORML 以上の口上を参考にさせていただきました。
PRINTFORML 「私なんて虐めても…むにゃ……ひぃぃ…」	PRINTFORML 「私なんて虐めても…むにゃ……ひぃぃ…」
PRINTFORML 「ルナみたいにかっこ悪くころんじゃえ！」	PRINTFORML 「ルナみたいにかっこ悪くころんじゃえ！」
PRINTFORMDL サニーは胸を守ろうと必死に身をよじった	PRINTFORMDL サニーは胸を守ろうと必死に身をよじった
PRINTFORMDL サニーは必死の形相でアソコを守っている	PRINTFORMDL サニーは必死の形相でアソコを守っている
PRINTFORML 「あとちょっと…あとちょっとなのにぃ…」	PRINTFORML 「あとちょっと…あとちょっとなのにぃ…」
PRINTFORML 「な……なんなの……？なにしてる…の？」	PRINTFORML 「な……なんなの……？なにしてる…の？」
PRINTFORML 「やめて！あんたの子供なんていらない！」	PRINTFORML 「やめて！あんたの子供なんていらない！」
PRINTFORML 「だ、大丈夫よね……全部外にでたよね？」	PRINTFORML 「だ、大丈夫よね……全部外にでたよね？」
PRINTFORML 「いやあああ！隠すものなにかないの！？」	PRINTFORML 「いやあああ！隠すものなにかないの！？」
PRINTFORML 「変なとこばっかり触んないでってば…！」	PRINTFORML 「変なとこばっかり触んないでってば…！」
PRINTFORMDL サニーは苦しそうなうめき声を漏らした…	PRINTFORMDL サニーは苦しそうなうめき声を漏らした…
PRINTFORML 「ねえ…もう満足でしょう？やめてよお…」	PRINTFORML 「ねえ…もう満足でしょう？やめてよお…」
PRINTFORML 「はぁぁ…倒しても倒してもきりがないわ」	PRINTFORML 「はぁぁ…倒しても倒してもきりがないわ」
PRINTFORMDL 誰かの弱々しい息遣いが聞えた気がした。	PRINTFORMDL 誰かの弱々しい息遣いが聞えた気がした。
PRINTFORML (のんびり話をしている場合じゃないわね)	PRINTFORML (のんびり話をしている場合じゃないわね)
PRINTFORML 「スター、なんだかんだで楽しんでない？」	PRINTFORML 「スター、なんだかんだで楽しんでない？」
PRINTFORML 「なんか勝手に動いているのは不気味ね…」	PRINTFORML 「なんか勝手に動いているのは不気味ね…」
PRINTFORML 「お守りかー、いまいち可愛くないのよね」	PRINTFORML 「お守りかー、いまいち可愛くないのよね」
PRINTFORML 「変な汁とか入ってそうで少しだけ不安…」	PRINTFORML 「変な汁とか入ってそうで少しだけ不安…」
PRINTFORML 「早く奴らに襲われる前に服を着ないと！」	PRINTFORML 「早く奴らに襲われる前に服を着ないと！」
PRINTFORML 「お腹っ！破れちゃうっ！暴れないでえ！」	PRINTFORML 「お腹っ！破れちゃうっ！暴れないでえ！」
PRINTFORML 「自分からあえて出て行く必要はないわね」	PRINTFORML 「自分からあえて出て行く必要はないわね」
PRINTFORML 「一体今はここに来て何日目なのかしら？」	PRINTFORML 「一体今はここに来て何日目なのかしら？」
PRINTFORML 「ちょっときたなくなりはじめてるわね…」	PRINTFORML 「ちょっときたなくなりはじめてるわね…」
PRINTFORML 「んげえ！？ぺっぺっぺ…なによこの水！」	PRINTFORML 「んげえ！？ぺっぺっぺ…なによこの水！」
PRINTFORML 「ぎゃあぁあ！？潰れるところだったわ…」	PRINTFORML 「ぎゃあぁあ！？潰れるところだったわ…」
PRINTFORML 「妖精の底力ってものを見せてあげるわ！」	PRINTFORML 「妖精の底力ってものを見せてあげるわ！」
PRINTFORML 「妖精じゃどうしょうもないのかしら……」	PRINTFORML 「妖精じゃどうしょうもないのかしら……」
PRINTFORML 「そんな汚いところさわろうとしないで！」	PRINTFORML 「そんな汚いところさわろうとしないで！」
PRINTFORML 「やだっ！やだっ！！なんかヘンーーーッ」	PRINTFORML 「やだっ！やだっ！！なんかヘンーーーッ」
PRINTFORML 「いじわるしないでぇ…もっと強くっ……」	PRINTFORML 「いじわるしないでぇ…もっと強くっ……」
PRINTFORML 「こ、こらっ！なんてとこ触ってんのよ！」	PRINTFORML 「こ、こらっ！なんてとこ触ってんのよ！」
PRINTFORML 「そんなんじゃ毛玉一匹倒せやしないわよ」	PRINTFORML 「そんなんじゃ毛玉一匹倒せやしないわよ」
PRINTFORML 「いやあああ！私だって女の子なのよ！？」	PRINTFORML 「いやあああ！私だって女の子なのよ！？」
PRINTFORML 「うう…早く着替えをみつけなくっちゃ…」	PRINTFORML 「うう…早く着替えをみつけなくっちゃ…」
PRINTFORML 「ひぃっ！？なんで私捕まってるワケ！？」	PRINTFORML 「ひぃっ！？なんで私捕まってるワケ！？」
PRINTFORML 「ひゃあぁ！？壁のクセになにすんのよ！」	PRINTFORML 「ひゃあぁ！？壁のクセになにすんのよ！」
PRINTFORML 「んー、これって誰のカードなのかしら？」	PRINTFORML 「んー、これって誰のカードなのかしら？」
PRINTFORML 「……ヘンなもの食べたっけ？気持ち悪い」	PRINTFORML 「……ヘンなもの食べたっけ？気持ち悪い」
PRINTFORML 「んー！お日様がなくても完全復活よー！」	PRINTFORML 「んー！お日様がなくても完全復活よー！」
PRINTFORML 「あ、あれ……私どうしてこんな場所に？」	PRINTFORML 「あ、あれ……私どうしてこんな場所に？」
PRINTFORML 「たしか着替えはもってたような気がする」	PRINTFORML 「たしか着替えはもってたような気がする」
PRINTFORML 「いつまでこんな格好でいればいいのよ…」	PRINTFORML 「いつまでこんな格好でいればいいのよ…」
PRINTFORML 「着替えさえあればそろそろ着替えるのに」	PRINTFORML 「着替えさえあればそろそろ着替えるのに」
PRINTFORML 「髪も肌もベタベタだらけで気持ち悪い…」	PRINTFORML 「髪も肌もベタベタだらけで気持ち悪い…」
PRINTFORML 「お風呂ー！早くお風呂にはいりたーい！」	PRINTFORML 「お風呂ー！早くお風呂にはいりたーい！」
PRINTFORML 「ざまあみなさい！バチがあったたのよ！」	PRINTFORML 「ざまあみなさい！バチがあったたのよ！」
PRINTFORMDW また一人、不幸な犠牲者が神隠しにあった	PRINTFORMDW また一人、不幸な犠牲者が神隠しにあった
PRINTFORMDW 「まあいいわ。帰りましょ…クワガタ…」	PRINTFORMDW 「まあいいわ。帰りましょ…クワガタ…」
PRINTFORMDW その被害者には妖精も含まれているという	PRINTFORMDW その被害者には妖精も含まれているという
PRINTFORML 「うーんうーん…くんなぁ…くんなぁ…」	PRINTFORML 「うーんうーん…くんなぁ…くんなぁ…」
PRINTFORML 「もっと…うーん……酷いこと…やめ…」	PRINTFORML 「もっと…うーん……酷いこと…やめ…」
PRINTFORMDL サニーが痛みに顔を歪ませ悲鳴を上げた	PRINTFORMDL サニーが痛みに顔を歪ませ悲鳴を上げた
PRINTFORML (このままじゃおかしくなっちゃう…！)	PRINTFORML (このままじゃおかしくなっちゃう…！)
PRINTFORML 「イヤよ！あんなのに近づくのなんて！」	PRINTFORML 「イヤよ！あんなのに近づくのなんて！」
PRINTFORMDL 力ない弾幕がサニーを中心に広がった！	PRINTFORMDL 力ない弾幕がサニーを中心に広がった！
PRINTFORML 「後悔する前にあっちいきなさいよー！」	PRINTFORML 「後悔する前にあっちいきなさいよー！」
PRINTFORML 「やっちゃえ氷すら砕く私のレーザー！」	PRINTFORML 「やっちゃえ氷すら砕く私のレーザー！」
PRINTFORML 「私を襲ったことを後悔させてやるわ！」	PRINTFORML 「私を襲ったことを後悔させてやるわ！」
PRINTFORML (こんな時だからこそ無駄遣いはダメね)	PRINTFORML (こんな時だからこそ無駄遣いはダメね)
PRINTFORML 「弱点を狙うのは頭脳プレイの基本よ！」	PRINTFORML 「弱点を狙うのは頭脳プレイの基本よ！」
PRINTFORML (とにかく足をとめればチャンスが…！)	PRINTFORML (とにかく足をとめればチャンスが…！)
PRINTFORML (逃げるチャンスをつくるのよサニー！)	PRINTFORML (逃げるチャンスをつくるのよサニー！)
PRINTFORML 「と、とにかくチャンスを…んんっ……」	PRINTFORML 「と、とにかくチャンスを…んんっ……」
PRINTFORML 「それだけは本当にイヤなの！やめて！」	PRINTFORML 「それだけは本当にイヤなの！やめて！」
PRINTFORMDL サニーは虚ろな瞳のままなすがままだ…	PRINTFORMDL サニーは虚ろな瞳のままなすがままだ…
PRINTFORML 「もうやだぁ！食べられるの怖いよお！」	PRINTFORML 「もうやだぁ！食べられるの怖いよお！」
PRINTFORML 「気持ちいいっこれ以上……あぁぁ！？」	PRINTFORML 「気持ちいいっこれ以上……あぁぁ！？」
PRINTFORMW 「化物の赤ちゃんなんていらないのに！」	PRINTFORMW 「化物の赤ちゃんなんていらないのに！」
PRINTFORML 「おいしいもの…ずっと食べれてないわ」	PRINTFORML 「おいしいもの…ずっと食べれてないわ」
PRINTFORML 「この程度の武器じゃものたりないわ…」	PRINTFORML 「この程度の武器じゃものたりないわ…」
PRINTFORML 「ううー、もっとすごい武器はないの？」	PRINTFORML 「ううー、もっとすごい武器はないの？」
PRINTFORML 「見た目は派手でもいまいちなのよねえ」	PRINTFORML 「見た目は派手でもいまいちなのよねえ」
PRINTFORML 「きゃっ！？て、敵！？…じゃないの？」	PRINTFORML 「きゃっ！？て、敵！？…じゃないの？」
PRINTFORML 「これもアリスさんの人形なのかしら？」	PRINTFORML 「これもアリスさんの人形なのかしら？」
PRINTFORMDL サニーの体が時々不自然に痙攣している	PRINTFORMDL サニーの体が時々不自然に痙攣している
PRINTFORML 「ひぃ！？お腹の中で何か動いてる…！」	PRINTFORML 「ひぃ！？お腹の中で何か動いてる…！」
PRINTFORML 「化物の赤ちゃん……できちゃったんだ」	PRINTFORML 「化物の赤ちゃん……できちゃったんだ」
PRINTFORML 「どこの誰がこんなはた迷惑なものを…」	PRINTFORML 「どこの誰がこんなはた迷惑なものを…」
PRINTFORML (もうそろそろお風呂に入るべきかしら)	PRINTFORML (もうそろそろお風呂に入るべきかしら)
PRINTFORML 「お日様を見れれば元気、でるかしら？」	PRINTFORML 「お日様を見れれば元気、でるかしら？」
PRINTFORML 「なんで行っちゃうのよ…バカ！バカ！」	PRINTFORML 「なんで行っちゃうのよ…バカ！バカ！」
PRINTFORML 「………ぅ…ぅぅう…なんで岩なんかが」	PRINTFORML 「………ぅ…ぅぅう…なんで岩なんかが」
PRINTFORML 「私一人でどうしろっていうのよー！？」	PRINTFORML 「私一人でどうしろっていうのよー！？」
PRINTFORML 「もうクッキーも紅茶も飲めないんだ…」	PRINTFORML 「もうクッキーも紅茶も飲めないんだ…」
PRINTFORML 「……もう朝？あと１時間だけ……ぐー」	PRINTFORML 「……もう朝？あと１時間だけ……ぐー」
PRINTFORML 「空飛ぶ……まるでメルヘン…むにゃ…」	PRINTFORML 「空飛ぶ……まるでメルヘン…むにゃ…」
PRINTFORML 「ごめんなさーーい！……すぅ…すぅ…」	PRINTFORML 「ごめんなさーーい！……すぅ…すぅ…」
PRINTFORML 「もー！誰でもいいから早く服を頂戴！」	PRINTFORML 「もー！誰でもいいから早く服を頂戴！」
PRINTFORML 「ほらっ！これは避けられないでしょ？」	PRINTFORML 「ほらっ！これは避けられないでしょ？」
PRINTFORML 「もうっ！すりむいちゃったじゃない！」	PRINTFORML 「もうっ！すりむいちゃったじゃない！」
PRINTFORML 「わ、私なんて狙っても仕方ないわよ！」	PRINTFORML 「わ、私なんて狙っても仕方ないわよ！」
PRINTFORML 「ナカになんて絶対にださせないわよ！」	PRINTFORML 「ナカになんて絶対にださせないわよ！」
PRINTFORML 「よしっ！もうおいかけてこないわね！」	PRINTFORML 「よしっ！もうおいかけてこないわね！」
PRINTFORML 「ほら！まだ頑張れば助けられるわよ！」	PRINTFORML 「ほら！まだ頑張れば助けられるわよ！」
PRINTFORML 「よろしくねー！私がいれば百人力よ！」	PRINTFORML 「よろしくねー！私がいれば百人力よ！」
PRINTFORML 「これは確か御神体予備軍だったっけ？」	PRINTFORML 「これは確か御神体予備軍だったっけ？」
PRINTFORMDL サニーは突然ぺたんと地面に座り込んだ	PRINTFORMDL サニーは突然ぺたんと地面に座り込んだ
PRINTFORML 「ダ、ダメよそんなの！相手化物だし！」	PRINTFORML 「ダ、ダメよそんなの！相手化物だし！」
PRINTFORML 「ふあぁ…このまま一生浸かっていたい」	PRINTFORML 「ふあぁ…このまま一生浸かっていたい」
PRINTFORML 「自然があるようなないような変な場所」	PRINTFORML 「自然があるようなないような変な場所」
PRINTFORML 「もう何日くらいここにいるのかしら…」	PRINTFORML 「もう何日くらいここにいるのかしら…」
PRINTFORML 「図鑑でも見たことない生き物ばっかり」	PRINTFORML 「図鑑でも見たことない生き物ばっかり」
PRINTFORML 「なんとなくあちこちがべたつくような」	PRINTFORML 「なんとなくあちこちがべたつくような」
PRINTFORML 「ううぅ…結局全部食べられちゃった…」	PRINTFORML 「ううぅ…結局全部食べられちゃった…」
PRINTFORMDW 相変わらず声がこだまするだけである。	PRINTFORMDW 相変わらず声がこだまするだけである。
PRINTFORMW 「わかったわ！これが神隠しの正体ね！」	PRINTFORMW 「わかったわ！これが神隠しの正体ね！」
PRINTFORMDW 「そうだ！私の虫取り網とクワガタ！」	PRINTFORMDW 「そうだ！私の虫取り網とクワガタ！」
PRINTFORMW とりあえず、考えていても仕方がない。	PRINTFORMW とりあえず、考えていても仕方がない。
PRINTFORML 「絶対にこっちくるんじゃないわよ！」	PRINTFORML 「絶対にこっちくるんじゃないわよ！」
PRINTFORML 「これ以上ちかづくんじゃないわよ！」	PRINTFORML 「これ以上ちかづくんじゃないわよ！」
PRINTFORML (ううん、そうなる前ににげなくちゃ)	PRINTFORML (ううん、そうなる前ににげなくちゃ)
PRINTFORML 「食べられちゃう！食べられちゃう！」	PRINTFORML 「食べられちゃう！食べられちゃう！」
PRINTFORML 「はぁ…はぁ……なんとかかんとか…」	PRINTFORML 「はぁ…はぁ……なんとかかんとか…」
PRINTFORML 「やっぱり妖精じゃ……ダメなのね…」	PRINTFORML 「やっぱり妖精じゃ……ダメなのね…」
PRINTFORML 「ひぃっ…は、はやくなおさなくちゃ」	PRINTFORML 「ひぃっ…は、はやくなおさなくちゃ」
PRINTFORML 「穴が大きくなる前に着替えないと！」	PRINTFORML 「穴が大きくなる前に着替えないと！」
PRINTFORML 「いやぁぁ！？お腹の中に何かが！？」	PRINTFORML 「いやぁぁ！？お腹の中に何かが！？」
PRINTFORML 「あちこちから見られてる気がする…」	PRINTFORML 「あちこちから見られてる気がする…」
PRINTFORML 「いいかげんにしてよ！このエロ壁！」	PRINTFORML 「いいかげんにしてよ！このエロ壁！」
PRINTFORML 「やめてよお！出れなくなっちゃう！」	PRINTFORML 「やめてよお！出れなくなっちゃう！」
PRINTFORML 「このまま消化されちゃうのかしら…」	PRINTFORML 「このまま消化されちゃうのかしら…」
PRINTFORML (こんなにからまっちゃったらもう…)	PRINTFORML (こんなにからまっちゃったらもう…)
PRINTFORML 「ふぅ…もうおいかけてこないわね？」	PRINTFORML 「ふぅ…もうおいかけてこないわね？」
PRINTFORML 「待って！まだ私は生きてるわよー！」	PRINTFORML 「待って！まだ私は生きてるわよー！」
PRINTFORML 「酷い！助けて！ねえ！ねえってば！」	PRINTFORML 「酷い！助けて！ねえ！ねえってば！」
PRINTFORML 「いらないわよこんなよわっちいの！」	PRINTFORML 「いらないわよこんなよわっちいの！」
PRINTFORML 「なんかすごいの見つけちゃった！？」	PRINTFORML 「なんかすごいの見つけちゃった！？」
PRINTFORMDL サニーは腹部をしきりに気にしている	PRINTFORMDL サニーは腹部をしきりに気にしている
PRINTFORMDL サニーはどこか不安げに身構えている	PRINTFORMDL サニーはどこか不安げに身構えている
PRINTFORML 「へんなものみつけないといいなあ…」	PRINTFORML 「へんなものみつけないといいなあ…」
PRINTFORML 「…うーん、悪夢はまだ醒めないのね」	PRINTFORML 「…うーん、悪夢はまだ醒めないのね」
PRINTFORML 「なかなか体調がよくならないわねえ」	PRINTFORML 「なかなか体調がよくならないわねえ」
PRINTFORML 「お腹、こんなに大きくなっちゃった」	PRINTFORML 「お腹、こんなに大きくなっちゃった」
PRINTFORML 「まって！私の事見捨てる気なの！？」	PRINTFORML 「まって！私の事見捨てる気なの！？」
PRINTFORML 「これってまさか…霊夢さんが…！？」	PRINTFORML 「これってまさか…霊夢さんが…！？」
PRINTFORML 「……私はいつまで生き延びれるやら」	PRINTFORML 「……私はいつまで生き延びれるやら」
PRINTFORML 「ううー…どうしてこんなことに……」	PRINTFORML 「ううー…どうしてこんなことに……」
PRINTFORML 「困った時はとりあえず逃げるのよ！」	PRINTFORML 「困った時はとりあえず逃げるのよ！」
PRINTFORML 「くらえっ！ダイレクトサンライト！」	PRINTFORML 「くらえっ！ダイレクトサンライト！」
PRINTFORML 「離せー！おかしくなっちゃいそう！」	PRINTFORML 「離せー！おかしくなっちゃいそう！」
PRINTFORML 「妖精なんてまずいだけだってばー！」	PRINTFORML 「妖精なんてまずいだけだってばー！」
PRINTFORML 「ひっく……えっく……ゆるして……」	PRINTFORML 「ひっく……えっく……ゆるして……」
PRINTFORML 「赤ちゃんならもっと大人と作って！」	PRINTFORML 「赤ちゃんならもっと大人と作って！」
PRINTFORML 「やっぱり妖精じゃ……ダメなの…？」	PRINTFORML 「やっぱり妖精じゃ……ダメなの…？」
PRINTFORML 「ううーん…気持ちよく寝てたのに…」	PRINTFORML 「ううーん…気持ちよく寝てたのに…」
PRINTFORML 「どんどん呑み込まれてないコレ！？」	PRINTFORML 「どんどん呑み込まれてないコレ！？」
PRINTFORMW 「むー！むぐーぐーむぐぐぐーー！？」	PRINTFORMW 「むー！むぐーぐーむぐぐぐーー！？」
PRINTFORML 「えー、別行動？仕方ないわねえ……」	PRINTFORML 「えー、別行動？仕方ないわねえ……」
PRINTFORML 「私の弾幕とどっちが強いのかしら？」	PRINTFORML 「私の弾幕とどっちが強いのかしら？」
PRINTFORML 「ぅぅぅ……早く産んで楽になりたい」	PRINTFORML 「ぅぅぅ……早く産んで楽になりたい」
PRINTFORML 「ほらほらー！くるならきなさーい！」	PRINTFORML 「ほらほらー！くるならきなさーい！」
PRINTFORML 「こんな状況でも探検は楽しいわね♪」	PRINTFORML 「こんな状況でも探検は楽しいわね♪」
PRINTFORML 「痛たたたたたた！痛い！痛いっ！！」	PRINTFORML 「痛たたたたたた！痛い！痛いっ！！」
PRINTFORML (もうえっちなことで頭がいっぱい…)	PRINTFORML (もうえっちなことで頭がいっぱい…)
PRINTFORML 「ぎゃあ！後ろから丸見えじゃない！」	PRINTFORML 「ぎゃあ！後ろから丸見えじゃない！」
PRINTFORML 「この洞窟の謎を解明してやるのよ！」	PRINTFORML 「この洞窟の謎を解明してやるのよ！」
PRINTFORML 「うーん？まあ考えても仕方ないわね」	PRINTFORML 「うーん？まあ考えても仕方ないわね」
PRINTFORML 「もっ…もうやだあぁぁぁっ………」	PRINTFORML 「もっ…もうやだあぁぁぁっ………」
PRINTFORML 「はなして…はなして……むにゃ…」	PRINTFORML 「はなして…はなして……むにゃ…」
PRINTFORML 「こんな格好じゃ動けないわよ……」	PRINTFORML 「こんな格好じゃ動けないわよ……」
PRINTFORMDL サニーは弱々しい弾幕を放った……	PRINTFORMDL サニーは弱々しい弾幕を放った……
PRINTFORML 「あたると痛いんだからくんなー！」	PRINTFORML 「あたると痛いんだからくんなー！」
PRINTFORML （これがあたってもダメだったら…）	PRINTFORML （これがあたってもダメだったら…）
PRINTFORML 「近づいてきたらもっと痛いわよ！」	PRINTFORML 「近づいてきたらもっと痛いわよ！」
PRINTFORML 「ほらほら、足元がすっかすかよ♪」	PRINTFORML 「ほらほら、足元がすっかすかよ♪」
PRINTFORML 「やだぁ！出して！出してよぉ！！」	PRINTFORML 「やだぁ！出して！出してよぉ！！」
PRINTFORML 「充分うっぷんはらしたでしょう？」	PRINTFORML 「充分うっぷんはらしたでしょう？」
PRINTFORML (次でなんとしても逃げないと…！)	PRINTFORML (次でなんとしても逃げないと…！)
PRINTFORMDL サニーは必死におしりを庇っている	PRINTFORMDL サニーは必死におしりを庇っている
PRINTFORML 「もうナカに入れるのいやだよぉ！」	PRINTFORML 「もうナカに入れるのいやだよぉ！」
PRINTFORML 「こ、こんどは何をする気なの！？」	PRINTFORML 「こ、こんどは何をする気なの！？」
PRINTFORML 「初めてなの･･･ねえ、許して…」	PRINTFORML 「初めてなの･･･ねえ、許して…」
PRINTFORML 「いやあああ！もうそれはやめて！」	PRINTFORML 「いやあああ！もうそれはやめて！」
PRINTFORML 「もうっ！もうっおかしくッーーー」	PRINTFORML 「もうっ！もうっおかしくッーーー」
PRINTFORMDW そんな彼女に触手は動きで答えた。	PRINTFORMDW そんな彼女に触手は動きで答えた。
PRINTFORML 「いやああ！ヘンなモノ出すなぁ！」	PRINTFORML 「いやああ！ヘンなモノ出すなぁ！」
PRINTFORML 「ぎもぢいい…きもじいいのぉ……」	PRINTFORML 「ぎもぢいい…きもじいいのぉ……」
PRINTFORML 「このままじゃ裸にされちゃうっ…」	PRINTFORML 「このままじゃ裸にされちゃうっ…」
PRINTFORML 「いやああ！？これ以上くんなあ！」	PRINTFORML 「いやああ！？これ以上くんなあ！」
PRINTFORMDL 騒がしかった外が急に静かになった	PRINTFORMDL 騒がしかった外が急に静かになった
PRINTFORML 「元気でたら自力で逃げなさいよ？」	PRINTFORML 「元気でたら自力で逃げなさいよ？」
PRINTFORML 「アリスさんがいるなら心強いです」	PRINTFORML 「アリスさんがいるなら心強いです」
PRINTFORML 「さすがにちょっと心細かったの…」	PRINTFORML 「さすがにちょっと心細かったの…」
PRINTFORML 「草を焼くのには使えそうだけど…」	PRINTFORML 「草を焼くのには使えそうだけど…」
PRINTFORML (もうちょっと奥まで入ってたら…)	PRINTFORML (もうちょっと奥まで入ってたら…)
PRINTFORML 「まだ……少しでも動けるうちに…」	PRINTFORML 「まだ……少しでも動けるうちに…」
PRINTFORML 「たしか着替えはもってたわよねえ」	PRINTFORML 「たしか着替えはもってたわよねえ」
PRINTFORML 「こんなかっこじゃ襲われちゃう！」	PRINTFORML 「こんなかっこじゃ襲われちゃう！」
PRINTFORML 「もう酷い目には遭いたくないわ…」	PRINTFORML 「もう酷い目には遭いたくないわ…」
PRINTFORML 「どこかに安全な場所はないかなあ」	PRINTFORML 「どこかに安全な場所はないかなあ」
PRINTFORML 「やだ……あんなふうになるの……」	PRINTFORML 「やだ……あんなふうになるの……」
PRINTFORML 「んん～……なにぃ？…ぁんっ……」	PRINTFORML 「んん～……なにぃ？…ぁんっ……」
PRINTFORML 「うわーん！もう家に帰してよお！」	PRINTFORML 「うわーん！もう家に帰してよお！」
PRINTFORML 「今こそ必殺！妖精一刀流奥義よ！」	PRINTFORML 「今こそ必殺！妖精一刀流奥義よ！」
PRINTFORML 「ここだけはダメ！ほんとダメ！！」	PRINTFORML 「ここだけはダメ！ほんとダメ！！」
PRINTFORML 「………もう…えっちこと…イヤ…」	PRINTFORML 「………もう…えっちこと…イヤ…」
PRINTFORML 「あいたたた…やってくれたわね！」	PRINTFORML 「あいたたた…やってくれたわね！」
PRINTFORML 「よ、よかった……逃げ切れた……」	PRINTFORML 「よ、よかった……逃げ切れた……」
PRINTFORML 「わわ、不思議！この靴浮いてる！」	PRINTFORML 「わわ、不思議！この靴浮いてる！」
PRINTFORML (なんかお腹の中が苦しいような…)	PRINTFORML (なんかお腹の中が苦しいような…)
PRINTFORML 「あ、うん。気のせいだったみたい」	PRINTFORML 「あ、うん。気のせいだったみたい」
PRINTFORML (お腹の中で何かが動いてる…！？)	PRINTFORML (お腹の中で何かが動いてる…！？)
PRINTFORML 「一体なんだっていうのよ！もう！」	PRINTFORML 「一体なんだっていうのよ！もう！」
PRINTFORML 「こっちは迎え撃つ準備は完璧よ！」	PRINTFORML 「こっちは迎え撃つ準備は完璧よ！」
PRINTFORML 「なんだかお腹がはって…嫌な感じ」	PRINTFORML 「なんだかお腹がはって…嫌な感じ」
PRINTFORML (頭の中がぐらんぐらんするわー…)	PRINTFORML (頭の中がぐらんぐらんするわー…)
PRINTFORML 「えー、どうして行っちゃうの！？」	PRINTFORML 「えー、どうして行っちゃうの！？」
PRINTFORML 「なんか変わった泉ね～。ほっとこ」	PRINTFORML 「なんか変わった泉ね～。ほっとこ」
PRINTFORML 「やだやだ、こうはなりたくないわ」	PRINTFORML 「やだやだ、こうはなりたくないわ」
PRINTFORMW 「うーん…一体何だって言うのよ…」	PRINTFORMW 「うーん…一体何だって言うのよ…」
PRINTFORMDW 突然体を何かに引っ張られたこと、	PRINTFORMDW 突然体を何かに引っ張られたこと、
PRINTFORMW 『私達は先に朝ごはんをすませたわ』	PRINTFORMW 『私達は先に朝ごはんをすませたわ』
PRINTFORMDW 今まで夢でも見ていたのだろうか？	PRINTFORMDW 今まで夢でも見ていたのだろうか？
PRINTFORMW 「それ」は早速、活動を再開した。	PRINTFORMW 「それ」は早速、活動を再開した。
PRINTFORML この場を借りて御礼申し上げます。	PRINTFORML この場を借りて御礼申し上げます。
PRINTFORML 触手 ＝　妖精　＝　サニーちゃん	PRINTFORML 触手 ＝　妖精　＝　サニーちゃん
PRINTFORML 「……おいかけて…こないでよぉ」	PRINTFORML 「……おいかけて…こないでよぉ」
PRINTFORML 「…おなか……あついっ…………」	PRINTFORML 「…おなか……あついっ…………」
PRINTFORML 「目なんて…覚ましたくない……」	PRINTFORML 「目なんて…覚ましたくない……」
PRINTFORMDL サニーは必死の形相で駆け出した	PRINTFORMDL サニーは必死の形相で駆け出した
PRINTFORML 「私なんておいしくないわよー！」	PRINTFORML 「私なんておいしくないわよー！」
PRINTFORML 「いやぁああああ！誰か助けて！」	PRINTFORML 「いやぁああああ！誰か助けて！」
PRINTFORML （こんな攻撃でもしないよりは…）	PRINTFORML （こんな攻撃でもしないよりは…）
PRINTFORML 「よらないで…こっちこないで…」	PRINTFORML 「よらないで…こっちこないで…」
PRINTFORML 「こっちくんな！このっこのっ！」	PRINTFORML 「こっちくんな！このっこのっ！」
PRINTFORML (食べられるの…キモチイイ……)	PRINTFORML (食べられるの…キモチイイ……)
PRINTFORML 「おっぱいなんてさわんないで！」	PRINTFORML 「おっぱいなんてさわんないで！」
PRINTFORML 「やだやだやだやだやだやだやだ」	PRINTFORML 「やだやだやだやだやだやだやだ」
PRINTFORML 「このくらい痛くないんだから…」	PRINTFORML 「このくらい痛くないんだから…」
PRINTFORML 「あっ……ーーーーーーーー！？」	PRINTFORML 「あっ……ーーーーーーーー！？」
PRINTFORML 「逃げ…きれた……よかったぁ…」	PRINTFORML 「逃げ…きれた……よかったぁ…」
PRINTFORML 「かわいいし強いし優秀ねこれ！」	PRINTFORML 「かわいいし強いし優秀ねこれ！」
PRINTFORML 「奴らを穴だらけにしてやる…！」	PRINTFORML 「奴らを穴だらけにしてやる…！」
PRINTFORML 「痛い痛い痛い痛い痛い痛い！！」	PRINTFORML 「痛い痛い痛い痛い痛い痛い！！」
PRINTFORML 「のんびりしてる時間はないわよ」	PRINTFORML 「のんびりしてる時間はないわよ」
PRINTFORML 「できれば何もこないといいなあ」	PRINTFORML 「できれば何もこないといいなあ」
PRINTFORML (少しでも助けになるものは……)	PRINTFORML (少しでも助けになるものは……)
PRINTFORML (罠とかみつけませんように……)	PRINTFORML (罠とかみつけませんように……)
PRINTFORML 「こっちに何かありそうな予感！」	PRINTFORML 「こっちに何かありそうな予感！」
PRINTFORMW 「あはは…これは一回休みね……」	PRINTFORMW 「あはは…これは一回休みね……」
PRINTFORMW 「復活したらお日様みたいな……」	PRINTFORMW 「復活したらお日様みたいな……」
PRINTFORML 「……まだ生きた心地がしないわ」	PRINTFORML 「……まだ生きた心地がしないわ」
PRINTFORML (逃げなきゃ…早く逃げなきゃ…)	PRINTFORML (逃げなきゃ…早く逃げなきゃ…)
PRINTFORML 「このままじゃ…気が狂いそう…」	PRINTFORML 「このままじゃ…気が狂いそう…」
PRINTFORML 「ぐすっ…なんでこんな目に……」	PRINTFORML 「ぐすっ…なんでこんな目に……」
PRINTFORML 「こんな状態じゃ戦えないわよー」	PRINTFORML 「こんな状態じゃ戦えないわよー」
PRINTFORML 「…やつらの臭いがする気がする」	PRINTFORML 「…やつらの臭いがする気がする」
PRINTFORML 「ひっ…いつのまにこんな汚れが」	PRINTFORML 「ひっ…いつのまにこんな汚れが」
PRINTFORML 「ふぁぁ…ふわふわすりゅわ～…」	PRINTFORML 「ふぁぁ…ふわふわすりゅわ～…」
PRINTFORML 「むにゃ…お仕置きはやだー……」	PRINTFORML 「むにゃ…お仕置きはやだー……」
PRINTFORML 「ぐちゅぐちゅぬるぬるぅ～……」	PRINTFORML 「ぐちゅぐちゅぬるぬるぅ～……」
PRINTFORML 「道具はケチらず使ってこそよ！」	PRINTFORML 「道具はケチらず使ってこそよ！」
PRINTFORML 「当たればいいのよ当たればー！」	PRINTFORML 「当たればいいのよ当たればー！」
PRINTFORML 「ふっふっふ！奥の手を使うわ！」	PRINTFORML 「ふっふっふ！奥の手を使うわ！」
PRINTFORML 「ばら撒くのなら得意なのよー！」	PRINTFORML 「ばら撒くのなら得意なのよー！」
PRINTFORML 「全員まとめて相手してあげる！」	PRINTFORML 「全員まとめて相手してあげる！」
PRINTFORML 「絡みつくなー！えっち！変態！」	PRINTFORML 「絡みつくなー！えっち！変態！」
PRINTFORML 「ちょ、ちょっとタイムタイム！」	PRINTFORML 「ちょ、ちょっとタイムタイム！」
PRINTFORML 「へんなとこさわんなロリコン！」	PRINTFORML 「へんなとこさわんなロリコン！」
PRINTFORML 「ぎゃー！ズルっていったぁ！？」	PRINTFORML 「ぎゃー！ズルっていったぁ！？」
PRINTFORML 「これって大ピンチって奴じゃ…」	PRINTFORML 「これって大ピンチって奴じゃ…」
PRINTFORML 「ううう…動けない…どうしよう」	PRINTFORML 「ううう…動けない…どうしよう」
PRINTFORML 「といってもこう薄暗いとねー…」	PRINTFORML 「といってもこう薄暗いとねー…」
PRINTFORML 「お日様が私たちをよんでるわ！」	PRINTFORML 「お日様が私たちをよんでるわ！」
PRINTFORML 「誰が取ってよ…ねえ…誰か……」	PRINTFORML 「誰が取ってよ…ねえ…誰か……」
PRINTFORMW 「うう…どうしてこんなことに…」	PRINTFORMW 「うう…どうしてこんなことに…」
PRINTFORML 「助けてー！だれか助けてよー！」	PRINTFORML 「助けてー！だれか助けてよー！」
PRINTFORML 「もっと安全な探検がよかったわ」	PRINTFORML 「もっと安全な探検がよかったわ」
PRINTFORML 「あ…あれ…？天井ぐるぐる……」	PRINTFORML 「あ…あれ…？天井ぐるぐる……」
PRINTFORML 「ぐー……！？ね、寝てないわよ」	PRINTFORML 「ぐー……！？ね、寝てないわよ」
PRINTFORML 「はぁ……はぁ……休憩したい…」	PRINTFORML 「はぁ……はぁ……休憩したい…」
PRINTFORML 「あーあ、気に入ってたのになあ」	PRINTFORML 「あーあ、気に入ってたのになあ」
PRINTFORML 「別に喉かわいてないしほっとこ」	PRINTFORML 「別に喉かわいてないしほっとこ」
PRINTFORML 「待って待って！みぎゃぁあ！？」	PRINTFORML 「待って待って！みぎゃぁあ！？」
PRINTFORML 「………きゅぅ…生きてるの私？」	PRINTFORML 「………きゅぅ…生きてるの私？」
PRINTFORMW 「本当にどこなのよここはー！！」	PRINTFORMW 「本当にどこなのよここはー！！」
PRINTFORML 「早くさめて……こんな悪夢…」	PRINTFORML 「早くさめて……こんな悪夢…」
PRINTFORML 「こっちくんなこっちくんな！」	PRINTFORML 「こっちくんなこっちくんな！」
PRINTFORML 「全員まとめてどっかいけー！」	PRINTFORML 「全員まとめてどっかいけー！」
PRINTFORML 「最大出力ー！やっつけろー！」	PRINTFORML 「最大出力ー！やっつけろー！」
PRINTFORML (冷静に…落ち着くのよサニー)	PRINTFORML (冷静に…落ち着くのよサニー)
PRINTFORML 「もう酷いことしないでよぉ！」	PRINTFORML 「もう酷いことしないでよぉ！」
PRINTFORML (チャンスを逃したらまた……)	PRINTFORML (チャンスを逃したらまた……)
PRINTFORML 「そこはいやなの！こないで！」	PRINTFORML 「そこはいやなの！こないで！」
PRINTFORML 「こないでこないでこないで！」	PRINTFORML 「こないでこないでこないで！」
PRINTFORML 「ひいいっ！きもちわるいっ！」	PRINTFORML 「ひいいっ！きもちわるいっ！」
PRINTFORML 「………いっそ…一回休みに…」	PRINTFORML 「………いっそ…一回休みに…」
PRINTFORML (ぅぅ…このままじゃ意識が…)	PRINTFORML (ぅぅ…このままじゃ意識が…)
PRINTFORML 「もうおうちかえしてよお……」	PRINTFORML 「もうおうちかえしてよお……」
PRINTFORML 「そんなものかけないでよぉ！」	PRINTFORML 「そんなものかけないでよぉ！」
PRINTFORML 「ぎゃー！破けちゃってる……」	PRINTFORML 「ぎゃー！破けちゃってる……」
PRINTFORML 「いやあああ！？やだ！やだ！」	PRINTFORML 「いやあああ！？やだ！やだ！」
PRINTFORML 「あ…や、やだ……やめて……」	PRINTFORML 「あ…や、やだ……やめて……」
PRINTFORML 「はーー…なんとかなったわね」	PRINTFORML 「はーー…なんとかなったわね」
PRINTFORML 「ここは二手にわかれましょ！」	PRINTFORML 「ここは二手にわかれましょ！」
PRINTFORML 「ところでどう使えばいいの？」	PRINTFORML 「ところでどう使えばいいの？」
PRINTFORML 「ふぁあ…なぜか眠くなるわね」	PRINTFORML 「ふぁあ…なぜか眠くなるわね」
PRINTFORML 「もう……産まれる……のね…」	PRINTFORML 「もう……産まれる……のね…」
PRINTFORMW (もう…こんなとこ出たい……）	PRINTFORMW (もう…こんなとこ出たい……）
PRINTFORMDL サニーは虚空を見つめている…	PRINTFORMDL サニーは虚空を見つめている…
PRINTFORML 「帰りたい…お日様が恋しい…」	PRINTFORML 「帰りたい…お日様が恋しい…」
PRINTFORML 「ねむ……安全な場所ないの？」	PRINTFORML 「ねむ……安全な場所ないの？」
PRINTFORML 「…絶対コレなにかいるわよぉ」	PRINTFORML 「…絶対コレなにかいるわよぉ」
PRINTFORML 「早く出口をみつけなくっちゃ」	PRINTFORML 「早く出口をみつけなくっちゃ」
PRINTFORML 「なんか飲む気が起きないわ…」	PRINTFORML 「なんか飲む気が起きないわ…」
PRINTFORML 「はぁ…ひんやり気持ちいい…」	PRINTFORML 「はぁ…ひんやり気持ちいい…」
PRINTFORML 「ひぃいい！誰かたすけてー！」	PRINTFORML 「ひぃいい！誰かたすけてー！」
PRINTFORML 「こんな汚いトコさわんなー！」	PRINTFORML 「こんな汚いトコさわんなー！」
PRINTFORML 「いやーー！食べられるーー！」	PRINTFORML 「いやーー！食べられるーー！」
PRINTFORML (よかった…よけれたみたいね)	PRINTFORML (よかった…よけれたみたいね)
PRINTFORML 「もう朝？ってぎゃーーー！？」	PRINTFORML 「もう朝？ってぎゃーーー！？」
PRINTFORML 「こ、このっ！邪魔しないで！」	PRINTFORML 「こ、このっ！邪魔しないで！」
PRINTFORML 「こらー！聞けー！助けろー！」	PRINTFORML 「こらー！聞けー！助けろー！」
PRINTFORML 「ふふん！こんなものかしら？」	PRINTFORML 「ふふん！こんなものかしら？」
PRINTFORML 「やった！私が見つけたのよ！」	PRINTFORML 「やった！私が見つけたのよ！」
PRINTFORMW 「うぅ…これは一回休みね……」	PRINTFORMW 「うぅ…これは一回休みね……」
PRINTFORML 「なんだか空飛んでるみたい…」	PRINTFORML 「なんだか空飛んでるみたい…」
PRINTFORML 「ふぁぁあああああ…ねむ……」	PRINTFORML 「ふぁぁあああああ…ねむ……」
PRINTFORML （おなかの中がくすぐったい…）	PRINTFORML （おなかの中がくすぐったい…）
PRINTFORML 「気のせいでなく体が重いわ…」	PRINTFORML 「気のせいでなく体が重いわ…」
PRINTFORML 「ふぁぁ…なんか幸せな感じ…」	PRINTFORML 「ふぁぁ…なんか幸せな感じ…」
PRINTFORML 「ああは……なりたくない……」	PRINTFORML 「ああは……なりたくない……」
PRINTFORML 「これってまさか霊夢さんが？」	PRINTFORML 「これってまさか霊夢さんが？」
PRINTFORMW やがて再び「それ」は蘇った。	PRINTFORMW やがて再び「それ」は蘇った。
PRINTFORML 「……げほっ…けほっげほっ」	PRINTFORML 「……げほっ…けほっげほっ」
PRINTFORML 「いやー！誰か！誰かーー！」	PRINTFORML 「いやー！誰か！誰かーー！」
PRINTFORMW 「これも夢……おやすみ……」	PRINTFORMW 「これも夢……おやすみ……」
PRINTFORML (なんか…ボーってする……)	PRINTFORML (なんか…ボーってする……)
PRINTFORML (武器を持つのもやっと……)	PRINTFORML (武器を持つのもやっと……)
PRINTFORML 「こんなもんで大丈夫かしら」	PRINTFORML 「こんなもんで大丈夫かしら」
PRINTFORML 「うん、このくらいで充分ね」	PRINTFORML 「うん、このくらいで充分ね」
PRINTFORML 「散々やられたおかえしよ！」	PRINTFORML 「散々やられたおかえしよ！」
PRINTFORML (絶対にこれはあてなきゃ…)	PRINTFORML (絶対にこれはあてなきゃ…)
PRINTFORML 「弱点はそこ！もう諦めて！」	PRINTFORML 「弱点はそこ！もう諦めて！」
PRINTFORML (弱点さえつければきっと…)	PRINTFORML (弱点さえつければきっと…)
PRINTFORML 「イヤイヤイヤイヤイヤ！！」	PRINTFORML 「イヤイヤイヤイヤイヤ！！」
PRINTFORML 「せめて……はやく楽にして」	PRINTFORML 「せめて……はやく楽にして」
PRINTFORML 「エッチ！変態！ロリコン！」	PRINTFORML 「エッチ！変態！ロリコン！」
PRINTFORML 「変なトコさわらないで…！」	PRINTFORML 「変なトコさわらないで…！」
PRINTFORML 「いた…くるし……ぁあ……」	PRINTFORML 「いた…くるし……ぁあ……」
PRINTFORML 「ひぃっ！？いつのまに！？」	PRINTFORML 「ひぃっ！？いつのまに！？」
PRINTFORML 「……もう…助からないの？」	PRINTFORML 「……もう…助からないの？」
PRINTFORMDL 戦闘がおわったのだろうか？	PRINTFORMDL 戦闘がおわったのだろうか？
PRINTFORML 「お願い助けて！助けてよ！」	PRINTFORML 「お願い助けて！助けてよ！」
PRINTFORMW 「いやあああぁぁぁぁ……！」	PRINTFORMW 「いやあああぁぁぁぁ……！」
PRINTFORML 「随分とげっそりしちゃって」	PRINTFORML 「随分とげっそりしちゃって」
PRINTFORML 「うーん…メガネの強化版？」	PRINTFORML 「うーん…メガネの強化版？」
PRINTFORML 「はぁ…やっと服が着れる…」	PRINTFORML 「はぁ…やっと服が着れる…」
PRINTFORML 「あ、あれ？どうして涙が…」	PRINTFORML 「あ、あれ？どうして涙が…」
PRINTFORML 「とにかく安全な場所に……」	PRINTFORML 「とにかく安全な場所に……」
PRINTFORML (お日様をまた見たいわ……)	PRINTFORML (お日様をまた見たいわ……)
PRINTFORML 「なんてトコ狙ってるのよ！」	PRINTFORML 「なんてトコ狙ってるのよ！」
PRINTFORML 「絶対にそれだけはダメー！」	PRINTFORML 「絶対にそれだけはダメー！」
PRINTFORML 「ひっ…って安全な場所…？」	PRINTFORML 「ひっ…って安全な場所…？」
PRINTFORML 「助けて…だれか助けて……」	PRINTFORML 「助けて…だれか助けて……」
PRINTFORML 「気持ち悪い生き物ばっかり」	PRINTFORML 「気持ち悪い生き物ばっかり」
PRINTFORML 「着替えは落ちてないの！？」	PRINTFORML 「着替えは落ちてないの！？」
PRINTFORML 「ん～…今はほっときましょ」	PRINTFORML 「ん～…今はほっときましょ」
PRINTFORML 「いけいけー！私の弾幕ー！」	PRINTFORML 「いけいけー！私の弾幕ー！」
PRINTFORML 「離して！離せっててばー！」	PRINTFORML 「離して！離せっててばー！」
PRINTFORML 「今度は……なんなのぉ……」	PRINTFORML 「今度は……なんなのぉ……」
PRINTFORML 「ひぃぃいいぃぃいぃぃ！？」	PRINTFORML 「ひぃぃいいぃぃいぃぃ！？」
PRINTFORML 「ふふっ、そっちは残像よ！」	PRINTFORML 「ふふっ、そっちは残像よ！」
PRINTFORML 「ぎゃあああ！返せエッチ！」	PRINTFORML 「ぎゃあああ！返せエッチ！」
PRINTFORML 「お気に入りなのに酷いわ！」	PRINTFORML 「お気に入りなのに酷いわ！」
PRINTFORML 「ふふっ、ちょろいちょろい」	PRINTFORML 「ふふっ、ちょろいちょろい」
PRINTFORMW 「みぎゃあぁああああ……！」	PRINTFORMW 「みぎゃあぁああああ……！」
PRINTFORML 「はい、一丁あがりってね♪」	PRINTFORML 「はい、一丁あがりってね♪」
PRINTFORML 「光の屈折ならお任せあれ！」	PRINTFORML 「光の屈折ならお任せあれ！」
PRINTFORML 「さあさっそく行くわよー！」	PRINTFORML 「さあさっそく行くわよー！」
PRINTFORML 「や、やった！着替えだわ！」	PRINTFORML 「や、やった！着替えだわ！」
PRINTFORML 「はぁぁぁ…生き返るわー…」	PRINTFORML 「はぁぁぁ…生き返るわー…」
PRINTFORML 「まるでここはビックリ箱ね」	PRINTFORML 「まるでここはビックリ箱ね」
PRINTFORML 「ちょっと汚れちゃったわね」	PRINTFORML 「ちょっと汚れちゃったわね」
PRINTFORML 「もう嫌！だれか助けて！」	PRINTFORML 「もう嫌！だれか助けて！」
PRINTFORML 「こんな格好じゃまた……」	PRINTFORML 「こんな格好じゃまた……」
PRINTFORML 「とにかく逃げるのよー！」	PRINTFORML 「とにかく逃げるのよー！」
PRINTFORML 「ちーかーよーんーなー！」	PRINTFORML 「ちーかーよーんーなー！」
PRINTFORML 「寄るんじゃないわよ！？」	PRINTFORML 「寄るんじゃないわよ！？」
PRINTFORML 「いい加減にしてよお……」	PRINTFORML 「いい加減にしてよお……」
PRINTFORML 「よらないでってばあ……」	PRINTFORML 「よらないでってばあ……」
PRINTFORML 「全員あっちいってよお！」	PRINTFORML 「全員あっちいってよお！」
PRINTFORML 「これ以上やらせないわ！」	PRINTFORML 「これ以上やらせないわ！」
PRINTFORML 「出せー！出せってばー！」	PRINTFORML 「出せー！出せってばー！」
PRINTFORML 「離して！お願いだから！」	PRINTFORML 「離して！お願いだから！」
PRINTFORML 「次で…次でにげなくちゃ」	PRINTFORML 「次で…次でにげなくちゃ」
PRINTFORML 「もう怖いのやだよぉ……」	PRINTFORML 「もう怖いのやだよぉ……」
PRINTFORML 「こんなとこ触んないで！」	PRINTFORML 「こんなとこ触んないで！」
PRINTFORML 「もう………ゆるして……」	PRINTFORML 「もう………ゆるして……」
PRINTFORML 「気持ちいいのやだぁ……」	PRINTFORML 「気持ちいいのやだぁ……」
PRINTFORML 「やだやだやだ！汚いっ！」	PRINTFORML 「やだやだやだ！汚いっ！」
PRINTFORML 「ぁぁぁ…いた………い…」	PRINTFORML 「ぁぁぁ…いた………い…」
PRINTFORML 「よかった…目が覚めて…」	PRINTFORML 「よかった…目が覚めて…」
PRINTFORML 「……もう…おしまい…ね」	PRINTFORML 「……もう…おしまい…ね」
PRINTFORML 「よかった、逃げ切れて…」	PRINTFORML 「よかった、逃げ切れて…」
PRINTFORML （敵！？…じゃなさそうね）	PRINTFORML （敵！？…じゃなさそうね）
PRINTFORML 「んー？なにかしらコレ？」	PRINTFORML 「んー？なにかしらコレ？」
PRINTFORML 「妖精、諦めも肝心よね…」	PRINTFORML 「妖精、諦めも肝心よね…」
PRINTFORML 「そーっとよそーっと……」	PRINTFORML 「そーっとよそーっと……」
PRINTFORML 「ひっ！？そ、そこだけは」	PRINTFORML 「ひっ！？そ、そこだけは」
PRINTFORML 「そこだけはご勘弁をー！」	PRINTFORML 「そこだけはご勘弁をー！」
PRINTFORML 「そろそろ帰れないかなあ」	PRINTFORML 「そろそろ帰れないかなあ」
PRINTFORML 「寝なくちゃ逆に危ないわ」	PRINTFORML 「寝なくちゃ逆に危ないわ」
PRINTFORML 「赤ちゃん…いらない……」	PRINTFORML 「赤ちゃん…いらない……」
PRINTFORML （そろそろ着替えたいわね）	PRINTFORML （そろそろ着替えたいわね）
PRINTFORML 「とにかく前進あるのみね」	PRINTFORML 「とにかく前進あるのみね」
PRINTFORML 「まさかアリスさんが！？」	PRINTFORML 「まさかアリスさんが！？」
PRINTFORML 「げほっ…う、ううーん…」	PRINTFORML 「げほっ…う、ううーん…」
PRINTFORML 「ふぇ……ふぇあぁ……？」	PRINTFORML 「ふぇ……ふぇあぁ……？」
PRINTFORML 「いっけー！最大出力ー！」	PRINTFORML 「いっけー！最大出力ー！」
PRINTFORML (それも悪くはないけど…)	PRINTFORML (それも悪くはないけど…)
PRINTFORML 「このまま一回休みかあ……	PRINTFORML 「このまま一回休みかあ……
PRINTFORML 「いたたた、もう乱暴ね！」	PRINTFORML 「いたたた、もう乱暴ね！」
PRINTFORML 「だれがだずげでぇぇ！？」	PRINTFORML 「だれがだずげでぇぇ！？」
PRINTFORML 「ナカはダメなのにーー！」	PRINTFORML 「ナカはダメなのにーー！」
PRINTFORML 「一体なにするつもりよ！」	PRINTFORML 「一体なにするつもりよ！」
PRINTFORML 「…いた………い…やめ…」	PRINTFORML 「…いた………い…やめ…」
PRINTFORML 「……助からない…のかな」	PRINTFORML 「……助からない…のかな」
PRINTFORML 「着替えはどこなのよー！」	PRINTFORML 「着替えはどこなのよー！」
PRINTFORML 「ひええええ…酷い状況ね」	PRINTFORML 「ひええええ…酷い状況ね」
PRINTFORMDW 「そもそもどこよここ…」	PRINTFORMDW 「そもそもどこよここ…」
PRINTFORMW 「スター？いないのーー？」	PRINTFORMW 「スター？いないのーー？」
PRINTFORMW 「なんかピンチじゃない？」	PRINTFORMW 「なんかピンチじゃない？」
PRINTFORML 「んむっ……ん…んん…」	PRINTFORML 「んむっ……ん…んん…」
PRINTFORML 「おうち…かえして……」	PRINTFORML 「おうち…かえして……」
PRINTFORML 「一回休みヤダ！ヤダ！」	PRINTFORML 「一回休みヤダ！ヤダ！」
PRINTFORML 「もう怖いのはやだぁ！」	PRINTFORML 「もう怖いのはやだぁ！」
PRINTFORML 「ズガガガガガガガガ♪」	PRINTFORML 「ズガガガガガガガガ♪」
PRINTFORML 「私に近づくなーー！！」	PRINTFORML 「私に近づくなーー！！」
PRINTFORML 「全員まとめて一掃よ！」	PRINTFORML 「全員まとめて一掃よ！」
PRINTFORML (これで決めないと…！)	PRINTFORML (これで決めないと…！)
PRINTFORML 「全力でぶつければ…！」	PRINTFORML 「全力でぶつければ…！」
PRINTFORML 「お願いだから倒れて！」	PRINTFORML 「お願いだから倒れて！」
PRINTFORML 「いい加減はなして…！」	PRINTFORML 「いい加減はなして…！」
PRINTFORML 「………ぁぁ…ぁあぁ…」	PRINTFORML 「………ぁぁ…ぁあぁ…」
PRINTFORML 「ま、まだかすり傷よ！」	PRINTFORML 「ま、まだかすり傷よ！」
PRINTFORML 「ひっく……えっく……」	PRINTFORML 「ひっく……えっく……」
PRINTFORML 「うそ…うそでしょ…？」	PRINTFORML 「うそ…うそでしょ…？」
PRINTFORML 「きゃああ！裸でなんて」	PRINTFORML 「きゃああ！裸でなんて」
PRINTFORML 「もう……しらない……」	PRINTFORML 「もう……しらない……」
PRINTFORML 「身動きすら取れない…」	PRINTFORML 「身動きすら取れない…」
PRINTFORML 「はぁ、早く帰りたいわ」	PRINTFORML 「はぁ、早く帰りたいわ」
PRINTFORML 「きゃー！お酒よお酒！」	PRINTFORML 「きゃー！お酒よお酒！」
PRINTFORML 「やった！道具みっけ！」	PRINTFORML 「やった！道具みっけ！」
PRINTFORML 「……お腹の中で動いた」	PRINTFORML 「……お腹の中で動いた」
PRINTFORML (抜き足差し足っと……)	PRINTFORML (抜き足差し足っと……)
PRINTFORML 「ダメ、目の前が霞む…」	PRINTFORML 「ダメ、目の前が霞む…」
PRINTFORML 「早く着替えなくっちゃ」	PRINTFORML 「早く着替えなくっちゃ」
PRINTFORML 「いやあ！見ないでえ！」	PRINTFORML 「いやあ！見ないでえ！」
PRINTFORML 「うう、あぶなかった…」	PRINTFORML 「うう、あぶなかった…」
PRINTFORML 「あ…あれ？ここどこ？」	PRINTFORML 「あ…あれ？ここどこ？」
PRINTFORML 「次は我が身ね…はぁ…」	PRINTFORML 「次は我が身ね…はぁ…」
PRINTFORML 「痛い……むにゃむにゃ」	PRINTFORML 「痛い……むにゃむにゃ」
PRINTFORML 「…ぁぁん……えっちぃ」	PRINTFORML 「…ぁぁん……えっちぃ」
PRINTFORML 「こっちみんなエッチ！」	PRINTFORML 「こっちみんなエッチ！」
PRINTFORML 「あはは！踊れ踊れー！」	PRINTFORML 「あはは！踊れ踊れー！」
PRINTFORML 「これきっもちいいー♪」	PRINTFORML 「これきっもちいいー♪」
PRINTFORML 「これきもっちいいー♪」	PRINTFORML 「これきもっちいいー♪」
PRINTFORML 「いい加減許してよお！」	PRINTFORML 「いい加減許してよお！」
PRINTFORML 「………ナカ…やだぁ…」	PRINTFORML 「………ナカ…やだぁ…」
PRINTFORML 「ロリコン！ロリコン！」	PRINTFORML 「ロリコン！ロリコン！」
PRINTFORML 「ぎゃぁ……ぁぁぁ……」	PRINTFORML 「ぎゃぁ……ぁぁぁ……」
PRINTFORML 「ぅぅぅ、恥ずかしい…」	PRINTFORML 「ぅぅぅ、恥ずかしい…」
PRINTFORML 「これが妖精の底力よ！」	PRINTFORML 「これが妖精の底力よ！」
PRINTFORML （わわわ！誰かいる！？）	PRINTFORML （わわわ！誰かいる！？）
PRINTFORML 「！？…って気のせいね」	PRINTFORML 「！？…って気のせいね」
PRINTFORML 「一体なんなのよもうー」	PRINTFORML 「一体なんなのよもうー」
PRINTFORML 「？…なんだ気のせいか」	PRINTFORML 「？…なんだ気のせいか」
PRINTFORML 「んー！おーいしーい♪」	PRINTFORML 「んー！おーいしーい♪」
PRINTFORML 「ってあれ？みんなは？」	PRINTFORML 「ってあれ？みんなは？」
PRINTFORML 「……なにがあったの…」	PRINTFORML 「……なにがあったの…」
PRINTFORMW 「出口、探さなくちゃ！」	PRINTFORMW 「出口、探さなくちゃ！」
PRINTFORMW 『あ、お母さんおはよう』	PRINTFORMW 『あ、お母さんおはよう』
PRINTFORML 処女喪失には愛を込めて	PRINTFORML 処女喪失には愛を込めて
PRINTFORML 「ナカ……やだぁ……」	PRINTFORML 「ナカ……やだぁ……」
PRINTFORML 「これ…･･･以上…」	PRINTFORML 「これ…･･･以上…」
PRINTFORML 「ど、道具を使えば！」	PRINTFORML 「ど、道具を使えば！」
PRINTFORML 「もう…諦めてよ……」	PRINTFORML 「もう…諦めてよ……」
PRINTFORML 「とにかくあてるわ！」	PRINTFORML 「とにかくあてるわ！」
PRINTFORML 「これで倒れてよー！」	PRINTFORML 「これで倒れてよー！」
PRINTFORML 「それそれそこだー！」	PRINTFORML 「それそれそこだー！」
PRINTFORML 「はーなーしーてー！」	PRINTFORML 「はーなーしーてー！」
PRINTFORML 「ごめん…なさい……」	PRINTFORML 「ごめん…なさい……」
PRINTFORML 「ひゃっ！うそっ！？」	PRINTFORML 「ひゃっ！うそっ！？」
PRINTFORML 「ひ、ひぃぃいぃ！？」	PRINTFORML 「ひ、ひぃぃいぃ！？」
PRINTFORML 「ぁぁ……ぁぁぁ……」	PRINTFORML 「ぁぁ……ぁぁぁ……」
PRINTFORML 「ぐすっ…ひっく……」	PRINTFORML 「ぐすっ…ひっく……」
PRINTFORML 「あ、あぶなかった…」	PRINTFORML 「あ、あぶなかった…」
PRINTFORML 「もうやめてってば！」	PRINTFORML 「もうやめてってば！」
PRINTFORML 「は、離せってばー！」	PRINTFORML 「は、離せってばー！」
PRINTFORML 「はぁっ…はぁっ……」	PRINTFORML 「はぁっ…はぁっ……」
PRINTFORML 「ひっ？誰かいるの？」	PRINTFORML 「ひっ？誰かいるの？」
PRINTFORML （な、何がいるの！？）	PRINTFORML （な、何がいるの！？）
PRINTFORML 「うーん、ぶかぶか…」	PRINTFORML 「うーん、ぶかぶか…」
PRINTFORML 「これはありがたいわ」	PRINTFORML 「これはありがたいわ」
PRINTFORML (早く外に出たい……)	PRINTFORML (早く外に出たい……)
PRINTFORML 「あ、危なかったー…」	PRINTFORML 「あ、危なかったー…」
PRINTFORML 「さっぱりするわー！」	PRINTFORML 「さっぱりするわー！」
PRINTFORMW (一回休み…だよね？)	PRINTFORMW (一回休み…だよね？)
PRINTFORML 「きゃっ！？敵襲！？」	PRINTFORML 「きゃっ！？敵襲！？」
PRINTFORML 「あたると痛いわよ？」	PRINTFORML 「あたると痛いわよ？」
PRINTFORML 「こらー！暴力反対！」	PRINTFORML 「こらー！暴力反対！」
PRINTFORML 「もう好きにして……」	PRINTFORML 「もう好きにして……」
PRINTFORML 「こっちむくな変態！」	PRINTFORML 「こっちむくな変態！」
PRINTFORML 「ケチー！心が狭い！」	PRINTFORML 「ケチー！心が狭い！」
PRINTFORML 「……むにゃむにゃ」	PRINTFORML 「……むにゃむにゃ」
PRINTFORML 「ダメッ！ダメッ！」	PRINTFORML 「ダメッ！ダメッ！」
PRINTFORML 「こないでーー！！」	PRINTFORML 「こないでーー！！」
PRINTFORML 「もう…やめて……」	PRINTFORML 「もう…やめて……」
PRINTFORML 「ゆるじでえええ！」	PRINTFORML 「ゆるじでえええ！」
PRINTFORML 「や、やめれよぉお」	PRINTFORML 「や、やめれよぉお」
PRINTFORMW 「誰か…助けて……」	PRINTFORMW 「誰か…助けて……」
PRINTFORML 「ナカはダメーー！」	PRINTFORML 「ナカはダメーー！」
PRINTFORML 「かけあしかけあし」	PRINTFORML 「かけあしかけあし」
PRINTFORML 「失礼しまーす……」	PRINTFORML 「失礼しまーす……」
PRINTFORML 「何かないかしら？」	PRINTFORML 「何かないかしら？」
PRINTFORML 「今のうちに……！」	PRINTFORML 「今のうちに……！」
PRINTFORML 「そろそろ寝たい…」	PRINTFORML 「そろそろ寝たい…」
PRINTFORML 「嫌な予感がする…」	PRINTFORML 「嫌な予感がする…」
PRINTFORML 「？…ぐー…ぐー…」	PRINTFORML 「？…ぐー…ぐー…」
PRINTFORML 「んむっ……ん～？」	PRINTFORML 「んむっ……ん～？」
PRINTFORML 「あああぁぁあ……」	PRINTFORML 「あああぁぁあ……」
PRINTFORML 「い、今はダメー！」	PRINTFORML 「い、今はダメー！」
PRINTFORML 「光よっ！それっ！」	PRINTFORML 「光よっ！それっ！」
PRINTFORML 「まいた…のよね？」	PRINTFORML 「まいた…のよね？」
PRINTFORML 「ん？誰かいるの？」	PRINTFORML 「ん？誰かいるの？」
PRINTFORML （敵かな？人かな？）	PRINTFORML （敵かな？人かな？）
PRINTFORML 「わ！かわいいー！」	PRINTFORML 「わ！かわいいー！」
PRINTFORML 「…え？なにこれ？」	PRINTFORML 「…え？なにこれ？」
PRINTFORML (横になりたなぁ…)	PRINTFORML (横になりたなぁ…)
PRINTFORML 「それそれ進めー♪」	PRINTFORML 「それそれ進めー♪」
PRINTFORML 「あら？どこココ？」	PRINTFORML 「あら？どこココ？」
PRINTFORML 		以下特殊な仕様	PRINTFORML 		以下特殊な仕様
PRINTFORML 「死んじゃう……」	PRINTFORML 「死んじゃう……」
PRINTFORML 「んんんーーーッ」	PRINTFORML 「んんんーーーッ」
PRINTFORML 「むにゃんっ……」	PRINTFORML 「むにゃんっ……」
PRINTFORML 「やあぁぁぁあ！」	PRINTFORML 「やあぁぁぁあ！」
PRINTFORML 「もうやだあー！」	PRINTFORML 「もうやだあー！」
PRINTFORML 「倒れてってば！」	PRINTFORML 「倒れてってば！」
PRINTFORML (出力最大なら…)	PRINTFORML (出力最大なら…)
PRINTFORML 「サニーパンチ！」	PRINTFORML 「サニーパンチ！」
PRINTFORML 「う、動けない！」	PRINTFORML 「う、動けない！」
PRINTFORML 「やめ……て……」	PRINTFORML 「やめ……て……」
PRINTFORML 「いったーーい！」	PRINTFORML 「いったーーい！」
PRINTFORML 「もうやめてよ！」	PRINTFORML 「もうやめてよ！」
PRINTFORML 「痛ーーーいッ！」	PRINTFORML 「痛ーーーいッ！」
PRINTFORML 「もうこないで！」	PRINTFORML 「もうこないで！」
PRINTFORML (外れてくれた…)	PRINTFORML (外れてくれた…)
PRINTFORML 「誰か助けて……」	PRINTFORML 「誰か助けて……」
PRINTFORML 「別行動なの…？」	PRINTFORML 「別行動なの…？」
PRINTFORML 「お、何か発見！」	PRINTFORML 「お、何か発見！」
PRINTFORML 「あー…あぁー…」	PRINTFORML 「あー…あぁー…」
PRINTFORML 「……吐き…そう」	PRINTFORML 「……吐き…そう」
PRINTFORMW (気が…遠く……)	PRINTFORMW (気が…遠く……)
PRINTFORMW 「怖い…よお……」	PRINTFORMW 「怖い…よお……」
PRINTFORMW (夢なら覚めて…)	PRINTFORMW (夢なら覚めて…)
PRINTFORML 「……ぅぅ…ぅぁ」	PRINTFORML 「……ぅぅ…ぅぁ」
PRINTFORML 「もうやだよお…」	PRINTFORML 「もうやだよお…」
PRINTFORML 「はぁ…はぁ……」	PRINTFORML 「はぁ…はぁ……」
PRINTFORML 「ん？気のせい？」	PRINTFORML 「ん？気のせい？」
PRINTFORML 「ひゃあああ！？」	PRINTFORML 「ひゃあああ！？」
PRINTFORML 「おたすけー！！」	PRINTFORML 「おたすけー！！」
PRINTFORML 「今よっ！退散！」	PRINTFORML 「今よっ！退散！」
PRINTFORML 「もう諦めてよお」	PRINTFORML 「もう諦めてよお」
PRINTFORML 「もう諦めてよー」	PRINTFORML 「もう諦めてよー」
PRINTFORML 「それっそれっ♪」	PRINTFORML 「それっそれっ♪」
PRINTFORML 「はーなーせー！」	PRINTFORML 「はーなーせー！」
PRINTFORML 「やめてエッチ！」	PRINTFORML 「やめてエッチ！」
PRINTFORML 「残念でしたー♪」	PRINTFORML 「残念でしたー♪」
PRINTFORML 「ぁぐっ…………」	PRINTFORML 「ぁぐっ…………」
PRINTFORML 「や…くるし……」	PRINTFORML 「や…くるし……」
PRINTFORML 「…助かったの？」	PRINTFORML 「…助かったの？」
PRINTFORML 「ベッドどこー？」	PRINTFORML 「ベッドどこー？」
PRINTFORML (うう、苦しい…)	PRINTFORML (うう、苦しい…)
PRINTFORML 「わ！？何事！？」	PRINTFORML 「わ！？何事！？」
PRINTFORML 「おお怖い怖い…」	PRINTFORML 「おお怖い怖い…」
PRINTFORMW だが物足りない。	PRINTFORMW だが物足りない。
PRINTFORML 「…ぁぁん……」	PRINTFORML 「…ぁぁん……」
PRINTFORML 「もうやだー！」	PRINTFORML 「もうやだー！」
PRINTFORML 「あいたたた…」	PRINTFORML 「あいたたた…」
PRINTFORML 「ひひゃあぁあ」	PRINTFORML 「ひひゃあぁあ」
PRINTFORMW 「やだ！やだ！」	PRINTFORMW 「やだ！やだ！」
PRINTFORML 「恥ずかしい…」	PRINTFORML 「恥ずかしい…」
PRINTFORML 「あははっ……」	PRINTFORML 「あははっ……」
PRINTFORML 「のりこめー！」	PRINTFORML 「のりこめー！」
PRINTFORMW 「ひっ……！？」	PRINTFORMW 「ひっ……！？」
PRINTFORML 「ひ、ひぃぃ！」	PRINTFORML 「ひ、ひぃぃ！」
PRINTFORML 「………………」	PRINTFORML 「………………」
PRINTFORML 「ん…おいしい」	PRINTFORML 「ん…おいしい」
PRINTFORML 「みんな無事？」	PRINTFORML 「みんな無事？」
PRINTFORML 「こんのぉー！」	PRINTFORML 「こんのぉー！」
PRINTFORML 「うぎゃっ！？」	PRINTFORML 「うぎゃっ！？」
PRINTFORML 「絡まるぅ！？」	PRINTFORML 「絡まるぅ！？」
PRINTFORML 「帰りたいなあ」	PRINTFORML 「帰りたいなあ」
PRINTFORMW 「そうだっけ？」	PRINTFORMW 「そうだっけ？」
PRINTFORML 「もうイヤ…」	PRINTFORML 「もうイヤ…」
PRINTFORML 「……っぅぅ」	PRINTFORML 「……っぅぅ」
PRINTFORML 「ふぁぁ……」	PRINTFORML 「ふぁぁ……」
PRINTFORML 「てやーー！」	PRINTFORML 「てやーー！」
PRINTFORML 「いたたた…」	PRINTFORML 「いたたた…」
PRINTFORML 「きゃっ！？」	PRINTFORML 「きゃっ！？」
PRINTFORML 「もう………」	PRINTFORML 「もう………」
PRINTFORML 「え…え…？」	PRINTFORML 「え…え…？」
PRINTFORML 「……あはは」	PRINTFORML 「……あはは」
PRINTFORML 「ひぃっ！？」	PRINTFORML 「ひぃっ！？」
PRINTFORML 「帰りたい…」	PRINTFORML 「帰りたい…」
PRINTFORML 「苦しい……」	PRINTFORML 「苦しい……」
PRINTFORML 「もうだめ…」	PRINTFORML 「もうだめ…」
PRINTFORML 「……怖い…」	PRINTFORML 「……怖い…」
PRINTFORML 「……きゅう」	PRINTFORML 「……きゅう」
PRINTFORML 「うええ……」	PRINTFORML 「うええ……」
PRINTFORML 「はなせー！」	PRINTFORML 「はなせー！」
PRINTFORML 「たのもー！」	PRINTFORML 「たのもー！」
PRINTFORMW 「ルナーー？」	PRINTFORMW 「ルナーー？」
PRINTFORML 「やんっ…」	PRINTFORML 「やんっ…」
PRINTFORML 「んっ……」	PRINTFORML 「んっ……」
PRINTFORML 「……あっ」	PRINTFORML 「……あっ」
PRINTFORML 「うくっ…」	PRINTFORML 「うくっ…」
PRINTFORML 「！？！？」	PRINTFORML 「！？！？」
PRINTFORML 「……痛い」	PRINTFORML 「……痛い」
PRINTFORML 「あ…ッ…」	PRINTFORML 「あ…ッ…」
PRINTFORML 「ぎゃっ！」	PRINTFORML 「ぎゃっ！」
PRINTFORML 「痛いっ！」	PRINTFORML 「痛いっ！」
PRINTFORML 「ひっ！？」	PRINTFORML 「ひっ！？」
PRINTFORML 「ふぇ……」	PRINTFORML 「ふぇ……」
PRINTFORML 「……バカ」	PRINTFORML 「……バカ」
PRINTFORML 「突入ー！」	PRINTFORML 「突入ー！」
PRINTFORMW 「違うわよ」	PRINTFORMW 「違うわよ」
PRINTFORMW 神隠し異変	PRINTFORMW 神隠し異変
PRINTFORML 「え……」	PRINTFORML 「え……」
PRINTFORML 「え…？」	PRINTFORML 「え…？」
PRINTFORML 「………」	PRINTFORML 「………」
PRINTFORML 「はあ…」	PRINTFORML 「はあ…」
PRINTFORMW 「…え？」	PRINTFORMW 「…え？」
PRINTFORML 「！？」	PRINTFORML 「！？」
PRINTFORMW 「！？」	PRINTFORMW 「！？」
PRINTFORMDW ………	PRINTFORMDW ………
PRINTFORMDL …？	PRINTFORMDL …？
PRINTFORML 「？」	PRINTFORML 「？」
PRINTFORMDW ……	PRINTFORMDW ……
PRINTFORMDW …	PRINTFORMDW …
PRINTFORMDL 	PRINTFORMDL 
﻿PRINTFORML 	PRINTFORML 
