//口上:

PRINTFORMDL しかし、スターの細い手足ではぬめった肉壁の激しい動きに翻弄されるだけでむしろ奥へ奥へと押し込まれているように感じた	PRINTFORMDL しかし、スターの細い手足ではぬめった肉壁の激しい動きに翻弄されるだけでむしろ奥へ奥へと押し込まれているように感じた
PRINTFORMDL スターはしばらくの間苦しそうに身悶えたが、そのささやかな抵抗すらも触手に押さえつけられてしまう…	PRINTFORMDL スターはしばらくの間苦しそうに身悶えたが、そのささやかな抵抗すらも触手に押さえつけられてしまう…
PRINTFORMDL 普段は見せないような必死な様子で暴れていたものの、次第に諦めたのか大人しく陵辱を受け入れ始めた	PRINTFORMDL 普段は見せないような必死な様子で暴れていたものの、次第に諦めたのか大人しく陵辱を受け入れ始めた
PRINTFORMDW 獲物が完全に逃げられない、助けるものがいないと気づいた触手がスターを捕食しようと一斉に迫る	PRINTFORMDW 獲物が完全に逃げられない、助けるものがいないと気づいた触手がスターを捕食しようと一斉に迫る
PRINTFORMDL スターはすぐに見捨てられたことに気づきくぐもった抗議の声を上げるがどうすることもできない…	PRINTFORMDL スターはすぐに見捨てられたことに気づきくぐもった抗議の声を上げるがどうすることもできない…
PRINTFORMDL 肉壁で蠢いていた何本もの触手がスターを完全に捕食しようと全身にまとわりつきはじめた……！	PRINTFORMDL 肉壁で蠢いていた何本もの触手がスターを完全に捕食しようと全身にまとわりつきはじめた……！
PRINTFORMDL 呑み込まれているスターの救出を諦めた%CALLNAME:1%はこの場を離れることにした…	PRINTFORMDL 呑み込まれているスターの救出を諦めた%CALLNAME:1%はこの場を離れることにした…
PRINTFORML 仲間が妊娠すると気配を感じる能力であっさりと妊娠していることを教えてくれるすごい奴だよ！	PRINTFORML 仲間が妊娠すると気配を感じる能力であっさりと妊娠していることを教えてくれるすごい奴だよ！
PRINTFORML 「ふふっ、この戦いが終わったら妖夢さんに弟子入りして真面目に武器の練習してみようかしら」	PRINTFORML 「ふふっ、この戦いが終わったら妖夢さんに弟子入りして真面目に武器の練習してみようかしら」
PRINTFORMDL 青ざめた顔はすぐさま恐怖と苦痛で歪み手足をメチャクチャに振り回して必死に痛みに抵抗する	PRINTFORMDL 青ざめた顔はすぐさま恐怖と苦痛で歪み手足をメチャクチャに振り回して必死に痛みに抵抗する
PRINTFORMDL スターはどんな夢を見ているのか、きつく拳を握り、時々下唇を噛んで苦しげにしている……	PRINTFORMDL スターはどんな夢を見ているのか、きつく拳を握り、時々下唇を噛んで苦しげにしている……
PRINTFORMDW スターの哀願などもちろん聞き入られるわけもなく、部屋にスターの悲鳴が響き渡った……	PRINTFORMDW スターの哀願などもちろん聞き入られるわけもなく、部屋にスターの悲鳴が響き渡った……
PRINTFORMDL 人形のようになすがままの彼女の体を触手が貪るたびに苦しそうな小さな嬌声が漏れる	PRINTFORMDL 人形のようになすがままの彼女の体を触手が貪るたびに苦しそうな小さな嬌声が漏れる
PRINTFORML 「あなたまでお腹真っ黒になっちゃうけどいいの？話を聞いてー！はーなーしーてー！」	PRINTFORML 「あなたまでお腹真っ黒になっちゃうけどいいの？話を聞いてー！はーなーしーてー！」
PRINTFORMDW スターは痛みよりも自身を貫かれる初めての感覚に恐怖と驚きと戸惑いの声を漏らした	PRINTFORMDW スターは痛みよりも自身を貫かれる初めての感覚に恐怖と驚きと戸惑いの声を漏らした
PRINTFORMDL スターは時々逃げ出そうと身をよじるが結局は無駄そうなのですぐに諦めてしまった	PRINTFORMDL スターは時々逃げ出そうと身をよじるが結局は無駄そうなのですぐに諦めてしまった
PRINTFORMDL 見捨てられたととっさに悟ったスターはなんとか自力で這い出そうと必死にもがいた	PRINTFORMDL 見捨てられたととっさに悟ったスターはなんとか自力で這い出そうと必死にもがいた
PRINTFORML 「ここにいる化物は人形に……しないってことは分かったから睨まないでください…」	PRINTFORML 「ここにいる化物は人形に……しないってことは分かったから睨まないでください…」
PRINTFORMDL スターはビクビクしながらいやいやと頭を大きく振っている、が目を醒まさない。	PRINTFORMDL スターはビクビクしながらいやいやと頭を大きく振っている、が目を醒まさない。
PRINTFORML 「こういう武器って面白いわね。この戦いが終わったら記念に持って帰ろうかしら」	PRINTFORML 「こういう武器って面白いわね。この戦いが終わったら記念に持って帰ろうかしら」
PRINTFORML 「家族計画はちゃんと立てないといけないのよ？…私の話をきいてー！ぎゃーー！」	PRINTFORML 「家族計画はちゃんと立てないといけないのよ？…私の話をきいてー！ぎゃーー！」
PRINTFORMDW スターがもがけばもがくほど肉壁と服とが擦れ、そこから服がドロリと溶ける……	PRINTFORMDW スターがもがけばもがくほど肉壁と服とが擦れ、そこから服がドロリと溶ける……
PRINTFORMDW スターの瞳の光が消え次第に失われていき、やがてピクリとも動かなくなった……	PRINTFORMDW スターの瞳の光が消え次第に失われていき、やがてピクリとも動かなくなった……
PRINTFORML 「もっとボンキュッボンな人に挿入れたほうが絶対に楽しいから、だから、ね？」	PRINTFORML 「もっとボンキュッボンな人に挿入れたほうが絶対に楽しいから、だから、ね？」
PRINTFORML 「あのー%CALLNAME:(ARG:2)%さん。妊娠してるみたいですよ」	PRINTFORML 「あのー%CALLNAME:(ARG:2)%さん。妊娠してるみたいですよ」
PRINTFORML 「ほ、ほら！こんなにしっかり身を守ってる私なんて狙っても疲れるだけよ？」	PRINTFORML 「ほ、ほら！こんなにしっかり身を守ってる私なんて狙っても疲れるだけよ？」
PRINTFORML 「あら？%CALLNAME:(ARG:2)%、妊娠しちゃってるみたいよ」	PRINTFORML 「あら？%CALLNAME:(ARG:2)%、妊娠しちゃってるみたいよ」
PRINTFORMDL 悲痛な声でスターは叫ぶも、無慈悲にも気配はどんどん遠くへと去っていく	PRINTFORMDL 悲痛な声でスターは叫ぶも、無慈悲にも気配はどんどん遠くへと去っていく
PRINTFORMDL スターは蠢く肉壁から這い出そうとつかめそうな場所を必死に探している	PRINTFORMDL スターは蠢く肉壁から這い出そうとつかめそうな場所を必死に探している
PRINTFORML 「ごめんなさーい、ちゃんと助けに行くからもうちょっとだけまっててね」	PRINTFORML 「ごめんなさーい、ちゃんと助けに行くからもうちょっとだけまっててね」
PRINTFORMDL そう判断した%CALLNAME:1%はスターを置いていくことにした	PRINTFORMDL そう判断した%CALLNAME:1%はスターを置いていくことにした
PRINTFORML 「ほら！こんな弾幕しか撃てない雑魚を相手にしてもつまんないわよ！」	PRINTFORML 「ほら！こんな弾幕しか撃てない雑魚を相手にしてもつまんないわよ！」
PRINTFORML 「サニーったらこんな場所でもぐっすり寝れるのね…目が死んでたけど」	PRINTFORML 「サニーったらこんな場所でもぐっすり寝れるのね…目が死んでたけど」
PRINTFORMDL そう思った%CALLNAME:1%はスターを連れて行くことにした	PRINTFORMDL そう思った%CALLNAME:1%はスターを連れて行くことにした
PRINTFORML 「なんで誰も助けてくれないの！？ほんとに一回休みになっちゃう！」	PRINTFORML 「なんで誰も助けてくれないの！？ほんとに一回休みになっちゃう！」
PRINTFORML 「責任とらせるわよ？…やめて！責任とってもダメなものはダメよ！」	PRINTFORML 「責任とらせるわよ？…やめて！責任とってもダメなものはダメよ！」
PRINTFORMDL スターは時々幸せそうな息を漏らしのんびりと入浴を楽しんでいる。	PRINTFORMDL スターは時々幸せそうな息を漏らしのんびりと入浴を楽しんでいる。
PRINTFORMDL スターは自分の股間目指して這い上がる触手を追い払おうと必死だ	PRINTFORMDL スターは自分の股間目指して這い上がる触手を追い払おうと必死だ
PRINTFORML 「悪いけれど赤ちゃんが欲しいならほかをあたって頂戴。ルナとか」	PRINTFORML 「悪いけれど赤ちゃんが欲しいならほかをあたって頂戴。ルナとか」
PRINTFORMDL サニーはニコニコとしているスターに訝しげな視線を投げかけた。	PRINTFORMDL サニーはニコニコとしているスターに訝しげな視線を投げかけた。
PRINTFORMDL ぐったりと力なく床に横たわるスターをこれ以上連れてはいけない	PRINTFORMDL ぐったりと力なく床に横たわるスターをこれ以上連れてはいけない
PRINTFORML (気持ちいいしもうこのまま食べられちゃってもいいかしら……)	PRINTFORML (気持ちいいしもうこのまま食べられちゃってもいいかしら……)
PRINTFORML (もし罠を見つけたら大変だけど何もしないわけにもいかないわ)	PRINTFORML (もし罠を見つけたら大変だけど何もしないわけにもいかないわ)
PRINTFORMDL どこかでどさくさに紛れてどこかへいってしまったのだろうか？	PRINTFORMDL どこかでどさくさに紛れてどこかへいってしまったのだろうか？
PRINTFORML 「ぁぁんっ……ふふっ…今日は危ない日なのよ……くぅくぅ…」	PRINTFORML 「ぁぁんっ……ふふっ…今日は危ない日なのよ……くぅくぅ…」
PRINTFORMDL スターは必死に押したり引っ張ったり逃げようと抵抗している	PRINTFORMDL スターは必死に押したり引っ張ったり逃げようと抵抗している
PRINTFORMW 「復活したら外でした、なんて都合のいい事はないわよねえ…」	PRINTFORMW 「復活したら外でした、なんて都合のいい事はないわよねえ…」
PRINTFORMDL スターはじたばたしながら必死に挿入されまいと抵抗している	PRINTFORMDL スターはじたばたしながら必死に挿入されまいと抵抗している
PRINTFORML 「できれば見逃してほしいなーって…ダメ？……ひゃあっ！？」	PRINTFORML 「できれば見逃してほしいなーって…ダメ？……ひゃあっ！？」
PRINTFORML 「うふふふ……折角だもの、めいいっぱい楽しまなくっちゃね」	PRINTFORML 「うふふふ……折角だもの、めいいっぱい楽しまなくっちゃね」
PRINTFORMDL 緩みきった表情のスターの瞳は明後日のほうをむいていた……	PRINTFORMDL 緩みきった表情のスターの瞳は明後日のほうをむいていた……
PRINTFORML (自分の能力がイヤだって思う日がくるとはおもわなかったわ)	PRINTFORML (自分の能力がイヤだって思う日がくるとはおもわなかったわ)
PRINTFORML 「ほ、ほらおっぱいとかおしりならもっと触ってもいいから！」	PRINTFORML 「ほ、ほらおっぱいとかおしりならもっと触ってもいいから！」
PRINTFORML 「私より犯し甲斐のある相手を選んだほうが…話を聞いてえ！」	PRINTFORML 「私より犯し甲斐のある相手を選んだほうが…話を聞いてえ！」
PRINTFORMDL スターは地面を這いずるようにして必死に逃げようとしている	PRINTFORMDL スターは地面を這いずるようにして必死に逃げようとしている
PRINTFORML 「けほっ…オシオキするなら……ルナかサニーに…くぅ……」	PRINTFORML 「けほっ…オシオキするなら……ルナかサニーに…くぅ……」
PRINTFORMDL 絡みついた触手を一本一本スターは丁寧に解こうとしている	PRINTFORMDL 絡みついた触手を一本一本スターは丁寧に解こうとしている
PRINTFORMDL スターは大慌てで前を隠そうと触手の絡んだ腕に力を入れた	PRINTFORMDL スターは大慌てで前を隠そうと触手の絡んだ腕に力を入れた
PRINTFORMDL スターは呆然と身体に絡み付いていく触手を見つめている…	PRINTFORMDL スターは呆然と身体に絡み付いていく触手を見つめている…
PRINTFORML 「もう、なんて乱暴なえーと……なんて生き物なのかしら？」	PRINTFORML 「もう、なんて乱暴なえーと……なんて生き物なのかしら？」
PRINTFORML 「もっとエッチな体をした人にこういうことはするべきよ？」	PRINTFORML 「もっとエッチな体をした人にこういうことはするべきよ？」
PRINTFORML 「いろんな気配が増えたり消えたり…なんだか疲れちゃうの」	PRINTFORML 「いろんな気配が増えたり消えたり…なんだか疲れちゃうの」
PRINTFORML 「確かに一人のほうが見つかり辛いですけど…わかりました」	PRINTFORML 「確かに一人のほうが見つかり辛いですけど…わかりました」
PRINTFORML 「外の世界では生まれたての子供を使った料理があるそうね」	PRINTFORML 「外の世界では生まれたての子供を使った料理があるそうね」
PRINTFORMDL スターは自身に近づく危機になど少しも気づく様子はない	PRINTFORMDL スターは自身に近づく危機になど少しも気づく様子はない
PRINTFORML 「私のぺったんこな身体なんて見たって楽しくないわよ？」	PRINTFORML 「私のぺったんこな身体なんて見たって楽しくないわよ？」
PRINTFORMDL 余裕のある口調とは違い顔は耳まで真っ赤に染まっている	PRINTFORMDL 余裕のある口調とは違い顔は耳まで真っ赤に染まっている
PRINTFORML (こんなサボってる場合じゃないのは分かってるけど……)	PRINTFORML (こんなサボってる場合じゃないのは分かってるけど……)
PRINTFORML 「誰かー！ここにロリコンさんがいますよー！お助けー！」	PRINTFORML 「誰かー！ここにロリコンさんがいますよー！お助けー！」
PRINTFORML 「お腹が破裂しちゃう！ダメっ！そんなにいっぱいっ……」	PRINTFORML 「お腹が破裂しちゃう！ダメっ！そんなにいっぱいっ……」
PRINTFORML 「赤ちゃん出来たのね…まだ小さい気配なのに…わかるの」	PRINTFORML 「赤ちゃん出来たのね…まだ小さい気配なのに…わかるの」
PRINTFORML (ここだと時々レーダー能力が役に立たないから怖いわ…)	PRINTFORML (ここだと時々レーダー能力が役に立たないから怖いわ…)
PRINTFORML 「私なんかよりもっと襲い甲斐のある人おいかけてー！」	PRINTFORML 「私なんかよりもっと襲い甲斐のある人おいかけてー！」
PRINTFORML 「これを使って何か楽しいイタズラができないかしら？」	PRINTFORML 「これを使って何か楽しいイタズラができないかしら？」
PRINTFORML 「こんな重いものを振り回さなくちゃいけないなんて…」	PRINTFORML 「こんな重いものを振り回さなくちゃいけないなんて…」
PRINTFORMDL スターはおしりを振って触手を振りほどこうとしている	PRINTFORMDL スターはおしりを振って触手を振りほどこうとしている
PRINTFORML 「もう、先っちょだけよ？なんていうわけないでしょ！」	PRINTFORML 「もう、先っちょだけよ？なんていうわけないでしょ！」
PRINTFORML 「私よりルナの方が捕まえやすいし美味しいってばー！」	PRINTFORML 「私よりルナの方が捕まえやすいし美味しいってばー！」
PRINTFORMDL 肉壁の向こうの気配がどんどん遠のいていくのを感じる	PRINTFORMDL 肉壁の向こうの気配がどんどん遠のいていくのを感じる
PRINTFORML (お腹痛い…外に出たいのはわかったから早くしてー…)	PRINTFORML (お腹痛い…外に出たいのはわかったから早くしてー…)
PRINTFORML 「んー？いつのまにか随分と体の調子もよくなったわね」	PRINTFORML 「んー？いつのまにか随分と体の調子もよくなったわね」
PRINTFORML 「ふふっ、のこのこきたところをえいっ！って寸法よ☆」	PRINTFORML 「ふふっ、のこのこきたところをえいっ！って寸法よ☆」
PRINTFORMDL そう言ってどこかへ行ったきりスターが帰ってこない…	PRINTFORMDL そう言ってどこかへ行ったきりスターが帰ってこない…
PRINTFORML 「もー！こんな格好で動き回るなんて信じられない！」	PRINTFORML 「もー！こんな格好で動き回るなんて信じられない！」
PRINTFORML 「攻撃もしないとダメなのは分かってはいるけど……」	PRINTFORML 「攻撃もしないとダメなのは分かってはいるけど……」
PRINTFORML (逃げれたらそれでよし、ダメならその時はその時ね)	PRINTFORML (逃げれたらそれでよし、ダメならその時はその時ね)
PRINTFORML 「こんな体型だしまだ赤ちゃんなんて作れないって！」	PRINTFORML 「こんな体型だしまだ赤ちゃんなんて作れないって！」
PRINTFORML 「うふふ…きたきたきたぁぁああぁーーーーーーっ！」	PRINTFORML 「うふふ…きたきたきたぁぁああぁーーーーーーっ！」
PRINTFORML 「ナカに注ぎ込まれてるって意外とわかるものねえ…」	PRINTFORML 「ナカに注ぎ込まれてるって意外とわかるものねえ…」
PRINTFORML 「ああん！これじゃあんまり服の意味ないじゃない！」	PRINTFORML 「ああん！これじゃあんまり服の意味ないじゃない！」
PRINTFORML 「逃げ回っていればいつかはなんとかなる…わよね？」	PRINTFORML 「逃げ回っていればいつかはなんとかなる…わよね？」
PRINTFORML 「ふふっ、音を消す能力は逃げ回るのには便利そうね」	PRINTFORML 「ふふっ、音を消す能力は逃げ回るのには便利そうね」
PRINTFORML 「レーダー全体に超巨大な気配があって変な感じなの」	PRINTFORML 「レーダー全体に超巨大な気配があって変な感じなの」
PRINTFORMDL 抵抗するスターの表情には全くいつもの余裕がない	PRINTFORMDL 抵抗するスターの表情には全くいつもの余裕がない
PRINTFORML 「はぁ…早く一回休みにしてくれたほうが楽だわ…」	PRINTFORML 「はぁ…早く一回休みにしてくれたほうが楽だわ…」
PRINTFORMDL 完全に抵抗を諦めたスターは特大のため息をついた	PRINTFORMDL 完全に抵抗を諦めたスターは特大のため息をついた
PRINTFORML 「もっと大きい人を狙ったほうが絶対楽しいってば」	PRINTFORML 「もっと大きい人を狙ったほうが絶対楽しいってば」
PRINTFORMDL スターは何度も絶叫しながら全身を跳ねさせている	PRINTFORMDL スターは何度も絶叫しながら全身を跳ねさせている
PRINTFORML 「あんまりエッチなとこばっかり触っちゃダメよ！」	PRINTFORML 「あんまりエッチなとこばっかり触っちゃダメよ！」
PRINTFORML 「おなかの中にいっぱい気配があって気持ち悪い…」	PRINTFORML 「おなかの中にいっぱい気配があって気持ち悪い…」
PRINTFORML 「もうっ！どうしてこうエッチな化物ばかりなの…」	PRINTFORML 「もうっ！どうしてこうエッチな化物ばかりなの…」
PRINTFORML 「え？楽しそうですって？全然そんなことないわ♪」	PRINTFORML 「え？楽しそうですって？全然そんなことないわ♪」
PRINTFORML 「この場所自体が一匹の大きな生き物だったりして」	PRINTFORML 「この場所自体が一匹の大きな生き物だったりして」
PRINTFORMDL 虚ろな瞳で横たわっているスターを放っておけない	PRINTFORMDL 虚ろな瞳で横たわっているスターを放っておけない
PRINTFORML 「……さすがの私でもそんな料理は作らないわよ？」	PRINTFORML 「……さすがの私でもそんな料理は作らないわよ？」
PRINTFORMDL 身体を必死に庇うスターは目に涙を浮かべている	PRINTFORMDL 身体を必死に庇うスターは目に涙を浮かべている
PRINTFORML 「ごめんなさい、ちょっと用事が出来ちゃった♪」	PRINTFORML 「ごめんなさい、ちょっと用事が出来ちゃった♪」
PRINTFORML 「私の全力を…と思ったけど疲れるしやーめた☆」	PRINTFORML 「私の全力を…と思ったけど疲れるしやーめた☆」
PRINTFORMDL スターは泣きじゃくりながら力なくもがいている	PRINTFORMDL スターは泣きじゃくりながら力なくもがいている
PRINTFORML (チャンスを見つけて…あんっ♪でも気持ちいい)	PRINTFORML (チャンスを見つけて…あんっ♪でも気持ちいい)
PRINTFORML 「もう降参、煮るなり焼くなり食べるなりどうぞ」	PRINTFORML 「もう降参、煮るなり焼くなり食べるなりどうぞ」
PRINTFORMDL スターは胸に迫る触手を一生懸命引っ張っている	PRINTFORMDL スターは胸に迫る触手を一生懸命引っ張っている
PRINTFORML 「この事後みたいな感じが興奮するんでしょう？」	PRINTFORML 「この事後みたいな感じが興奮するんでしょう？」
PRINTFORML 「私のレーダー能力は探索ではきっと役に立つわ」	PRINTFORML 「私のレーダー能力は探索ではきっと役に立つわ」
PRINTFORML （だって一番後ろならサボっても誰もみないもの）	PRINTFORML （だって一番後ろならサボっても誰もみないもの）
PRINTFORML 「二手に分かれたほうがいいんじゃないかしら？」	PRINTFORML 「二手に分かれたほうがいいんじゃないかしら？」
PRINTFORML 「こんなか弱い妖精を一人にするって言うの！？」	PRINTFORML 「こんなか弱い妖精を一人にするって言うの！？」
PRINTFORML 「髪の毛のお手入れができるのはありがたいわね」	PRINTFORML 「髪の毛のお手入れができるのはありがたいわね」
PRINTFORML 「うーん、しょうがないわ。代わりを探しましょ」	PRINTFORML 「うーん、しょうがないわ。代わりを探しましょ」
PRINTFORML 「降り注げ輝く星々！プチコメット！なんてね」	PRINTFORML 「降り注げ輝く星々！プチコメット！なんてね」
PRINTFORML (どこかでチャンスを見つけないと危ないわね)	PRINTFORML (どこかでチャンスを見つけないと危ないわね)
PRINTFORML 「もうっ、ちゃんとゴムつけてくれなくちゃ…」	PRINTFORML 「もうっ、ちゃんとゴムつけてくれなくちゃ…」
PRINTFORML 「イっちゃう！イっちゃうからぁああんっっ！」	PRINTFORML 「イっちゃう！イっちゃうからぁああんっっ！」
PRINTFORML 「は、裸！？やだっ…どうしたものかしら……」	PRINTFORML 「は、裸！？やだっ…どうしたものかしら……」
PRINTFORML 「一回休みになっちゃう！ねえ！ねえってば！」	PRINTFORML 「一回休みになっちゃう！ねえ！ねえってば！」
PRINTFORML 「アリスさんもさすがに疲れてるみたいですね」	PRINTFORML 「アリスさんもさすがに疲れてるみたいですね」
PRINTFORML (どんどん元気になってるのがわかっちゃう…)	PRINTFORML (どんどん元気になってるのがわかっちゃう…)
PRINTFORML 「赤ちゃんを産むのってこんなに痛いのね……」	PRINTFORML 「赤ちゃんを産むのってこんなに痛いのね……」
PRINTFORMDL スターは気合充分といった様子で身構えている	PRINTFORMDL スターは気合充分といった様子で身構えている
PRINTFORML 「もう！はいっちゃったらどうするつもりよ！」	PRINTFORML 「もう！はいっちゃったらどうするつもりよ！」
PRINTFORML 「ちょっと露骨に利用しすぎちゃったかしら？」	PRINTFORML 「ちょっと露骨に利用しすぎちゃったかしら？」
PRINTFORML 「むにゃむにゃ……おまわりさんこの人…よ」	PRINTFORML 「むにゃむにゃ……おまわりさんこの人…よ」
PRINTFORMDL 下半身を貫かれスターは眉間に皺を寄せた。	PRINTFORMDL 下半身を貫かれスターは眉間に皺を寄せた。
PRINTFORML 「目立つのはサニーに任せたいかなーって…」	PRINTFORML 「目立つのはサニーに任せたいかなーって…」
PRINTFORML 「わー！！やっぱり私は後ろがいいわ！！」」	PRINTFORML 「わー！！やっぱり私は後ろがいいわ！！」」
PRINTFORML 「波紋のように広がる星の煌きをごらんあれ」	PRINTFORML 「波紋のように広がる星の煌きをごらんあれ」
PRINTFORML 「うう…暴力は何も解決しないものなのよ？」	PRINTFORML 「うう…暴力は何も解決しないものなのよ？」
PRINTFORML 「もう……えっちなんだから……ふふっ……」	PRINTFORML 「もう……えっちなんだから……ふふっ……」
PRINTFORML 「……一回休みなの？食べられて嬲られて？」	PRINTFORML 「……一回休みなの？食べられて嬲られて？」
PRINTFORML 「こんな不思議な場所誰が作ったのかしら？」	PRINTFORML 「こんな不思議な場所誰が作ったのかしら？」
PRINTFORML (早くこの状況をなんとかしないとダメね…)	PRINTFORML (早くこの状況をなんとかしないとダメね…)
PRINTFORMW （私…気持ちよすぎて壊れちゃうのかしら？）	PRINTFORMW （私…気持ちよすぎて壊れちゃうのかしら？）
PRINTFORMW （どうでもいっか。気持ちいいんだもの……）	PRINTFORMW （どうでもいっか。気持ちいいんだもの……）
PRINTFORMDL スターは地面に座り込んで呆然としている…	PRINTFORMDL スターは地面に座り込んで呆然としている…
PRINTFORML 「今回の一回休みは随分と早く終わったわね」	PRINTFORML 「今回の一回休みは随分と早く終わったわね」
PRINTFORMDL スターは真剣な面持ちで身体を庇っている	PRINTFORMDL スターは真剣な面持ちで身体を庇っている
PRINTFORML 「スペルカードはどこにしまったかしら？」	PRINTFORML 「スペルカードはどこにしまったかしら？」
PRINTFORML 「綺麗でしょう？スターピースシャワー！」	PRINTFORML 「綺麗でしょう？スターピースシャワー！」
PRINTFORML (ん～…でもやっぱり一回休みはイヤだわ)	PRINTFORML (ん～…でもやっぱり一回休みはイヤだわ)
PRINTFORML 「そろそろ離してくれてもいいでしょう？」	PRINTFORML 「そろそろ離してくれてもいいでしょう？」
PRINTFORML 「絶対にそんな大きいのはいらないから！」	PRINTFORML 「絶対にそんな大きいのはいらないから！」
PRINTFORML 「気持ちよさそうだけど、遠慮しておくわ」	PRINTFORML 「気持ちよさそうだけど、遠慮しておくわ」
PRINTFORMDL やたらいい笑顔でスターは去っていった…	PRINTFORMDL やたらいい笑顔でスターは去っていった…
PRINTFORML 「お願い助けて！一人じゃ逃げれないわ！」	PRINTFORML 「お願い助けて！一人じゃ逃げれないわ！」
PRINTFORML 「一人じゃ逃げられないの！助けてよー！」	PRINTFORML 「一人じゃ逃げられないの！助けてよー！」
PRINTFORMDL スターは虚ろな目でお腹をさすっている…	PRINTFORMDL スターは虚ろな目でお腹をさすっている…
PRINTFORML 「うぅぅ…ストレス？風邪？体が重いわ…」	PRINTFORML 「うぅぅ…ストレス？風邪？体が重いわ…」
PRINTFORML 「あまり移動はしないほうがよさそうね…」	PRINTFORML 「あまり移動はしないほうがよさそうね…」
PRINTFORML (じっとしていられる状態じゃないのに…)	PRINTFORML (じっとしていられる状態じゃないのに…)
﻿PRINTFORML いつでもどこでも余裕のあるスターちゃん	PRINTFORML いつでもどこでも余裕のあるスターちゃん
PRINTFORML 「ごめんなさーーい！……くぅ……くぅ」	PRINTFORML 「ごめんなさーーい！……くぅ……くぅ」
PRINTFORML (だ、誰か盾にできそうなものや人は…)	PRINTFORML (だ、誰か盾にできそうなものや人は…)
PRINTFORML 「残念、逃げ足は3人の中で一番なのよ」	PRINTFORML 「残念、逃げ足は3人の中で一番なのよ」
PRINTFORML 「こういう力仕事は二人の役目なのに…」	PRINTFORML 「こういう力仕事は二人の役目なのに…」
PRINTFORML 「出して！出してって言ってるでしょ！」	PRINTFORML 「出して！出してって言ってるでしょ！」
PRINTFORML (離して欲しいような欲しくないような)	PRINTFORML (離して欲しいような欲しくないような)
PRINTFORMDL スターは必死に手足をばたつかせている	PRINTFORMDL スターは必死に手足をばたつかせている
PRINTFORMDL スターはぐったりと身を投げ出している	PRINTFORMDL スターはぐったりと身を投げ出している
PRINTFORML 「うふふ、挿入れたいの？まだダーメ♪」	PRINTFORML 「うふふ、挿入れたいの？まだダーメ♪」
PRINTFORML 「た、食べられちゃう！？ぎゃーーー！」	PRINTFORML 「た、食べられちゃう！？ぎゃーーー！」
PRINTFORML 「もっ…もっ……らめえぇぇええぇぇ！」	PRINTFORML 「もっ…もっ……らめえぇぇええぇぇ！」
PRINTFORML 「もうっ、私の体なんて触って楽しい？」	PRINTFORML 「もうっ、私の体なんて触って楽しい？」
PRINTFORML 「……はぁ、こうなる気はしてたのよね」	PRINTFORML 「……はぁ、こうなる気はしてたのよね」
PRINTFORML 「あーあ、早く帰って直さなくちゃ……」	PRINTFORML 「あーあ、早く帰って直さなくちゃ……」
PRINTFORML 「ふふふっ、逃げるのは得意中の得意よ」	PRINTFORML 「ふふふっ、逃げるのは得意中の得意よ」
PRINTFORML 「ルナったらすっかりやつれちゃって…」	PRINTFORML 「ルナったらすっかりやつれちゃって…」
PRINTFORML 「ルナが生き延びてるなんて意外だわ♪」	PRINTFORML 「ルナが生き延びてるなんて意外だわ♪」
PRINTFORML 「……このまま一回休みになるのかしら」	PRINTFORML 「……このまま一回休みになるのかしら」
PRINTFORML 「お腹の中に間違いなく何かがいるわ…」	PRINTFORML 「お腹の中に間違いなく何かがいるわ…」
PRINTFORML 「待って待って！落ち着きましょうよ！」	PRINTFORML 「待って待って！落ち着きましょうよ！」
PRINTFORML 「あら？もう気持ちいいことおしまい？」	PRINTFORML 「あら？もう気持ちいいことおしまい？」
PRINTFORML (あら？もしかして逃がしてくれるの？)	PRINTFORML (あら？もしかして逃がしてくれるの？)
PRINTFORML 「むにゃ…悪いのはサニーなのに……」	PRINTFORML 「むにゃ…悪いのはサニーなのに……」
PRINTFORML 「ひゃあぁああ！……ん……ぁぁ……」	PRINTFORML 「ひゃあぁああ！……ん……ぁぁ……」
PRINTFORML 「捕まえるならー……私より二人を…」	PRINTFORML 「捕まえるならー……私より二人を…」
PRINTFORMDL スターは涙目で弾幕を展開させている	PRINTFORMDL スターは涙目で弾幕を展開させている
PRINTFORMDL 初めてを死守しようとスターは必死だ	PRINTFORMDL 初めてを死守しようとスターは必死だ
PRINTFORML 「なんとかナカだけはかわしたけど…」	PRINTFORML 「なんとかナカだけはかわしたけど…」
PRINTFORML 「ふふっ……うふふふふふふふふ……」	PRINTFORML 「ふふっ……うふふふふふふふふ……」
PRINTFORML 「うふふっ、よろしくお願いします☆」	PRINTFORML 「うふふっ、よろしくお願いします☆」
PRINTFORML 「どうして私がこんな目に……ぅぅ…」	PRINTFORML 「どうして私がこんな目に……ぅぅ…」
PRINTFORML 「おなかの中から気配を感じるんです」	PRINTFORML 「おなかの中から気配を感じるんです」
PRINTFORML 「ごめんなさい、私はやっぱり一人で」	PRINTFORML 「ごめんなさい、私はやっぱり一人で」
PRINTFORMDL 　スターは火照る身体で駆け出した	PRINTFORMDL 　スターは火照る身体で駆け出した
PRINTFORML 「私なんて食べたらお腹こわすわよ」	PRINTFORML 「私なんて食べたらお腹こわすわよ」
PRINTFORML 「さすがに冗談になってないわよ！」	PRINTFORML 「さすがに冗談になってないわよ！」
PRINTFORML 「そんなに安い妖精じゃないのよ♪」	PRINTFORML 「そんなに安い妖精じゃないのよ♪」
PRINTFORML 「ふう、これで落ち着いて…ふふっ」	PRINTFORML 「ふう、これで落ち着いて…ふふっ」
PRINTFORML 「はーはー、もう、冗談じゃないわ」	PRINTFORML 「はーはー、もう、冗談じゃないわ」
PRINTFORML 「待って！見捨てるなんて酷いわ！」	PRINTFORML 「待って！見捨てるなんて酷いわ！」
PRINTFORML (手を抜いてもなんとかなるものね)	PRINTFORML (手を抜いてもなんとかなるものね)
PRINTFORML 「この気配は…化物じゃなさそうね」	PRINTFORML 「この気配は…化物じゃなさそうね」
PRINTFORML 「サニーもさすがにやつれてるわね」	PRINTFORML 「サニーもさすがにやつれてるわね」
PRINTFORML 「何かあったら助けてくださいよ？」	PRINTFORML 「何かあったら助けてくださいよ？」
PRINTFORML 「まさか何か産み付けられたの…？」	PRINTFORML 「まさか何か産み付けられたの…？」
PRINTFORML 「こっちはまだ調べてなかったわね」	PRINTFORML 「こっちはまだ調べてなかったわね」
PRINTFORML 「おなかの中から気配を感じるもの」	PRINTFORML 「おなかの中から気配を感じるもの」
PRINTFORML 「このままずっと浸かっていたいわ」	PRINTFORML 「このままずっと浸かっていたいわ」
PRINTFORML 「逃げなきゃ…すこしでも遠くに…」	PRINTFORML 「逃げなきゃ…すこしでも遠くに…」
PRINTFORML 「へ、変態！変態！……ぅぅぅ…」	PRINTFORML 「へ、変態！変態！……ぅぅぅ…」
PRINTFORML 「うふふ、ついにこれの出番ね！」	PRINTFORML 「うふふ、ついにこれの出番ね！」
PRINTFORML 「ルナがみたら気に入りそうねー」	PRINTFORML 「ルナがみたら気に入りそうねー」
PRINTFORML 「サボってるわけじゃないわよ？」	PRINTFORML 「サボってるわけじゃないわよ？」
PRINTFORML 「グレイズ…って失敗しちゃった」	PRINTFORML 「グレイズ…って失敗しちゃった」
PRINTFORML 「クセになっちゃいそうぉおぅぅ」	PRINTFORML 「クセになっちゃいそうぉおぅぅ」
PRINTFORML 「あんっ…おいたはダメだってば」	PRINTFORML 「あんっ…おいたはダメだってば」
PRINTFORML 「ナカに出されるのは遠慮するわ」	PRINTFORML 「ナカに出されるのは遠慮するわ」
PRINTFORML 「あら…こんな場所にまで穴が…」	PRINTFORML 「あら…こんな場所にまで穴が…」
PRINTFORML 「ほっ……気配はもうないみたい」	PRINTFORML 「ほっ……気配はもうないみたい」
PRINTFORML 「やめて……私なんて襲っても…」	PRINTFORML 「やめて……私なんて襲っても…」
PRINTFORML （怖くなさそうな人ならいいけど）	PRINTFORML （怖くなさそうな人ならいいけど）
PRINTFORML 「でもそれ以外は全部任せるわ♪」	PRINTFORML 「でもそれ以外は全部任せるわ♪」
PRINTFORML 「しんがりはまかせてください！」	PRINTFORML 「しんがりはまかせてください！」
PRINTFORML (おなかの中に気配が…そんな…)	PRINTFORML (おなかの中に気配が…そんな…)
PRINTFORML 「面白そうなものはないかしら？」	PRINTFORML 「面白そうなものはないかしら？」
PRINTFORMDL いつの間にかスターの姿がない！	PRINTFORMDL いつの間にかスターの姿がない！
PRINTFORML 「ふふ、また後であいましょう」	PRINTFORML 「ふふ、また後であいましょう」
PRINTFORML 「ふふふっ、どんどんいくわよ」	PRINTFORML 「ふふふっ、どんどんいくわよ」
PRINTFORML 「集中…なんて柄じゃないわ♪」	PRINTFORML 「集中…なんて柄じゃないわ♪」
PRINTFORML 「吐き出して！お願いだから！」	PRINTFORML 「吐き出して！お願いだから！」
PRINTFORML 「もうっ！気持ち悪いわねえ！」	PRINTFORML 「もうっ！気持ち悪いわねえ！」
PRINTFORML 「えーと、どうしようかしら？」	PRINTFORML 「えーと、どうしようかしら？」
PRINTFORML 「それはさすがに絶対だめー！」	PRINTFORML 「それはさすがに絶対だめー！」
PRINTFORML 「やんっ、ぬるぬるしてる……」	PRINTFORML 「やんっ、ぬるぬるしてる……」
PRINTFORML 「ダメっ！これ以上されたら！」	PRINTFORML 「ダメっ！これ以上されたら！」
PRINTFORML 「残念でした、早漏触手さん♪」	PRINTFORML 「残念でした、早漏触手さん♪」
PRINTFORML 「下着までボロボロじゃない…」	PRINTFORML 「下着までボロボロじゃない…」
PRINTFORML 「くすくす、探してる探してる」	PRINTFORML 「くすくす、探してる探してる」
PRINTFORMW 「いやよ……そんなのいや……」	PRINTFORMW 「いやよ……そんなのいや……」
PRINTFORML （別に関わらなくてもいいわね）	PRINTFORML （別に関わらなくてもいいわね）
PRINTFORMDL （もっと強い人さがしましょ）	PRINTFORMDL （もっと強い人さがしましょ）
PRINTFORML (心が折れる前に逃げるのよ！)	PRINTFORML (心が折れる前に逃げるのよ！)
PRINTFORML 「んー…早くこないかしら……」	PRINTFORML 「んー…早くこないかしら……」
PRINTFORML 「さっぱりして気持ちいいわね」	PRINTFORML 「さっぱりして気持ちいいわね」
PRINTFORML 「本当にエッチな怪物だったわ」	PRINTFORML 「本当にエッチな怪物だったわ」
PRINTFORML 「うう……ちょっとだけよ？」	PRINTFORML 「うう……ちょっとだけよ？」
PRINTFORML 「追いかけてこないでよー！」	PRINTFORML 「追いかけてこないでよー！」
PRINTFORML 「そうねえ、こんな時は……」	PRINTFORML 「そうねえ、こんな時は……」
PRINTFORML 「これ以上は……本当に……」	PRINTFORML 「これ以上は……本当に……」
PRINTFORML 「あら？擦り切れちゃってる」	PRINTFORML 「あら？擦り切れちゃってる」
PRINTFORML 「さすがに恥ずかしいわ……」	PRINTFORML 「さすがに恥ずかしいわ……」
PRINTFORML 「あらあら、だらしないわね」	PRINTFORML 「あらあら、だらしないわね」
PRINTFORML （んー、どうしようかしら？）	PRINTFORML （んー、どうしようかしら？）
PRINTFORML （みなかったことにしましょ）	PRINTFORML （みなかったことにしましょ）
PRINTFORML (急いでこの場を離れないと)	PRINTFORML (急いでこの場を離れないと)
PRINTFORML 「私に気づきませんように…」	PRINTFORML 「私に気づきませんように…」
PRINTFORML 「身を守るものはないの…？」	PRINTFORML 「身を守るものはないの…？」
PRINTFORML 「いやああ！それはダメェ！」	PRINTFORML 「いやああ！それはダメェ！」
PRINTFORMW （残念、おやすみなさい……）	PRINTFORMW （残念、おやすみなさい……）
PRINTFORML 「ふふっ……えっちぃ……」	PRINTFORML 「ふふっ……えっちぃ……」
PRINTFORML (やっぱり自分が一番よね)	PRINTFORML (やっぱり自分が一番よね)
PRINTFORML 「あっち行ってってばー！」	PRINTFORML 「あっち行ってってばー！」
PRINTFORML 「それっ！スペルカード♪」	PRINTFORML 「それっ！スペルカード♪」
PRINTFORML 「あ……またするの……？」	PRINTFORML 「あ……またするの……？」
PRINTFORML 「いやーー！離してーー！」	PRINTFORML 「いやーー！離してーー！」
PRINTFORML 「ちょっとふざけないで！」	PRINTFORML 「ちょっとふざけないで！」
PRINTFORML 「ナカはダメだってばー！」	PRINTFORML 「ナカはダメだってばー！」
PRINTFORML 「ゲホッ…………かはっ…」	PRINTFORML 「ゲホッ…………かはっ…」
PRINTFORML 「あはっ…気持ちいい……」	PRINTFORML 「あはっ…気持ちいい……」
PRINTFORML 「狙うなら私以外にして！」	PRINTFORML 「狙うなら私以外にして！」
PRINTFORML 「あらあら、こっちこっち」	PRINTFORML 「あらあら、こっちこっち」
PRINTFORML 「ほらほら捕まえてごらん」	PRINTFORML 「ほらほら捕まえてごらん」
PRINTFORML 「うん、気配は感じないわ」	PRINTFORML 「うん、気配は感じないわ」
PRINTFORMW 「きゃぁああぁぁぁあ！！」	PRINTFORMW 「きゃぁああぁぁぁあ！！」
PRINTFORML 「本当にえっちな化物ね！」	PRINTFORML 「本当にえっちな化物ね！」
PRINTFORML 「本当に酷い目にあったわ」	PRINTFORML 「本当に酷い目にあったわ」
PRINTFORML 「ちょっとお花を積みに☆」	PRINTFORML 「ちょっとお花を積みに☆」
PRINTFORML 「……生ぬるいわ…すぅ」	PRINTFORML 「……生ぬるいわ…すぅ」
PRINTFORML 「…二人には…内緒よ♪」	PRINTFORML 「…二人には…内緒よ♪」
PRINTFORML 「わーー！撤収よ撤収！」	PRINTFORML 「わーー！撤収よ撤収！」
PRINTFORML 「もうっ、マニアックね」	PRINTFORML 「もうっ、マニアックね」
PRINTFORML (これで楽ができるわ♪)	PRINTFORML (これで楽ができるわ♪)
PRINTFORML 「どんどん育ってる……」	PRINTFORML 「どんどん育ってる……」
PRINTFORML (今見つかったら…うぅ)	PRINTFORML (今見つかったら…うぅ)
PRINTFORML 「静かにね、静かに……」	PRINTFORML 「静かにね、静かに……」
PRINTFORML 「はぁ…あぶなかった…」	PRINTFORML 「はぁ…あぶなかった…」
PRINTFORML 「ふぅぅ…まるで天国ね」	PRINTFORML 「ふぅぅ…まるで天国ね」
PRINTFORML 「んー…まだだぁめ♪」	PRINTFORML 「んー…まだだぁめ♪」
PRINTFORML 「うふふ、おあずけよ」	PRINTFORML 「うふふ、おあずけよ」
PRINTFORML 「これはどうかしら？」	PRINTFORML 「これはどうかしら？」
PRINTFORML 「さあ弾幕ごっこよ♪」	PRINTFORML 「さあ弾幕ごっこよ♪」
PRINTFORML (早く逃げなくちゃ…)	PRINTFORML (早く逃げなくちゃ…)
PRINTFORML 「早く誰かたすけてー」	PRINTFORML 「早く誰かたすけてー」
PRINTFORML 「あいやこれまで……」	PRINTFORML 「あいやこれまで……」
PRINTFORML 「そっちはめっ、よ？」	PRINTFORML 「そっちはめっ、よ？」
PRINTFORML 「やぁん、いけずぅ♪」	PRINTFORML 「やぁん、いけずぅ♪」
PRINTFORML 「これまで……かしら」	PRINTFORML 「これまで……かしら」
PRINTFORMDL 弱々しい気配を感じる	PRINTFORMDL 弱々しい気配を感じる
PRINTFORML 「返して…私の体……」	PRINTFORML 「返して…私の体……」
PRINTFORML 「…お腹の中に気配が」	PRINTFORML 「…お腹の中に気配が」
PRINTFORML 「それっ！いくわよ！」	PRINTFORML 「それっ！いくわよ！」
PRINTFORML 「おじゃましまーす☆」	PRINTFORML 「おじゃましまーす☆」
PRINTFORML 「お邪魔しまーす……」	PRINTFORML 「お邪魔しまーす……」
PRINTFORML (早く外にでたいなあ)	PRINTFORML (早く外にでたいなあ)
PRINTFORML 「ちょ、ちょっと！？」	PRINTFORML 「ちょ、ちょっと！？」
PRINTFORML 「いやあああああ！！」	PRINTFORML 「いやあああああ！！」
PRINTFORMW （あら…この感じ……）	PRINTFORMW （あら…この感じ……）
PRINTFORML 「……すぅ……すぅ」	PRINTFORML 「……すぅ……すぅ」
PRINTFORML 「んんっ……暑い…」	PRINTFORML 「んんっ……暑い…」
PRINTFORML 「逃げろーーー！！」	PRINTFORML 「逃げろーーー！！」
PRINTFORML 「もう……見逃して」	PRINTFORML 「もう……見逃して」
PRINTFORML 「……いじめないで」	PRINTFORML 「……いじめないで」
PRINTFORML (よ、よかった……)	PRINTFORML (よ、よかった……)
PRINTFORML 「うふふ、ハズレ♪」	PRINTFORML 「うふふ、ハズレ♪」
PRINTFORMW （あ……意識が……）	PRINTFORMW （あ……意識が……）
PRINTFORMW （一回休み…なのね）	PRINTFORMW （一回休み…なのね）
PRINTFORML 「……痛い…すぅ」	PRINTFORML 「……痛い…すぅ」
PRINTFORML 「んんんーーーッ」	PRINTFORML 「んんんーーーッ」
PRINTFORML 「……ん～？ん？」	PRINTFORML 「……ん～？ん？」
PRINTFORML 「視線が痛いわ…」	PRINTFORML 「視線が痛いわ…」
PRINTFORML 「早く出してー！」	PRINTFORML 「早く出してー！」
PRINTFORML 「しゅごいのぉお」	PRINTFORML 「しゅごいのぉお」
PRINTFORML 「ひゃぁぁぁぁ！」	PRINTFORML 「ひゃぁぁぁぁ！」
PRINTFORML 「ぎゃああああ！」	PRINTFORML 「ぎゃああああ！」
PRINTFORMW 「…………たぶん」	PRINTFORMW 「…………たぶん」
PRINTFORML (抜き足差し足…)	PRINTFORML (抜き足差し足…)
PRINTFORML 「さあ宝探しよ♪」	PRINTFORML 「さあ宝探しよ♪」
PRINTFORML 「助かったの…？」	PRINTFORML 「助かったの…？」
PRINTFORML 「気の短い人ねえ」	PRINTFORML 「気の短い人ねえ」
PRINTFORML 「………むにゃ」	PRINTFORML 「………むにゃ」
PRINTFORML 「……きゃんっ」	PRINTFORML 「……きゃんっ」
PRINTFORML 「ねばねばー…」	PRINTFORML 「ねばねばー…」
PRINTFORML 「きゃあっ！？」	PRINTFORML 「きゃあっ！？」
PRINTFORML 「戦闘終了ね♪」	PRINTFORML 「戦闘終了ね♪」
PRINTFORML 「どうしよう…」	PRINTFORML 「どうしよう…」
PRINTFORML 「のりこめー☆」	PRINTFORML 「のりこめー☆」
PRINTFORML 「……きゅう」	PRINTFORML 「……きゅう」
PRINTFORML 「やだぁ……」	PRINTFORML 「やだぁ……」
PRINTFORML 「あんっ……」	PRINTFORML 「あんっ……」
PRINTFORML 「すぅ……？」	PRINTFORML 「すぅ……？」
PRINTFORML 「っ……！？」	PRINTFORML 「っ……！？」
PRINTFORML 「……酷い人」	PRINTFORML 「……酷い人」
PRINTFORML 「ぎゃーー！」	PRINTFORML 「ぎゃーー！」
PRINTFORML 「はなしてー」	PRINTFORML 「はなしてー」
PRINTFORML 「いやっ！？」	PRINTFORML 「いやっ！？」
PRINTFORML 「痛いわね！」	PRINTFORML 「痛いわね！」
PRINTFORML 「降参よ……」	PRINTFORML 「降参よ……」
PRINTFORML 「ぅぅぅぅ…」	PRINTFORML 「ぅぅぅぅ…」
PRINTFORML 「お助けー！」	PRINTFORML 「お助けー！」
PRINTFORML 「んんっ…」	PRINTFORML 「んんっ…」
PRINTFORML 「きゅう…」	PRINTFORML 「きゅう…」
PRINTFORML 「ぎゃっ！」	PRINTFORML 「ぎゃっ！」
PRINTFORML 「いたたた」	PRINTFORML 「いたたた」
PRINTFORML 「やんっ…」	PRINTFORML 「やんっ…」
PRINTFORML 「あ……」	PRINTFORML 「あ……」
PRINTFORML 「！？」	PRINTFORML 「！？」
PRINTFORML 「……」	PRINTFORML 「……」
PRINTFORMW （……）	PRINTFORMW （……）
