//口上:

PRINTFORMDW 面倒になった%CALLNAME:1%は、%CALLNAME:TARGET%の腕を掴んで連れ出した…	PRINTFORMDW 面倒になった%CALLNAME:1%は、%CALLNAME:TARGET%の腕を掴んで連れ出した…
PRINTFORML 「今のところ、飲まず…はともかく、しばらく絶食状態ですが、人間の私も特に体調に変化がありませんね。	PRINTFORML 「今のところ、飲まず…はともかく、しばらく絶食状態ですが、人間の私も特に体調に変化がありませんね。
PRINTFORML 　………いや、でも、あの人弾幕勝負でばら撒いた諸々をめんどくさいからって放置して帰りますからねぇ…	PRINTFORML 　………いや、でも、あの人弾幕勝負でばら撒いた諸々をめんどくさいからって放置して帰りますからねぇ…
PRINTFORMW 　手回し装填式の連弩のようですので、連射は効きますが、正直なところ威力には期待出来ませんね…」	PRINTFORMW 　手回し装填式の連弩のようですので、連射は効きますが、正直なところ威力には期待出来ませんね…」
PRINTFORML 　私の記憶にもありませんし、この迷宮ごと幻想入りしてきた妖怪、と一括りにするには、少し―――	PRINTFORML 　私の記憶にもありませんし、この迷宮ごと幻想入りしてきた妖怪、と一括りにするには、少し―――
PRINTFORMW 　日本では弩は普及しませんでしたから、恐らくは紅魔館辺りと諸共に幻想入りしたものでしょう。	PRINTFORMW 　日本では弩は普及しませんでしたから、恐らくは紅魔館辺りと諸共に幻想入りしたものでしょう。
PRINTFORMDW %CALLNAME:TARGET%はこの状況で自分にできる精一杯の行動を考え始めた。	PRINTFORMDW %CALLNAME:TARGET%はこの状況で自分にできる精一杯の行動を考え始めた。
PRINTFORML ・AQNはまともに異性と接する機会が殆ど無い…つまり、レズだったんだよーーーー！！！	PRINTFORML ・AQNはまともに異性と接する機会が殆ど無い…つまり、レズだったんだよーーーー！！！
PRINTFORML 　…果たしてこれがそれであるかは、求聞持の千年の記憶を持ってしても分かりませんが、	PRINTFORML 　…果たしてこれがそれであるかは、求聞持の千年の記憶を持ってしても分かりませんが、
PRINTFORML 　弾幕がある程度使えるということは、幻想郷の外、という訳ではないのでしょうが…	PRINTFORML 　弾幕がある程度使えるということは、幻想郷の外、という訳ではないのでしょうが…
PRINTFORMW 　八雲の紫さんや、あの仙人の方々のように、独自の空間を構築したんでしょうか…」	PRINTFORMW 　八雲の紫さんや、あの仙人の方々のように、独自の空間を構築したんでしょうか…」
PRINTFORMW 　身を守るものは幾らあっても損にはならない、ので、も、持ってるだけ、なら…」	PRINTFORMW 　身を守るものは幾らあっても損にはならない、ので、も、持ってるだけ、なら…」
PRINTFORML 　幸いなことに紙と筆を持ち歩いていましたので、私なりに地図を描いてまして、	PRINTFORML 　幸いなことに紙と筆を持ち歩いていましたので、私なりに地図を描いてまして、
PRINTFORML 　有難いことに必要分の魔力も貯蔵されているようですね。大事に使いましょう」	PRINTFORML 　有難いことに必要分の魔力も貯蔵されているようですね。大事に使いましょう」
PRINTFORMW 　その、何というか…きょ、凶悪ですね。棍棒よりこれで殴った方が強いのでは…	PRINTFORMW 　その、何というか…きょ、凶悪ですね。棍棒よりこれで殴った方が強いのでは…
PRINTFORML 　魔力でも霊力でもなく、純然たる物理現象を発生させる機械のようですが…	PRINTFORML 　魔力でも霊力でもなく、純然たる物理現象を発生させる機械のようですが…
PRINTFORML 　外の、火を吹く道具でしたか。何事か叫びながら使うのがマナーだとか…	PRINTFORML 　外の、火を吹く道具でしたか。何事か叫びながら使うのがマナーだとか…
PRINTFORMW 　出てくるものが真っ赤な十字架、とは…ちょっと、センスを疑いますね…	PRINTFORMW 　出てくるものが真っ赤な十字架、とは…ちょっと、センスを疑いますね…
PRINTFORML 「縁起の編纂に当たって、弾幕ごっこについて調べる機会がありまして。	PRINTFORML 「縁起の編纂に当たって、弾幕ごっこについて調べる機会がありまして。
PRINTFORML 「スキルカードですね。いわゆる『魔力の矢』、初歩的な加害魔法です。	PRINTFORML 「スキルカードですね。いわゆる『魔力の矢』、初歩的な加害魔法です。
PRINTFORML 「この状況では、足手まといかどうかなんて言ってられないですよね…」	PRINTFORML 「この状況では、足手まといかどうかなんて言ってられないですよね…」
PRINTFORMW 　っと、そろそろ失礼しますね。余り一つ所に長居はしたくないので」	PRINTFORMW 　っと、そろそろ失礼しますね。余り一つ所に長居はしたくないので」
PRINTFORMW 　…つまり、宣言中に、何かがあって、落とした、と言うことですね。	PRINTFORMW 　…つまり、宣言中に、何かがあって、落とした、と言うことですね。
PRINTFORMW 　霊力増幅媒体の一種…でも無いですか、単なる棒みたいですが…？」	PRINTFORMW 　霊力増幅媒体の一種…でも無いですか、単なる棒みたいですが…？」
PRINTFORML 「………布、ですね。布をくるくる巻いて出来た…手鉾？でしょうか。	PRINTFORML 「………布、ですね。布をくるくる巻いて出来た…手鉾？でしょうか。
PRINTFORMW 　外部からの救出を待つ余裕もありませんし、厳しい状況ですね…」	PRINTFORMW 　外部からの救出を待つ余裕もありませんし、厳しい状況ですね…」
PRINTFORMW 　太陽のように朱く、月のように冷たく、水鏡のように揺らめく鋼。	PRINTFORMW 　太陽のように朱く、月のように冷たく、水鏡のように揺らめく鋼。
PRINTFORML 　私が使っても焼け石に水ですが…まあ、あって損は無いですよね」	PRINTFORML 　私が使っても焼け石に水ですが…まあ、あって損は無いですよね」
PRINTFORML 　何を言ってるか分からないと思いますが、私もよく分かりません」	PRINTFORML 　何を言ってるか分からないと思いますが、私もよく分かりません」
PRINTFORML 　な、なか、あつい、なんですか！？何してるんですか…っ！？」	PRINTFORML 　な、なか、あつい、なんですか！？何してるんですか…っ！？」
PRINTFORMW 　あと、何だか苺臭いんですけど…これ、ひょっとして動力源…」	PRINTFORMW 　あと、何だか苺臭いんですけど…これ、ひょっとして動力源…」
PRINTFORML 「薙刀、ですね。柄の短い巴型…女性用に拵えたもののようです。	PRINTFORML 「薙刀、ですね。柄の短い巴型…女性用に拵えたもののようです。
PRINTFORMW 　ほんの触り程度でしたが、弾幕自体は何とか使えはしますよ。	PRINTFORMW 　ほんの触り程度でしたが、弾幕自体は何とか使えはしますよ。
PRINTFORMW 「───金より軽く、金剛より硬く、永久に錆びず、朽ちない。	PRINTFORMW 「───金より軽く、金剛より硬く、永久に錆びず、朽ちない。
PRINTFORMW 　これが凡百の刀剣と一線を画すものであることは、確かです」	PRINTFORMW 　これが凡百の刀剣と一線を画すものであることは、確かです」
PRINTFORMW 　弾幕ごっこはおろか、ろくに運動もしたことがありませんし、	PRINTFORMW 　弾幕ごっこはおろか、ろくに運動もしたことがありませんし、
PRINTFORML 　どうやら、ここでは能力にかなりの制限を受けるようです。	PRINTFORML 　どうやら、ここでは能力にかなりの制限を受けるようです。
PRINTFORML 　これだけの広さとなると、地底にでも作ったのでなければ、	PRINTFORML 　これだけの広さとなると、地底にでも作ったのでなければ、
PRINTFORML 　まさか、"彼ら"も茶を嗜んでいたり…しません、よね。	PRINTFORML 　まさか、"彼ら"も茶を嗜んでいたり…しません、よね。
PRINTFORMW 　そうですか、天狗でも容易には脱出できない訳ですね…」	PRINTFORMW 　そうですか、天狗でも容易には脱出できない訳ですね…」
PRINTFORML 　見る限りは、式神か何かの使役のためのものでしょうか…	PRINTFORML 　見る限りは、式神か何かの使役のためのものでしょうか…
PRINTFORML 　…今、ネジを巻いたら、体感時間が遅くなりましたね…。	PRINTFORML 　…今、ネジを巻いたら、体感時間が遅くなりましたね…。
PRINTFORML 　正直に申し上げますと、余り戦いの役には立てませんよ？	PRINTFORML 　正直に申し上げますと、余り戦いの役には立てませんよ？
PRINTFORML 「この迷宮に巣くう"彼ら"…一体何者なんでしょうか。	PRINTFORML 「この迷宮に巣くう"彼ら"…一体何者なんでしょうか。
PRINTFORMW 　撃剣興行も、とっくに幻想入りしてるんでしょうね…」	PRINTFORMW 　撃剣興行も、とっくに幻想入りしてるんでしょうね…」
PRINTFORML 「えぇっと…なんでしょう、これは。奇天烈な形ですね。	PRINTFORML 「えぇっと…なんでしょう、これは。奇天烈な形ですね。
PRINTFORML 　職業の方の駆け出し魔法使いがよく使うタイプですね…	PRINTFORML 　職業の方の駆け出し魔法使いがよく使うタイプですね…
PRINTFORML 　ただし苦痛への耐性がある訳ではない　リョナるよ！	PRINTFORML 　ただし苦痛への耐性がある訳ではない　リョナるよ！
PRINTFORML 　この妙な空気や霧が活力を供給してたりするのかも…	PRINTFORML 　この妙な空気や霧が活力を供給してたりするのかも…
PRINTFORMW 　ただ、やっぱり口寂しいですね。兎鍋が恋しいです」	PRINTFORMW 　ただ、やっぱり口寂しいですね。兎鍋が恋しいです」
PRINTFORMW 　微妙に、霊夢さんが持っていたものとは違いますね。	PRINTFORMW 　微妙に、霊夢さんが持っていたものとは違いますね。
PRINTFORML 　弾幕の補助くらいなら任せられるかも知れませんね」	PRINTFORML 　弾幕の補助くらいなら任せられるかも知れませんね」
PRINTFORML 「私は元々の力が力なのでよく分からないのですが…	PRINTFORML 「私は元々の力が力なのでよく分からないのですが…
PRINTFORML 　分かりました。ここからは私なりに動いてみます。	PRINTFORML 　分かりました。ここからは私なりに動いてみます。
PRINTFORML 　弦も、緩いですね。これくらいなら引けそうです」	PRINTFORML 　弦も、緩いですね。これくらいなら引けそうです」
PRINTFORMW 　天人の羽衣にも見えますが…っ！　ま、回った！？	PRINTFORMW 　天人の羽衣にも見えますが…っ！　ま、回った！？
PRINTFORML 　も…っ、やです、はなし、離してください…！」	PRINTFORML 　も…っ、やです、はなし、離してください…！」
PRINTFORML  　見ないで、見ないでくださっ、ぁっ―――！」	PRINTFORML  　見ないで、見ないでくださっ、ぁっ―――！」
PRINTFORML 「抜いてくださいっ！抜い、て…あっ───！？」	PRINTFORML 「抜いてくださいっ！抜い、て…あっ───！？」
PRINTFORMW 　あ、もし紅茶を見掛けたら是非教えて下さいね」	PRINTFORMW 　あ、もし紅茶を見掛けたら是非教えて下さいね」
PRINTFORMW 　ここ、もしかして結界の境に近いんでしょうか」	PRINTFORMW 　ここ、もしかして結界の境に近いんでしょうか」
PRINTFORMW 　というよりは、汎用の霊撃札に近いようですが。	PRINTFORMW 　というよりは、汎用の霊撃札に近いようですが。
PRINTFORML 「ふ、ぁっ！ふかい、ふかすぎ、ますっ…！！」	PRINTFORML 「ふ、ぁっ！ふかい、ふかすぎ、ますっ…！！」
PRINTFORML 　…あ、本当に踏み込んでこないで下さいね？」	PRINTFORML 　…あ、本当に踏み込んでこないで下さいね？」
PRINTFORML 「何だか誂えたように手頃な棒が落ちてますね…	PRINTFORML 「何だか誂えたように手頃な棒が落ちてますね…
PRINTFORML 　いま、イって、イってます…っからぁ…！」	PRINTFORML 　いま、イって、イってます…っからぁ…！」
PRINTFORML 「そこばっかりっ…苛め、ないでくださっ…」	PRINTFORML 「そこばっかりっ…苛め、ないでくださっ…」
PRINTFORMW 　…豆鉄砲にも、劣るようなものですけれど」	PRINTFORMW 　…豆鉄砲にも、劣るようなものですけれど」
PRINTFORML 「時折茶筒が転がっているのを見かけますが…	PRINTFORML 「時折茶筒が転がっているのを見かけますが…
PRINTFORMW 　ま、まあ、何かの役には立ちます…かね…」	PRINTFORMW 　ま、まあ、何かの役には立ちます…かね…」
PRINTFORML  「あっ、駄目、嫌、見られてるのにっ…！	PRINTFORML  「あっ、駄目、嫌、見られてるのにっ…！
PRINTFORML 「あぁっ…！スカート、返して下さいっ！」	PRINTFORML 「あぁっ…！スカート、返して下さいっ！」
PRINTFORML 「破れちゃいますって、止めてください！」	PRINTFORML 「破れちゃいますって、止めてください！」
PRINTFORML 「そんな、揉むほど、無いですからっ…！」	PRINTFORML 「そんな、揉むほど、無いですからっ…！」
PRINTFORML 「やっ、ぬるって、気持ち悪、あぁっ！？」	PRINTFORML 「やっ、ぬるって、気持ち悪、あぁっ！？」
PRINTFORML 「少しは、運動しておけば良かったなぁ…」	PRINTFORML 「少しは、運動しておけば良かったなぁ…」
PRINTFORML 「もう起き上がって来ないでくださいね…」	PRINTFORML 「もう起き上がって来ないでくださいね…」
PRINTFORML 　何やら魔法が掛けられているようですが…	PRINTFORML 　何やら魔法が掛けられているようですが…
PRINTFORML 「…河童のバザーで見かけましたね、これ。	PRINTFORML 「…河童のバザーで見かけましたね、これ。
PRINTFORMW 　足を引っ張ってばかりで御迷惑に…あっ」	PRINTFORMW 　足を引っ張ってばかりで御迷惑に…あっ」
PRINTFORML 　後で、痣にならないと良いですけど…」	PRINTFORML 　後で、痣にならないと良いですけど…」
PRINTFORML 「なんでっ、そんなに、腋を狙って…！」	PRINTFORML 「なんでっ、そんなに、腋を狙って…！」
PRINTFORML 　そんな、とこ、突かな、いでぇっ…！」	PRINTFORML 　そんな、とこ、突かな、いでぇっ…！」
PRINTFORML 「なんで、わざわざ、私の胸なんて…！」	PRINTFORML 「なんで、わざわざ、私の胸なんて…！」
PRINTFORMW 　短い間でしたが、お世話になりました」	PRINTFORMW 　短い間でしたが、お世話になりました」
PRINTFORMW 　どうやって止めるんですかこれー！？」	PRINTFORMW 　どうやって止めるんですかこれー！？」
PRINTFORML ・気丈、というよりは死への恐怖が薄い	PRINTFORML ・気丈、というよりは死への恐怖が薄い
PRINTFORML 「牽制くらいなら、私の霊力でも…！」	PRINTFORML 「牽制くらいなら、私の霊力でも…！」
PRINTFORML 「あっ、また、またキて───っ！！」	PRINTFORML 「あっ、また、またキて───っ！！」
PRINTFORML 　そんなところ、駄目なのにぃっ…！」	PRINTFORML 　そんなところ、駄目なのにぃっ…！」
PRINTFORML 　やっ、危なっ…、で、電撃までっ！？	PRINTFORML 　やっ、危なっ…、で、電撃までっ！？
PRINTFORML 「あら、これは…媒体、みたいですね。	PRINTFORML 「あら、これは…媒体、みたいですね。
PRINTFORML 「懐中時計、ですね。動いてませんが。	PRINTFORML 「懐中時計、ですね。動いてませんが。
PRINTFORMW 　特に変わった点はあり、ませ、ん…？	PRINTFORMW 　特に変わった点はあり、ませ、ん…？
PRINTFORML 「下手に撃ったら、あの人にまで…」	PRINTFORML 「下手に撃ったら、あの人にまで…」
PRINTFORML 「体を乗せて、踏み込みは鋭く…！」	PRINTFORML 「体を乗せて、踏み込みは鋭く…！」
PRINTFORML 「だ、駄目ですっ！下着だけは…！」	PRINTFORML 「だ、駄目ですっ！下着だけは…！」
PRINTFORML 「そんなに…先っぽ、ばっかりっ…」	PRINTFORML 「そんなに…先っぽ、ばっかりっ…」
PRINTFORML 「なか、ぐりって、抉られてっ…！」	PRINTFORML 「なか、ぐりって、抉られてっ…！」
PRINTFORML 「お、お尻でなんて、嫌です…っ！」	PRINTFORML 「お、お尻でなんて、嫌です…っ！」
PRINTFORML 「付け焼き刃では、厳しいですね…」	PRINTFORML 「付け焼き刃では、厳しいですね…」
PRINTFORML 「せ、背が小さくて助かりました…」	PRINTFORML 「せ、背が小さくて助かりました…」
PRINTFORML 「ここは、一体どこなんでしょうね。	PRINTFORML 「ここは、一体どこなんでしょうね。
PRINTFORML 「これは…山の、木端天狗の方々の…	PRINTFORML 「これは…山の、木端天狗の方々の…
PRINTFORML 「これは…霊力増幅用の方陣ですか。	PRINTFORML 「これは…霊力増幅用の方陣ですか。
PRINTFORML 「相手の回避ルートを潰して…！」	PRINTFORML 「相手の回避ルートを潰して…！」
PRINTFORML 「無駄撃ちは出来ませんからね…」	PRINTFORML 「無駄撃ちは出来ませんからね…」
PRINTFORML 　そこはだめっ、だめぇぇっ！？」	PRINTFORML 　そこはだめっ、だめぇぇっ！？」
PRINTFORML 「あ、ぁあっ…むか、れてぇ…！」	PRINTFORML 「あ、ぁあっ…むか、れてぇ…！」
PRINTFORML 「こんな、化け物、なんかに…！」	PRINTFORML 「こんな、化け物、なんかに…！」
PRINTFORML 「嫌、嫌ですっ！食べられっ…！」	PRINTFORML 「嫌、嫌ですっ！食べられっ…！」
PRINTFORMW 　───無駄には、しませんから」	PRINTFORMW 　───無駄には、しませんから」
PRINTFORMW 　ええ、願ってもないことですが…	PRINTFORMW 　ええ、願ってもないことですが…
PRINTFORML 「落ち着いて、相手の中心を…」	PRINTFORML 「落ち着いて、相手の中心を…」
PRINTFORML 「とにかく、数を減らして…！」	PRINTFORML 「とにかく、数を減らして…！」
PRINTFORML 「近寄らないで、くださいっ！」	PRINTFORML 「近寄らないで、くださいっ！」
PRINTFORML 「落とした腰を軸に、払う…！」	PRINTFORML 「落とした腰を軸に、払う…！」
PRINTFORML 「な、縄抜けの、応用で…っ！」	PRINTFORML 「な、縄抜けの、応用で…っ！」
PRINTFORML 「ちょっと、どこを狙って…！」	PRINTFORML 「ちょっと、どこを狙って…！」
PRINTFORML 「今、ぞくって、…あぁっ！？」	PRINTFORML 「今、ぞくって、…あぁっ！？」
PRINTFORML 「あら…スペルカード、ですね。	PRINTFORML 「あら…スペルカード、ですね。
PRINTFORMW 　まあ、無いよりはマシですか」	PRINTFORMW 　まあ、無いよりはマシですか」
PRINTFORML 　その、すごく…大入りです…。	PRINTFORML 　その、すごく…大入りです…。
PRINTFORMW 　実物を見たのは初めてですが…	PRINTFORMW 　実物を見たのは初めてですが…
PRINTFORML ・耳年増で自慰以外は経験無し	PRINTFORML ・耳年増で自慰以外は経験無し
PRINTFORML 「あの腕を、落とせばっ…！」	PRINTFORML 「あの腕を、落とせばっ…！」
PRINTFORML 　ちから、はいらなくっ…！」	PRINTFORML 　ちから、はいらなくっ…！」
PRINTFORML  　体が、勝手に、いぃ…！」	PRINTFORML  　体が、勝手に、いぃ…！」
PRINTFORML 「振り抜く瞬間に、潜る…！」	PRINTFORML 「振り抜く瞬間に、潜る…！」
PRINTFORML 「踏み込みが、足りませんっ！	PRINTFORML 「踏み込みが、足りませんっ！
PRINTFORML 　霊力も、充填済み…ですか。	PRINTFORML 　霊力も、充填済み…ですか。
PRINTFORML 「は、張り型、ですね、はい。	PRINTFORML 「は、張り型、ですね、はい。
PRINTFORML 　そ、そう！これは武器です！	PRINTFORML 　そ、そう！これは武器です！
PRINTFORML 「あの腕に、当てれば…っ」	PRINTFORML 「あの腕に、当てれば…っ」
PRINTFORML 「これ以上、やらせない！」	PRINTFORML 「これ以上、やらせない！」
PRINTFORML 「やたらと器用ですねっ…」	PRINTFORML 「やたらと器用ですねっ…」
PRINTFORML 「や、やっぱり…私じゃ…」	PRINTFORML 「や、やっぱり…私じゃ…」
PRINTFORML 「あ、はい、構いませんよ。	PRINTFORML 「あ、はい、構いませんよ。
PRINTFORMW 「…なんでしょうか、これ。	PRINTFORMW 「…なんでしょうか、これ。
PRINTFORMW 　早計、だといいんですが」	PRINTFORMW 　早計、だといいんですが」
PRINTFORML 「………び、媚薬、ですね。	PRINTFORML 「………び、媚薬、ですね。
PRINTFORML 「今、助けますから…！」	PRINTFORML 「今、助けますから…！」
PRINTFORML 「弾も墨も、効率的に…」	PRINTFORML 「弾も墨も、効率的に…」
PRINTFORML 「ん、ぐっ！…むぅっ！」	PRINTFORML 「ん、ぐっ！…むぅっ！」
PRINTFORML 「んー…っ！んむーっ！」	PRINTFORML 「んー…っ！んむーっ！」
PRINTFORML  「ちがうん、ですっ…！	PRINTFORML  「ちがうん、ですっ…！
PRINTFORML 「これくらい、ならっ！」	PRINTFORML 「これくらい、ならっ！」
PRINTFORML 「は、破廉恥ですっ…！」	PRINTFORML 「は、破廉恥ですっ…！」
PRINTFORML 　足が、閉じれなっ…！」	PRINTFORML 　足が、閉じれなっ…！」
PRINTFORML 　えーと、そうですね…」	PRINTFORML 　えーと、そうですね…」
PRINTFORMW 　───よかっ、たぁ…」	PRINTFORMW 　───よかっ、たぁ…」
﻿PRINTFORML ・ﾔﾏﾄﾅﾃﾞｼｺｫ！	PRINTFORML ・ﾔﾏﾄﾅﾃﾞｼｺｫ！
PRINTFORML 「カスりさえすれば！」	PRINTFORML 「カスりさえすれば！」
PRINTFORML 「今、助けますから…」	PRINTFORML 「今、助けますから…」
PRINTFORML 「この間合いならっ！」	PRINTFORML 「この間合いならっ！」
PRINTFORML 「出鼻を挫ければ…！」	PRINTFORML 「出鼻を挫ければ…！」
PRINTFORML 「はぅっ、く、ふぅ…！	PRINTFORML 「はぅっ、く、ふぅ…！
PRINTFORML 　──────っ！！」	PRINTFORML 　──────っ！！」
PRINTFORML 「西洋弓、でしょうか。	PRINTFORML 「西洋弓、でしょうか。
PRINTFORML 　興味？アリアリだよ	PRINTFORML 　興味？アリアリだよ
PRINTFORML 　Ω　ΩΩ＜…ﾊｧ?	PRINTFORML 　Ω　ΩΩ＜…ﾊｧ?
PRINTFORML 「足を止めればっ…」	PRINTFORML 「足を止めればっ…」
PRINTFORML 　でもっ…まだ…！」	PRINTFORML 　でもっ…まだ…！」
PRINTFORML 　手、止まらなっ…」	PRINTFORML 　手、止まらなっ…」
PRINTFORML 「けほっ、こほっ…」	PRINTFORML 「けほっ、こほっ…」
PRINTFORML 「は、挿入って…っ」	PRINTFORML 「は、挿入って…っ」
PRINTFORML 「ん、ぐむっ…！？」	PRINTFORML 「ん、ぐむっ…！？」
PRINTFORML 　…う、くぅ…っ！」	PRINTFORML 　…う、くぅ…っ！」
PRINTFORML 　倒し、ました…？」	PRINTFORML 　倒し、ました…？」
PRINTFORMW 「まさか、霊夢さん…	PRINTFORMW 「まさか、霊夢さん…
PRINTFORML 　………えー、あー…	PRINTFORML 　………えー、あー…
PRINTFORML 「一発くらいは！」	PRINTFORML 「一発くらいは！」
PRINTFORML 「この距離なら…」	PRINTFORML 「この距離なら…」
PRINTFORML 「させませんっ！」	PRINTFORML 「させませんっ！」
PRINTFORML 「…だ、めぇっ…！	PRINTFORML 「…だ、めぇっ…！
PRINTFORML 「あっ、やぁっ！？	PRINTFORML 「あっ、やぁっ！？
PRINTFORML 「あ、ぐぅっ…！」	PRINTFORML 「あ、ぐぅっ…！」
PRINTFORML 「いた、い…っ…」	PRINTFORML 「いた、い…っ…」
PRINTFORML 「大、丈夫です…」	PRINTFORML 「大、丈夫です…」
PRINTFORML 「だめ、ですっ…！	PRINTFORML 「だめ、ですっ…！
PRINTFORML 「洋弓銃、ですね。	PRINTFORML 「洋弓銃、ですね。
PRINTFORML 「ここですっ！」	PRINTFORML 「ここですっ！」
PRINTFORML 「倒れてっ…！」	PRINTFORML 「倒れてっ…！」
PRINTFORML 「参りますっ！」	PRINTFORML 「参りますっ！」
PRINTFORML 「あっ、ぅぁ…！	PRINTFORML 「あっ、ぅぁ…！
PRINTFORML 　後、ろ…！？」	PRINTFORML 　後、ろ…！？」
PRINTFORML 「そう、ですか。	PRINTFORML 「そう、ですか。
PRINTFORML 「くる、しい…	PRINTFORML 「くる、しい…
PRINTFORML 「あっ！つぅ…	PRINTFORML 「あっ！つぅ…
PRINTFORML 「汚いのにっ…	PRINTFORML 「汚いのにっ…
PRINTFORML 「いぁっ！？」	PRINTFORML 「いぁっ！？」
PRINTFORML 「うぁっ…！？	PRINTFORML 「うぁっ…！？
PRINTFORML 「私…ですか？	PRINTFORML 「私…ですか？
PRINTFORML ・貧弱貧弱ゥ	PRINTFORML ・貧弱貧弱ゥ
PRINTFORML 「ひっ…！？	PRINTFORML 「ひっ…！？
PRINTFORML 「───っ！	PRINTFORML 「───っ！
PRINTFORML 「しまっ…！	PRINTFORML 「しまっ…！
PRINTFORML 「はぁっ…！	PRINTFORML 「はぁっ…！
PRINTFORML 「……………	PRINTFORML 「……………
PRINTFORML ・無駄知識	PRINTFORML ・無駄知識
PRINTFORML 「やっ…！	PRINTFORML 「やっ…！
PRINTFORML 　	PRINTFORML 　
PRINTFORML 	PRINTFORML 
PRINTFORML	PRINTFORML
