//口上:

﻿PRINTFORML ---------------------------------------------------------------------------------------------------	PRINTFORML ---------------------------------------------------------------------------------------------------
PRINTFORML 後の空気→本音を建前で包み隠してるような衣玖さんだとぼくは得します、ちょうどこの口上のようなネッ	PRINTFORML 後の空気→本音を建前で包み隠してるような衣玖さんだとぼくは得します、ちょうどこの口上のようなネッ
PRINTFORMDW 身動きが取れなくなった衣玖はこの後の自分がどうされるか想像していた	PRINTFORMDW 身動きが取れなくなった衣玖はこの後の自分がどうされるか想像していた
PRINTFORMDW 衣玖は逃げ遂せた事に安堵しつつも、逃げられなかった時の事を考え…	PRINTFORMDW 衣玖は逃げ遂せた事に安堵しつつも、逃げられなかった時の事を考え…
PRINTFORML 作った人→みかん理事　http://aqua-coro.net/	PRINTFORML 作った人→みかん理事　http://aqua-coro.net/
PRINTFORMDW 衣玖は体の奥底が疼き、気持ちが抑えられなくなっていくのを感じた	PRINTFORMDW 衣玖は体の奥底が疼き、気持ちが抑えられなくなっていくのを感じた
PRINTFORMDW 衣玖は絡みつく触手を拒絶したいのかどうか分からなくなっている	PRINTFORMDW 衣玖は絡みつく触手を拒絶したいのかどうか分からなくなっている
PRINTFORMDW 触手を押し返す衣玖の腕は触手を誘っているようにすら見える	PRINTFORMDW 触手を押し返す衣玖の腕は触手を誘っているようにすら見える
PRINTFORMDW 絡め取られた衣玖の頭の中は触手の事でいっぱいになっている	PRINTFORMDW 絡め取られた衣玖の頭の中は触手の事でいっぱいになっている
PRINTFORMW 「こんな所にあるとは思えない程…とても清浄な水です…！」	PRINTFORMW 「こんな所にあるとは思えない程…とても清浄な水です…！」
PRINTFORMDW ドリルのような形状になった衣玖の羽衣が突き出される！	PRINTFORMDW ドリルのような形状になった衣玖の羽衣が突き出される！
PRINTFORMDW 衣玖は目を白黒させながらも貪欲に快楽を受け入れている	PRINTFORMDW 衣玖は目を白黒させながらも貪欲に快楽を受け入れている
PRINTFORMDW 衣玖が触手を押さえつけると触手は更に絡みついてきた	PRINTFORMDW 衣玖が触手を押さえつけると触手は更に絡みついてきた
PRINTFORMDW 衣玖はピンとアピールしている乳首を両手で覆い隠した	PRINTFORMDW 衣玖はピンとアピールしている乳首を両手で覆い隠した
PRINTFORMW 「や、やめましょう…そういう空気ではないです…ッ！」	PRINTFORMW 「や、やめましょう…そういう空気ではないです…ッ！」
PRINTFORMDW 衣玖はふよふよとしながらも激しく隣の部屋に移動した	PRINTFORMDW 衣玖はふよふよとしながらも激しく隣の部屋に移動した
PRINTFORMDW 衣玖の動作は逆に触手を誘っているようにすら見える	PRINTFORMDW 衣玖の動作は逆に触手を誘っているようにすら見える
PRINTFORMDW 衣玖は息が上がりながらもレーザーで薙ぎ払った！	PRINTFORMDW 衣玖は息が上がりながらもレーザーで薙ぎ払った！
PRINTFORMDW 衣玖は力を振り絞り、拘束から逃れようとしている	PRINTFORMDW 衣玖は力を振り絞り、拘束から逃れようとしている
PRINTFORMDW あまりの快楽に衣玖の意識が飛びそうになっている	PRINTFORMDW あまりの快楽に衣玖の意識が飛びそうになっている
PRINTFORMW 「もう少し楽に倒せる方法があれば嬉しいのですが」	PRINTFORMW 「もう少し楽に倒せる方法があれば嬉しいのですが」
PRINTFORMW 「もしかするとこれも異変だったりするのでは…？」	PRINTFORMW 「もしかするとこれも異変だったりするのでは…？」
PRINTFORMDW 衣玖の指の先から微弱だが正確に電撃が放たれた	PRINTFORMDW 衣玖の指の先から微弱だが正確に電撃が放たれた
PRINTFORMDW 幾重にも重なるレーザーが空間を制圧していく！	PRINTFORMDW 幾重にも重なるレーザーが空間を制圧していく！
PRINTFORMDW 衣玖はまるで自発的に触手に埋もれているようだ	PRINTFORMDW 衣玖はまるで自発的に触手に埋もれているようだ
PRINTFORMDW 衣玖は勃起している陰核を隠すように守っている	PRINTFORMDW 衣玖は勃起している陰核を隠すように守っている
PRINTFORMDW 衣玖は目をトロンとさせて快楽を受け入れている	PRINTFORMDW 衣玖は目をトロンとさせて快楽を受け入れている
PRINTFORMDW 衣玖はろくに声も出せず口をパクパクさせている	PRINTFORMDW 衣玖はろくに声も出せず口をパクパクさせている
PRINTFORMDW 子供扱いされた天子は不満そうに衣玖を見ている	PRINTFORMDW 子供扱いされた天子は不満そうに衣玖を見ている
PRINTFORMW 「これで…！　痛い目をみて反省してください」	PRINTFORMW 「これで…！　痛い目をみて反省してください」
PRINTFORM （こんなに気持ちいいのに…逆らう必要なんて……	PRINTFORM （こんなに気持ちいいのに…逆らう必要なんて……
PRINTFORMDW あまりの苦痛に衣玖は意識が飛びそうになった	PRINTFORMDW あまりの苦痛に衣玖は意識が飛びそうになった
PRINTFORMW 「…こんな攻撃…何回ももらえないですね……」	PRINTFORMW 「…こんな攻撃…何回ももらえないですね……」
PRINTFORMDW 衣玖はだらしなく舌を突き出して痙攣している	PRINTFORMDW 衣玖はだらしなく舌を突き出して痙攣している
PRINTFORMDW 発情した衣玖は、なりふり構わず懇願している	PRINTFORMDW 発情した衣玖は、なりふり構わず懇願している
PRINTFORMDW まるで読んでいたかのように衣玖は身を躱した	PRINTFORMDW まるで読んでいたかのように衣玖は身を躱した
PRINTFORMW 「こんな所でまでお会いするだなんて本当に…」	PRINTFORMW 「こんな所でまでお会いするだなんて本当に…」
PRINTFORMDW 衣玖はまるで水を得た魚のように元気になった	PRINTFORMDW 衣玖はまるで水を得た魚のように元気になった
PRINTFORMW 「いや、痩せたとかそういうわけでは…ッ！！」	PRINTFORMW 「いや、痩せたとかそういうわけでは…ッ！！」
PRINTFORML 漂う空気→感想とかもらえたらとても喜びます	PRINTFORML 漂う空気→感想とかもらえたらとても喜びます
PRINTFORMW 「道具を使うことで打開できる事もあります」	PRINTFORMW 「道具を使うことで打開できる事もあります」
PRINTFORMDW 衣玖は肩を震わせながら羽衣を突き出した！	PRINTFORMDW 衣玖は肩を震わせながら羽衣を突き出した！
PRINTFORMDW 衣玖は巨大な雷球を作り、周囲に放電した！	PRINTFORMDW 衣玖は巨大な雷球を作り、周囲に放電した！
PRINTFORMDW 衣玖は呆けた表情で口をパクパクさせている	PRINTFORMDW 衣玖は呆けた表情で口をパクパクさせている
PRINTFORMDW 衣玖は快楽のあまり完全に白目を剥いている	PRINTFORMDW 衣玖は快楽のあまり完全に白目を剥いている
PRINTFORMDW 衣玖は息を荒げながらもなんとか身を翻した	PRINTFORMDW 衣玖は息を荒げながらもなんとか身を翻した
PRINTFORMDW 衣玖は真っ赤になりながら体を隠そうとした	PRINTFORMDW 衣玖は真っ赤になりながら体を隠そうとした
PRINTFORMW 「手のかかる子供を連れていると大変ですよ」	PRINTFORMW 「手のかかる子供を連れていると大変ですよ」
PRINTFORMW 「ここならまだ私の部屋のほうが綺麗ですね」	PRINTFORMW 「ここならまだ私の部屋のほうが綺麗ですね」
PRINTFORMW 「え…、いやいや冗談です……忘れて下さい」	PRINTFORMW 「え…、いやいや冗談です……忘れて下さい」
PRINTFORMW 「この流れなら一度待って様子を見ましょう」	PRINTFORMW 「この流れなら一度待って様子を見ましょう」
PRINTFORMDW 衣玖の指の先から弱々しい電撃が放たれた	PRINTFORMDW 衣玖の指の先から弱々しい電撃が放たれた
PRINTFORMDW 衣玖は顔を真っ赤にしながら電流を放った	PRINTFORMDW 衣玖は顔を真っ赤にしながら電流を放った
PRINTFORM （あ…、でも…このまま包まれていたい…かも	PRINTFORM （あ…、でも…このまま包まれていたい…かも
PRINTFORMDW 衣玖は脱出のため、じっと力を溜めている	PRINTFORMDW 衣玖は脱出のため、じっと力を溜めている
PRINTFORMDW 衣玖はだらしない表情で快楽を貪っている	PRINTFORMDW 衣玖はだらしない表情で快楽を貪っている
PRINTFORMW 「協力して無事に脱出したいところですね」	PRINTFORMW 「協力して無事に脱出したいところですね」
PRINTFORMW 「い、嫌な予感は…していたんですよね…」	PRINTFORMW 「い、嫌な予感は…していたんですよね…」
PRINTFORMW 「薬っぽい味ですね…、おいしいですけど」	PRINTFORMW 「薬っぽい味ですね…、おいしいですけど」
PRINTFORMDW 衣玖は羽衣で覆うように身を守っている	PRINTFORMDW 衣玖は羽衣で覆うように身を守っている
PRINTFORMW （そろそろ下がっても良い頃合いでは…）	PRINTFORMW （そろそろ下がっても良い頃合いでは…）
PRINTFORMDW 震える衣玖から強力な電撃が放たれる！	PRINTFORMDW 震える衣玖から強力な電撃が放たれる！
PRINTFORMDW 衣玖から全方位に弾幕が撃ち出される！	PRINTFORMDW 衣玖から全方位に弾幕が撃ち出される！
PRINTFORMDW 足元を掬うかのように弾幕が放たれる！	PRINTFORMDW 足元を掬うかのように弾幕が放たれる！
PRINTFORMDW 衣玖はなんとか力を溜めようとしている	PRINTFORMDW 衣玖はなんとか力を溜めようとしている
PRINTFORM 「んお゛お゛お゛お゛お゛ぉお゛ぉお゛ぉぉ	PRINTFORM 「んお゛お゛お゛お゛お゛ぉお゛ぉお゛ぉぉ
PRINTFORMDW 衣玖にはもはや抵抗する気力がなかった	PRINTFORMDW 衣玖にはもはや抵抗する気力がなかった
PRINTFORMW 「あら、総領娘様　御機嫌如何ですか？」	PRINTFORMW 「あら、総領娘様　御機嫌如何ですか？」
PRINTFORMDW 衣玖は敢えて空気を読んでいないようだ	PRINTFORMDW 衣玖は敢えて空気を読んでいないようだ
PRINTFORMW 「こうしてくつろぐのも悪くは…、ええ」	PRINTFORMW 「こうしてくつろぐのも悪くは…、ええ」
PRINTFORMW 「やはり慎重に越したことはありません」	PRINTFORMW 「やはり慎重に越したことはありません」
PRINTFORMW 「地獄に極楽とはまさにこの事ですね…」	PRINTFORMW 「地獄に極楽とはまさにこの事ですね…」
PRINTFORMDW 衣玖は身に迫る危機を感じ取っている	PRINTFORMDW 衣玖は身に迫る危機を感じ取っている
PRINTFORMW 「…まるで聞き分けのない子供ですね」	PRINTFORMW 「…まるで聞き分けのない子供ですね」
PRINTFORMDW 衣玖から一際強力な電撃が放たれた！	PRINTFORMDW 衣玖から一際強力な電撃が放たれた！
PRINTFORMDW 衣玖は雷球を作り、周囲に放電した！	PRINTFORMDW 衣玖は雷球を作り、周囲に放電した！
PRINTFORMW （本当はこのまま離されないほうが…）	PRINTFORMW （本当はこのまま離されないほうが…）
PRINTFORMDW 衣玖は媚びきった目で触手を見上げた	PRINTFORMDW 衣玖は媚びきった目で触手を見上げた
PRINTFORMDW 衣玖は両手を後ろに回し、尻を隠した	PRINTFORMDW 衣玖は両手を後ろに回し、尻を隠した
PRINTFORMW 「これならまだグレイズで通ります…」	PRINTFORMW 「これならまだグレイズで通ります…」
PRINTFORMDW 衣玖は指を噛んで声を押し殺している	PRINTFORMDW 衣玖は指を噛んで声を押し殺している
PRINTFORMDW 衣玖は最小限の動きで身を身を躱した	PRINTFORMDW 衣玖は最小限の動きで身を身を躱した
PRINTFORMDW 衣玖は恥ずかしがりながら怒っている	PRINTFORMDW 衣玖は恥ずかしがりながら怒っている
PRINTFORMW 「貴方は…、化物ではないようですね」	PRINTFORMW 「貴方は…、化物ではないようですね」
PRINTFORMW 「不束者ですがよろしくお願いします」	PRINTFORMW 「不束者ですがよろしくお願いします」
PRINTFORMW 「たまには景気よく突き進みましょう」	PRINTFORMW 「たまには景気よく突き進みましょう」
PRINTFORMDW 衣玖はふよふよと隣の部屋に移動した	PRINTFORMDW 衣玖はふよふよと隣の部屋に移動した
PRINTFORMDW 衣玖は明らかに顔色が悪くなっている	PRINTFORMDW 衣玖は明らかに顔色が悪くなっている
PRINTFORMW 「ここで戦うべきではない空気です」	PRINTFORMW 「ここで戦うべきではない空気です」
PRINTFORMW 「化物相手なら遠慮も不要でしょう」	PRINTFORMW 「化物相手なら遠慮も不要でしょう」
PRINTFORMW 衣玖は決めポーズをとっている…！？	PRINTFORMW 衣玖は決めポーズをとっている…！？
PRINTFORMDW 衣玖の羽衣が巨大な螺旋を描く！！	PRINTFORMDW 衣玖の羽衣が巨大な螺旋を描く！！
PRINTFORMDW 衣玖は震えながら触手に手を添えた	PRINTFORMDW 衣玖は震えながら触手に手を添えた
PRINTFORMDW 衣玖は屈服し、全てを受け入れた…	PRINTFORMDW 衣玖は屈服し、全てを受け入れた…
PRINTFORMW 「この程度、食らったうちには…！」	PRINTFORMW 「この程度、食らったうちには…！」
PRINTFORMDW 衣玖は羽衣を使い攻撃を受け流した	PRINTFORMDW 衣玖は羽衣を使い攻撃を受け流した
PRINTFORM （もっと…もっと気持ちよくなりたい…	PRINTFORM （もっと…もっと気持ちよくなりたい…
PRINTFORMW 「こんな所にも人は居るんですね…」	PRINTFORMW 「こんな所にも人は居るんですね…」
PRINTFORMW 「やれやれ…一体誰の仕業なのか…」	PRINTFORMW 「やれやれ…一体誰の仕業なのか…」
PRINTFORMW 「総領娘様もまだまだ子供ですね…」	PRINTFORMW 「総領娘様もまだまだ子供ですね…」
PRINTFORMW 「折角ですし、ゆっくりしましょう」	PRINTFORMW 「折角ですし、ゆっくりしましょう」
PRINTFORMW 「無事帰れたら一杯やりたいですね」	PRINTFORMW 「無事帰れたら一杯やりたいですね」
PRINTFORMDW 衣玖は目を輝かせて水を飲んでいる	PRINTFORMDW 衣玖は目を輝かせて水を飲んでいる
PRINTFORMW （これは私が前にでる空気では…）	PRINTFORMW （これは私が前にでる空気では…）
PRINTFORMDW 衣玖から強力な電撃が放たれる！	PRINTFORMDW 衣玖から強力な電撃が放たれる！
PRINTFORMDW 衣玖は電撃棘のバリアを纏った！	PRINTFORMDW 衣玖は電撃棘のバリアを纏った！
PRINTFORMW 「これに触れると…痛いですよ？」	PRINTFORMW 「これに触れると…痛いですよ？」
PRINTFORMDW 衣玖は強力なレーザーを放った！	PRINTFORMDW 衣玖は強力なレーザーを放った！
PRINTFORMDW 衣玖は完全に触手に遊ばれている	PRINTFORMDW 衣玖は完全に触手に遊ばれている
PRINTFORMDW 衣玖は力なく触手に埋もれている	PRINTFORMDW 衣玖は力なく触手に埋もれている
PRINTFORMW 「…私を取って食うつもりですか」	PRINTFORMW 「…私を取って食うつもりですか」
PRINTFORMW 「これではされるがままに…！？」	PRINTFORMW 「これではされるがままに…！？」
PRINTFORMW （はっ…、私は何を考えて…！？）	PRINTFORMW （はっ…、私は何を考えて…！？）
PRINTFORMW 「無駄な争いは避けたいものです」	PRINTFORMW 「無駄な争いは避けたいものです」
PRINTFORMW 「次も上手くいくと良いのですが」	PRINTFORMW 「次も上手くいくと良いのですが」
PRINTFORMDW 衣玖は服についた埃を払っている	PRINTFORMDW 衣玖は服についた埃を払っている
PRINTFORMW 「いや…てっきり貴方の仕業かと」	PRINTFORMW 「いや…てっきり貴方の仕業かと」
PRINTFORMW 「うーん、私の部屋を思い出し…」	PRINTFORMW 「うーん、私の部屋を思い出し…」
PRINTFORMW 「今はそういう空気ではないです」	PRINTFORMW 「今はそういう空気ではないです」
PRINTFORMW 「こういう時こそ…手堅く…！」	PRINTFORMW 「こういう時こそ…手堅く…！」
PRINTFORMW 「力加減が難しいところですね」	PRINTFORMW 「力加減が難しいところですね」
PRINTFORMW 衣玖は静かに力を溜めている…！	PRINTFORMW 衣玖は静かに力を溜めている…！
PRINTFORMDW 衣玖はレーザーで薙ぎ払った！	PRINTFORMDW 衣玖はレーザーで薙ぎ払った！
PRINTFORMDW 衣玖は艶かしく体をうねらせた	PRINTFORMDW 衣玖は艶かしく体をうねらせた
PRINTFORMW 「なんとか脱出しないと…！！」	PRINTFORMW 「なんとか脱出しないと…！！」
PRINTFORMW 「これでは力を溜めようにも…」	PRINTFORMW 「これでは力を溜めようにも…」
PRINTFORMW （乳首が弱いと知られたら…！）	PRINTFORMW （乳首が弱いと知られたら…！）
PRINTFORMDW 衣玖は息ができなくなっている	PRINTFORMDW 衣玖は息ができなくなっている
PRINTFORM 「ん゛ほお゛お゛お゛ぉぉお゛ぉぉ	PRINTFORM 「ん゛ほお゛お゛お゛ぉぉお゛ぉぉ
PRINTFORMDW 衣玖は快楽に身を震わせている	PRINTFORMDW 衣玖は快楽に身を震わせている
PRINTFORMDW 衣玖は快楽にじっと耐えている	PRINTFORMDW 衣玖は快楽にじっと耐えている
PRINTFORMW 「ちょっと許せないですね…！」	PRINTFORMW 「ちょっと許せないですね…！」
PRINTFORMDW 衣玖は無言のまま羽衣を翻した	PRINTFORMDW 衣玖は無言のまま羽衣を翻した
PRINTFORMDW 衣玖のまわりに集中線が見える	PRINTFORMDW 衣玖のまわりに集中線が見える
PRINTFORMDW 衣玖は意識が遠のくのを感じた	PRINTFORMDW 衣玖は意識が遠のくのを感じた
PRINTFORMW 「体が軽くなった気がしますね」	PRINTFORMW 「体が軽くなった気がしますね」
PRINTFORMW 「仕方がありません、私が…」	PRINTFORMW 「仕方がありません、私が…」
PRINTFORMW 「…まずは様子を見ましょう」	PRINTFORMW 「…まずは様子を見ましょう」
PRINTFORMW 「こんな…化物相手に…ッ！」	PRINTFORMW 「こんな…化物相手に…ッ！」
PRINTFORMW 衣玖は両手で股間を覆い隠した	PRINTFORMW 衣玖は両手で股間を覆い隠した
PRINTFORMDW 衣玖は余裕のフリをしている	PRINTFORMDW 衣玖は余裕のフリをしている
PRINTFORMW 「この服は高いんですから…」	PRINTFORMW 「この服は高いんですから…」
PRINTFORMW 「どうやら倒せたようですね」	PRINTFORMW 「どうやら倒せたようですね」
PRINTFORMDW 衣玖は安堵の溜息をついた…	PRINTFORMDW 衣玖は安堵の溜息をついた…
PRINTFORMDW 衣玖は天子をからかっている	PRINTFORMDW 衣玖は天子をからかっている
PRINTFORMW 「酷い休暇もあったものです」	PRINTFORMW 「酷い休暇もあったものです」
PRINTFORMW 「はい、そうですね…、ええ」	PRINTFORMW 「はい、そうですね…、ええ」
PRINTFORMW 「向こう側に気配を感じます」	PRINTFORMW 「向こう側に気配を感じます」
PRINTFORMW 「これで一手有利になるはず」	PRINTFORMW 「これで一手有利になるはず」
PRINTFORML スペシャルサンクス→ぱの人	PRINTFORML スペシャルサンクス→ぱの人
PRINTFORMW 「いずれ隙が生まれるはず」	PRINTFORMW 「いずれ隙が生まれるはず」
PRINTFORMDW 衣玖はじっと身構えている	PRINTFORMDW 衣玖はじっと身構えている
PRINTFORMW 「…良くない気配がします」	PRINTFORMW 「…良くない気配がします」
PRINTFORMW 「戦いには布石が必要です」	PRINTFORMW 「戦いには布石が必要です」
PRINTFORMW 「このままでは…、でも…」	PRINTFORMW 「このままでは…、でも…」
PRINTFORMW 「この…！　離して…ッ！」	PRINTFORMW 「この…！　離して…ッ！」
PRINTFORM 「お゛お゛お゛お゛ぉお゛ぉぉ	PRINTFORM 「お゛お゛お゛お゛ぉお゛ぉぉ
PRINTFORMDW 衣玖は必死に抵抗している	PRINTFORMDW 衣玖は必死に抵抗している
PRINTFORMDW 衣玖はぺこりとお辞儀した	PRINTFORMDW 衣玖はぺこりとお辞儀した
PRINTFORMW 「天界の桃のような味が…」	PRINTFORMW 「天界の桃のような味が…」
PRINTFORMW 「今は守りを固めて…！」	PRINTFORMW 「今は守りを固めて…！」
PRINTFORMW 「これを使いましょう！」	PRINTFORMW 「これを使いましょう！」
PRINTFORMW 「電流のプレゼントです」	PRINTFORMW 「電流のプレゼントです」
PRINTFORMW （今最後にかっこいい…）	PRINTFORMW （今最後にかっこいい…）
PRINTFORMDW 衣玖はもぞもぞしている	PRINTFORMDW 衣玖はもぞもぞしている
PRINTFORMDW 衣玖は大きく咳き込んだ	PRINTFORMDW 衣玖は大きく咳き込んだ
PRINTFORMW （じ…焦らされてる…？）	PRINTFORMW （じ…焦らされてる…？）
PRINTFORMW 「流れを読めばこの程度」	PRINTFORMW 「流れを読めばこの程度」
PRINTFORM （もう…どうなっても…イイ	PRINTFORM （もう…どうなっても…イイ
PRINTFORMW 「今回は出直しましょう」	PRINTFORMW 「今回は出直しましょう」
PRINTFORM 　このままで…いい…かな…	PRINTFORM 　このままで…いい…かな…
PRINTFORMW 「あ…、ま、待って…！」	PRINTFORMW 「あ…、ま、待って…！」
PRINTFORMW 「それでは次に行きます」	PRINTFORMW 「それでは次に行きます」
PRINTFORMW 「和をもって貴しとなす」	PRINTFORMW 「和をもって貴しとなす」
PRINTFORMW 「ゆっくり進みましょう」	PRINTFORMW 「ゆっくり進みましょう」
PRINTFORMW 「…なんでもありません」	PRINTFORMW 「…なんでもありません」
PRINTFORMW 「慎重に探索しましょう」	PRINTFORMW 「慎重に探索しましょう」
PRINTFORMW 「はあ…生き返ります…」	PRINTFORMW 「はあ…生き返ります…」
PRINTFORMDW 衣玖はもじもじしている	PRINTFORMDW 衣玖はもじもじしている
PRINTFORMW 「水、いいですね、水！」	PRINTFORMW 「水、いいですね、水！」
PRINTFORMDW 衣玖はスッと進み出た	PRINTFORMDW 衣玖はスッと進み出た
PRINTFORMDW 衣玖はスッと下がった	PRINTFORMDW 衣玖はスッと下がった
PRINTFORMW （に…逃げないと…！）	PRINTFORMW （に…逃げないと…！）
PRINTFORMW （集中、集中して…！）	PRINTFORMW （集中、集中して…！）
PRINTFORMW 「せめて足止めに…！」	PRINTFORMW 「せめて足止めに…！」
PRINTFORMW 「足止めをしましょう」	PRINTFORMW 「足止めをしましょう」
PRINTFORMW 「踊りは良いものです」	PRINTFORMW 「踊りは良いものです」
PRINTFORMW 「やめてください！！」	PRINTFORMW 「やめてください！！」
PRINTFORM 「ん゛ほお゛お゛お゛ぉぉ	PRINTFORM 「ん゛ほお゛お゛お゛ぉぉ
PRINTFORM 　ああああぁぁぁあああぁ	PRINTFORM 　ああああぁぁぁあああぁ
PRINTFORMW 「せめて羽衣だけは…」	PRINTFORMW 「せめて羽衣だけは…」
PRINTFORMW 「す、すいません…！」	PRINTFORMW 「す、すいません…！」
PRINTFORMW 「はい、お疲れ様です」	PRINTFORMW 「はい、お疲れ様です」
PRINTFORMW 「皆で頑張りましょう」	PRINTFORMW 「皆で頑張りましょう」
PRINTFORM （あ…頭……まっしろに…	PRINTFORM （あ…頭……まっしろに…
PRINTFORMW 「後はお任せします」	PRINTFORMW 「後はお任せします」
PRINTFORMW 「先を急ぎましょう」	PRINTFORMW 「先を急ぎましょう」
PRINTFORMW 「手堅くいきますか」	PRINTFORMW 「手堅くいきますか」
PRINTFORMW 「この丁度…で…！」	PRINTFORMW 「この丁度…で…！」
PRINTFORMW 「今はこれしか…！」	PRINTFORMW 「今はこれしか…！」
PRINTFORM 　私の気持ちを読んで…	PRINTFORM 　私の気持ちを読んで…
PRINTFORMW 「あ……　あぁ……」	PRINTFORMW 「あ……　あぁ……」
PRINTFORMW 「すぅ…、すぅ……」	PRINTFORMW 「すぅ…、すぅ……」
PRINTFORMW 「一旦引きましょう」	PRINTFORMW 「一旦引きましょう」
PRINTFORMW 「あら、総領娘様…」	PRINTFORMW 「あら、総領娘様…」
PRINTFORMW 「はあ…、帰りたい」	PRINTFORMW 「はあ…、帰りたい」
PRINTFORMDW 衣玖は軽く会釈した	PRINTFORMDW 衣玖は軽く会釈した
PRINTFORMDW 衣玖は警戒を解いた	PRINTFORMDW 衣玖は警戒を解いた
PRINTFORMW 「何かありそうな…」	PRINTFORMW 「何かありそうな…」
PRINTFORMW 「あ……　これは…」	PRINTFORMW 「あ……　これは…」
PRINTFORMW （うまく集中が…）	PRINTFORMW （うまく集中が…）
PRINTFORMW 「はあ…はあ……」	PRINTFORMW 「はあ…はあ……」
PRINTFORM 　駄目ですってばぁ…	PRINTFORM 　駄目ですってばぁ…
PRINTFORMW 「んん～～～…ッ」	PRINTFORMW 「んん～～～…ッ」
PRINTFORM （駄目になっちゃう…	PRINTFORM （駄目になっちゃう…
PRINTFORMW 「はい、次どうぞ」	PRINTFORMW 「はい、次どうぞ」
PRINTFORM 　こ、これ…良…いっ	PRINTFORM 　こ、これ…良…いっ
PRINTFORM 　はああぁぁあぁぁ…	PRINTFORM 　はああぁぁあぁぁ…
PRINTFORM 　イかせてくださいッ	PRINTFORM 　イかせてくださいッ
PRINTFORMW 「ま、まずい…！」	PRINTFORMW 「ま、まずい…！」
PRINTFORMW 「あら、総領娘様」	PRINTFORMW 「あら、総領娘様」
PRINTFORMW 「あらこんにちは」	PRINTFORMW 「あらこんにちは」
PRINTFORM 　はやく…はやくッ	PRINTFORM 　はやく…はやくッ
PRINTFORMW 「がッ！…あ…」	PRINTFORMW 「がッ！…あ…」
PRINTFORMW 「うぐ…ッ！？」	PRINTFORMW 「うぐ…ッ！？」
PRINTFORMW 「まだまだです」	PRINTFORMW 「まだまだです」
PRINTFORM 　お゛お゛ぉお゛ぉ	PRINTFORM 　お゛お゛ぉお゛ぉ
PRINTFORM 　おおおぉおぉぉ…	PRINTFORM 　おおおぉおぉぉ…
PRINTFORM 「あっ…、んんっ…	PRINTFORM 「あっ…、んんっ…
PRINTFORMDW 衣玖は会釈した	PRINTFORMDW 衣玖は会釈した
PRINTFORMW 「これで…！」	PRINTFORMW 「これで…！」
PRINTFORMW 「牽制球です」	PRINTFORMW 「牽制球です」
PRINTFORMW 「んんっ…！」	PRINTFORMW 「んんっ…！」
PRINTFORM （もっと欲しい…	PRINTFORM （もっと欲しい…
PRINTFORMW 「そんな…！」	PRINTFORMW 「そんな…！」
PRINTFORMW 「げほッ！！」	PRINTFORMW 「げほッ！！」
PRINTFORMW 「あ゛ッ！？」	PRINTFORMW 「あ゛ッ！？」
PRINTFORMW 「ああッ！！」	PRINTFORMW 「ああッ！！」
PRINTFORMW 「あんッ！？」	PRINTFORMW 「あんッ！？」
PRINTFORM 　こんな…駄目っ	PRINTFORM 　こんな…駄目っ
PRINTFORM 「…くっ…、んっ	PRINTFORM 「…くっ…、んっ
PRINTFORMW 「…それで？」	PRINTFORMW 「…それで？」
PRINTFORMW 「総領娘様…」	PRINTFORMW 「総領娘様…」
PRINTFORMW 「あ、どうも」	PRINTFORMW 「あ、どうも」
PRINTFORMW 「そぉいッ！」	PRINTFORMW 「そぉいッ！」
PRINTFORMW 「…何か？」	PRINTFORMW 「…何か？」
PRINTFORMW 「せいッ！」	PRINTFORMW 「せいッ！」
PRINTFORM 　こん…なの…	PRINTFORM 　こん…なの…
PRINTFORM 「あ…、あぁ…	PRINTFORM 「あ…、あぁ…
PRINTFORM 　堕ち…ても…	PRINTFORM 　堕ち…ても…
PRINTFORM 「あ…手が……	PRINTFORM 「あ…手が……
PRINTFORMW 「くぅぅ…」	PRINTFORMW 「くぅぅ…」
PRINTFORMW 「あ……っ」	PRINTFORMW 「あ……っ」
PRINTFORMW 「う……！」	PRINTFORMW 「う……！」
PRINTFORM 「は…ああ……	PRINTFORM 「は…ああ……
PRINTFORM 　も、もっとッ	PRINTFORM 　も、もっとッ
PRINTFORM 「イかせて…ッ	PRINTFORM 「イかせて…ッ
PRINTFORM 「う…、んっ…	PRINTFORM 「う…、んっ…
PRINTFORM 「あっ、駄目っ	PRINTFORM 「あっ、駄目っ
PRINTFORM 　駄目なのにッ	PRINTFORM 　駄目なのにッ
PRINTFORM 　んッ、ああッ	PRINTFORM 　んッ、ああッ
PRINTFORM 　くぅ…んんっ	PRINTFORM 　くぅ…んんっ
PRINTFORMW 「しまっ…」	PRINTFORMW 「しまっ…」
PRINTFORM 「も…駄目ぇ…	PRINTFORM 「も…駄目ぇ…
PRINTFORMW 「ふぅ…」	PRINTFORMW 「ふぅ…」
PRINTFORMW 「ッ！！」	PRINTFORMW 「ッ！！」
PRINTFORMW 「はッ！」	PRINTFORMW 「はッ！」
PRINTFORM （わ…私……	PRINTFORM （わ…私……
PRINTFORM 「はぁ～～…	PRINTFORM 「はぁ～～…
PRINTFORM （イきたい…	PRINTFORM （イきたい…
PRINTFORM 　うんん……	PRINTFORM 　うんん……
PRINTFORM 　もっと……	PRINTFORM 　もっと……
PRINTFORM 　勝手に……	PRINTFORM 　勝手に……
PRINTFORMW 「ッ！？」	PRINTFORMW 「ッ！？」
PRINTFORMW 「くっ…」	PRINTFORMW 「くっ…」
PRINTFORMW 「痛ッ！」	PRINTFORMW 「痛ッ！」
PRINTFORM 　～～～～ッ	PRINTFORM 　～～～～ッ
PRINTFORM 　あ…お゛っ	PRINTFORM 　あ…お゛っ
PRINTFORM 　ああぁぁ…	PRINTFORM 　ああぁぁ…
PRINTFORM 　くださいッ	PRINTFORM 　くださいッ
PRINTFORM 　こんな…ッ	PRINTFORM 　こんな…ッ
PRINTFORM 　きたぁ……	PRINTFORM 　きたぁ……
PRINTFORMW 「く…っ」	PRINTFORMW 「く…っ」
PRINTFORMW 「…ふぅ」	PRINTFORMW 「…ふぅ」
PRINTFORMW 「う……」	PRINTFORMW 「う……」
PRINTFORMW 「え…？」	PRINTFORMW 「え…？」
PRINTFORMW 「！！」	PRINTFORMW 「！！」
PRINTFORM 「駄…目…	PRINTFORM 「駄…目…
PRINTFORM 　…イイ…	PRINTFORM 　…イイ…
PRINTFORM 　～～～ッ	PRINTFORM 　～～～ッ
PRINTFORM 　んんんッ	PRINTFORM 　んんんッ
PRINTFORM 「んっ……	PRINTFORM 「んっ……
PRINTFORM 「だ、駄目	PRINTFORM 「だ、駄目
PRINTFORM 　あぁ……	PRINTFORM 　あぁ……
PRINTFORMW 「ふぅ」	PRINTFORMW 「ふぅ」
PRINTFORMW 「はい」	PRINTFORMW 「はい」
PRINTFORMW 「う…」	PRINTFORMW 「う…」
PRINTFORMW 「…」	PRINTFORMW 「…」
PRINTFORM 「はひ…	PRINTFORM 「はひ…
PRINTFORM 　は…ぁ	PRINTFORM 　は…ぁ
PRINTFORM 「は…ッ	PRINTFORM 「は…ッ
PRINTFORM 　は……	PRINTFORM 　は……
PRINTFORM 　もう…	PRINTFORM 　もう…
PRINTFORM 　駄目…	PRINTFORM 　駄目…
PRINTFORM 「駄目…	PRINTFORM 「駄目…
PRINTFORM （もう…	PRINTFORM （もう…
PRINTFORM 「ふッ…	PRINTFORM 「ふッ…
PRINTFORM 　～～ッ	PRINTFORM 　～～ッ
PRINTFORM 「んぎッ	PRINTFORM 「んぎッ
PRINTFORM 　あ゛ッ	PRINTFORM 　あ゛ッ
PRINTFORM 　！！　	PRINTFORM 　！！　
PRINTFORM 「いいっ	PRINTFORM 「いいっ
PRINTFORM 「んんッ	PRINTFORM 「んんッ
PRINTFORM 「んひっ	PRINTFORM 「んひっ
PRINTFORM 　い゛っ	PRINTFORM 　い゛っ
PRINTFORM 　んっ…	PRINTFORM 　んっ…
PRINTFORM 「ひっ…	PRINTFORM 「ひっ…
PRINTFORM 　イクッ	PRINTFORM 　イクッ
PRINTFORM 「…んっ	PRINTFORM 「…んっ
PRINTFORM 「あ……	PRINTFORM 「あ……
PRINTFORM 「はー…	PRINTFORM 「はー…
PRINTFORM 　はひ…	PRINTFORM 　はひ…
PRINTFORM 「は…あ	PRINTFORM 「は…あ
PRINTFORM 　ぁ…	PRINTFORM 　ぁ…
PRINTFORM （あ…	PRINTFORM （あ…
PRINTFORM 「ん…	PRINTFORM 「ん…
PRINTFORM 　くっ	PRINTFORM 　くっ
PRINTFORM 　んッ	PRINTFORM 　んッ
PRINTFORM 　ひっ	PRINTFORM 　ひっ
PRINTFORM 　あッ	PRINTFORM 　あッ
PRINTFORM 「んッ	PRINTFORM 「んッ
PRINTFORM 　ふッ	PRINTFORM 　ふッ
PRINTFORM 「んっ	PRINTFORM 「んっ
PRINTFORM （も…	PRINTFORM （も…
PRINTFORM 　あ…	PRINTFORM 　あ…
PRINTFORM 　…	PRINTFORM 　…
PRINTFORMW 」	PRINTFORMW 」
PRINTFORMW ）	PRINTFORMW ）
PRINTFORM 　～	PRINTFORM 　～
PRINTFORM 　ッ	PRINTFORM 　ッ
PRINTFORM 　あ	PRINTFORM 　あ
PRINTFORM 「あ	PRINTFORM 「あ
PRINTFORML 	PRINTFORML 
PRINTFORM 　	PRINTFORM 　
PRINTFORM ）	PRINTFORM ）
PRINTFORM 」	PRINTFORM 」
PRINTFORM 「	PRINTFORM 「
PRINTFORM 	PRINTFORM 
