//口上:

﻿PRINTFORML ---------------------------------------------------------------------------------------------------	PRINTFORML ---------------------------------------------------------------------------------------------------
PRINTFORMDW 身動きが取れなくなった天子はまるで触手を待ち望んでいたかのような顔をした	PRINTFORMDW 身動きが取れなくなった天子はまるで触手を待ち望んでいたかのような顔をした
PRINTFORMDW 絡め取られた天子の頭の中は触手の事でいっぱいになってしまっている	PRINTFORMDW 絡め取られた天子の頭の中は触手の事でいっぱいになってしまっている
PRINTFORMW 「皆で協力しないと駄目だものね、これから一緒に頑張りましょう！」	PRINTFORMW 「皆で協力しないと駄目だものね、これから一緒に頑張りましょう！」
PRINTFORMDW 天子は体の奥底が疼き、気持ちが抑えられなくなっていくのを感じた	PRINTFORMDW 天子は体の奥底が疼き、気持ちが抑えられなくなっていくのを感じた
PRINTFORMDW 天子は絡みつく触手を拒絶したいのかどうか分からなくなっている	PRINTFORMDW 天子は絡みつく触手を拒絶したいのかどうか分からなくなっている
PRINTFORMDW 天子の要石から複数の細いレーザーが下部分目掛けて放たれる	PRINTFORMDW 天子の要石から複数の細いレーザーが下部分目掛けて放たれる
PRINTFORMDW 嫌がる天子の動作は逆に触手を誘っているようにすら見える	PRINTFORMDW 嫌がる天子の動作は逆に触手を誘っているようにすら見える
PRINTFORMW 「私、ここから出たら真面目になろうって思ってるのよね…」	PRINTFORMW 「私、ここから出たら真面目になろうって思ってるのよね…」
PRINTFORMW 「天人くずれの恐ろしさ、存分に見せつけてやるんだから！」	PRINTFORMW 「天人くずれの恐ろしさ、存分に見せつけてやるんだから！」
PRINTFORMDW 天子の要石から全方位に小さいレーザーが撃ち出される！	PRINTFORMDW 天子の要石から全方位に小さいレーザーが撃ち出される！
PRINTFORMDW 天子は目を白黒させながらも貪欲に快楽を受け入れている	PRINTFORMDW 天子は目を白黒させながらも貪欲に快楽を受け入れている
PRINTFORMDW 天子はだらしなく舌を突き出してびくびくと痙攣している	PRINTFORMDW 天子はだらしなく舌を突き出してびくびくと痙攣している
PRINTFORMDW 天子は力が入らないのか、思うように弾幕が撃てない。	PRINTFORMDW 天子は力が入らないのか、思うように弾幕が撃てない。
PRINTFORMDW 複数の要石から放たれたレーザーが魔物を吹き飛ばす！	PRINTFORMDW 複数の要石から放たれたレーザーが魔物を吹き飛ばす！
PRINTFORMDW 天子はまるで自発的に触手に埋もれているように見える	PRINTFORMDW 天子はまるで自発的に触手に埋もれているように見える
PRINTFORMW 「こちらスネーク…これより潜入を開始する…なんてね」	PRINTFORMW 「こちらスネーク…これより潜入を開始する…なんてね」
PRINTFORMDW 天子は快楽のあまり完全に白目を剥いてしまっている	PRINTFORMDW 天子は快楽のあまり完全に白目を剥いてしまっている
PRINTFORMW （もしあのまま捕まってたら、どうなってたのかな…）	PRINTFORMW （もしあのまま捕まってたら、どうなってたのかな…）
PRINTFORMW 「アイテムに頼るのもアレだけど、仕方ないわね…」	PRINTFORMW 「アイテムに頼るのもアレだけど、仕方ないわね…」
PRINTFORMDW 天子は巨大なレーザーで何とか魔物を薙ぎ払った！	PRINTFORMDW 天子は巨大なレーザーで何とか魔物を薙ぎ払った！
PRINTFORMDW 天子は息が上がりながらもレーザーで薙ぎ払った！	PRINTFORMDW 天子は息が上がりながらもレーザーで薙ぎ払った！
PRINTFORMDW 天子は要石を使い、巨大なレーザーで薙ぎ払った！	PRINTFORMDW 天子は要石を使い、巨大なレーザーで薙ぎ払った！
PRINTFORMDW あまりの快楽に天子の意識が飛びそうになっている	PRINTFORMDW あまりの快楽に天子の意識が飛びそうになっている
PRINTFORMDW 天子は余裕のフリをしているが、身体が震えている	PRINTFORMDW 天子は余裕のフリをしているが、身体が震えている
PRINTFORMW 「衣玖もここに迷い込んだのね… 大丈夫だった？」	PRINTFORMW 「衣玖もここに迷い込んだのね… 大丈夫だった？」
PRINTFORMW 「元凶はあんただと思ってたけど、違うなんてね…」	PRINTFORMW 「元凶はあんただと思ってたけど、違うなんてね…」
PRINTFORMW 「罠があるかもしれないし、慎重に探索しないとね」	PRINTFORMW 「罠があるかもしれないし、慎重に探索しないとね」
PRINTFORMW 「うぅ～…苦い… でも、体調が良くなった気が…」	PRINTFORMW 「うぅ～…苦い… でも、体調が良くなった気が…」
PRINTFORMDW 天子は危ない足取りで敵に要石で殴りかかった。	PRINTFORMDW 天子は危ない足取りで敵に要石で殴りかかった。
PRINTFORMDW 天子は勃起している陰核を隠すように守っている	PRINTFORMDW 天子は勃起している陰核を隠すように守っている
PRINTFORMDW 天子は目をトロンとさせて快楽を受け入れている	PRINTFORMDW 天子は目をトロンとさせて快楽を受け入れている
PRINTFORMDW 天子はろくに声も出せず口をパクパクさせている	PRINTFORMDW 天子はろくに声も出せず口をパクパクさせている
PRINTFORMW 「や、やめなさい！ 今なら許してあげるから！」	PRINTFORMW 「や、やめなさい！ 今なら許してあげるから！」
PRINTFORMDW まるで分かっていたかのように天子は身を躱した	PRINTFORMDW まるで分かっていたかのように天子は身を躱した
PRINTFORMW 「まさかここで会うなんて思って無かったわ…」」	PRINTFORMW 「まさかここで会うなんて思って無かったわ…」」
PRINTFORMW 「作った奴は本当に頭がおかしいんじゃないの？」	PRINTFORMW 「作った奴は本当に頭がおかしいんじゃないの？」
PRINTFORMW 「何が居るか分からないし、慎重に進まないとね」	PRINTFORMW 「何が居るか分からないし、慎重に進まないとね」
PRINTFORMDW 天子は要石に身を隠し、ゆっくりと進み始めた…	PRINTFORMDW 天子は要石に身を隠し、ゆっくりと進み始めた…
PRINTFORMW 「待ち伏せしておけば、多少は有利になるかもね」	PRINTFORMW 「待ち伏せしておけば、多少は有利になるかもね」
PRINTFORMDW 天子の巨大な要石が魔物目掛けて飛んで行く！	PRINTFORMDW 天子の巨大な要石が魔物目掛けて飛んで行く！
PRINTFORMDW 天子は巨大な要石を使ってアッパーを放った！	PRINTFORMDW 天子は巨大な要石を使ってアッパーを放った！
PRINTFORMDW 魔物を転ばせるようにレーザーが放たれていく	PRINTFORMDW 魔物を転ばせるようにレーザーが放たれていく
PRINTFORMDW 幾重にも重なるレーザーが魔物を囲んでいく！	PRINTFORMDW 幾重にも重なるレーザーが魔物を囲んでいく！
PRINTFORMDW 天子は極太のレーザーで魔物を焼き尽くした！	PRINTFORMDW 天子は極太のレーザーで魔物を焼き尽くした！
PRINTFORMDW 天子はまるで誘うように触手に抱きついている	PRINTFORMDW 天子はまるで誘うように触手に抱きついている
PRINTFORMDW 天子は腕を振り、拘束から逃れようとしている	PRINTFORMDW 天子は腕を振り、拘束から逃れようとしている
PRINTFORMDW あまりの苦痛に天子は意識が飛びそうになった	PRINTFORMDW あまりの苦痛に天子は意識が飛びそうになった
PRINTFORMW 「…流石にこれは、耐えれそうに無いわね…」」	PRINTFORMW 「…流石にこれは、耐えれそうに無いわね…」」
PRINTFORMW 「誰…！？、なんだ、化け物じゃないみたいね」	PRINTFORMW 「誰…！？、なんだ、化け物じゃないみたいね」
PRINTFORMW 「住めば都とは言うけど、流石にこれはねぇ…」	PRINTFORMW 「住めば都とは言うけど、流石にこれはねぇ…」
PRINTFORMW 「見逃してあげるんだから、感謝しなさい！」	PRINTFORMW 「見逃してあげるんだから、感謝しなさい！」
PRINTFORMDW 天子は敵に狙いを定め、要石を投げつけた。	PRINTFORMDW 天子は敵に狙いを定め、要石を投げつけた。
PRINTFORMW 「…そろそろ、おしまいにさせて貰うわよ？」	PRINTFORMW 「…そろそろ、おしまいにさせて貰うわよ？」
PRINTFORMW 「これが、緋想天エーテルちゃぶ台返しよ！」	PRINTFORMW 「これが、緋想天エーテルちゃぶ台返しよ！」
PRINTFORMDW 天子のか細い腕に触手は更に絡みついてきた	PRINTFORMDW 天子のか細い腕に触手は更に絡みついてきた
PRINTFORMW 「いひぃっ♪ んほぉぉぉぉぉぉぉぉっ♪♪」	PRINTFORMW 「いひぃっ♪ んほぉぉぉぉぉぉぉぉっ♪♪」
PRINTFORMW 「あ゛ひっ♪ ん゛ぃぃぃぃい゛ぃぃっ♪♪」	PRINTFORMW 「あ゛ひっ♪ ん゛ぃぃぃぃい゛ぃぃっ♪♪」
PRINTFORMDW 天子は呆けた表情で口をパクパクさせている	PRINTFORMDW 天子は呆けた表情で口をパクパクさせている
PRINTFORMW 「何よこれ？ もっと真面目にやりなさいよ」	PRINTFORMW 「何よこれ？ もっと真面目にやりなさいよ」
PRINTFORMDW 天子はよろけながらも何とか攻撃を回避した	PRINTFORMDW 天子はよろけながらも何とか攻撃を回避した
PRINTFORMW 「私以外にも迷い込んだ人がいたなんてね…」	PRINTFORMW 「私以外にも迷い込んだ人がいたなんてね…」
PRINTFORMW 「要石に身を潜めればバレずに済むかしら？」	PRINTFORMW 「要石に身を潜めればバレずに済むかしら？」
PRINTFORMW 「う～ん… 天界の桃もこんな味だったわね」	PRINTFORMW 「う～ん… 天界の桃もこんな味だったわね」
PRINTFORMW 「こんな所に、こんな凄い水があるなんて…」	PRINTFORMW 「こんな所に、こんな凄い水があるなんて…」
PRINTFORMW 「あまり力を消耗しないほうがいいわね。」	PRINTFORMW 「あまり力を消耗しないほうがいいわね。」
PRINTFORMDW 天子は肩を震わせながら要石を取り出した	PRINTFORMDW 天子は肩を震わせながら要石を取り出した
PRINTFORMDW 天子はだらしない表情で快楽を貪っている	PRINTFORMDW 天子はだらしない表情で快楽を貪っている
PRINTFORMDW 天子は真っ赤になりながら体を隠している	PRINTFORMDW 天子は真っ赤になりながら体を隠している
PRINTFORMW 「これじゃあ、ただの布切れじゃない…！」	PRINTFORMW 「これじゃあ、ただの布切れじゃない…！」
PRINTFORMW 「しかし本当にじめじめして気味悪いわ…」	PRINTFORMW 「しかし本当にじめじめして気味悪いわ…」
PRINTFORMW 「うーん、結構色んな物が落ちてるのねぇ」	PRINTFORMW 「うーん、結構色んな物が落ちてるのねぇ」
PRINTFORMDW 要石から放たれたレーザーが敵を射抜く	PRINTFORMDW 要石から放たれたレーザーが敵を射抜く
PRINTFORMDW 巨大な要石が敵へと振り下ろされる…！	PRINTFORMDW 巨大な要石が敵へと振り下ろされる…！
PRINTFORMDW 複数の弾幕で魔物の動きを鈍らせていく	PRINTFORMDW 複数の弾幕で魔物の動きを鈍らせていく
PRINTFORMDW 天子は震えながら触手に身を委ねている	PRINTFORMDW 天子は震えながら触手に身を委ねている
PRINTFORMW （もっと…気持ち良くしてくれるの…？）	PRINTFORMW （もっと…気持ち良くしてくれるの…？）
PRINTFORMW （も、もう少しこのままでもいい気が…）	PRINTFORMW （も、もう少しこのままでもいい気が…）
PRINTFORMW （あ… ちょっと気持ちいい…かも…♪）	PRINTFORMW （あ… ちょっと気持ちいい…かも…♪）
PRINTFORMDW 天子はなんとか力を溜めようとしている	PRINTFORMDW 天子はなんとか力を溜めようとしている
PRINTFORMDW 天子は屈服し、全てを受け入れ始めた…	PRINTFORMDW 天子は屈服し、全てを受け入れ始めた…
PRINTFORMDW 天子にはもはや抵抗する気力がなかった	PRINTFORMDW 天子にはもはや抵抗する気力がなかった
PRINTFORMW 「…ふん、何をするっていうのかしら？」	PRINTFORMW 「…ふん、何をするっていうのかしら？」
PRINTFORMW （って…、何考えているのよ、私…！？）	PRINTFORMW （って…、何考えているのよ、私…！？）
PRINTFORMW 「え…、やだ！待って！行かないで！！」	PRINTFORMW 「え…、やだ！待って！行かないで！！」
PRINTFORMW 「もしかするとこれも異変なのかしら？」	PRINTFORMW 「もしかするとこれも異変なのかしら？」
PRINTFORMW 「今日はこの程度で勘弁してやるわ！」	PRINTFORMW 「今日はこの程度で勘弁してやるわ！」
PRINTFORMW 「峰打ちよ、たいした事無いでしょ？」	PRINTFORMW 「峰打ちよ、たいした事無いでしょ？」
PRINTFORMW 天子は要石を振り回し、準備をしている	PRINTFORMW 天子は要石を振り回し、準備をしている
PRINTFORMW 「何でもいいから奴を止めないと…！」	PRINTFORMW 「何でもいいから奴を止めないと…！」
PRINTFORMW （イきたい… もっと、何回でも…♪）	PRINTFORMW （イきたい… もっと、何回でも…♪）
PRINTFORMW 「ぁッ…！ んんっ……！ ふぅ…♪」	PRINTFORMW 「ぁッ…！ んんっ……！ ふぅ…♪」
PRINTFORMDW 天子は痛みで息ができなくなっている	PRINTFORMDW 天子は痛みで息ができなくなっている
PRINTFORMW 「まぁ、丁度いい刺激にはなったわね」	PRINTFORMW 「まぁ、丁度いい刺激にはなったわね」
PRINTFORMDW 発情した天子は、魔物に懇願している	PRINTFORMDW 発情した天子は、魔物に懇願している
PRINTFORMDW 天子は恥ずかしがりながら怒っている	PRINTFORMDW 天子は恥ずかしがりながら怒っている
PRINTFORMW 「まったく、奴らが遅くて助かったわ」	PRINTFORMW 「まったく、奴らが遅くて助かったわ」
PRINTFORMW 「もっと楽に倒せれば嬉しいんだけど」	PRINTFORMW 「もっと楽に倒せれば嬉しいんだけど」
PRINTFORMDW そう言って天子は手を差し出してきた	PRINTFORMDW そう言って天子は手を差し出してきた
PRINTFORMW 「苦いけど… 甘い？不思議な味ねぇ」	PRINTFORMW 「苦いけど… 甘い？不思議な味ねぇ」
PRINTFORML 本音→これから毎日触手宮やろうぜ？	PRINTFORML 本音→これから毎日触手宮やろうぜ？
PRINTFORMW 「こんな奴に…負けるものですか！」	PRINTFORMW 「こんな奴に…負けるものですか！」
PRINTFORMDW 天子は要石に摑まり突撃してきた！	PRINTFORMDW 天子は要石に摑まり突撃してきた！
PRINTFORMDW 巨大な要石が魔物を潰しにかかる！	PRINTFORMDW 巨大な要石が魔物を潰しにかかる！
PRINTFORMW （もっと… もっとちょうだい…♪）	PRINTFORMW （もっと… もっとちょうだい…♪）
PRINTFORMW （おなにぃ…気持ちいいよぉ……♪）	PRINTFORMW （おなにぃ…気持ちいいよぉ……♪）
PRINTFORMW （駄目…こんなの、耐えられない…」	PRINTFORMW （駄目…こんなの、耐えられない…」
PRINTFORMW （お尻が弱いなんて知られたら…！）	PRINTFORMW （お尻が弱いなんて知られたら…！）
PRINTFORMW （胸なんて触らせるものですか…！）	PRINTFORMW （胸なんて触らせるものですか…！）
PRINTFORMW 「いぎっ！？ げほッ！ごほッ！！」	PRINTFORMW 「いぎっ！？ げほッ！ごほッ！！」
PRINTFORMDW 天子はなんとか声を押し殺している	PRINTFORMDW 天子はなんとか声を押し殺している
PRINTFORMW 「折角だし、ゆっくりしましょうか」	PRINTFORMW 「折角だし、ゆっくりしましょうか」
PRINTFORMW 「何でかしら、不思議な泉ねぇ…」」	PRINTFORMW 「何でかしら、不思議な泉ねぇ…」」
PRINTFORMW 「ぁ…っ…！ 何よ、これ…！？」」	PRINTFORMW 「ぁ…っ…！ 何よ、これ…！？」」
PRINTFORMW 「一旦下がらないと危ないわね。」	PRINTFORMW 「一旦下がらないと危ないわね。」
PRINTFORMDW 要石から細いレーザーが放たれる	PRINTFORMDW 要石から細いレーザーが放たれる
PRINTFORMW 「悪いけど、手加減はしないわよ」	PRINTFORMW 「悪いけど、手加減はしないわよ」
PRINTFORMW 天子は巨大な要石を出し始めた…！	PRINTFORMW 天子は巨大な要石を出し始めた…！
PRINTFORMDW 天子は強力なレーザーを放った！	PRINTFORMDW 天子は強力なレーザーを放った！
PRINTFORMDW 天子は完全に触手に遊ばれている	PRINTFORMDW 天子は完全に触手に遊ばれている
PRINTFORMDW 天子は力なく触手に埋もれている	PRINTFORMDW 天子は力なく触手に埋もれている
PRINTFORMDW 天子は触手の責めに体を震わせた	PRINTFORMDW 天子は触手の責めに体を震わせた
PRINTFORMW 「このままじゃ…、でも…うぅ…」	PRINTFORMW 「このままじゃ…、でも…うぅ…」
PRINTFORMDW 天子は蕩けた目で触手を見上げた	PRINTFORMDW 天子は蕩けた目で触手を見上げた
PRINTFORMW 　ん゛ほお゛お゛お゛ぉぉお゛ぉぉ	PRINTFORMW 　ん゛ほお゛お゛お゛ぉぉお゛ぉぉ
PRINTFORMW 「はぁ…、さっさと帰りたいわ…」	PRINTFORMW 「はぁ…、さっさと帰りたいわ…」
PRINTFORMW 「さぁ、倒されたいのは誰！？」	PRINTFORMW 「さぁ、倒されたいのは誰！？」
PRINTFORMW （とにかく、集中しないと…！）	PRINTFORMW （とにかく、集中しないと…！）
PRINTFORMW 「要石をお見舞いしてやるわ！」	PRINTFORMW 「要石をお見舞いしてやるわ！」
PRINTFORMW 「何事にも下準備が必要なのよ」	PRINTFORMW 「何事にも下準備が必要なのよ」
PRINTFORMW （こ…こんなの駄目なのに……）	PRINTFORMW （こ…こんなの駄目なのに……）
PRINTFORMW 「駄…目… こわれちゃぅ……」	PRINTFORMW 「駄…目… こわれちゃぅ……」
PRINTFORMW 「こ…のッ、離しなさいよ…！」	PRINTFORMW 「こ…のッ、離しなさいよ…！」
PRINTFORMW （もう、好きにしなさいよ……）	PRINTFORMW （もう、好きにしなさいよ……）
PRINTFORMDW 天子は衝撃で大きく咳き込んだ	PRINTFORMDW 天子は衝撃で大きく咳き込んだ
PRINTFORMW 「あぐ…っ！ 何するのよ…！」	PRINTFORMW 「あぐ…っ！ 何するのよ…！」
PRINTFORMDW 天子は快楽に身を震わせている	PRINTFORMDW 天子は快楽に身を震わせている
PRINTFORM （もっと…もっと気持ちよくして…	PRINTFORM （もっと…もっと気持ちよくして…
PRINTFORMW 「はぁ…まだ先があるのよね…」	PRINTFORMW 「はぁ…まだ先があるのよね…」
PRINTFORMW 「まったく、誰がこんな事を…」	PRINTFORMW 「まったく、誰がこんな事を…」
PRINTFORMW 「ふぅ… 元気が出てきたわ！」	PRINTFORMW 「ふぅ… 元気が出てきたわ！」
PRINTFORMDW 天子は意識が遠のくのを感じた	PRINTFORMDW 天子は意識が遠のくのを感じた
PRINTFORMDW 天子は腹を押さえ苦しんでいる	PRINTFORMDW 天子は腹を押さえ苦しんでいる
PRINTFORMW 「悪い事ばかりじゃないのね…」	PRINTFORMW 「悪い事ばかりじゃないのね…」
PRINTFORMDW 天子は要石を盾にしている。	PRINTFORMDW 天子は要石を盾にしている。
PRINTFORMW 「とにかく、攻めないと…！」	PRINTFORMW 「とにかく、攻めないと…！」
PRINTFORMW 「せめて足止めしなきゃ…！」	PRINTFORMW 「せめて足止めしなきゃ…！」
PRINTFORMW 「まずは動きを止めなきゃね」	PRINTFORMW 「まずは動きを止めなきゃね」
PRINTFORMDW 天子は身体をくねらせている	PRINTFORMDW 天子は身体をくねらせている
PRINTFORMW 「やぁ…っ！　離して…ッ！」	PRINTFORMW 「やぁ…っ！　離して…ッ！」
PRINTFORMW 「これじゃぁ、力なんて…！」	PRINTFORMW 「これじゃぁ、力なんて…！」
PRINTFORMW （何が何でも脱出しないと！）	PRINTFORMW （何が何でも脱出しないと！）
PRINTFORMW 天子は両手で股間を覆い隠した	PRINTFORMW 天子は両手で股間を覆い隠した
PRINTFORMW 「あなた、天人舐めてない？」	PRINTFORMW 「あなた、天人舐めてない？」
PRINTFORM 「お゛お゛お゛お゛ぉお゛ぉぉっ	PRINTFORM 「お゛お゛お゛お゛ぉお゛ぉぉっ
PRINTFORMW 「んっ…くすぐったいわね。」	PRINTFORMW 「んっ…くすぐったいわね。」
PRINTFORMW 「こ、このままじゃ……！？」	PRINTFORMW 「こ、このままじゃ……！？」
PRINTFORMDW 天子は軽い動きで身を躱した	PRINTFORMDW 天子は軽い動きで身を躱した
PRINTFORM （もう…どうなっても…いいや…	PRINTFORM （もう…どうなっても…いいや…
PRINTFORMW 「はぁ… 酷い目にあったわ」	PRINTFORMW 「はぁ… 酷い目にあったわ」
PRINTFORMW 「仕方ない、出直しましょう」	PRINTFORMW 「仕方ない、出直しましょう」
PRINTFORMW 「まぁ、ざっとこんなものね」	PRINTFORMW 「まぁ、ざっとこんなものね」
PRINTFORMDW 天子は安心した表情を見せた	PRINTFORMDW 天子は安心した表情を見せた
PRINTFORMW 「ふーん… なるほどねぇ…」	PRINTFORMW 「ふーん… なるほどねぇ…」
PRINTFORMDW 天子は要石を構え走り出した	PRINTFORMDW 天子は要石を構え走り出した
PRINTFORMW 「さぁ、天子様のお通りよ！」	PRINTFORMW 「さぁ、天子様のお通りよ！」
PRINTFORMW （集中、集中しないと…！）	PRINTFORMW （集中、集中しないと…！）
PRINTFORMW （ふふん… 決まったわね）	PRINTFORMW （ふふん… 決まったわね）
PRINTFORMW 「はぁ… 気持ち悪いわ…」	PRINTFORMW 「はぁ… 気持ち悪いわ…」
PRINTFORMDW 天子は必死に抵抗している	PRINTFORMDW 天子は必死に抵抗している
PRINTFORMW 「この服高いんだから…！」	PRINTFORMW 「この服高いんだから…！」
PRINTFORMW 「ちょっと許せないわね…」	PRINTFORMW 「ちょっと許せないわね…」
PRINTFORM 　このままでも…いぃ…かも…	PRINTFORM 　このままでも…いぃ…かも…
PRINTFORMW 「あら、あなたもいたのね」	PRINTFORMW 「あら、あなたもいたのね」
PRINTFORM （もっと…もっとちょうだぃ…	PRINTFORM （もっと…もっとちょうだぃ…
PRINTFORMW 「ふ～ぅ… 生き返るわ…」	PRINTFORMW 「ふ～ぅ… 生き返るわ…」
PRINTFORMW 「はぁ～～ 生き返った…」	PRINTFORMW 「はぁ～～ 生き返った…」
PRINTFORMW 「嫌な予感しかしないもの」	PRINTFORMW 「嫌な予感しかしないもの」
PRINTFORMW 「ぅ… はめられたわね…」	PRINTFORMW 「ぅ… はめられたわね…」
PRINTFORMW 「ここは守らないと…！」	PRINTFORMW 「ここは守らないと…！」
PRINTFORMW 「は…ッ… だめぇ……」	PRINTFORMW 「は…ッ… だめぇ……」
PRINTFORMW 「ふーん… この程度？」	PRINTFORMW 「ふーん… この程度？」
PRINTFORM 　こ、これ…気持ち…良ぃ…	PRINTFORM 　こ、これ…気持ち…良ぃ…
PRINTFORM 　こんなの、駄目なのにぃッ	PRINTFORM 　こんなの、駄目なのにぃッ
PRINTFORMW 「ご、ごめんなさい…！」	PRINTFORMW 「ご、ごめんなさい…！」
PRINTFORMW 「何か使えそうな物は…」	PRINTFORMW 「何か使えそうな物は…」
PRINTFORMDW 天子はもじもじしている	PRINTFORMDW 天子はもじもじしている
PRINTFORMW 「まぁ、警戒しないとね」	PRINTFORMW 「まぁ、警戒しないとね」
PRINTFORML スペシャルサンクス→俺	PRINTFORML スペシャルサンクス→俺
PRINTFORMW （に、逃げないと…！）	PRINTFORMW （に、逃げないと…！）
PRINTFORMW 「これで…仕舞いよ！」	PRINTFORMW 「これで…仕舞いよ！」
PRINTFORMW 「駄目…これ以上は…」	PRINTFORMW 「駄目…これ以上は…」
PRINTFORMW 「あ…っ、ふぅ…っ！」	PRINTFORMW 「あ…っ、ふぅ…っ！」
PRINTFORM 　ああああぁぁぁあああぁ	PRINTFORM 　ああああぁぁぁあああぁ
PRINTFORM 　もっと気持ちよくして…	PRINTFORM 　もっと気持ちよくして…
PRINTFORMW 「あら、衣玖じゃない」	PRINTFORMW 「あら、衣玖じゃない」
PRINTFORML 作った人→ガルンダス	PRINTFORML 作った人→ガルンダス
PRINTFORMW 「後は任せたわよ。」	PRINTFORMW 「後は任せたわよ。」
PRINTFORMW 「この程度で十分ね」	PRINTFORMW 「この程度で十分ね」
PRINTFORMW 「これで終わりよ！」	PRINTFORMW 「これで終わりよ！」
PRINTFORMW 「一緒に踊らない？」	PRINTFORMW 「一緒に踊らない？」
PRINTFORMW 「はぁ… ぁっ…♪」	PRINTFORMW 「はぁ… ぁっ…♪」
PRINTFORMW 「ん… ぁっ……♪」	PRINTFORMW 「ん… ぁっ……♪」
PRINTFORMW 「がぁ…っ！…ぁ…」	PRINTFORMW 「がぁ…っ！…ぁ…」
PRINTFORMW 「すぅ…、すぅ……」	PRINTFORMW 「すぅ…、すぅ……」
PRINTFORMW 「あ、ありがとう…」	PRINTFORMW 「あ、ありがとう…」
PRINTFORMW 「気が利くじゃない」	PRINTFORMW 「気が利くじゃない」
PRINTFORMW 「それじゃあ、次ね」	PRINTFORMW 「それじゃあ、次ね」
PRINTFORMW 「あら、こんにちは」	PRINTFORMW 「あら、こんにちは」
PRINTFORMDW 天子は軽く挨拶した	PRINTFORMDW 天子は軽く挨拶した
PRINTFORMDW 天子は軽く会釈した	PRINTFORMDW 天子は軽く会釈した
PRINTFORMW 「突撃あるのみよ！」	PRINTFORMW 「突撃あるのみよ！」
PRINTFORMW 「…誰か来てるわね」	PRINTFORMW 「…誰か来てるわね」
PRINTFORMW 「防いでみせる！」	PRINTFORMW 「防いでみせる！」
PRINTFORMW 「これを使うわ！」	PRINTFORMW 「これを使うわ！」
PRINTFORMW 「まずは様子見ね」	PRINTFORMW 「まずは様子見ね」
PRINTFORMW 「どっせぇぇぃ！」	PRINTFORMW 「どっせぇぇぃ！」
PRINTFORMW 「はあ…はあ……」	PRINTFORMW 「はあ…はあ……」
PRINTFORMW 「あぁ…うぁっ…」	PRINTFORMW 「あぁ…うぁっ…」
PRINTFORM 　はああぁぁあぁぁ…	PRINTFORM 　はああぁぁあぁぁ…
PRINTFORMW 「ぁ……ぁぅ……」	PRINTFORMW 「ぁ……ぁぅ……」
PRINTFORMW 「構えが遅いわね」	PRINTFORMW 「構えが遅いわね」
PRINTFORMW 「ま、まずい…！」	PRINTFORMW 「ま、まずい…！」
PRINTFORMW 「身体が軽い…？」	PRINTFORMW 「身体が軽い…？」
PRINTFORMW 「進撃開始よ！」	PRINTFORMW 「進撃開始よ！」
PRINTFORMW 「戦術的撤退！」	PRINTFORMW 「戦術的撤退！」
PRINTFORMW 「このぉぉっ！」	PRINTFORMW 「このぉぉっ！」
PRINTFORMW 「はぁぁっ！！」	PRINTFORMW 「はぁぁっ！！」
PRINTFORMW 「ぁ…うぅ……」	PRINTFORMW 「ぁ…うぅ……」
PRINTFORMW 「う゛ぁっ！？」	PRINTFORMW 「う゛ぁっ！？」
PRINTFORM 　おおおぉおぉぉ…	PRINTFORM 　おおおぉおぉぉ…
PRINTFORMW 「な、しまっ…」	PRINTFORMW 「な、しまっ…」
PRINTFORMW 「あ…、衣玖…」	PRINTFORMW 「あ…、衣玖…」
PRINTFORMDW 天子は会釈した	PRINTFORMDW 天子は会釈した
PRINTFORMW 「弾幕発射！」	PRINTFORMW 「弾幕発射！」
PRINTFORMW 「はぁぁっ！」	PRINTFORMW 「はぁぁっ！」
PRINTFORMW 「んんっ…！」	PRINTFORMW 「んんっ…！」
PRINTFORMW 「くぅ…っ！」	PRINTFORMW 「くぅ…っ！」
PRINTFORMW 「ひぐっ…！」	PRINTFORMW 「ひぐっ…！」
PRINTFORMW 「痛……っ！」	PRINTFORMW 「痛……っ！」
PRINTFORMW 「く…っ！？」	PRINTFORMW 「く…っ！？」
PRINTFORMW 「きゃっ！！」	PRINTFORMW 「きゃっ！！」
PRINTFORMW 「あぁっ！？」	PRINTFORMW 「あぁっ！？」
PRINTFORMW 「わわっ！？」	PRINTFORMW 「わわっ！？」
PRINTFORM 　―――――-ッ	PRINTFORM 　―――――-ッ
PRINTFORM 「あっ、だめぇっ	PRINTFORM 「あっ、だめぇっ
PRINTFORM 　んッ、ああぁッ	PRINTFORM 　んッ、ああぁッ
PRINTFORM 「…くっ…、んっ	PRINTFORM 「…くっ…、んっ
PRINTFORMW 「あら、衣玖」	PRINTFORMW 「あら、衣玖」
PRINTFORMW 「く…っ！」	PRINTFORMW 「く…っ！」
PRINTFORMW 「そぉぃ！」	PRINTFORMW 「そぉぃ！」
PRINTFORMW 「ぁっ…♪」	PRINTFORMW 「ぁっ…♪」
PRINTFORMW 「ぁ……っ」	PRINTFORMW 「ぁ……っ」
PRINTFORMW 「甘いわね」	PRINTFORMW 「甘いわね」
PRINTFORM 「お゛ぉっ！？	PRINTFORM 「お゛ぉっ！？
PRINTFORM 「は…ぁぁ……	PRINTFORM 「は…ぁぁ……
PRINTFORM 　も、もっとッ	PRINTFORM 　も、もっとッ
PRINTFORM 　ちょうだいッ	PRINTFORM 　ちょうだいッ
PRINTFORM 「イかせて…ッ	PRINTFORM 「イかせて…ッ
PRINTFORM 「う…、んっ…	PRINTFORM 「う…、んっ…
PRINTFORM 　イッちゃぅぅ	PRINTFORM 　イッちゃぅぅ
PRINTFORM 「だ、駄目ぇっ	PRINTFORM 「だ、駄目ぇっ
PRINTFORM 　ぁああぁぁ…	PRINTFORM 　ぁああぁぁ…
PRINTFORM 「は…ぁっ……	PRINTFORM 「は…ぁっ……
PRINTFORMW 「ほぃっと」	PRINTFORMW 「ほぃっと」
PRINTFORMW 「遅いわよ」	PRINTFORMW 「遅いわよ」
PRINTFORM 「もう…駄目…	PRINTFORM 「もう…駄目…
PRINTFORMW 「突撃ー！」	PRINTFORMW 「突撃ー！」
PRINTFORMW 「うぅ……」	PRINTFORMW 「うぅ……」
PRINTFORMW 「ほぇ…？」	PRINTFORMW 「ほぇ…？」
PRINTFORMW 「はっ！」	PRINTFORMW 「はっ！」
PRINTFORMW 「ッ！？」	PRINTFORMW 「ッ！？」
PRINTFORMW 「つ…っ」	PRINTFORMW 「つ…っ」
PRINTFORM 　んほぉぉっ	PRINTFORM 　んほぉぉっ
PRINTFORM 　あ…お゛っ	PRINTFORM 　あ…お゛っ
PRINTFORM 　ああぁぁ…	PRINTFORM 　ああぁぁ…
PRINTFORM 　あふっ……	PRINTFORM 　あふっ……
PRINTFORM 　きたぁ……	PRINTFORM 　きたぁ……
PRINTFORMW 「よっと」	PRINTFORMW 「よっと」
PRINTFORMW 「ぁ…っ」	PRINTFORMW 「ぁ…っ」
PRINTFORMW 「うぅ…」	PRINTFORMW 「うぅ…」
PRINTFORM 「はぁ…ぁっ	PRINTFORM 「はぁ…ぁっ
PRINTFORM 「んひぃッ	PRINTFORM 「んひぃッ
PRINTFORM 「んぎぃッ	PRINTFORM 「んぎぃッ
PRINTFORM 　あ゛ぁッ	PRINTFORM 　あ゛ぁッ
PRINTFORM 「いひぃっ	PRINTFORM 「いひぃっ
PRINTFORM 「はひっ…	PRINTFORM 「はひっ…
PRINTFORM 「ひぅっ…	PRINTFORM 「ひぅっ…
PRINTFORM 「んっ……	PRINTFORM 「んっ……
PRINTFORM 「んひぃっ	PRINTFORM 「んひぃっ
PRINTFORM 　だめぇ…	PRINTFORM 　だめぇ…
PRINTFORM 　くぅ…ッ	PRINTFORM 　くぅ…ッ
PRINTFORM 　はひっ…	PRINTFORM 　はひっ…
PRINTFORM 　ひぅっ…	PRINTFORM 　ひぅっ…
PRINTFORM 　ぁひっ…	PRINTFORM 　ぁひっ…
PRINTFORM 　～～ッ	PRINTFORM 　～～ッ
PRINTFORM 　あ゛ッ	PRINTFORM 　あ゛ッ
PRINTFORM 　！！　	PRINTFORM 　！！　
PRINTFORM 「んんッ	PRINTFORM 「んんッ
PRINTFORM 「んひっ	PRINTFORM 「んひっ
PRINTFORM 　い゛っ	PRINTFORM 　い゛っ
PRINTFORM 「んぁっ	PRINTFORM 「んぁっ
PRINTFORM 　はぁッ	PRINTFORM 　はぁッ
PRINTFORM 　んっ…	PRINTFORM 　んっ…
PRINTFORM 　イクっ	PRINTFORM 　イクっ
PRINTFORM 「ぁ……	PRINTFORM 「ぁ……
PRINTFORM 「はぁ…	PRINTFORM 「はぁ…
PRINTFORM （もぅ…	PRINTFORM （もぅ…
PRINTFORM 　ぁ……	PRINTFORM 　ぁ……
PRINTFORM 　ひっ	PRINTFORM 　ひっ
PRINTFORM 　あッ	PRINTFORM 　あッ
PRINTFORM 　おっ	PRINTFORM 　おっ
PRINTFORM 　ぃっ	PRINTFORM 　ぃっ
PRINTFORM （あ…	PRINTFORM （あ…
PRINTFORMW 」	PRINTFORMW 」
PRINTFORM 　～	PRINTFORM 　～
PRINTFORM 　ッ	PRINTFORM 　ッ
PRINTFORM 　あ	PRINTFORM 　あ
PRINTFORM 「あ	PRINTFORM 「あ
PRINTFORMW ）	PRINTFORMW ）
PRINTFORML 	PRINTFORML 
PRINTFORM 「	PRINTFORM 「
PRINTFORM 	PRINTFORM 
PRINTFORM	PRINTFORM
