﻿PRINTFORML いつものように可能性空間移動船で魔法、魔力の研究に没頭していた岡崎夢美	!#!PRINTFORML いつものように可能性空間移動船で魔法、魔力の研究に没頭していた岡崎夢美
PRINTFORML そんな彼女には最近気になっていることがある	!#!PRINTFORML そんな彼女には最近気になっていることがある
PRINTFORML ちゆり伝いに聞いた話なのだが、幻想郷に異空間へと繋がる〝穴〟がつい最近発見されたという話	!#!PRINTFORML ちゆり伝いに聞いた話なのだが、幻想郷に異空間へと繋がる〝穴〟がつい最近発見されたという話
PRINTFORML 好奇心旺盛な夢美は早速その場所を里の人間や妖怪達に聞きまわった	!#!PRINTFORML 好奇心旺盛な夢美は早速その場所を里の人間や妖怪達に聞きまわった
PRINTFORMW ようやくその場所を特定したのだが、その〝穴〟というのは小さなものだった	!#!PRINTFORMW ようやくその場所を特定したのだが、その〝穴〟というのは小さなものだった
PRINTFORML 人一人がしゃがみこめば潜れるような広さしかなく、どう考えても船は置いていくしか無かった	!#!PRINTFORML 人一人がしゃがみこめば潜れるような広さしかなく、どう考えても船は置いていくしか無かった
PRINTFORML 夢美はちゆりに留守番を任せ、一人で調査することを決意	!#!PRINTFORML 夢美はちゆりに留守番を任せ、一人で調査することを決意
PRINTFORML そしてその〝穴〟に歩いて近づいたときのことである　穴からおびただしい量の触手が伸びてきたのだ！	!#!PRINTFORML そしてその〝穴〟に歩いて近づいたときのことである　穴からおびただしい量の触手が伸びてきたのだ！
PRINTFORML 夢美は危険を感じて船に戻ろうと思うも、触手に足を掴まれてしまう！	!#!PRINTFORML 夢美は危険を感じて船に戻ろうと思うも、触手に足を掴まれてしまう！
PRINTFORML 慌てて助手の名前を叫ぶも、あっという間に異空間へ引きずり込まれてしまうのだった…	!#!PRINTFORML 慌てて助手の名前を叫ぶも、あっという間に異空間へ引きずり込まれてしまうのだった…
PRINTFORML 	!#!PRINTFORML 
PRINTFORMW 	!#!PRINTFORMW 
PRINTFORML 東方夢時空ラスボスの、岡崎夢美の口上です	!#!PRINTFORML 東方夢時空ラスボスの、岡崎夢美の口上です
PRINTFORML ヨガることはありません　堕落しない姫騎士的な	!#!PRINTFORML ヨガることはありません　堕落しない姫騎士的な
PRINTFORML 「気丈 プライド高い 一線越えない」がついているので、それをイメージしています	!#!PRINTFORML 「気丈 プライド高い 一線越えない」がついているので、それをイメージしています
PRINTFORML 口調的には原作霊夢に近いイメージ	!#!PRINTFORML 口調的には原作霊夢に近いイメージ
PRINTFORML 魔法使いと出会うとテンションが上がりますが	!#!PRINTFORML 魔法使いと出会うとテンションが上がりますが
PRINTFORML 好奇心旺盛なので誰と合ってもテンションがあがるかも	!#!PRINTFORML 好奇心旺盛なので誰と合ってもテンションがあがるかも
PRINTFORML 文字色は薄いめの赤	!#!PRINTFORML 文字色は薄いめの赤
PRINTFORML 作：だおもん	!#!PRINTFORML 作：だおもん
PRINTFORMW (落ち着くのよ…何か手を考えて…）	!#!PRINTFORMW (落ち着くのよ…何か手を考えて…）
PRINTFORMW （なんとかしなきゃ！　なんとか…！）	!#!PRINTFORMW （なんとかしなきゃ！　なんとか…！）
PRINTFORMW （こんなときにすごい魔法でも使えたら…）	!#!PRINTFORMW （こんなときにすごい魔法でも使えたら…）
PRINTFORMW 「様子見しましょう」	!#!PRINTFORMW 「様子見しましょう」
PRINTFORMW 「それ！」	!#!PRINTFORMW 「それ！」
PRINTFORMW 「一気に片付けるわよ！」	!#!PRINTFORMW 「一気に片付けるわよ！」
PRINTFORMW 「仕方がないわね、もう」	!#!PRINTFORMW 「仕方がないわね、もう」
PRINTFORMW 「体制を立て直すわ」	!#!PRINTFORMW 「体制を立て直すわ」
PRINTFORMW 「距離を取らせてもらうわよ」	!#!PRINTFORMW 「距離を取らせてもらうわよ」
PRINTFORMW 「不味いかも…」	!#!PRINTFORMW 「不味いかも…」
PRINTFORMW 「倒すしかないかしら…」	!#!PRINTFORMW 「倒すしかないかしら…」
PRINTFORMW 「ちょっと…危ないわね」	!#!PRINTFORMW 「ちょっと…危ないわね」
PRINTFORMW 「見逃してくれると嬉しいんだけど…」	!#!PRINTFORMW 「見逃してくれると嬉しいんだけど…」
PRINTFORMW 「今は堪えるのよ…！」	!#!PRINTFORMW 「今は堪えるのよ…！」
PRINTFORMW 「う、上手く狙えない…」	!#!PRINTFORMW 「う、上手く狙えない…」
PRINTFORMW 「はぁ！」	!#!PRINTFORMW 「はぁ！」
PRINTFORMW 「じっくり狙って…」	!#!PRINTFORMW 「じっくり狙って…」
PRINTFORMW 「体が…アツい…」	!#!PRINTFORMW 「体が…アツい…」
PRINTFORMW 「集中、集中…！」	!#!PRINTFORMW 「集中、集中…！」
PRINTFORMW 「やぁ！」	!#!PRINTFORMW 「やぁ！」
PRINTFORMW 「似非魔法を舐めないでよね！」	!#!PRINTFORMW 「似非魔法を舐めないでよね！」
PRINTFORML 「か、体が震えて集中できない…！」	!#!PRINTFORML 「か、体が震えて集中できない…！」
PRINTFORMW 夢美は誘惑に堪え、弾幕を放った！	!#!PRINTFORMW 夢美は誘惑に堪え、弾幕を放った！
PRINTFORMW 「はぁ、はぁっ…」	!#!PRINTFORMW 「はぁ、はぁっ…」
PRINTFORML 「これでトドメよ！」	!#!PRINTFORML 「これでトドメよ！」
PRINTFORMW 夢美は両手に力をこめ、弾幕を放った！	!#!PRINTFORMW 夢美は両手に力をこめ、弾幕を放った！
PRINTFORML 「食らいなさい！」	!#!PRINTFORML 「食らいなさい！」
PRINTFORMW 夢美は敵に向けて十字架を飛ばした！	!#!PRINTFORMW 夢美は敵に向けて十字架を飛ばした！
PRINTFORML 「はあぁ……」	!#!PRINTFORML 「はあぁ……」
PRINTFORMW 夢美は目を閉じて集中し、己の力を高めている！	!#!PRINTFORMW 夢美は目を閉じて集中し、己の力を高めている！
PRINTFORML 「そろそろ…消えて！」	!#!PRINTFORML 「そろそろ…消えて！」
PRINTFORMW 巨大な十字架で敵を押し潰す！	!#!PRINTFORMW 巨大な十字架で敵を押し潰す！
PRINTFORML 「こんなところで…やられてたまるもんですか！」	!#!PRINTFORML 「こんなところで…やられてたまるもんですか！」
PRINTFORMW 溜まった力を解放し、強烈な弾幕を放った！	!#!PRINTFORMW 溜まった力を解放し、強烈な弾幕を放った！
PRINTFORML 「苺クロス！」	!#!PRINTFORML 「苺クロス！」
PRINTFORML 「これで終わりよ！　夢幻伝説！」	!#!PRINTFORML 「これで終わりよ！　夢幻伝説！」
PRINTFORMW 「どれかに当たって…！」	!#!PRINTFORMW 「どれかに当たって…！」
PRINTFORMW 「こっちに来ないで…！」	!#!PRINTFORMW 「こっちに来ないで…！」
PRINTFORML 「こんなのはいかが？」	!#!PRINTFORML 「こんなのはいかが？」
PRINTFORMW 夢美の全方位弾が敵を足止めする！	!#!PRINTFORMW 夢美の全方位弾が敵を足止めする！
PRINTFORML 「さあ、動けなくしちゃうわよ！」	!#!PRINTFORML 「さあ、動けなくしちゃうわよ！」
PRINTFORML 「一気に片付けないと…不味いわね」	!#!PRINTFORML 「一気に片付けないと…不味いわね」
PRINTFORMW 強度が高く、鋭い弾が複数の敵を巻き込む！	!#!PRINTFORMW 強度が高く、鋭い弾が複数の敵を巻き込む！
PRINTFORML 「か、体が疼いてるっ…でも、今は敵を倒すのよ！」	!#!PRINTFORML 「か、体が疼いてるっ…でも、今は敵を倒すのよ！」
PRINTFORMW 強度が高い十字架が複数の敵を巻き込む！	!#!PRINTFORMW 強度が高い十字架が複数の敵を巻き込む！
PRINTFORML 「面倒臭いわねぇ、もう！」	!#!PRINTFORML 「面倒臭いわねぇ、もう！」
PRINTFORML 「これが科学の力よ！」	!#!PRINTFORML 「これが科学の力よ！」
PRINTFORMW 「これでトドメよ！」	!#!PRINTFORMW 「これでトドメよ！」
PRINTFORMW 「今は戦いに専念するのよ…」	!#!PRINTFORMW 「今は戦いに専念するのよ…」
PRINTFORMW 「食らいなさい！」	!#!PRINTFORMW 「食らいなさい！」
PRINTFORMW 「頭がぼーっとして…狙いが…ブレる…」	!#!PRINTFORMW 「頭がぼーっとして…狙いが…ブレる…」
PRINTFORMW 「面倒臭いわねぇ、もう！」	!#!PRINTFORMW 「面倒臭いわねぇ、もう！」
PRINTFORMW 「お、落ち着くのよ…！」	!#!PRINTFORMW 「お、落ち着くのよ…！」
PRINTFORMW 「科学者を舐めないでよ！」	!#!PRINTFORMW 「科学者を舐めないでよ！」
PRINTFORMW 「ソコ、がら空きよ！」	!#!PRINTFORMW 「ソコ、がら空きよ！」
PRINTFORMW （もしかしたら…ここが弱点！？）	!#!PRINTFORMW （もしかしたら…ここが弱点！？）
PRINTFORMW 「くぅっ！　体に力が入らない…」	!#!PRINTFORMW 「くぅっ！　体に力が入らない…」
PRINTFORMW （こ、この敏感そうなココは守っておかないと…）	!#!PRINTFORMW （こ、この敏感そうなココは守っておかないと…）
PRINTFORMW （どこかに隙があるはずよ！）	!#!PRINTFORMW （どこかに隙があるはずよ！）
PRINTFORMW 「…ちゆり、後は任せたわよ」	!#!PRINTFORMW 「…ちゆり、後は任せたわよ」
PRINTFORMW 「あぁんもう、最悪！」	!#!PRINTFORMW 「あぁんもう、最悪！」
PRINTFORMW 「そ、そんな所触らないで！」	!#!PRINTFORMW 「そ、そんな所触らないで！」
PRINTFORMW （ち、乳首は守らないと…）	!#!PRINTFORMW （ち、乳首は守らないと…）
PRINTFORMW （気持ち悪い物だけど…守らないとまた全身が痺れてしまう！）	!#!PRINTFORMW （気持ち悪い物だけど…守らないとまた全身が痺れてしまう！）
PRINTFORMW （こ、ここは守らないと…また全身が痺れてしまう！）	!#!PRINTFORMW （こ、ここは守らないと…また全身が痺れてしまう！）
PRINTFORMW 「ダメダメダメ！　ここは大事な場所なんだから！」	!#!PRINTFORMW 「ダメダメダメ！　ここは大事な場所なんだから！」
PRINTFORMW 「ぐっ！　げほっ…うぅ…」	!#!PRINTFORMW 「ぐっ！　げほっ…うぅ…」
PRINTFORMW 「だ、誰か…助け…」	!#!PRINTFORMW 「だ、誰か…助け…」
PRINTFORMW 「ち、ちゆり……」	!#!PRINTFORMW 「ち、ちゆり……」
PRINTFORMW 「うっ、げほっ、ごほっ！」	!#!PRINTFORMW 「うっ、げほっ、ごほっ！」
PRINTFORMW 「あっ、ぐうぅっ！　ま、まだ…」	!#!PRINTFORMW 「あっ、ぐうぅっ！　ま、まだ…」
PRINTFORMW 「きゃあ！　ぼ、防御しきれなっ…！」	!#!PRINTFORMW 「きゃあ！　ぼ、防御しきれなっ…！」
PRINTFORMW 「うぐっ！？　や、やったわね…」	!#!PRINTFORMW 「うぐっ！？　や、やったわね…」
PRINTFORMW 「いっ…たいわね、んもう！」	!#!PRINTFORMW 「いっ…たいわね、んもう！」
PRINTFORMW 「お、覚えてなさい！」	!#!PRINTFORMW 「お、覚えてなさい！」
PRINTFORMW 「まだやれるわよ！」	!#!PRINTFORMW 「まだやれるわよ！」
PRINTFORMW 「い、イってる！？　イかされてっ…んんんんっ！」	!#!PRINTFORMW 「い、イってる！？　イかされてっ…んんんんっ！」
PRINTFORMW 「だ、ダメっ、頭の中溶けてるっ…ふあああぁぁん！」	!#!PRINTFORMW 「だ、ダメっ、頭の中溶けてるっ…ふあああぁぁん！」
PRINTFORMW 「んひいぃ！？　い、意識飛んじゃう！？」	!#!PRINTFORMW 「んひいぃ！？　い、意識飛んじゃう！？」
PRINTFORMW （き、気持ち良いはずないがない！　…でも、体痺れてっ…！）	!#!PRINTFORMW （き、気持ち良いはずないがない！　…でも、体痺れてっ…！）
PRINTFORMW 「くっ、んんんんんっ！？」	!#!PRINTFORMW 「くっ、んんんんんっ！？」
PRINTFORMW 「きゃふんっ！　や、やめてっ！」	!#!PRINTFORMW 「きゃふんっ！　や、やめてっ！」
PRINTFORMW （そ、そこ刺激されるのは…！）	!#!PRINTFORMW （そ、そこ刺激されるのは…！）
PRINTFORML 「…い…いや………」	!#!PRINTFORML 「…い…いや………」
PRINTFORMW 夢美に抗う意思はあるが、もう体がついてこない様だ…	!#!PRINTFORMW 夢美に抗う意思はあるが、もう体がついてこない様だ…
PRINTFORMW 「なんとかしないと…なんとかしないと…！」	!#!PRINTFORMW 「なんとかしないと…なんとかしないと…！」
PRINTFORMW 「何考えているのよ！　え、エッチなことは嫌よ！」	!#!PRINTFORMW 「何考えているのよ！　え、エッチなことは嫌よ！」
PRINTFORMW 「せ、正々堂々戦いなさいよー！」	!#!PRINTFORMW 「せ、正々堂々戦いなさいよー！」
PRINTFORMW 「あっ！？　う、嘘……」	!#!PRINTFORMW 「あっ！？　う、嘘……」
PRINTFORMW 「な、何を狙ってるのよ！」	!#!PRINTFORMW 「な、何を狙ってるのよ！」
PRINTFORMW 「イヤイヤイヤ！　なんとかして防がないと！」	!#!PRINTFORMW 「イヤイヤイヤ！　なんとかして防がないと！」
PRINTFORMW 「まだ倒れるわけには…」	!#!PRINTFORMW 「まだ倒れるわけには…」
PRINTFORMW 「遅い！」	!#!PRINTFORMW 「遅い！」
PRINTFORMW 「甘いわよ！」	!#!PRINTFORMW 「甘いわよ！」
PRINTFORMW 「当たるわけには…！」	!#!PRINTFORMW 「当たるわけには…！」
PRINTFORMW 「そ、そういう破廉恥なのはやめてよ！」	!#!PRINTFORMW 「そ、そういう破廉恥なのはやめてよ！」
PRINTFORMW 「ここの怪物は皆こうことしか考えていないの！？」	!#!PRINTFORMW 「ここの怪物は皆こうことしか考えていないの！？」
PRINTFORMW 「そういうのは防ぎようがないんだから、勘弁してよね！」	!#!PRINTFORMW 「そういうのは防ぎようがないんだから、勘弁してよね！」
PRINTFORMW 「危ないじゃないの、もう！」	!#!PRINTFORMW 「危ないじゃないの、もう！」
PRINTFORMW 「はぁっ、はぁっ…！」	!#!PRINTFORMW 「はぁっ、はぁっ…！」
PRINTFORMW （早く安全な場所を確保して休まないと…）	!#!PRINTFORMW （早く安全な場所を確保して休まないと…）
PRINTFORMW 「やった！」	!#!PRINTFORMW 「やった！」
PRINTFORMW 「さあ、次はどいつ？」	!#!PRINTFORMW 「さあ、次はどいつ？」
PRINTFORMW 「はぁ…はぁ…まだ、やられるわけには…」	!#!PRINTFORMW 「はぁ…はぁ…まだ、やられるわけには…」
PRINTFORMW 「回復するか、安全な場所まで逃げて休まないと…」	!#!PRINTFORMW 「回復するか、安全な場所まで逃げて休まないと…」
PRINTFORMW 「ち…ゆ、り……」	!#!PRINTFORMW 「ち…ゆ、り……」
PRINTFORMW 「おかあ…さん…」	!#!PRINTFORMW 「おかあ…さん…」
PRINTFORMW 「やぁん、もう！」	!#!PRINTFORMW 「やぁん、もう！」
PRINTFORMW 「やめてったら！」	!#!PRINTFORMW 「やめてったら！」
PRINTFORMW 「何が狙いなのよ！」	!#!PRINTFORMW 「何が狙いなのよ！」
PRINTFORMW 「これ以上破かれるのは…」	!#!PRINTFORMW 「これ以上破かれるのは…」
PRINTFORMW 「ま、まさか本当に裸にされるなんて…！」	!#!PRINTFORMW 「ま、まさか本当に裸にされるなんて…！」
PRINTFORMW 「きゃああぁぁ！　は、早く代えを！」	!#!PRINTFORMW 「きゃああぁぁ！　は、早く代えを！」
PRINTFORMW 「ま、不味い…！」	!#!PRINTFORMW 「ま、不味い…！」
PRINTFORMW 「ゆ、油断したっ！？」	!#!PRINTFORMW 「ゆ、油断したっ！？」
PRINTFORMW 「へっ？　な、何か流し込まれた！？」	!#!PRINTFORMW 「へっ？　な、何か流し込まれた！？」
PRINTFORMW 「いだっ！　も、もしかして…」	!#!PRINTFORMW 「いだっ！　も、もしかして…」
PRINTFORMW 「いだっ！　て、敵！？」	!#!PRINTFORMW 「いだっ！　て、敵！？」
PRINTFORMW 「いだっ！　んもー、寝てるときぐらい出てこないでよね…」	!#!PRINTFORMW 「いだっ！　んもー、寝てるときぐらい出てこないでよね…」
PRINTFORMW 「…ま…また……」	!#!PRINTFORMW 「…ま…また……」
PRINTFORML 「こ、こっち見たら殴るわよ！」	!#!PRINTFORML 「こ、こっち見たら殴るわよ！」
PRINTFORML 「…変態」	!#!PRINTFORML 「…変態」
PRINTFORML 「これは仕方なくよ！　仕方なく！　好きでやっているんじゃないの…」	!#!PRINTFORML 「これは仕方なくよ！　仕方なく！　好きでやっているんじゃないの…」
PRINTFORMW 「ふぅっ…んんんっ！？」	!#!PRINTFORMW 「ふぅっ…んんんっ！？」
PRINTFORMW 「あのまま戦っていたら今頃…」	!#!PRINTFORMW 「あのまま戦っていたら今頃…」
PRINTFORMW 「使えるアイテムとか無かったかしら…」	!#!PRINTFORMW 「使えるアイテムとか無かったかしら…」
PRINTFORMW 「私は先を急いでいるのよ」	!#!PRINTFORMW 「私は先を急いでいるのよ」
PRINTFORMW 「わ、私…もうダメかも……」	!#!PRINTFORMW 「わ、私…もうダメかも……」
PRINTFORMW 「こんな…ところで…」	!#!PRINTFORMW 「こんな…ところで…」
PRINTFORML 「……」	!#!PRINTFORML 「……」
PRINTFORMW 夢美は戦う力を失い、抵抗することが出来ない様だ…	!#!PRINTFORMW 夢美は戦う力を失い、抵抗することが出来ない様だ…
PRINTFORMW 「あ…ありがとう……」	!#!PRINTFORMW 「あ…ありがとう……」
PRINTFORMW 「これが似非科学の力よ！」	!#!PRINTFORMW 「これが似非科学の力よ！」
PRINTFORMW 「もしかしたら私って妖怪退治屋になれるかも？　まあ忙しいけどね」	!#!PRINTFORMW 「もしかしたら私って妖怪退治屋になれるかも？　まあ忙しいけどね」
PRINTFORMW 「ふー…早く帰って綺麗なお布団で休みたいわね」	!#!PRINTFORMW 「ふー…早く帰って綺麗なお布団で休みたいわね」
PRINTFORMW 「勝てばいい、それが全てよ！」	!#!PRINTFORMW 「勝てばいい、それが全てよ！」
PRINTFORML 「…まあ、こんなものかしら」	!#!PRINTFORML 「…まあ、こんなものかしら」
PRINTFORMW 夢美は伸びをして呼吸を整え、詮索に戻った…	!#!PRINTFORMW 夢美は伸びをして呼吸を整え、詮索に戻った…
PRINTFORML 「ちゆり、ごめん！」	!#!PRINTFORML 「ちゆり、ごめん！」
PRINTFORML 「このままでは共倒れになるかもしれないから、一旦引くわ！」	!#!PRINTFORML 「このままでは共倒れになるかもしれないから、一旦引くわ！」
PRINTFORMW 「戻ってくるわよ！　心配しないで！」	!#!PRINTFORMW 「戻ってくるわよ！　心配しないで！」
PRINTFORML 「ごめんなさい！」	!#!PRINTFORML 「ごめんなさい！」
PRINTFORML 「ちょ、ちょっと待ちなさいよちゆり！」	!#!PRINTFORML 「ちょ、ちょっと待ちなさいよちゆり！」
PRINTFORML 「…も、戻ってくるのよね…？」	!#!PRINTFORML 「…も、戻ってくるのよね…？」
PRINTFORMW 「信じてるわよー！」	!#!PRINTFORMW 「信じてるわよー！」
PRINTFORML 「ちょ、ちょっと待ちなさいよ！」	!#!PRINTFORML 「ちょ、ちょっと待ちなさいよ！」
PRINTFORMW 「…い、生きてるの？」	!#!PRINTFORMW 「…い、生きてるの？」
PRINTFORML 「ちゆり！」	!#!PRINTFORML 「ちゆり！」
PRINTFORMW 「お留守番するように言ってたじゃないの！　どうしてここに居るのよ！」	!#!PRINTFORMW 「お留守番するように言ってたじゃないの！　どうしてここに居るのよ！」
PRINTFORML 「靈夢！　靈夢じゃない！」	!#!PRINTFORML 「靈夢！　靈夢じゃない！」
PRINTFORMW 「え？　霊夢なの？　しかも私のこと覚えていないの？　酷い！」	!#!PRINTFORMW 「え？　霊夢なの？　しかも私のこと覚えていないの？　酷い！」
PRINTFORML 「魔理沙！　魔理沙よね！　あなたにあげたICBMはどうしたの？」	!#!PRINTFORML 「魔理沙！　魔理沙よね！　あなたにあげたICBMはどうしたの？」
PRINTFORMW 「え？　そんなこと覚えていない？　大丈夫なのかしら…」	!#!PRINTFORMW 「え？　そんなこと覚えていない？　大丈夫なのかしら…」
PRINTFORML 「あら、本物の魔女さん？」	!#!PRINTFORML 「あら、本物の魔女さん？」
PRINTFORMW 「素敵。是非ともお近づきになりたいわ」	!#!PRINTFORMW 「素敵。是非ともお近づきになりたいわ」
PRINTFORML 「あら、時を止められるメイドさん？」	!#!PRINTFORML 「あら、時を止められるメイドさん？」
PRINTFORML 「あら、吸血鬼さん？」	!#!PRINTFORML 「あら、吸血鬼さん？」
PRINTFORML 「あら、本物の魔法使い…え？　人形の魔法使いさん？」	!#!PRINTFORML 「あら、本物の魔法使い…え？　人形の魔法使いさん？」
PRINTFORML 「あら、あなたは…半人半霊？　変わっているのね」	!#!PRINTFORML 「あら、あなたは…半人半霊？　変わっているのね」
PRINTFORML 「あら、亡霊さん？」	!#!PRINTFORML 「あら、亡霊さん？」
PRINTFORML 「あら、あなたが境界を操るっていう妖怪？」	!#!PRINTFORML 「あら、あなたが境界を操るっていう妖怪？」
PRINTFORMW 「素敵。是非とも研究してみたいわ」	!#!PRINTFORMW 「素敵。是非とも研究してみたいわ」
PRINTFORML 「あら、あなた鬼なの？」	!#!PRINTFORML 「あら、あなた鬼なの？」
PRINTFORML 「あら、あなた月の住人なの？」	!#!PRINTFORML 「あら、あなた月の住人なの？」
PRINTFORML 「あら、もしかしてあのカグヤ姫さん！？」	!#!PRINTFORML 「あら、もしかしてあのカグヤ姫さん！？」
PRINTFORMW 「素敵！　是非ともお近づきになりたいわ」	!#!PRINTFORMW 「素敵！　是非ともお近づきになりたいわ」
PRINTFORML 「あら、あなた死なない人間なの？」	!#!PRINTFORML 「あら、あなた死なない人間なの？」
PRINTFORML 「あら、もしかして天狗さん？」	!#!PRINTFORML 「あら、もしかして天狗さん？」
PRINTFORML 「あら、あなたお花を操る妖怪なの？」	!#!PRINTFORML 「あら、あなたお花を操る妖怪なの？」
PRINTFORML 「あら、あなた死神さん？」	!#!PRINTFORML 「あら、あなた死神さん？」
PRINTFORML 「あら、あなた閻魔様なんですか？」	!#!PRINTFORML 「あら、あなた閻魔様なんですか？」
PRINTFORMW 「素敵。是非ともお近づきになりたいわ。でも私の舌は抜かないでね…」	!#!PRINTFORMW 「素敵。是非ともお近づきになりたいわ。でも私の舌は抜かないでね…」
PRINTFORML 「あら、神様なんですか？」	!#!PRINTFORML 「あら、神様なんですか？」
PRINTFORMW 「素敵。是非ともお近づきになりたいです」	!#!PRINTFORMW 「素敵。是非ともお近づきになりたいです」
PRINTFORML 「あら、あなた河童なの？」	!#!PRINTFORML 「あら、あなた河童なの？」
PRINTFORML 「あら、あなた天狗さん？　え？　正しくは白狼天狗？」	!#!PRINTFORML 「あら、あなた天狗さん？　え？　正しくは白狼天狗？」
PRINTFORML 「あら、あなたも巫女さん？」	!#!PRINTFORML 「あら、あなたも巫女さん？」
PRINTFORML 「あら…あ、あなたただの人間じゃないの！？　こ、こんなところに居て大丈夫なの！？」	!#!PRINTFORML 「あら…あ、あなたただの人間じゃないの！？　こ、こんなところに居て大丈夫なの！？」
PRINTFORMW 「え？　私もただの人間にしか見えない？　ま、まあね…」	!#!PRINTFORMW 「え？　私もただの人間にしか見えない？　ま、まあね…」
PRINTFORML 「あら、あなたは…え！？　大学生！？　こんなところで何してるのよ！」	!#!PRINTFORML 「あら、あなたは…え！？　大学生！？　こんなところで何してるのよ！」
PRINTFORMW 「…あいつらの慰み者にされても知らないわよ」	!#!PRINTFORMW 「…あいつらの慰み者にされても知らないわよ」
PRINTFORML 「あら、いつぞやの悪霊さん」	!#!PRINTFORML 「あら、いつぞやの悪霊さん」
PRINTFORMW 「あなたも迷い込んでしまったの？」	!#!PRINTFORMW 「あなたも迷い込んでしまったの？」
PRINTFORML 「あら、魔界の神様なの？」	!#!PRINTFORML 「あら、魔界の神様なの？」
PRINTFORMW 「とっても素敵。是非とも私の研究に…いや、なんでも」	!#!PRINTFORMW 「とっても素敵。是非とも私の研究に…いや、なんでも」
PRINTFORML 「あら、あなたおもしろそう。リュウグウノツカイ？」	!#!PRINTFORML 「あら、あなたおもしろそう。リュウグウノツカイ？」
PRINTFORML 「あら、あなた天界の住民さん？」	!#!PRINTFORML 「あら、あなた天界の住民さん？」
PRINTFORML 「あら、あなた心を読める妖怪なの？」	!#!PRINTFORML 「あら、あなた心を読める妖怪なの？」
PRINTFORMW 「素敵。是非とも研究してみたいわ。…どうして遠ざかるの？」	!#!PRINTFORMW 「素敵。是非とも研究してみたいわ。…どうして遠ざかるの？」
PRINTFORML 「あら、あなた仙人なの？」	!#!PRINTFORML 「あら、あなた仙人なの？」
PRINTFORML 「あら、これは…幽霊？」	!#!PRINTFORML 「あら、これは…幽霊？」
PRINTFORMW 「う～ん…一体何者なのかしら…」	!#!PRINTFORMW 「う～ん…一体何者なのかしら…」
PRINTFORML 「あら、あなたお人形さん？」	!#!PRINTFORML 「あら、あなたお人形さん？」
PRINTFORMW 「素敵。抱っこしてもいいかしら？」	!#!PRINTFORMW 「素敵。抱っこしてもいいかしら？」
PRINTFORML 「あら、本物の魔法使いさん？」	!#!PRINTFORML 「あら、本物の魔法使いさん？」
PRINTFORML 「あら、仏僧さん？　え、ちょっと違う？　魔法を使う仏僧さん？」	!#!PRINTFORML 「あら、仏僧さん？　え、ちょっと違う？　魔法を使う仏僧さん？」
PRINTFORMW 「すごく素敵。今度私の研究に…いえ、なんでも」	!#!PRINTFORMW 「すごく素敵。今度私の研究に…いえ、なんでも」
PRINTFORML 「あら、あなたもしかしてあの鵺？」	!#!PRINTFORML 「あら、あなたもしかしてあの鵺？」
PRINTFORML 「あら、あなた仙人なの？　え？　ちょっと違う？」	!#!PRINTFORML 「あら、あなた仙人なの？　え？　ちょっと違う？」
PRINTFORMW 「でもまあ、素敵。是非ともお近づきになりたいわ」	!#!PRINTFORMW 「でもまあ、素敵。是非ともお近づきになりたいわ」
PRINTFORML 「え？　嘘！　あなたあの聖徳太子なの！？」	!#!PRINTFORML 「え？　嘘！　あなたあの聖徳太子なの！？」
PRINTFORML 「敵！？」	!#!PRINTFORML 「敵！？」
PRINTFORMW 「…ではない、わよね？」	!#!PRINTFORMW 「…ではない、わよね？」
PRINTFORMW 「あら、おもしろそうな方。素敵」	!#!PRINTFORMW 「あら、おもしろそうな方。素敵」
PRINTFORMW 「あら、あなたも迷い込んでしまった方？」	!#!PRINTFORMW 「あら、あなたも迷い込んでしまった方？」
PRINTFORML 「ちゆり、ちょっと別のところを調べてくるわ」	!#!PRINTFORML 「ちゆり、ちょっと別のところを調べてくるわ」
PRINTFORMW 「出口でも見つけておいて！」	!#!PRINTFORMW 「出口でも見つけておいて！」
PRINTFORML 「ちょっと別のところを調べてくるわ」	!#!PRINTFORML 「ちょっと別のところを調べてくるわ」
PRINTFORMW 「それじゃあ、気をつけてね」	!#!PRINTFORMW 「それじゃあ、気をつけてね」
PRINTFORML 「ねぇ、月のお姫様が起こしたという異変があるでしょ？」	!#!PRINTFORML 「ねぇ、月のお姫様が起こしたという異変があるでしょ？」
PRINTFORML 「それよりも以前に永遠の月が置かれたことがあるの、ご存知？」	!#!PRINTFORML 「それよりも以前に永遠の月が置かれたことがあるの、ご存知？」
PRINTFORMW 「あれ実は私が…え？　そんなこと知らない？　そ、そう…」	!#!PRINTFORMW 「あれ実は私が…え？　そんなこと知らない？　そ、そう…」
PRINTFORML 「ねぇあなた、幻想郷に帰ったら私の実験に付き合ってみない？」	!#!PRINTFORML 「ねぇあなた、幻想郷に帰ったら私の実験に付き合ってみない？」
PRINTFORML 「ちょっとベッドに縛られてもらって色々するだけだから大丈夫！」	!#!PRINTFORML 「ちょっとベッドに縛られてもらって色々するだけだから大丈夫！」
PRINTFORMW 「え？　そんな怪しいのに付き合えない？　残念…」	!#!PRINTFORMW 「え？　そんな怪しいのに付き合えない？　残念…」
PRINTFORMW 「本家で出番が欲しいなー…私だって弾幕ごっこしたいのに」	!#!PRINTFORMW 「本家で出番が欲しいなー…私だって弾幕ごっこしたいのに」
PRINTFORMW 「幻想郷に戻りたいわね…こんな汚いところから抜け出したいわ…」	!#!PRINTFORMW 「幻想郷に戻りたいわね…こんな汚いところから抜け出したいわ…」
PRINTFORMW 「私が周辺を調査した結果はこんな感じ」	!#!PRINTFORMW 「私が周辺を調査した結果はこんな感じ」
PRINTFORML 「ありがと、ちゆり」	!#!PRINTFORML 「ありがと、ちゆり」
PRINTFORMW 「帰ったら掃除でもやっておきなさいよ！」	!#!PRINTFORMW 「帰ったら掃除でもやっておきなさいよ！」
PRINTFORML 「ありがとう！」	!#!PRINTFORML 「ありがとう！」
PRINTFORML 「どうしてなのよー！」	!#!PRINTFORML 「どうしてなのよー！」
PRINTFORMW 「よこしなさいよー！　こらー、ちゆりー！」	!#!PRINTFORMW 「よこしなさいよー！　こらー、ちゆりー！」
PRINTFORML 「ないなら、仕方ないわね」	!#!PRINTFORML 「ないなら、仕方ないわね」
PRINTFORMW 「私も人にあげるほどの余裕はないし…またね…」	!#!PRINTFORMW 「私も人にあげるほどの余裕はないし…またね…」
PRINTFORMW 「さっさとここの出口を探すわよ！」	!#!PRINTFORMW 「さっさとここの出口を探すわよ！」
PRINTFORML 「あなたおもしろそう。そんなあなたと組めるなんて素敵」	!#!PRINTFORML 「あなたおもしろそう。そんなあなたと組めるなんて素敵」
PRINTFORML 「幻想郷に戻ったら私の実験を手伝ってくれない！？」	!#!PRINTFORML 「幻想郷に戻ったら私の実験を手伝ってくれない！？」
PRINTFORMW 「え？　嫌？　それは残念…」	!#!PRINTFORMW 「え？　嫌？　それは残念…」
PRINTFORMW 「じゃあ、あんた一人で出口探しておいてよね！」	!#!PRINTFORMW 「じゃあ、あんた一人で出口探しておいてよね！」
PRINTFORML 「おもしろそうなあなたと組んで研究用のデータを取る計画が…」	!#!PRINTFORML 「おもしろそうなあなたと組んで研究用のデータを取る計画が…」
PRINTFORML 「な、なんでもないのよ！　なんでもないの！」	!#!PRINTFORML 「な、なんでもないのよ！　なんでもないの！」
PRINTFORMW 「残念だけど、そっちはそっちで気をつけてね」	!#!PRINTFORMW 「残念だけど、そっちはそっちで気をつけてね」
PRINTFORMW 「仕方がないわね、力を貸してあげるわよ」	!#!PRINTFORMW 「仕方がないわね、力を貸してあげるわよ」
PRINTFORML 「私と一緒に行動してくれるの！？　素敵！」	!#!PRINTFORML 「私と一緒に行動してくれるの！？　素敵！」
PRINTFORML 「あなたのデータはバッチリ記録させてもらうわ！」	!#!PRINTFORML 「あなたのデータはバッチリ記録させてもらうわ！」
PRINTFORMW 「も、もちろん脱出するために協力もするわよ！」	!#!PRINTFORMW 「も、もちろん脱出するために協力もするわよ！」
PRINTFORMW 「私は別のところを調べてみるわ」	!#!PRINTFORMW 「私は別のところを調べてみるわ」
PRINTFORMW 「…痛いじゃない！　もう！」	!#!PRINTFORMW 「…痛いじゃない！　もう！」
PRINTFORMW 「…ちょっと、ここ危なくない？」	!#!PRINTFORMW 「…ちょっと、ここ危なくない？」
PRINTFORML 「やっぱり！　ふっ、んんんっ！」	!#!PRINTFORML 「やっぱり！　ふっ、んんんっ！」
PRINTFORML 「くうんっ！　は、離れて！」	!#!PRINTFORML 「くうんっ！　は、離れて！」
PRINTFORML 「寝かせてよー！　きゃんっ！」	!#!PRINTFORML 「寝かせてよー！　きゃんっ！」
PRINTFORMW 「んんっ…くっ…あぁ…」	!#!PRINTFORMW 「んんっ…くっ…あぁ…」
PRINTFORML 「やっぱり、こんなことするんじゃなかったわ…」	!#!PRINTFORML 「やっぱり、こんなことするんじゃなかったわ…」
PRINTFORMW 夢美は俯き、自分にそう言い聞かせた…	!#!PRINTFORMW 夢美は俯き、自分にそう言い聞かせた…
PRINTFORMW 「う、嘘！？　な、何かが出ちゃっ…！」	!#!PRINTFORMW 「う、嘘！？　な、何かが出ちゃっ…！」
PRINTFORMW 「こ、こんな所でイくなんてっ…！」	!#!PRINTFORMW 「こ、こんな所でイくなんてっ…！」
PRINTFORMW 男性器での絶頂に戸惑いながらも、夢美は喘ぎ声を漏らした…	!#!PRINTFORMW 男性器での絶頂に戸惑いながらも、夢美は喘ぎ声を漏らした…
PRINTFORML 「や、いやっ！　い、意識飛んじゃう！」	!#!PRINTFORML 「や、いやっ！　い、意識飛んじゃう！」
PRINTFORMW 絶頂に達したせいか、夢美の体は震えながら反っている！	!#!PRINTFORMW 絶頂に達したせいか、夢美の体は震えながら反っている！
PRINTFORML 「うぅっ…！　あああぁぁぁぁぁっ！」	!#!PRINTFORML 「うぅっ…！　あああぁぁぁぁぁっ！」
PRINTFORML 「んんんっ！？　あっ、くうんんんんっ！」	!#!PRINTFORML 「んんんっ！？　あっ、くうんんんんっ！」
PRINTFORMW 絶頂のせいか、夢美の視界が明滅を繰り返す！	!#!PRINTFORMW 絶頂のせいか、夢美の視界が明滅を繰り返す！
PRINTFORMW 「…さ、もう大丈夫」	!#!PRINTFORMW 「…さ、もう大丈夫」
PRINTFORMW 「…だ…だれか……うううっ！」	!#!PRINTFORMW 「…だ…だれか……うううっ！」
PRINTFORMW 「やっ……あぁぁっ！」	!#!PRINTFORMW 「やっ……あぁぁっ！」
PRINTFORMW 「うっ！　あっ！　うぅっ…………」	!#!PRINTFORMW 「うっ！　あっ！　うぅっ…………」
PRINTFORMW 「で、出るわけが…え、嘘ぉ！？」	!#!PRINTFORMW 「で、出るわけが…え、嘘ぉ！？」
PRINTFORMW 「い、痛っ！　やめっ…す、吸われてる！？」	!#!PRINTFORMW 「い、痛っ！　やめっ…す、吸われてる！？」
PRINTFORMW (ん？　い、今何か動…)	!#!PRINTFORMW (ん？　い、今何か動…)
PRINTFORML 「んっ！？」	!#!PRINTFORML 「んっ！？」
PRINTFORML 「あ、いや、なんでもないわ…」	!#!PRINTFORML 「あ、いや、なんでもないわ…」
PRINTFORMW (お腹の中に何かいる…！？)	!#!PRINTFORMW (お腹の中に何かいる…！？)
PRINTFORML 「な、ナカにいる！？」	!#!PRINTFORML 「な、ナカにいる！？」
PRINTFORML 「あっ…んんんっ！　い、痛っ！」	!#!PRINTFORML 「あっ…んんんっ！　い、痛っ！」
PRINTFORMW （私の中から出て行ってよ…）	!#!PRINTFORMW （私の中から出て行ってよ…）
PRINTFORML 「げほっ、ごほっ…うぅっ…」	!#!PRINTFORML 「げほっ、ごほっ…うぅっ…」
PRINTFORMW 「はぁ…はぁ…い、一体何が起こってるの…」	!#!PRINTFORMW 「はぁ…はぁ…い、一体何が起こってるの…」
PRINTFORMW （あれ？　さっきのは何だったのかしら？）	!#!PRINTFORMW （あれ？　さっきのは何だったのかしら？）
PRINTFORML 「嘘…これって…」	!#!PRINTFORML 「嘘…これって…」
PRINTFORMW 「こ、こんなに早く子供が出来るわけないじゃない！」	!#!PRINTFORMW 「こ、こんなに早く子供が出来るわけないじゃない！」
PRINTFORMW 「そもそもあんな怪物との子供なんかできるわけがないのよ！」	!#!PRINTFORMW 「そもそもあんな怪物との子供なんかできるわけがないのよ！」
PRINTFORML 「うぐっ！　お、お腹蹴ってる…」	!#!PRINTFORML 「うぐっ！　お、お腹蹴ってる…」
PRINTFORMW 「病院でもあればすぐに中絶して欲しいんだけど…」	!#!PRINTFORMW 「病院でもあればすぐに中絶して欲しいんだけど…」
PRINTFORML 「出口が見つからないし…産んでしまうしかないの…」	!#!PRINTFORML 「出口が見つからないし…産んでしまうしかないの…」
PRINTFORML 「うっ！？　げほっ、ごほっ！　こ、これってつわりなの…」	!#!PRINTFORML 「うっ！？　げほっ、ごほっ！　こ、これってつわりなの…」
PRINTFORMW 「…うぅ、ぐすっ！　怪物との子供なんか産みたくないのに…誰か助けてよ……」	!#!PRINTFORMW 「…うぅ、ぐすっ！　怪物との子供なんか産みたくないのに…誰か助けてよ……」
PRINTFORML 「はぁ…はぁ…うぐっ、げほっ…はぁ、はぁ…」	!#!PRINTFORML 「はぁ…はぁ…うぐっ、げほっ…はぁ、はぁ…」
PRINTFORML 「い、痛！　お、お腹破れそう！」	!#!PRINTFORML 「い、痛！　お、お腹破れそう！」
PRINTFORML 「いやあぁぁぁぁぁぁぁ！　痛い、痛い、痛い！」	!#!PRINTFORML 「いやあぁぁぁぁぁぁぁ！　痛い、痛い、痛い！」
PRINTFORML 「い、痛いのに…苦しいのに…体おかしい…イかされそうに…んんんんっ！？」	!#!PRINTFORML 「い、痛いのに…苦しいのに…体おかしい…イかされそうに…んんんんっ！？」
PRINTFORMW 痛みに堪える夢美だが、同時に未知なる快楽にも襲われている！	!#!PRINTFORMW 痛みに堪える夢美だが、同時に未知なる快楽にも襲われている！
PRINTFORMW 「や、やめてよ！　乳首はダメ…あううぅぅっ！」	!#!PRINTFORMW 「や、やめてよ！　乳首はダメ…あううぅぅっ！」
PRINTFORML 「ば、化け物の子供生んでイくなんて…ありえない…！」	!#!PRINTFORML 「ば、化け物の子供生んでイくなんて…ありえない…！」
PRINTFORMW 「ダメ、イかされちゃう！　いやあああああああぁぁぁぁぁ！」	!#!PRINTFORMW 「ダメ、イかされちゃう！　いやあああああああぁぁぁぁぁ！」
PRINTFORML 「ば、化け物との子供生んでイくなんて…ありえない…！」	!#!PRINTFORML 「ば、化け物との子供生んでイくなんて…ありえない…！」
PRINTFORML 「えい、やー！　触手退散！」	!#!PRINTFORML 「えい、やー！　触手退散！」
PRINTFORML 夢美は科学の力で小さな触手を消し去った！	!#!PRINTFORML 夢美は科学の力で小さな触手を消し去った！
PRINTFORML 「急いで安全な場所を確保しないと…」	!#!PRINTFORML 「急いで安全な場所を確保しないと…」
PRINTFORML 「出口！　出口はどこなの！」	!#!PRINTFORML 「出口！　出口はどこなの！」
PRINTFORML 「この部屋は…大丈夫かしら？」	!#!PRINTFORML 「この部屋は…大丈夫かしら？」
PRINTFORML 「敵がいるのなら、私が相手になるわよ！」	!#!PRINTFORML 「敵がいるのなら、私が相手になるわよ！」
PRINTFORML 「そーっと…そーっと…」	!#!PRINTFORML 「そーっと…そーっと…」
PRINTFORML 「何も居ませんように…」	!#!PRINTFORML 「何も居ませんように…」
PRINTFORML 足音を殺し、物陰から周囲の気配を探っている…	!#!PRINTFORML 足音を殺し、物陰から周囲の気配を探っている…
PRINTFORML 「いきなり出てくるのとかはやめてよね…」	!#!PRINTFORML 「いきなり出てくるのとかはやめてよね…」
PRINTFORML 「こういうときに限って何か出てきそうなのよね…」	!#!PRINTFORML 「こういうときに限って何か出てきそうなのよね…」
PRINTFORML 「まだまだ…こんなところでやられるわけにはいかないのよ…」	!#!PRINTFORML 「まだまだ…こんなところでやられるわけにはいかないのよ…」
PRINTFORML 夢美は呼吸を整えつつ、物陰に隠れて様子を伺う…	!#!PRINTFORML 夢美は呼吸を整えつつ、物陰に隠れて様子を伺う…
PRINTFORML 「さぁ…来るなら来てみなさい…！」	!#!PRINTFORML 「さぁ…来るなら来てみなさい…！」
PRINTFORML 「こういうときに限って罠にひっかかったりするのよね…」	!#!PRINTFORML 「こういうときに限って罠にひっかかったりするのよね…」
PRINTFORML 「体の調子を整えるアイテムが都合よく見つかると良いんだけど…」	!#!PRINTFORML 「体の調子を整えるアイテムが都合よく見つかると良いんだけど…」
PRINTFORML 「研究の役に立つものでも見つからないかしら」	!#!PRINTFORML 「研究の役に立つものでも見つからないかしら」
PRINTFORML 「出口はまだ見つからないのかしら…」	!#!PRINTFORML 「出口はまだ見つからないのかしら…」
PRINTFORMW 「その汚いものを近づけないで！」	!#!PRINTFORMW 「その汚いものを近づけないで！」
PRINTFORMW 「ま、待って…い、挿れたら殺すわよ…」	!#!PRINTFORMW 「ま、待って…い、挿れたら殺すわよ…」
PRINTFORML 「あ」	!#!PRINTFORML 「あ」
PRINTFORML 「あ…あぁ…」	!#!PRINTFORML 「あ…あぁ…」
PRINTFORML 「よくも…よくもやったわね…はぁ、はぁ…」	!#!PRINTFORML 「よくも…よくもやったわね…はぁ、はぁ…」
PRINTFORMW 「げほっ、げほっ…ぜ、絶対に許さないんだから…」	!#!PRINTFORMW 「げほっ、げほっ…ぜ、絶対に許さないんだから…」
PRINTFORMW 「しまった！　偽者だった！？」	!#!PRINTFORMW 「しまった！　偽者だった！？」
PRINTFORMW 「え、な、何！？」	!#!PRINTFORMW 「え、な、何！？」
PRINTFORMW 「うふふ…私の実験に付き合ってもらうわよ♪」	!#!PRINTFORMW 「うふふ…私の実験に付き合ってもらうわよ♪」
PRINTFORMW 「何か頂戴！　悪いようにはしないから！」	!#!PRINTFORMW 「何か頂戴！　悪いようにはしないから！」
PRINTFORML 「ちゆり…ねぇ…ちゆり！」	!#!PRINTFORML 「ちゆり…ねぇ…ちゆり！」
PRINTFORMW 「しっかりしなさい！　今助けてあげる！」	!#!PRINTFORMW 「しっかりしなさい！　今助けてあげる！」
PRINTFORMW 「ほ、ほら！　今助けてあげるから！」	!#!PRINTFORMW 「ほ、ほら！　今助けてあげるから！」
PRINTFORML 「仕方がないわね…ほら、肩貸してあげるわよ」	!#!PRINTFORML 「仕方がないわね…ほら、肩貸してあげるわよ」
PRINTFORMW 「無理しないようにね。早くここから抜け出しましょう」	!#!PRINTFORMW 「無理しないようにね。早くここから抜け出しましょう」
PRINTFORML 「ごめん…ちゆり…」	!#!PRINTFORML 「ごめん…ちゆり…」
PRINTFORMW 「出口が見つかったら、また来るから…」	!#!PRINTFORMW 「出口が見つかったら、また来るから…」
PRINTFORMW 「ごめんなさい…」	!#!PRINTFORMW 「ごめんなさい…」
PRINTFORMW 「ちゆり…待って……」	!#!PRINTFORMW 「ちゆり…待って……」
PRINTFORMW 「ま、待って…」	!#!PRINTFORMW 「ま、待って…」
PRINTFORMW 「わ、私も連れて行ってよちゆり…」	!#!PRINTFORMW 「わ、私も連れて行ってよちゆり…」
PRINTFORMW 「わ、私も連れて行って…」	!#!PRINTFORMW 「わ、私も連れて行って…」
PRINTFORMW 「ありがとう…帰ったら埋め合わせするわね」	!#!PRINTFORMW 「ありがとう…帰ったら埋め合わせするわね」
PRINTFORMW 「ありがとう…」	!#!PRINTFORMW 「ありがとう…」
PRINTFORMW 「ちゆり…ど、どうして…もう殴ったりしないから…」	!#!PRINTFORMW 「ちゆり…ど、どうして…もう殴ったりしないから…」
PRINTFORMW 「そんな…どうして……」	!#!PRINTFORMW 「そんな…どうして……」
PRINTFORML 「ちゆり？　どうかした？」	!#!PRINTFORML 「ちゆり？　どうかした？」
PRINTFORMW 「まあ、無理はしないようにね」	!#!PRINTFORMW 「まあ、無理はしないようにね」
PRINTFORML 「ん？　どうかした？」	!#!PRINTFORML 「ん？　どうかした？」
PRINTFORML 「ちゆり…ちょっと、大丈夫なの？」	!#!PRINTFORML 「ちゆり…ちょっと、大丈夫なの？」
PRINTFORMW 「暫く休んでおきなさいよ」	!#!PRINTFORMW 「暫く休んでおきなさいよ」
PRINTFORML 「ちょっと、大丈夫なの？」	!#!PRINTFORML 「ちょっと、大丈夫なの？」
PRINTFORML 「ちゆり…あなたもしかして…」	!#!PRINTFORML 「ちゆり…あなたもしかして…」
PRINTFORMW 「ちょっとそこで横になっておきなさい。私が見張ってあげるから」	!#!PRINTFORMW 「ちょっとそこで横になっておきなさい。私が見張ってあげるから」
PRINTFORML 「ねぇ…あなたもしかして…」	!#!PRINTFORML 「ねぇ…あなたもしかして…」
PRINTFORMW （問題なさそうね）	!#!PRINTFORMW （問題なさそうね）
PRINTFORML 「ちゆり…そのお腹もしかして…」	!#!PRINTFORML 「ちゆり…そのお腹もしかして…」
PRINTFORMW 「だ、大丈夫よ！　幻想郷に帰れば中絶してくれるわよ！」	!#!PRINTFORMW 「だ、大丈夫よ！　幻想郷に帰れば中絶してくれるわよ！」
PRINTFORML 「そのお腹もしかして…」	!#!PRINTFORML 「そのお腹もしかして…」
PRINTFORML 「ちゆり…動くのも辛そうね…」	!#!PRINTFORML 「ちゆり…動くのも辛そうね…」
PRINTFORMW 「あ、諦めないで！　もうすぐ出口が見つかると思うから！」	!#!PRINTFORMW 「あ、諦めないで！　もうすぐ出口が見つかると思うから！」
PRINTFORML 「動くのも辛そうね…」	!#!PRINTFORML 「動くのも辛そうね…」
PRINTFORML 「ちゆり…もう動かない方が良さそうね。どの薬も効果は無いし…」	!#!PRINTFORML 「ちゆり…もう動かない方が良さそうね。どの薬も効果は無いし…」
PRINTFORMW （私には…見ているしかできない…）	!#!PRINTFORMW （私には…見ているしかできない…）
PRINTFORML 「もう動かない方が良さそうね。どの薬も効果は無いし…」	!#!PRINTFORML 「もう動かない方が良さそうね。どの薬も効果は無いし…」
PRINTFORML （酷い…こんな気持ち悪いものがちゆりの体内から出てくるなんて…）	!#!PRINTFORML （酷い…こんな気持ち悪いものがちゆりの体内から出てくるなんて…）
PRINTFORMW （でもどうやってこんなものが出てくるのか…探究心が刺激されて仕方がないわ…ちゆりには悪いけど）	!#!PRINTFORMW （でもどうやってこんなものが出てくるのか…探究心が刺激されて仕方がないわ…ちゆりには悪いけど）
PRINTFORML （酷い…こんな気持ち悪いものが体内から出てくるなんて…）	!#!PRINTFORML （酷い…こんな気持ち悪いものが体内から出てくるなんて…）
PRINTFORMW （でもどうやってこんなものが出てくるのか…探究心が刺激されて仕方がないわ…）	!#!PRINTFORMW （でもどうやってこんなものが出てくるのか…探究心が刺激されて仕方がないわ…）
PRINTFORML 「ちゆり……」	!#!PRINTFORML 「ちゆり……」
PRINTFORMW （こんなとき、どう声をかけてあげればいいのよ…）	!#!PRINTFORMW （こんなとき、どう声をかけてあげればいいのよ…）
PRINTFORML （信じられない…本当に赤ちゃんが生まれてくるなんて…）	!#!PRINTFORML （信じられない…本当に赤ちゃんが生まれてくるなんて…）
PRINTFORMW （でもどうやって子供が出来るのか…探究心が刺激されて仕方がないわ…ちゆりには悪いけど）	!#!PRINTFORMW （でもどうやって子供が出来るのか…探究心が刺激されて仕方がないわ…ちゆりには悪いけど）
PRINTFORMW （でもどうやって子供が出来るのか…探究心が刺激されて仕方がないわ…）	!#!PRINTFORMW （でもどうやって子供が出来るのか…探究心が刺激されて仕方がないわ…）
PRINTFORML 「こんな……ところで……」	!#!PRINTFORML 「こんな……ところで……」
PRINTFORMW （でも、もう体動かない……）	!#!PRINTFORMW （でも、もう体動かない……）
PRINTFORMW 「嫌な気配が強まったような…？」	!#!PRINTFORMW 「嫌な気配が強まったような…？」
PRINTFORMW 「勝手にしてなさいよ！　ちゆりなんか、もう知らない！」	!#!PRINTFORMW 「勝手にしてなさいよ！　ちゆりなんか、もう知らない！」
PRINTFORMW 「勝手にしてなさいよ！　あなたなんか、もう知らない！」	!#!PRINTFORMW 「勝手にしてなさいよ！　あなたなんか、もう知らない！」
PRINTFORMW 「ま、待ってよ！　もう殴ったり、こき使ったりしないから！」	!#!PRINTFORMW 「ま、待ってよ！　もう殴ったり、こき使ったりしないから！」
PRINTFORMW 「ま、待ってよ！」	!#!PRINTFORMW 「ま、待ってよ！」
PRINTFORML 「やっぱりこれがないとね」	!#!PRINTFORML 「やっぱりこれがないとね」
PRINTFORMW 「…苺、食べたいな」	!#!PRINTFORMW 「…苺、食べたいな」
PRINTFORMW 「これって靈夢の武器よね？　私にも扱えるのかしら」	!#!PRINTFORMW 「これって靈夢の武器よね？　私にも扱えるのかしら」
PRINTFORMW 「これ…もしかして！　よ、よーし！　私のスペカ名とか考えておこうかしら！」	!#!PRINTFORMW 「これ…もしかして！　よ、よーし！　私のスペカ名とか考えておこうかしら！」
PRINTFORMW 「これは…きっと魔法の道具だわ！　研究に持ってこいね！」	!#!PRINTFORMW 「これは…きっと魔法の道具だわ！　研究に持ってこいね！」
PRINTFORML 「私にはわかる！　これはとても素敵なお宝よ！」	!#!PRINTFORML 「私にはわかる！　これはとても素敵なお宝よ！」
PRINTFORMW 「船に持ち帰ってじっくり研究したいわね…」	!#!PRINTFORMW 「船に持ち帰ってじっくり研究したいわね…」
PRINTFORML 「魔力を補強する道具？　素敵！」	!#!PRINTFORML 「魔力を補強する道具？　素敵！」
PRINTFORML 「魔力を強める道具？　素敵！」	!#!PRINTFORML 「魔力を強める道具？　素敵！」
PRINTFORML 「魔力を増強する道具？　素敵！」	!#!PRINTFORML 「魔力を増強する道具？　素敵！」
PRINTFORML 「魔力を大幅に強める道具？　素敵！」	!#!PRINTFORML 「魔力を大幅に強める道具？　素敵！」
PRINTFORMW 「あら、これは…私の三つ折りソックスより暖かそうね」	!#!PRINTFORMW 「あら、これは…私の三つ折りソックスより暖かそうね」
PRINTFORMW 「こ、これって…やっぱりエッチなことに使う薬よね…」	!#!PRINTFORMW 「こ、これって…やっぱりエッチなことに使う薬よね…」
PRINTFORMW 「い、一応拾っておくだけよ！　使うつもりなんて全然ないわよ！」	!#!PRINTFORMW 「い、一応拾っておくだけよ！　使うつもりなんて全然ないわよ！」
PRINTFORML 「ウソウソウソぉ！　わ、私のく、クリ…が男の人のになってる！」	!#!PRINTFORML 「ウソウソウソぉ！　わ、私のく、クリ…が男の人のになってる！」
PRINTFORML 「……きゃっ！？」	!#!PRINTFORML 「……きゃっ！？」
PRINTFORML （触ってみたら意識飛びそうなぐらい感じてる…）	!#!PRINTFORML （触ってみたら意識飛びそうなぐらい感じてる…）
PRINTFORMW （こんなの…どうすれば良いのよ…）	!#!PRINTFORMW （こんなの…どうすれば良いのよ…）
PRINTFORML 「お、お尻！？」	!#!PRINTFORML 「お、お尻！？」
PRINTFORMW 「ダメダメダメっ！　あっち行ってよ！」	!#!PRINTFORMW 「ダメダメダメっ！　あっち行ってよ！」
PRINTFORML 「む、胸に！？」	!#!PRINTFORML 「む、胸に！？」
PRINTFORMW 「ダメダメダメっ！　こっち来ないで！」	!#!PRINTFORMW 「ダメダメダメっ！　こっち来ないで！」
PRINTFORML 「……きゃっ！？　んんんんんっ！？」	!#!PRINTFORML 「……きゃっ！？　んんんんんっ！？」
PRINTFORMW （触られたら意識飛びそうなぐらい感じてる…！）	!#!PRINTFORMW （触られたら意識飛びそうなぐらい感じてる…！）
PRINTFORML 「そ、そこはダメよっ！」	!#!PRINTFORML 「そ、そこはダメよっ！」
PRINTFORMW 「手で振り払いきれないっ…んんんんっ…！」	!#!PRINTFORMW 「手で振り払いきれないっ…んんんんっ…！」
PRINTFORML 「ちょ、ちょっとそこは…！」	!#!PRINTFORML 「ちょ、ちょっとそこは…！」
PRINTFORMW 「い、嫌！　入ってくるっ…くっ、あぁぁん！」	!#!PRINTFORMW 「い、嫌！　入ってくるっ…くっ、あぁぁん！」
PRINTFORMW 「気持ち悪い…まだ何か入っている気がする…」	!#!PRINTFORMW 「気持ち悪い…まだ何か入っている気がする…」
PRINTFORML 「うぐっ！」	!#!PRINTFORML 「うぐっ！」
PRINTFORMW 「ゆ、油断していたわ…」	!#!PRINTFORMW 「ゆ、油断していたわ…」
PRINTFORML 「危ない、危ない…」	!#!PRINTFORML 「危ない、危ない…」
PRINTFORMW 「何が起こるかわからないわね…」	!#!PRINTFORMW 「何が起こるかわからないわね…」
PRINTFORML 「えっ…こ、これって…！」	!#!PRINTFORML 「えっ…こ、これって…！」
PRINTFORML 「ちゆりの物じゃない！　ちゆり、ちゆりー！」	!#!PRINTFORML 「ちゆりの物じゃない！　ちゆり、ちゆりー！」
PRINTFORMW 「ま、まさかね…ちゆりがやられたはずが…」	!#!PRINTFORMW 「ま、まさかね…ちゆりがやられたはずが…」
PRINTFORML 「そんな…どうして…どうしてなの……」	!#!PRINTFORML 「そんな…どうして…どうしてなの……」
PRINTFORMW 「私、どうすれば…だって…ちゆりは私の大切な助手なのよ……」	!#!PRINTFORMW 「私、どうすれば…だって…ちゆりは私の大切な助手なのよ……」
PRINTFORML 「あ…あぁ…ちゆりいいぃぃぃぃぃ！」	!#!PRINTFORML 「あ…あぁ…ちゆりいいぃぃぃぃぃ！」
PRINTFORML 「仇は取ってあげるわよ、ちゆり…」	!#!PRINTFORML 「仇は取ってあげるわよ、ちゆり…」
PRINTFORML 「あいつら…絶対に許せないわ…」	!#!PRINTFORML 「あいつら…絶対に許せないわ…」
PRINTFORMW 夢美は涙を流しながらもそう決意し、迷宮探索を続けることにした…	!#!PRINTFORMW 夢美は涙を流しながらもそう決意し、迷宮探索を続けることにした…
PRINTFORML 「誰かの物！？　じゃ、じゃあ今頃持ち主は……」	!#!PRINTFORML 「誰かの物！？　じゃ、じゃあ今頃持ち主は……」
PRINTFORMW 「あいつら…絶対に許せないわ…」	!#!PRINTFORMW 「あいつら…絶対に許せないわ…」
