﻿PRINTFORML 蓬莱口上は練習用の超単純口上なので、口上手始めのコピペにでも使ってやってくださいな。		PRINTFORML 蓬莱口上は練習用の超単純口上なので、口上手始めのコピペにでも使ってやってくださいな。	!#!
PRINTFORML サンプル上海と共にアリスの仲間にしてあげると（気分的に）きっと喜びます。		PRINTFORML サンプル上海と共にアリスの仲間にしてあげると（気分的に）きっと喜びます。	!#!
PRINTFORML ﾏｯｽｸﾞｳｯﾃ　ﾌﾞｯﾄﾊﾞｽｰ		PRINTFORML ﾏｯｽｸﾞｳｯﾃ　ﾌﾞｯﾄﾊﾞｽｰ	!#!
PRINTFORML ｸﾗｲﾔｶﾞﾚｰ		PRINTFORML ｸﾗｲﾔｶﾞﾚｰ	!#!
PRINTFORML ｺﾚﾃﾞﾄﾞｳﾀﾞｰ		PRINTFORML ｺﾚﾃﾞﾄﾞｳﾀﾞｰ	!#!
PRINTFORML ｻﾜﾝﾅﾖｰｰ		PRINTFORML ｻﾜﾝﾅﾖｰｰ	!#!
PRINTFORML ｳﾜｰ		PRINTFORML ｳﾜｰ	!#!
PRINTFORML ﾔｰﾗﾚｰﾀｰ		PRINTFORML ﾔｰﾗﾚｰﾀｰ	!#!
PRINTFORML ﾆﾝｷﾞｮｳ　ｷﾞｬｸﾀｲ		PRINTFORML ﾆﾝｷﾞｮｳ　ｷﾞｬｸﾀｲ	!#!
PRINTFORML ｺﾜﾚﾁｬｳﾖｰｰ		PRINTFORML ｺﾜﾚﾁｬｳﾖｰｰ	!#!
PRINTFORML ｲﾔｰ　ｹﾀﾞﾓﾉｰ		PRINTFORML ｲﾔｰ　ｹﾀﾞﾓﾉｰ	!#!
PRINTFORML ｱﾝｱﾝ　ｱｱﾝ		PRINTFORML ｱﾝｱﾝ　ｱｱﾝ	!#!
PRINTFORML ﾍﾝﾀｲﾀﾞｰ!		PRINTFORML ﾍﾝﾀｲﾀﾞｰ!	!#!
PRINTFORML ｸﾗｳｶﾖｰ		PRINTFORML ｸﾗｳｶﾖｰ	!#!
PRINTFORML ﾄﾞｺｦﾐﾃｲﾙｰ		PRINTFORML ﾄﾞｺｦﾐﾃｲﾙｰ	!#!
PRINTFORML ｺｯﾁｸﾝﾅｰ		PRINTFORML ｺｯﾁｸﾝﾅｰ	!#!
PRINTFORML ｳｺﾞｹﾅｲﾖｰ		PRINTFORML ｳｺﾞｹﾅｲﾖｰ	!#!
PRINTFORML ﾓｳﾀﾞﾒ…		PRINTFORML ﾓｳﾀﾞﾒ…	!#!
PRINTFORML ﾊﾀﾞｶﾀﾞﾖｰ		PRINTFORML ﾊﾀﾞｶﾀﾞﾖｰ	!#!
PRINTFORML ｵﾚﾉﾌｸｳﾞｧﾓｳ　ﾎﾞﾛﾎﾞﾛﾀﾞｰ		PRINTFORML ｵﾚﾉﾌｸｳﾞｧﾓｳ　ﾎﾞﾛﾎﾞﾛﾀﾞｰ	!#!
PRINTFORML ﾔﾌﾞｸﾅﾖｰ		PRINTFORML ﾔﾌﾞｸﾅﾖｰ	!#!
PRINTFORML ｽｹﾍﾞﾔﾛｰ		PRINTFORML ｽｹﾍﾞﾔﾛｰ	!#!
PRINTFORML ﾋﾞﾘﾋﾞﾘﾀﾞｰ		PRINTFORML ﾋﾞﾘﾋﾞﾘﾀﾞｰ	!#!
PRINTFORML ﾅﾝｶﾀﾞｻﾚﾀｰ		PRINTFORML ﾅﾝｶﾀﾞｻﾚﾀｰ	!#!
PRINTFORML ﾃｯﾀｲﾀﾞｰ		PRINTFORML ﾃｯﾀｲﾀﾞｰ	!#!
PRINTFORML ｻﾗﾊﾞﾀﾞｰ		PRINTFORML ｻﾗﾊﾞﾀﾞｰ	!#!
PRINTFORML ｵﾎﾞｴﾃﾛﾖ-		PRINTFORML ｵﾎﾞｴﾃﾛﾖ-	!#!
PRINTFORML ﾔｯﾀｰ		PRINTFORML ﾔｯﾀｰ	!#!
PRINTFORML ﾆﾄﾞﾄｸﾝﾅｰ		PRINTFORML ﾆﾄﾞﾄｸﾝﾅｰ	!#!
PRINTFORML ｱｯｹﾈｴｾﾞｰ		PRINTFORML ｱｯｹﾈｴｾﾞｰ	!#!
PRINTFORML ﾏｲｽﾀｰ!!!		PRINTFORML ﾏｲｽﾀｰ!!!	!#!
PRINTFORML ｼｬﾝﾊｰｲ!!		PRINTFORML ｼｬﾝﾊｰｲ!!	!#!
PRINTFORML ｺﾝﾆﾁﾊｰ		PRINTFORML ｺﾝﾆﾁﾊｰ	!#!
PRINTFORML ﾐｶﾀｶﾅｰ?		PRINTFORML ﾐｶﾀｶﾅｰ?	!#!
PRINTFORML ﾎﾗｰｲ		PRINTFORML ﾎﾗｰｲ	!#!
PRINTFORML ﾎﾗｰｲ!		PRINTFORML ﾎﾗｰｲ!	!#!
PRINTFORML ﾐﾂｹﾀｰ		PRINTFORML ﾐﾂｹﾀｰ	!#!
PRINTFORML ﾅﾝﾀﾞｺﾚｰ		PRINTFORML ﾅﾝﾀﾞｺﾚｰ	!#!
PRINTFORML ﾊｹｰﾝ		PRINTFORML ﾊｹｰﾝ	!#!
PRINTFORML ｲｲﾓﾉｶｰ?		PRINTFORML ｲｲﾓﾉｶｰ?	!#!
PRINTFORML 		PRINTFORML 	!#!
PRINTFORML ﾍﾝﾅﾉ　ｲﾚﾗﾚﾀｰ		PRINTFORML ﾍﾝﾅﾉ　ｲﾚﾗﾚﾀｰ	!#!
PRINTFORML ﾑｽﾞﾑｽﾞｽﾙﾖｰ		PRINTFORML ﾑｽﾞﾑｽﾞｽﾙﾖｰ	!#!
PRINTFORML ﾅﾝｶｸﾙｼｲﾖｰ		PRINTFORML ﾅﾝｶｸﾙｼｲﾖｰ	!#!
PRINTFORML ﾅﾝｶﾔﾊﾞｲﾖｰ		PRINTFORML ﾅﾝｶﾔﾊﾞｲﾖｰ	!#!
PRINTFORML ﾓｳ　ﾃﾞｿｳﾀﾞﾖｰ		PRINTFORML ﾓｳ　ﾃﾞｿｳﾀﾞﾖｰ	!#!
PRINTFORML ﾅﾝｶﾍﾝﾀﾞﾖｰ		PRINTFORML ﾅﾝｶﾍﾝﾀﾞﾖｰ	!#!
PRINTFORML ｷﾓﾁﾜﾙｲﾖｰ		PRINTFORML ｷﾓﾁﾜﾙｲﾖｰ	!#!
PRINTFORML ﾅｵｯﾀｰ		PRINTFORML ﾅｵｯﾀｰ	!#!
PRINTFORML ﾃﾞｷﾁｬｯﾀｰ		PRINTFORML ﾃﾞｷﾁｬｯﾀｰ	!#!
PRINTFORML ｵﾅｶ　ﾍﾝﾀﾞﾖｰ		PRINTFORML ｵﾅｶ　ﾍﾝﾀﾞﾖｰ	!#!
PRINTFORML ｵﾅｶ　ｵﾓｲﾖｰ		PRINTFORML ｵﾅｶ　ｵﾓｲﾖｰ	!#!
PRINTFORML ｵﾅｶ　ｲﾀｲﾖｰ		PRINTFORML ｵﾅｶ　ｲﾀｲﾖｰ	!#!
PRINTFORML ｵｯﾊﾟｲ　ﾃﾞﾀﾖｰ		PRINTFORML ｵｯﾊﾟｲ　ﾃﾞﾀﾖｰ	!#!
PRINTFORML ﾅﾝｶﾃﾞﾃｸﾙｰ		PRINTFORML ﾅﾝｶﾃﾞﾃｸﾙｰ	!#!
PRINTFORML ｽﾜﾚﾙﾖｰ		PRINTFORML ｽﾜﾚﾙﾖｰ	!#!
PRINTFORML ｲｯﾁｬｯﾀﾖｰ		PRINTFORML ｲｯﾁｬｯﾀﾖｰ	!#!
PRINTFORML ｳﾏﾚｿｳﾀﾞﾖｰ		PRINTFORML ｳﾏﾚｿｳﾀﾞﾖｰ	!#!
PRINTFORML ｱｶﾁｬﾝﾀﾞｰ		PRINTFORML ｱｶﾁｬﾝﾀﾞｰ	!#!
PRINTFORML ﾏｯﾃｰ		PRINTFORML ﾏｯﾃｰ	!#!
PRINTFORML ﾋｬｯﾊｰ!		PRINTFORML ﾋｬｯﾊｰ!	!#!
PRINTFORML ｵﾌﾞﾂﾊ　ｼｮｳﾄﾞｸﾀﾞｰ!		PRINTFORML ｵﾌﾞﾂﾊ　ｼｮｳﾄﾞｸﾀﾞｰ!	!#!
PRINTFORML ｵｿｳｼﾞ　ｶﾝﾘｮｳ		PRINTFORML ｵｿｳｼﾞ　ｶﾝﾘｮｳ	!#!
PRINTFORML ｼﾞｮｳｶｼﾃ　ｱｹﾞﾙﾜｰ		PRINTFORML ｼﾞｮｳｶｼﾃ　ｱｹﾞﾙﾜｰ	!#!
PRINTFORML ﾄﾂｹﾞｷﾀﾞｰ		PRINTFORML ﾄﾂｹﾞｷﾀﾞｰ	!#!
PRINTFORML ﾉﾘｺﾒｰ		PRINTFORML ﾉﾘｺﾒｰ	!#!
PRINTFORML ｼﾝﾁｮｳﾆ　ｲｸﾖｰ		PRINTFORML ｼﾝﾁｮｳﾆ　ｲｸﾖｰ	!#!
PRINTFORML ｱﾝｾﾞﾝ　ﾀﾞｲｲﾁ		PRINTFORML ｱﾝｾﾞﾝ　ﾀﾞｲｲﾁ	!#!
PRINTFORML ｻｶﾞｾｰ		PRINTFORML ｻｶﾞｾｰ	!#!
PRINTFORML ｻｰﾁﾓｰﾄﾞ		PRINTFORML ｻｰﾁﾓｰﾄﾞ	!#!
PRINTFORML ﾅﾆｶﾞｱﾙｶﾅｰ		PRINTFORML ﾅﾆｶﾞｱﾙｶﾅｰ	!#!
PRINTFORML ﾀﾝｻｸｰ		PRINTFORML ﾀﾝｻｸｰ	!#!
PRINTFORML ｿｺﾊ　ﾀﾞﾒｰ!		PRINTFORML ｿｺﾊ　ﾀﾞﾒｰ!	!#!
PRINTFORML ｴ……		PRINTFORML ｴ……	!#!
PRINTFORML ｱﾌﾞﾅｶｯﾀﾖ-		PRINTFORML ｱﾌﾞﾅｶｯﾀﾖ-	!#!
PRINTFORML ｺﾜﾚ…ﾁｬｯﾀ……ﾖ…		PRINTFORML ｺﾜﾚ…ﾁｬｯﾀ……ﾖ…
