//口上:

PRINTFORML 「六道とも違う次元の狭間？外部からの加護がある道具は力を削がれているみたい。宝塔の威力が……」	PRINTFORML 「六道とも違う次元の狭間？外部からの加護がある道具は力を削がれているみたい。宝塔の威力が……」
PRINTFORML 「向かい挑めば必ず敗れ、背にすれば必勝を約束される天の星。さあ、私の名を言ってみなさい！」	PRINTFORML 「向かい挑めば必ず敗れ、背にすれば必勝を約束される天の星。さあ、私の名を言ってみなさい！」
PRINTFORML 「迷宮に力を奪われたとしても、足りない分は努力で補うだけです！知恵を絞り、工夫を重ねる！」	PRINTFORML 「迷宮に力を奪われたとしても、足りない分は努力で補うだけです！知恵を絞り、工夫を重ねる！」
PRINTFORML 「私の体術では皆についていくがのやっと……それでも、ついていけるようにはなったんです！」	PRINTFORML 「私の体術では皆についていくがのやっと……それでも、ついていけるようにはなったんです！」
PRINTFORML 「……？探し物をしていたはずが、いつの間にこんなところに……。宝塔は……あ、無事ですね」	PRINTFORML 「……？探し物をしていたはずが、いつの間にこんなところに……。宝塔は……あ、無事ですね」
PRINTFORML 「いくら待ち望んでいても、奇跡は起きない。ならば力を尽くして、自らの手で叩き起こす！」	PRINTFORML 「いくら待ち望んでいても、奇跡は起きない。ならば力を尽くして、自らの手で叩き起こす！」
PRINTFORML 「いい考えが浮かびました。虎の咆哮で威嚇しつつ進んでみましょう。……『はにゃーん！』」	PRINTFORML 「いい考えが浮かびました。虎の咆哮で威嚇しつつ進んでみましょう。……『はにゃーん！』」
PRINTFORML 「一度罠にかかった鼠は二度と罠からは出られない。罠ごと黒幕を叩き潰すべきという事です」	PRINTFORML 「一度罠にかかった鼠は二度と罠からは出られない。罠ごと黒幕を叩き潰すべきという事です」
PRINTFORML 「もしも敗れ、犯され、凌辱されつくしたとしても……あなた達の下僕にだけはなりません」	PRINTFORML 「もしも敗れ、犯され、凌辱されつくしたとしても……あなた達の下僕にだけはなりません」
PRINTFORML 「勝つだけでは不十分。倒すことの意味を、倒された者との相互理解まで考慮しなくては。」	PRINTFORML 「勝つだけでは不十分。倒すことの意味を、倒された者との相互理解まで考慮しなくては。」
PRINTFORML 「奴らには通用しなくても、地面や天井を少し壊すくらいは……生き埋めになりなさい！」	PRINTFORML 「奴らには通用しなくても、地面や天井を少し壊すくらいは……生き埋めになりなさい！」
PRINTFORML 「……ごめんなさい。大切なものを落してしまったみたいなので、探しに行ってきますね」	PRINTFORML 「……ごめんなさい。大切なものを落してしまったみたいなので、探しに行ってきますね」
PRINTFORML 「コレは、迷宮に落ちていた弾薬。言わば皆の願いが込められた弾。必ず通じさせる！」	PRINTFORML 「コレは、迷宮に落ちていた弾薬。言わば皆の願いが込められた弾。必ず通じさせる！」
PRINTFORMDL そう判断した%CALLNAME:1%は苦渋の決断で星をおいていくことにした……	PRINTFORMDL そう判断した%CALLNAME:1%は苦渋の決断で星をおいていくことにした……
PRINTFORML 「長年にわたる魔界封印の仕打ちを思えば、私だって、これくらいは……耐えてみせる」	PRINTFORML 「長年にわたる魔界封印の仕打ちを思えば、私だって、これくらいは……耐えてみせる」
PRINTFORML 「『敵と差し違えよう』は甘え。そんなものは、生きる希望を捨て戦いを放棄する行為」	PRINTFORML 「『敵と差し違えよう』は甘え。そんなものは、生きる希望を捨て戦いを放棄する行為」
PRINTFORML 「コレは、迷宮に落ちていた道具。巻き込まれた皆の意志を…無念を此処で晴らす！」	PRINTFORML 「コレは、迷宮に落ちていた道具。巻き込まれた皆の意志を…無念を此処で晴らす！」
PRINTFORML 「私なら大丈夫です！こんなとき用の法界の教えが数えきれないほどありますから！」	PRINTFORML 「私なら大丈夫です！こんなとき用の法界の教えが数えきれないほどありますから！」
PRINTFORML 「真に恐ろしいのは、己の信念を曲げること。果たすべきことも果たさず生きること」	PRINTFORML 「真に恐ろしいのは、己の信念を曲げること。果たすべきことも果たさず生きること」
PRINTFORML 「困難と障害を乗り越えて手に入れたモノにこそ、本当の価値が宿るのだと思います」	PRINTFORML 「困難と障害を乗り越えて手に入れたモノにこそ、本当の価値が宿るのだと思います」
PRINTFORML 「決め技というものは、相手に反抗しようという意志すら生ませないことが大切！」	PRINTFORML 「決め技というものは、相手に反抗しようという意志すら生ませないことが大切！」
PRINTFORML 「泣き言や嬌声を期待されたところで……私の唇から出るのは未来への希望のみ！」	PRINTFORML 「泣き言や嬌声を期待されたところで……私の唇から出るのは未来への希望のみ！」
PRINTFORML 「もう２度と私達の寺をこのようなボロボロにはさせません。その為にも今は……」	PRINTFORML 「もう２度と私達の寺をこのようなボロボロにはさせません。その為にも今は……」
PRINTFORML 「最後まで闘い抜く勇気と希望を持った者のみが、未来を掴み取ることができる！」	PRINTFORML 「最後まで闘い抜く勇気と希望を持った者のみが、未来を掴み取ることができる！」
PRINTFORML 「宝塔を失くす度に……絆というかけがえのない宝物が私の心に増えていきます。」	PRINTFORML 「宝塔を失くす度に……絆というかけがえのない宝物が私の心に増えていきます。」
PRINTFORML 「迷宮避難の３原則。逃がさないこと、騒がせないこと、抵抗させないこと！」	PRINTFORML 「迷宮避難の３原則。逃がさないこと、騒がせないこと、抵抗させないこと！」
PRINTFORML (今襲われるのは駄目♥　ただでさえ戦闘は苦手なのに……♥ どうしよう♥)	PRINTFORML (今襲われるのは駄目♥　ただでさえ戦闘は苦手なのに……♥ どうしよう♥)
PRINTFORML 「万策尽きたのなら、億の策を考えるまでのこと！絶対にあきらめません！」	PRINTFORML 「万策尽きたのなら、億の策を考えるまでのこと！絶対にあきらめません！」
PRINTFORML 「状況は最悪。ですが！状況は把握するものではなく！掌握するものです！」	PRINTFORML 「状況は最悪。ですが！状況は把握するものではなく！掌握するものです！」
PRINTFORML 「げんそへんかん？……何を言っているのですか、これも法界のお力です。」	PRINTFORML 「げんそへんかん？……何を言っているのですか、これも法界のお力です。」
PRINTFORML 「早苗さんが言っていました。猛虎は小細工をしないで強引に突き進むと！」	PRINTFORML 「早苗さんが言っていました。猛虎は小細工をしないで強引に突き進むと！」
PRINTFORML 「人の英知と妖怪の力と法界の教え。これが私のトリプルビーフケーキ！」	PRINTFORML 「人の英知と妖怪の力と法界の教え。これが私のトリプルビーフケーキ！」
PRINTFORML  (必要以上に恐れる必要はないけど……。お酒の力でごまかしたいかも)	PRINTFORML  (必要以上に恐れる必要はないけど……。お酒の力でごまかしたいかも)
PRINTFORML 「体の傷ならいつかは癒えます。されど仲間を救えなかった心の傷は……」	PRINTFORML 「体の傷ならいつかは癒えます。されど仲間を救えなかった心の傷は……」
PRINTFORML 「命は捨てるものじゃない。大切なものを守るために懸けるものです！」	PRINTFORML 「命は捨てるものじゃない。大切なものを守るために懸けるものです！」
PRINTFORML 「毘沙門天の宝塔が照らす法の光が、あなたから邪心を奪うでしょう！」	PRINTFORML 「毘沙門天の宝塔が照らす法の光が、あなたから邪心を奪うでしょう！」
PRINTFORML 「侵略に対しては武をもって戦うのみ。一歩も退くわけにはいかない！」	PRINTFORML 「侵略に対しては武をもって戦うのみ。一歩も退くわけにはいかない！」
PRINTFORML 「差し違えるつもりなどありません！それでは勝利を放棄したも同じ！」	PRINTFORML 「差し違えるつもりなどありません！それでは勝利を放棄したも同じ！」
PRINTFORML 「形勢は不利。ごまかさずに真実を直視することもまた、心の強さです」	PRINTFORML 「形勢は不利。ごまかさずに真実を直視することもまた、心の強さです」
PRINTFORML 「万の軍勢を倒したところで、最後の一匹に倒されたら意味がないっ！」	PRINTFORML 「万の軍勢を倒したところで、最後の一匹に倒されたら意味がないっ！」
PRINTFORML 「……必ず戻ります！もう二度とあのような思いをするわけには……！」	PRINTFORML 「……必ず戻ります！もう二度とあのような思いをするわけには……！」
PRINTFORML (必要以上に恐れる必要はないけど……。お酒の力でごまかしたいかも)	PRINTFORML (必要以上に恐れる必要はないけど……。お酒の力でごまかしたいかも)
PRINTFORML 「はぁぁ……。気持ちいい…。帰れたらもっと信仰が集まるといいなぁ」	PRINTFORML 「はぁぁ……。気持ちいい…。帰れたらもっと信仰が集まるといいなぁ」
PRINTFORML (あっ♥ あっ♥ こんな恥ずかしいこと、相談できる相手がいない♥)	PRINTFORML (あっ♥ あっ♥ こんな恥ずかしいこと、相談できる相手がいない♥)
PRINTFORML 「二兎追う者は一兎も得ず…。ですが、三兎を追えば、一兎を得る！」	PRINTFORML 「二兎追う者は一兎も得ず…。ですが、三兎を追えば、一兎を得る！」
PRINTFORML 「楽をして手に入れた力は肝心なときに役に立たない。使うなら今！」	PRINTFORML 「楽をして手に入れた力は肝心なときに役に立たない。使うなら今！」
PRINTFORML 「私の明日があなた達の向こう側にある以上、ここは押し通るのみ！」	PRINTFORML 「私の明日があなた達の向こう側にある以上、ここは押し通るのみ！」
PRINTFORML 「こんな絶望なんて。私の描く未来を全力でぶつけて塗り潰すまで！」	PRINTFORML 「こんな絶望なんて。私の描く未来を全力でぶつけて塗り潰すまで！」
PRINTFORML 「今動けないからって、なにもできないわけじゃないんだから……！」	PRINTFORML 「今動けないからって、なにもできないわけじゃないんだから……！」
PRINTFORML 「よかった……かった……これで明日の朝日はまた昇るはずです……」	PRINTFORML 「よかった……かった……これで明日の朝日はまた昇るはずです……」
PRINTFORML 「仲間も……妖怪も…人間も…教えも……ぜんぶ私が守らないと……」	PRINTFORML 「仲間も……妖怪も…人間も…教えも……ぜんぶ私が守らないと……」
PRINTFORML 「そんな……。またあの時のような思いをすることになるなんて……」	PRINTFORML 「そんな……。またあの時のような思いをすることになるなんて……」
PRINTFORML 「わたし、今、震えて……いいえ、これは禁酒による震えよッ……！」	PRINTFORML 「わたし、今、震えて……いいえ、これは禁酒による震えよッ……！」
PRINTFORML 「あなた達の狙い通りには……絶対に、絶対になったりしません！」	PRINTFORML 「あなた達の狙い通りには……絶対に、絶対になったりしません！」
PRINTFORML 「肌を晒そうとも、責めに対して何も感じなければいいだけ……！」	PRINTFORML 「肌を晒そうとも、責めに対して何も感じなければいいだけ……！」
PRINTFORML 「私から何の力を奪う気なのでしょう。光耐性？秘められた野生？」	PRINTFORML 「私から何の力を奪う気なのでしょう。光耐性？秘められた野生？」
PRINTFORML 「白兵戦なら、武器性能より鍛錬の度合いがモノを言うけど……」	PRINTFORML 「白兵戦なら、武器性能より鍛錬の度合いがモノを言うけど……」
PRINTFORML 「人の道から外れたものは、たとえ神でもこの私が許しません！」	PRINTFORML 「人の道から外れたものは、たとえ神でもこの私が許しません！」
PRINTFORML 「これでも虎です。身のこなしが違います、当たりはしません！」	PRINTFORML 「これでも虎です。身のこなしが違います、当たりはしません！」
PRINTFORML 「どんなに時間がかかっても……この異変を終わらせてみせる！」	PRINTFORML 「どんなに時間がかかっても……この異変を終わらせてみせる！」
PRINTFORML 「ふぅ……私の胸ってどうなのでしょう。魅力があるといいなぁ」	PRINTFORML 「ふぅ……私の胸ってどうなのでしょう。魅力があるといいなぁ」
PRINTFORML 「今こそ虎の心を……『歯の喰いしばり』と『血の滲み』をっ！」	PRINTFORML 「今こそ虎の心を……『歯の喰いしばり』と『血の滲み』をっ！」
PRINTFORML 「もし探索に失敗したら毘沙門天は廃業します。……６時間ほど」	PRINTFORML 「もし探索に失敗したら毘沙門天は廃業します。……６時間ほど」
PRINTFORML 「！？　……あら。宝塔の調子が悪いみたい……。ならばッ！」	PRINTFORML 「！？　……あら。宝塔の調子が悪いみたい……。ならばッ！」
PRINTFORML 「はぁ…はぁ……。まだよ、まだ。怒りで窒息しそうなだけ…」	PRINTFORML 「はぁ…はぁ……。まだよ、まだ。怒りで窒息しそうなだけ…」
PRINTFORML 「……悪を前にして、恥ずかしがっている暇などありません！」	PRINTFORML 「……悪を前にして、恥ずかしがっている暇などありません！」
PRINTFORML 「あなたと道が交わったのも法界の導きあってのことでしょう」	PRINTFORML 「あなたと道が交わったのも法界の導きあってのことでしょう」
PRINTFORML 「法界の教えを守っていれば、必ず勝機は訪れるはずです……」	PRINTFORML 「法界の教えを守っていれば、必ず勝機は訪れるはずです……」
PRINTFORML 「瞳には勇気を。唇には明日を。手には涙を。心には愛を……」	PRINTFORML 「瞳には勇気を。唇には明日を。手には涙を。心には愛を……」
PRINTFORML 「命蓮寺組一号生筆頭として、ふさわしい立ち振る舞いを……」	PRINTFORML 「命蓮寺組一号生筆頭として、ふさわしい立ち振る舞いを……」
PRINTFORML 「正義の光は不規則な軌道となり、邪悪を討ち滅ぼします！」	PRINTFORML 「正義の光は不規則な軌道となり、邪悪を討ち滅ぼします！」
PRINTFORML 「もう誰も失いたくないっ！ だから……私は戦うんです！」	PRINTFORML 「もう誰も失いたくないっ！ だから……私は戦うんです！」
PRINTFORML 「道が塞がっているのなら……突き破るまで！どきなさい！」	PRINTFORML 「道が塞がっているのなら……突き破るまで！どきなさい！」
PRINTFORML 「くっ！……痛みを知らずして魂の成長などありえません！」	PRINTFORML 「くっ！……痛みを知らずして魂の成長などありえません！」
PRINTFORML 「ふぁっ……声をあげさせたくらいでいい気にならないで！」	PRINTFORML 「ふぁっ……声をあげさせたくらいでいい気にならないで！」
PRINTFORML 「時も場所も選ばせずに訪れる嵐。人それを一大事と言う！」	PRINTFORML 「時も場所も選ばせずに訪れる嵐。人それを一大事と言う！」
PRINTFORMDL 虚ろな瞳で命蓮寺組の名を呟く星を放置することはできない	PRINTFORMDL 虚ろな瞳で命蓮寺組の名を呟く星を放置することはできない
PRINTFORML 「百聞は一見に如かず。されど百見は！一撃に如かず！！」	PRINTFORML 「百聞は一見に如かず。されど百見は！一撃に如かず！！」
PRINTFORML 「むやみに己の力を誇示するような真似は……しません！」	PRINTFORML 「むやみに己の力を誇示するような真似は……しません！」
PRINTFORML 「叩いて、叩いて、叩き続ける！無論、私が飽きるまで！」	PRINTFORML 「叩いて、叩いて、叩き続ける！無論、私が飽きるまで！」
PRINTFORML 「よかった……これで明日の朝日はまた昇るはずです……」	PRINTFORML 「よかった……これで明日の朝日はまた昇るはずです……」
PRINTFORML 「うっかりはダメ。うっかりはダメ。うっかりはダメ……」	PRINTFORML 「うっかりはダメ。うっかりはダメ。うっかりはダメ……」
PRINTFORML 「まだ、まだよ！！ まだ倒れるわけにはいかない！！」	PRINTFORML 「まだ、まだよ！！ まだ倒れるわけにはいかない！！」
PRINTFORML 「たしかに戦闘は不得意ですが、悪に容赦はしません！」	PRINTFORML 「たしかに戦闘は不得意ですが、悪に容赦はしません！」
PRINTFORML 「小鳥の羽散らす者あらば、それを裁くのが己の正義！」	PRINTFORML 「小鳥の羽散らす者あらば、それを裁くのが己の正義！」
PRINTFORML 「嫌！前よりはマシかもしれないけど、絶対に嫌……！」	PRINTFORML 「嫌！前よりはマシかもしれないけど、絶対に嫌……！」
PRINTFORMDL 星は言葉にならない声をあげ全身を痙攣させている……	PRINTFORMDL 星は言葉にならない声をあげ全身を痙攣させている……
PRINTFORML 「きちゃうっ♥ きもちいいのがっ♥♥ あひぃ♥♥♥」	PRINTFORML 「きちゃうっ♥ きもちいいのがっ♥♥ あひぃ♥♥♥」
PRINTFORML 「むりっ♥ これ無理ぃ♥♥ もう無理だからぁ♥♥♥」	PRINTFORML 「むりっ♥ これ無理ぃ♥♥ もう無理だからぁ♥♥♥」
PRINTFORML 「……視線であなたの息の根を止められればいいのにね」	PRINTFORML 「……視線であなたの息の根を止められればいいのにね」
PRINTFORML 「……衣服を集めるだけのことです。問題はありません」	PRINTFORML 「……衣服を集めるだけのことです。問題はありません」
PRINTFORML 「前に飲んだ……お酒の……せいだからぁ……んっ……」	PRINTFORML 「前に飲んだ……お酒の……せいだからぁ……んっ……」
PRINTFORML 「駄目ぇ！ナズやぬえにだってこういうことは……！」	PRINTFORML 「駄目ぇ！ナズやぬえにだってこういうことは……！」
PRINTFORML 「いっちゃう♥ イっちゃう♥♥ イッちゃう♥♥♥」	PRINTFORML 「いっちゃう♥ イっちゃう♥♥ イッちゃう♥♥♥」
PRINTFORML 「かんじてるっ♥ かんじちゃう♥♥ あーッ♥♥♥」	PRINTFORML 「かんじてるっ♥ かんじちゃう♥♥ あーッ♥♥♥」
PRINTFORML 「しらないっ♥ こんなのっ♥♥ 気持ちいい♥♥♥」	PRINTFORML 「しらないっ♥ こんなのっ♥♥ 気持ちいい♥♥♥」
PRINTFORMDL 星はだらしなく顔をゆるませ甘えるような声をあげた	PRINTFORMDL 星はだらしなく顔をゆるませ甘えるような声をあげた
PRINTFORML 「明日の勝利のために、今日の屈辱に耐えるんです！」	PRINTFORML 「明日の勝利のために、今日の屈辱に耐えるんです！」
PRINTFORML 「うーん、思ったよりは、ボロボロのようですね……」	PRINTFORML 「うーん、思ったよりは、ボロボロのようですね……」
PRINTFORML 「危険だけど、一度別れるしかないみたいですね……」	PRINTFORML 「危険だけど、一度別れるしかないみたいですね……」
PRINTFORMDL 完全に力尽きた星を守りながら探索は出来そうにない	PRINTFORMDL 完全に力尽きた星を守りながら探索は出来そうにない
PRINTFORML 「命をつなぐための……行為なんだから……んっ……」	PRINTFORML 「命をつなぐための……行為なんだから……んっ……」
PRINTFORML 「わたしのからだ……はやくおさまって……んっ……」	PRINTFORML 「わたしのからだ……はやくおさまって……んっ……」
PRINTFORML 「覗き見されるくらいは……慣れてるんだからぁ……」	PRINTFORML 「覗き見されるくらいは……慣れてるんだからぁ……」
PRINTFORML 「後悔は猛毒、考えれば考える程、体が動かなくなる」	PRINTFORML 「後悔は猛毒、考えれば考える程、体が動かなくなる」
PRINTFORML 「非常事態ですし、お酒が落ちているといいですね！」	PRINTFORML 「非常事態ですし、お酒が落ちているといいですね！」
PRINTFORML 「心なしか、宝塔の光が弱いように感じますね……」	PRINTFORML 「心なしか、宝塔の光が弱いように感じますね……」
PRINTFORML 「花を手折る者あらば、それを挫くのが己の正義！」	PRINTFORML 「花を手折る者あらば、それを挫くのが己の正義！」
PRINTFORML 「我れを空にして煩悩を断つ……今がその時です！」	PRINTFORML 「我れを空にして煩悩を断つ……今がその時です！」
PRINTFORML 「む、無駄。そんなことをしても私は折れない……」	PRINTFORML 「む、無駄。そんなことをしても私は折れない……」
PRINTFORML 「形あるものはいつかは……。ただそれだけのこと」	PRINTFORML 「形あるものはいつかは……。ただそれだけのこと」
PRINTFORMDL %CALLNAME:1%は星の綺麗な手を取った	PRINTFORMDL %CALLNAME:1%は星の綺麗な手を取った
PRINTFORML 「あきらめないって……いってる…でしょうが……」	PRINTFORML 「あきらめないって……いってる…でしょうが……」
PRINTFORML 「体の自由が利かなくなった時は、魂で這う……！」	PRINTFORML 「体の自由が利かなくなった時は、魂で這う……！」
PRINTFORML 「体を弄んだところで、誇りまでは奪えません！」	PRINTFORML 「体を弄んだところで、誇りまでは奪えません！」
PRINTFORML 「うっ！……この痛みこそが新たな教訓となる！」	PRINTFORML 「うっ！……この痛みこそが新たな教訓となる！」
PRINTFORML 「将を射るつもりなら、まずは……ってところね」	PRINTFORML 「将を射るつもりなら、まずは……ってところね」
PRINTFORML 「ダメっ♥ これダメっ♥♥ ダメなのぉ♥♥♥」	PRINTFORML 「ダメっ♥ これダメっ♥♥ ダメなのぉ♥♥♥」
PRINTFORML 「ズルイっ♥ これズルイっ♥♥ あーっ♥♥♥」	PRINTFORML 「ズルイっ♥ これズルイっ♥♥ あーっ♥♥♥」
PRINTFORML 「まっ♥ まってぇ♥♥ これダメなのぉ♥♥♥」	PRINTFORML 「まっ♥ まってぇ♥♥ これダメなのぉ♥♥♥」
PRINTFORML 「やめっ♥ やめてぇ♥♥ イっちゃうぅ♥♥♥」	PRINTFORML 「やめっ♥ やめてぇ♥♥ イっちゃうぅ♥♥♥」
PRINTFORML 「こわれる♥ こわされるっ♥♥ あーっ♥♥♥」	PRINTFORML 「こわれる♥ こわされるっ♥♥ あーっ♥♥♥」
PRINTFORML 「だめっ♥ たえられないっ♥♥ あーっ♥♥♥」	PRINTFORML 「だめっ♥ たえられないっ♥♥ あーっ♥♥♥」
PRINTFORML 「むりっ♥ たえられないっ♥♥ いくぅ♥♥♥」	PRINTFORML 「むりっ♥ たえられないっ♥♥ いくぅ♥♥♥」
PRINTFORML （してるぅ、カラダが白状しちゃってるぅ……！）	PRINTFORML （してるぅ、カラダが白状しちゃってるぅ……！）
PRINTFORML 「っ…こんなことくらいで気持ちが潰えると……」	PRINTFORML 「っ…こんなことくらいで気持ちが潰えると……」
PRINTFORML 「よく言われるでしょう？勇気と無謀は違うと。」	PRINTFORML 「よく言われるでしょう？勇気と無謀は違うと。」
PRINTFORML 「探すのは得意です。見つからないだけです……」	PRINTFORML 「探すのは得意です。見つからないだけです……」
PRINTFORML 「道具袋の管理に不安があるからでしょうか……」	PRINTFORML 「道具袋の管理に不安があるからでしょうか……」
PRINTFORML 「心なしか、空腹になるのが早い気がします……」	PRINTFORML 「心なしか、空腹になるのが早い気がします……」
PRINTFORML 「なっ、失くしたからなんだっていうんですか！」	PRINTFORML 「なっ、失くしたからなんだっていうんですか！」
PRINTFORML 「虎に…後ろに下がる脚がついているとでも？」	PRINTFORML 「虎に…後ろに下がる脚がついているとでも？」
PRINTFORML 「邪悪が正義から逃げきれる道理など…ない！」	PRINTFORML 「邪悪が正義から逃げきれる道理など…ない！」
PRINTFORML 「使える手を残したまま倒れるわけには……！」	PRINTFORML 「使える手を残したまま倒れるわけには……！」
PRINTFORML 「このような手口で他の方々を……。ですが！」	PRINTFORML 「このような手口で他の方々を……。ですが！」
PRINTFORML 「くるっ♥ なにかくるっ♥♥ あーッ♥♥♥」	PRINTFORML 「くるっ♥ なにかくるっ♥♥ あーッ♥♥♥」
PRINTFORML 「こんなっ♥ こんなのぉ♥♥ むりぃ♥♥♥」	PRINTFORML 「こんなっ♥ こんなのぉ♥♥ むりぃ♥♥♥」
PRINTFORML 「こんなっ♥ されたらぁ♥♥ むりぃ♥♥♥」	PRINTFORML 「こんなっ♥ されたらぁ♥♥ むりぃ♥♥♥」
PRINTFORML 「狂う♥ くるわされるっ♥♥ あーっ♥♥♥」	PRINTFORML 「狂う♥ くるわされるっ♥♥ あーっ♥♥♥」
PRINTFORML 「どうして……なみだが……とまらないの……」	PRINTFORML 「どうして……なみだが……とまらないの……」
PRINTFORML 「！？でも……倒す敵が１匹増えるだけよ……」	PRINTFORML 「！？でも……倒す敵が１匹増えるだけよ……」
PRINTFORML 「友情、努力、勝利。法界の教えの通りです。」	PRINTFORML 「友情、努力、勝利。法界の教えの通りです。」
PRINTFORML 「毘沙門天がここに居ます。縁起がいいですね」	PRINTFORML 「毘沙門天がここに居ます。縁起がいいですね」
PRINTFORML 「ふう。やっぱりもう息が上がってしまう……」	PRINTFORML 「ふう。やっぱりもう息が上がってしまう……」
PRINTFORML 「それが貴方の正義なら、それも良いでしょう」	PRINTFORML 「それが貴方の正義なら、それも良いでしょう」
PRINTFORML 「宝塔の倒れたほうに進みましょう。えいっ。」	PRINTFORML 「宝塔の倒れたほうに進みましょう。えいっ。」
PRINTFORML 「毘沙門天の宝塔の前にひれ伏しなさい！！」	PRINTFORML 「毘沙門天の宝塔の前にひれ伏しなさい！！」
PRINTFORML 「威力は……試してみればわかるはずっ！！」	PRINTFORML 「威力は……試してみればわかるはずっ！！」
PRINTFORML 「今使うべきは頭や口ではなく……手です！」	PRINTFORML 「今使うべきは頭や口ではなく……手です！」
PRINTFORML 「体を弄ばれても、信念までは屈しません！」	PRINTFORML 「体を弄ばれても、信念までは屈しません！」
PRINTFORML 「四肢を封じられたのなら、噛みつくまで！」	PRINTFORML 「四肢を封じられたのなら、噛みつくまで！」
PRINTFORML 「こんなところで、じっとはしてられない！」	PRINTFORML 「こんなところで、じっとはしてられない！」
PRINTFORML 「いつまでも同じ手が通用するとでも……！」	PRINTFORML 「いつまでも同じ手が通用するとでも……！」
PRINTFORML 「避けきれない……なんて広い攻撃範囲なの」	PRINTFORML 「避けきれない……なんて広い攻撃範囲なの」
PRINTFORML 「こんなもの……効いてたまるものですか！」	PRINTFORML 「こんなもの……効いてたまるものですか！」
PRINTFORML 「ひぃっ♥ ひぃぃん♥♥ イくぅっ♥♥♥」	PRINTFORML 「ひぃっ♥ ひぃぃん♥♥ イくぅっ♥♥♥」
PRINTFORML 「これっ♥ これダメっ♥♥ ダメぇ♥♥♥」	PRINTFORML 「これっ♥ これダメっ♥♥ ダメぇ♥♥♥」
PRINTFORML 「はぁ…はぁ…♥　……こんなときにですか」	PRINTFORML 「はぁ…はぁ…♥　……こんなときにですか」
PRINTFORML 「よく言われるでしょう？手段と目的の違い」	PRINTFORML 「よく言われるでしょう？手段と目的の違い」
PRINTFORML 「力無き正義もまた無力。法界の教えです。」	PRINTFORML 「力無き正義もまた無力。法界の教えです。」
PRINTFORMDL 星はふらつく足取りで必死に逃げ出した……	PRINTFORMDL 星はふらつく足取りで必死に逃げ出した……
PRINTFORML 「私の道は、間違っていたのでしょうか……」	PRINTFORML 「私の道は、間違っていたのでしょうか……」
PRINTFORML 「……私自身の妖力は乏しいと思うのですが」	PRINTFORML 「……私自身の妖力は乏しいと思うのですが」
PRINTFORML 「……すぅ～……すりぷる……すぅ～……」	PRINTFORML 「……すぅ～……すりぷる……すぅ～……」
PRINTFORML 「長々とした問答は無用！ いざ、勝負！」	PRINTFORML 「長々とした問答は無用！ いざ、勝負！」
PRINTFORML 「堪忍袋の緒が切れました！許しません！」	PRINTFORML 「堪忍袋の緒が切れました！許しません！」
PRINTFORML 「ひぃっ♥ んひっ♥♥ んあーっ♥♥♥」	PRINTFORML 「ひぃっ♥ んひっ♥♥ んあーっ♥♥♥」
PRINTFORML 「おっ♥ 犯されてぇ♥♥ やめぇ♥♥♥」	PRINTFORML 「おっ♥ 犯されてぇ♥♥ やめぇ♥♥♥」
PRINTFORML 「あぁっ！？でも、まだ終わるわけには！」	PRINTFORML 「あぁっ！？でも、まだ終わるわけには！」
PRINTFORML 「ここからは敵の動きに注意しないと……」	PRINTFORML 「ここからは敵の動きに注意しないと……」
PRINTFORML 「私と戦うと言うのなら、相手になります」	PRINTFORML 「私と戦うと言うのなら、相手になります」
PRINTFORMDL 誰かの弱々しい息遣いが聞えた気がした。	PRINTFORMDL 誰かの弱々しい息遣いが聞えた気がした。
PRINTFORMDL 星は濁った瞳でふらふらと立ち上がった…	PRINTFORMDL 星は濁った瞳でふらふらと立ち上がった…
PRINTFORML （しゅうちゅうして……平常心を……♥）	PRINTFORML （しゅうちゅうして……平常心を……♥）
PRINTFORML 「そんな包囲、私の無理でこじ開ける！」	PRINTFORML 「そんな包囲、私の無理でこじ開ける！」
PRINTFORML 「幻想郷では……無茶が心の燃料です！」	PRINTFORML 「幻想郷では……無茶が心の燃料です！」
PRINTFORML 「あーっ♥ あーっ♥♥ あーっ♥♥♥」	PRINTFORML 「あーっ♥ あーっ♥♥ あーっ♥♥♥」
PRINTFORML 「くぅ。力で押さえつけられたって……」	PRINTFORML 「くぅ。力で押さえつけられたって……」
PRINTFORML 「か、覚悟ならすでに……はぁ…はぁ…」	PRINTFORML 「か、覚悟ならすでに……はぁ…はぁ…」
PRINTFORML 「動けないのは好きじゃないですが……」	PRINTFORML 「動けないのは好きじゃないですが……」
PRINTFORML 「残念だけど、覚悟ならすでにッ……！」	PRINTFORML 「残念だけど、覚悟ならすでにッ……！」
PRINTFORML 「この法の光からは逃げられません！」	PRINTFORML 「この法の光からは逃げられません！」
PRINTFORML 「我慢の限界です！たぁぁぁぁぁっ！」	PRINTFORML 「我慢の限界です！たぁぁぁぁぁっ！」
PRINTFORML 「ぉっ♥ おぅっ♥♥ あーっ♥♥♥」	PRINTFORML 「ぉっ♥ おぅっ♥♥ あーっ♥♥♥」
PRINTFORML （に、忍辱の修行だと思えばぁ……！）	PRINTFORML （に、忍辱の修行だと思えばぁ……！）
PRINTFORML （ば、ばれないようにしないとぉ……）	PRINTFORML （ば、ばれないようにしないとぉ……）
PRINTFORML 「闇の眷属に種付けされるなんて……」	PRINTFORML 「闇の眷属に種付けされるなんて……」
PRINTFORML 「からだが……もう…うごかない……」	PRINTFORML 「からだが……もう…うごかない……」
PRINTFORML 「！？内部からってわけね。くっ……」	PRINTFORML 「！？内部からってわけね。くっ……」
PRINTFORML 「道具集めなら役に立てると思います」	PRINTFORML 「道具集めなら役に立てると思います」
PRINTFORML 「絆だけは絶対に失くしませんから！」	PRINTFORML 「絆だけは絶対に失くしませんから！」
PRINTFORML （許さない……♥　許さない……♥）	PRINTFORML （許さない……♥　許さない……♥）
PRINTFORML 「ナズ、みんな……ごめんなさい…」	PRINTFORML 「ナズ、みんな……ごめんなさい…」
PRINTFORML （あ、あと一押しされたらぁ……！）	PRINTFORML （あ、あと一押しされたらぁ……！）
PRINTFORML 「あ、危ない……平常心、平常心…」	PRINTFORML 「あ、危ない……平常心、平常心…」
PRINTFORML 「っ…どんな手を使われたって……」	PRINTFORML 「っ…どんな手を使われたって……」
PRINTFORML 「っ…物分かりが悪いみたいですね」	PRINTFORML 「っ…物分かりが悪いみたいですね」
PRINTFORML 「っ……命蓮寺組は清楚なんだから」	PRINTFORML 「っ……命蓮寺組は清楚なんだから」
PRINTFORML 「許さない……絶対に許さないっ！」	PRINTFORML 「許さない……絶対に許さないっ！」
PRINTFORML 「！？どうやら手遅れのようね……」	PRINTFORML 「！？どうやら手遅れのようね……」
PRINTFORML 「努力、勝利、友情。ハイ、復唱！」	PRINTFORML 「努力、勝利、友情。ハイ、復唱！」
PRINTFORML 「勝ってくるから、ここで待ってて」	PRINTFORML 「勝ってくるから、ここで待ってて」
PRINTFORML 「さあ、私と共にこの迷宮に光を！」	PRINTFORML 「さあ、私と共にこの迷宮に光を！」
PRINTFORML 「失くさないようにしなくちゃ……」	PRINTFORML 「失くさないようにしなくちゃ……」
PRINTFORML (落とさないように気を付けて……)	PRINTFORML (落とさないように気を付けて……)
PRINTFORMDL 星は幸せそうに湯船に浸かっている	PRINTFORMDL 星は幸せそうに湯船に浸かっている
PRINTFORML 「前を向いて、顔を上げて……っ！」	PRINTFORML 「前を向いて、顔を上げて……っ！」
PRINTFORML 「力が吸われているのがわかる……」	PRINTFORML 「力が吸われているのがわかる……」
PRINTFORML 「正義の怒り、受けてみなさい！」	PRINTFORML 「正義の怒り、受けてみなさい！」
PRINTFORML 「正義の心理は永遠に不滅です！」	PRINTFORML 「正義の心理は永遠に不滅です！」
PRINTFORML 「痛いけど……痛いけどっっっ！」	PRINTFORML 「痛いけど……痛いけどっっっ！」
PRINTFORML 「あばらの一本や二本関係ない！」	PRINTFORML 「あばらの一本や二本関係ない！」
PRINTFORML 「……悪知恵がまわるようですね」	PRINTFORML 「……悪知恵がまわるようですね」
PRINTFORML （あっけなくイクわけには……！）	PRINTFORML （あっけなくイクわけには……！）
PRINTFORML 「遅かれ早かれこうなるのは……」	PRINTFORML 「遅かれ早かれこうなるのは……」
PRINTFORML 「最低の結末は避けたいけど……」	PRINTFORML 「最低の結末は避けたいけど……」
PRINTFORML 「べ、別にどうってことは……！」	PRINTFORML 「べ、別にどうってことは……！」
PRINTFORML 「諦めない……諦めたくない……」	PRINTFORML 「諦めない……諦めたくない……」
PRINTFORML 「！？邪悪の波動が……くっ……」	PRINTFORML 「！？邪悪の波動が……くっ……」
PRINTFORML 「思ったよりは、元気そうですね」	PRINTFORML 「思ったよりは、元気そうですね」
PRINTFORML 「う、うぅぅ……あ、ありがとう」	PRINTFORML 「う、うぅぅ……あ、ありがとう」
PRINTFORML 「なんだか嫌な予感がします……」	PRINTFORML 「なんだか嫌な予感がします……」
PRINTFORML 「あぁっ！？見切れなかった！」	PRINTFORML 「あぁっ！？見切れなかった！」
PRINTFORML 「くっ、いい加減にしてよ……」	PRINTFORML 「くっ、いい加減にしてよ……」
PRINTFORML 「折れない…私は折れない……」	PRINTFORML 「折れない…私は折れない……」
PRINTFORML 「このまま終わりたくない……」	PRINTFORML 「このまま終わりたくない……」
PRINTFORML 「くっ…なにか…何か手を……」	PRINTFORML 「くっ…なにか…何か手を……」
PRINTFORML （直撃だけは避けないと……♥）	PRINTFORML （直撃だけは避けないと……♥）
PRINTFORML 「受けが無理ならかわすのみ！」	PRINTFORML 「受けが無理ならかわすのみ！」
PRINTFORML 「あぁっ……宝塔の輝きが……」	PRINTFORML 「あぁっ……宝塔の輝きが……」
PRINTFORML 「力、抜けてく…ごめん、ね…」	PRINTFORML 「力、抜けてく…ごめん、ね…」
PRINTFORML 「身軽になったと思えば……！」	PRINTFORML 「身軽になったと思えば……！」
PRINTFORML 「！？面倒な事に……くっ……」	PRINTFORML 「！？面倒な事に……くっ……」
PRINTFORML 「負ける……もんですかっ！！」	PRINTFORML 「負ける……もんですかっ！！」
PRINTFORML 「吉報を呼び込みましょう……」	PRINTFORML 「吉報を呼び込みましょう……」
PRINTFORML 「…こ、こんなことでぇぇぇ！」	PRINTFORML 「…こ、こんなことでぇぇぇ！」
PRINTFORMW 「ナズ……みんな……ごめんね」	PRINTFORMW 「ナズ……みんな……ごめんね」
PRINTFORML 「睡眠のとれそうな場所は……」	PRINTFORML 「睡眠のとれそうな場所は……」
PRINTFORML 「も、もしかしてこのお腹……」	PRINTFORML 「も、もしかしてこのお腹……」
PRINTFORML 「……お腹がすいてきました…」	PRINTFORML 「……お腹がすいてきました…」
PRINTFORML 「こ、こんな状態じゃ……♥」	PRINTFORML 「こ、こんな状態じゃ……♥」
PRINTFORML （カラダ、火照ってる……♥）	PRINTFORML （カラダ、火照ってる……♥）
PRINTFORML 「何かあったはずだけど……」	PRINTFORML 「何かあったはずだけど……」
PRINTFORML 「私の答えは……こうです！」	PRINTFORML 「私の答えは……こうです！」
PRINTFORML 「来い…かかって来なさい！」	PRINTFORML 「来い…かかって来なさい！」
PRINTFORML 「悪を殴って何が悪いのか！」	PRINTFORML 「悪を殴って何が悪いのか！」
PRINTFORML 「肉を切ったら…骨も断つ！」	PRINTFORML 「肉を切ったら…骨も断つ！」
PRINTFORML 「そのような卑劣な手を……」	PRINTFORML 「そのような卑劣な手を……」
PRINTFORML 「ま、間に合わなかった……」	PRINTFORML 「ま、間に合わなかった……」
PRINTFORML 「真に纏うは心の法衣……！」	PRINTFORML 「真に纏うは心の法衣……！」
PRINTFORML 「ちょっと…こんなのって…」	PRINTFORML 「ちょっと…こんなのって…」
PRINTFORML 「……本番後は……お酒ぇ」	PRINTFORML 「……本番後は……お酒ぇ」
PRINTFORML （はぁ……♥ はぁ……♥）	PRINTFORML （はぁ……♥ はぁ……♥）
PRINTFORMDL 星の呼吸が乱れている……	PRINTFORMDL 星の呼吸が乱れている……
PRINTFORML 「悪に上下の区別無し！！」	PRINTFORML 「悪に上下の区別無し！！」
PRINTFORML （た、耐えないとぉ……！）	PRINTFORML （た、耐えないとぉ……！）
PRINTFORML （あ、喘ぐわけには……！）	PRINTFORML （あ、喘ぐわけには……！）
PRINTFORML （わ、私の弱点ってぇ……）	PRINTFORML （わ、私の弱点ってぇ……）
PRINTFORML 「きゃぁ！やってくれる！」	PRINTFORML 「きゃぁ！やってくれる！」
PRINTFORML 「うそっ！？捕まった！？」	PRINTFORML 「うそっ！？捕まった！？」
PRINTFORML 「こ、こんなやつらに……」	PRINTFORML 「こ、こんなやつらに……」
PRINTFORML 「同じ轍を踏むわけには！」	PRINTFORML 「同じ轍を踏むわけには！」
PRINTFORML 「ギリギリでしたけど……」	PRINTFORML 「ギリギリでしたけど……」
PRINTFORML 「お腹が…すいただけ……」	PRINTFORML 「お腹が…すいただけ……」
﻿PRINTFORML 熱血気味な寅丸星ちゃん。	PRINTFORML 熱血気味な寅丸星ちゃん。
PRINTFORML では、よい触手ライフを…	PRINTFORML では、よい触手ライフを…
PRINTFORML 「清楚って……すぅ……」	PRINTFORML 「清楚って……すぅ……」
PRINTFORML 「ひ、ひきょうものッ♥」	PRINTFORML 「ひ、ひきょうものッ♥」
PRINTFORML （おちつかないと……♥）	PRINTFORML （おちつかないと……♥）
PRINTFORML （これくらいでぇ……♥）	PRINTFORML （これくらいでぇ……♥）
PRINTFORML （む、胸が擦れて……♥）	PRINTFORML （む、胸が擦れて……♥）
PRINTFORML （いま、ジワって……♥）	PRINTFORML （いま、ジワって……♥）
PRINTFORML 「宝塔よ、その力を……」	PRINTFORML 「宝塔よ、その力を……」
PRINTFORML 「目眩ましくらいなら！」	PRINTFORML 「目眩ましくらいなら！」
PRINTFORML 「せいっやぁぁぁぁっ！」	PRINTFORML 「せいっやぁぁぁぁっ！」
PRINTFORML 「やってみるしか……♥」	PRINTFORML 「やってみるしか……♥」
PRINTFORML 「うっ、何をしたの……」	PRINTFORML 「うっ、何をしたの……」
PRINTFORML （か、感じてなどぉ……）	PRINTFORML （か、感じてなどぉ……）
PRINTFORML 「ええぃ！面倒なのに！」	PRINTFORML 「ええぃ！面倒なのに！」
PRINTFORML 「これじゃ動けない！？」	PRINTFORML 「これじゃ動けない！？」
PRINTFORML 「だ、だされた……！？」	PRINTFORML 「だ、だされた……！？」
PRINTFORML 「ナカにだされたか……」	PRINTFORML 「ナカにだされたか……」
PRINTFORML 「好き勝手なことを……」	PRINTFORML 「好き勝手なことを……」
PRINTFORML 「ど、どうにかぁ……♥」	PRINTFORML 「ど、どうにかぁ……♥」
PRINTFORML 「この毘沙門天の光で！」	PRINTFORML 「この毘沙門天の光で！」
PRINTFORML 「まぁ……ナズったら」	PRINTFORML 「まぁ……ナズったら」
PRINTFORML 「もぅ……ナズったら」	PRINTFORML 「もぅ……ナズったら」
PRINTFORML 「……まだ飲めますぅ」	PRINTFORML 「……まだ飲めますぅ」
PRINTFORML （ア、アソコが……♥）	PRINTFORML （ア、アソコが……♥）
PRINTFORML 「かくなる上は……！」	PRINTFORML 「かくなる上は……！」
PRINTFORML 「絶対に駄目よ……！」	PRINTFORML 「絶対に駄目よ……！」
PRINTFORML 「ぜ、全力でガード！」	PRINTFORML 「ぜ、全力でガード！」
PRINTFORML （くううぅぅぅ……！）	PRINTFORML （くううぅぅぅ……！）
PRINTFORML 「くぅぅぅ……んッ！」	PRINTFORML 「くぅぅぅ……んッ！」
PRINTFORML 「ぁーっ…あーっ……」	PRINTFORML 「ぁーっ…あーっ……」
PRINTFORML 「よくも…よくも……」	PRINTFORML 「よくも…よくも……」
PRINTFORML 「はーっ…はーっ……」	PRINTFORML 「はーっ…はーっ……」
PRINTFORML 「ふーっ…ふーっ……」	PRINTFORML 「ふーっ…ふーっ……」
PRINTFORML 「弾き返してみせる！」	PRINTFORML 「弾き返してみせる！」
PRINTFORML 「……たすかったの？」	PRINTFORML 「……たすかったの？」
PRINTFORML 「ナズ……みんな……」	PRINTFORML 「ナズ……みんな……」
PRINTFORML 「光符『浄化の魔』！」	PRINTFORML 「光符『浄化の魔』！」
PRINTFORML 「痛ッ、痛ぁぁぁっ！」	PRINTFORML 「痛ッ、痛ぁぁぁっ！」
PRINTFORML 「……あ、ありがとう」	PRINTFORML 「……あ、ありがとう」
PRINTFORML 「どこかで睡眠を……」	PRINTFORML 「どこかで睡眠を……」
PRINTFORML 「順調に育ってる……」	PRINTFORML 「順調に育ってる……」
PRINTFORML 「もうすぐなのね……」	PRINTFORML 「もうすぐなのね……」
PRINTFORML (はぁ…♥ はぁ…♥)	PRINTFORML (はぁ…♥ はぁ…♥)
PRINTFORML 「すぅ……すぅ……」	PRINTFORML 「すぅ……すぅ……」
PRINTFORML （もう濡れて……♥）	PRINTFORML （もう濡れて……♥）
PRINTFORML （ク、クリが……♥）	PRINTFORML （ク、クリが……♥）
PRINTFORML （敏感にされたッ♥）	PRINTFORML （敏感にされたッ♥）
PRINTFORML 「ま、守りを……♥」	PRINTFORML 「ま、守りを……♥」
PRINTFORML 「はぁ……はぁ……」	PRINTFORML 「はぁ……はぁ……」
PRINTFORML 「げほっげほっ……」	PRINTFORML 「げほっげほっ……」
PRINTFORML 「ああああああっ！」	PRINTFORML 「ああああああっ！」
PRINTFORML 「やっ、やめぇぇ！」	PRINTFORML 「やっ、やめぇぇ！」
PRINTFORML 「ライフで受ける！」	PRINTFORML 「ライフで受ける！」
PRINTFORML 「耐えて、私の法衣」	PRINTFORML 「耐えて、私の法衣」
PRINTFORML 「先に倒すしか……」	PRINTFORML 「先に倒すしか……」
PRINTFORML 「……長期戦は不利」	PRINTFORML 「……長期戦は不利」
PRINTFORML 「っ……不倫の禁止」	PRINTFORML 「っ……不倫の禁止」
PRINTFORML 「っ……禅定の心で」	PRINTFORML 「っ……禅定の心で」
PRINTFORML 「きゃっ…離れろ！」	PRINTFORML 「きゃっ…離れろ！」
PRINTFORML 「きゃぁ！よくも！」	PRINTFORML 「きゃぁ！よくも！」
PRINTFORML 「反応が遅れた！？」	PRINTFORML 「反応が遅れた！？」
PRINTFORML 「誘い込まれた！？」	PRINTFORML 「誘い込まれた！？」
PRINTFORML 「い、今のって……」	PRINTFORML 「い、今のって……」
PRINTFORML 「ナズ……ナズ……」	PRINTFORML 「ナズ……ナズ……」
PRINTFORML （疼いてる……♥）	PRINTFORML （疼いてる……♥）
PRINTFORML （くぅぅぅ……♥）	PRINTFORML （くぅぅぅ……♥）
PRINTFORML （理不尽な……♥）	PRINTFORML （理不尽な……♥）
PRINTFORML 「はああああっ！」	PRINTFORML 「はああああっ！」
PRINTFORML 「絶対に嫌……！」	PRINTFORML 「絶対に嫌……！」
PRINTFORML 「何をしてぇ……」	PRINTFORML 「何をしてぇ……」
PRINTFORML 「げほっげほっ…」	PRINTFORML 「げほっげほっ…」
PRINTFORML 「く、苦しい……」	PRINTFORML 「く、苦しい……」
PRINTFORML 「や、やめっ……」	PRINTFORML 「や、やめっ……」
PRINTFORML 「やっ、やめっ！」	PRINTFORML 「やっ、やめっ！」
PRINTFORML 「んんんッ……！」	PRINTFORML 「んんんッ……！」
PRINTFORML 「ッ……それで？」	PRINTFORML 「ッ……それで？」
PRINTFORML 「ッ……だから？」	PRINTFORML 「ッ……だから？」
PRINTFORML 「ひぃ…ひぃッ…」	PRINTFORML 「ひぃ…ひぃッ…」
PRINTFORML 「最低の感触……」	PRINTFORML 「最低の感触……」
PRINTFORML 「力、及ばず……」	PRINTFORML 「力、及ばず……」
PRINTFORML 「私の法衣が……」	PRINTFORML 「私の法衣が……」
PRINTFORML （休憩したい……）	PRINTFORML （休憩したい……）
PRINTFORML 「すぅ…zzz」	PRINTFORML 「すぅ…zzz」
PRINTFORML 「きゃぁぁぁ！」	PRINTFORML 「きゃぁぁぁ！」
PRINTFORML 「あああぁ……」	PRINTFORML 「あああぁ……」
PRINTFORML 「それだめぇ…」	PRINTFORML 「それだめぇ…」
PRINTFORML 「わたひぃ……」	PRINTFORML 「わたひぃ……」
PRINTFORML 「呑まれる！？」	PRINTFORML 「呑まれる！？」
PRINTFORML 「ぉっ…おッ…」	PRINTFORML 「ぉっ…おッ…」
PRINTFORML 「ぅ…ぁぁ……」	PRINTFORML 「ぅ…ぁぁ……」
PRINTFORML 「げほっ……」	PRINTFORML 「げほっ……」
PRINTFORML 「うぇぇ……」	PRINTFORML 「うぇぇ……」
PRINTFORML 「かはっ……」	PRINTFORML 「かはっ……」
PRINTFORML 「ごほっ……」	PRINTFORML 「ごほっ……」
PRINTFORML 「しまった！」	PRINTFORML 「しまった！」
PRINTFORML 「速いっ！？」	PRINTFORML 「速いっ！？」
PRINTFORML 「そんな！？」	PRINTFORML 「そんな！？」
PRINTFORML 「勝てました」	PRINTFORML 「勝てました」
PRINTFORML 「ゃぁ……」	PRINTFORML 「ゃぁ……」
PRINTFORML 「ぉぇ……」	PRINTFORML 「ぉぇ……」
PRINTFORML 「……ぅぅ」	PRINTFORML 「……ぅぅ」
PRINTFORML 「力がっ…」	PRINTFORML 「力がっ…」
PRINTFORML 「瘴気！？」	PRINTFORML 「瘴気！？」
PRINTFORML 「すごぃ…」	PRINTFORML 「すごぃ…」
PRINTFORML 「あひぃ…」	PRINTFORML 「あひぃ…」
PRINTFORML 「はひっ…」	PRINTFORML 「はひっ…」
PRINTFORML 「むりぃ…」	PRINTFORML 「むりぃ…」
PRINTFORML 「いぃ……」	PRINTFORML 「いぃ……」
PRINTFORML 「あっ……」	PRINTFORML 「あっ……」
PRINTFORML 「眠い……」	PRINTFORML 「眠い……」
PRINTFORML 「うぅ……」	PRINTFORML 「うぅ……」
PRINTFORML 「痛っ…」	PRINTFORML 「痛っ…」
PRINTFORML 「………」	PRINTFORML 「………」
PRINTFORML 「成敗！」	PRINTFORML 「成敗！」
PRINTFORML 「次！」	PRINTFORML 「次！」
PRINTFORML 「……」	PRINTFORML 「……」
PRINTFORMDL …？	PRINTFORMDL …？
PRINTFORML 「」	PRINTFORML 「」
PRINTFORML 	PRINTFORML 
PRINTL 	PRINTL 
