﻿PRINTFORM 「い、いまされた、らぁ…	!#!PRINTFORM 「い、いまされた、らぁ…
PRINTFORMW 」	!#!PRINTFORMW 」
PRINTFORM 「が、我慢、我慢しないと…	!#!PRINTFORM 「が、我慢、我慢しないと…
PRINTFORM どんなに気持ちいいのが来ても、我慢…	!#!PRINTFORM どんなに気持ちいいのが来ても、我慢…
PRINTFORM 「が、我慢しない、とぉ…	!#!PRINTFORM 「が、我慢しない、とぉ…
PRINTFORM 「う、ぁ	!#!PRINTFORM 「う、ぁ
PRINTFORM 　が、がまん、しない、とぉ…	!#!PRINTFORM 　が、がまん、しない、とぉ…
PRINTFORM 「く…ふぅ…	!#!PRINTFORM 「く…ふぅ…
PRINTFORMW い、今は……」	!#!PRINTFORMW い、今は……」
PRINTFORMW 「身を、守らないと……」	!#!PRINTFORMW 「身を、守らないと……」
PRINTFORMW 「く……、今は、耐えないと……」	!#!PRINTFORMW 「く……、今は、耐えないと……」
PRINTFORM 「い、いま、狙われたら、だめなのにぃ…	!#!PRINTFORM 「い、いま、狙われたら、だめなのにぃ…
PRINTFORM 　でも、わらひ…	!#!PRINTFORM 　でも、わらひ…
PRINTFORM 「ん…	!#!PRINTFORM 「ん…
PRINTFORM だ、大丈夫、です	!#!PRINTFORM だ、大丈夫、です
PRINTFORM 私が前に出れば、一石二鳥ですからぁ	!#!PRINTFORM 私が前に出れば、一石二鳥ですからぁ
PRINTFORM 「ま、前に出たら……、狙っていただけるんでしょうか…	!#!PRINTFORM 「ま、前に出たら……、狙っていただけるんでしょうか…
PRINTFORM 「う、うずいひゃって……	!#!PRINTFORM 「う、うずいひゃって……
PRINTFORMW 　で、でも、前に、出ないと…」	!#!PRINTFORMW 　で、でも、前に、出ないと…」
PRINTFORMW 「私が前に出ます！」	!#!PRINTFORMW 「私が前に出ます！」
PRINTFORMW 「これでも、肉体操作系の魔法は得意なんですよ！」	!#!PRINTFORMW 「これでも、肉体操作系の魔法は得意なんですよ！」
PRINTFORMW 「ここは、私が！」	!#!PRINTFORMW 「ここは、私が！」
PRINTFORMW 「さぁ……、来なさい！」	!#!PRINTFORMW 「さぁ……、来なさい！」
PRINTFORM 「ゆ、ゆるひ、れ、くらさっ	!#!PRINTFORM 「ゆ、ゆるひ、れ、くらさっ
PRINTFORM 　わらひっ	!#!PRINTFORM 　わらひっ
PRINTFORM 　これいじょう、されるとぉっ	!#!PRINTFORM 　これいじょう、されるとぉっ
PRINTFORM 「はひっ	!#!PRINTFORM 「はひっ
PRINTFORM 　ひうっ	!#!PRINTFORM 　ひうっ
PRINTFORM 　こ、これいじょう、だめぇ…	!#!PRINTFORM 　こ、これいじょう、だめぇ…
PRINTFORM 「ふぁ	!#!PRINTFORM 「ふぁ
PRINTFORM はぁ	!#!PRINTFORM はぁ
PRINTFORM 「こ、これ以上されると…	!#!PRINTFORM 「こ、これ以上されると…
PRINTFORMW 「く……、少し、下がります」	!#!PRINTFORMW 「く……、少し、下がります」
PRINTFORMW 「や、やめ、くぅっ……！」	!#!PRINTFORMW 「や、やめ、くぅっ……！」
PRINTFORMW 「は、放して！ このぉぉっ！」	!#!PRINTFORMW 「は、放して！ このぉぉっ！」
PRINTFORM 「い、いまは、らめ、れすぅ…	!#!PRINTFORM 「い、いまは、らめ、れすぅ…
PRINTFORM 　にげ、にゃいとぉ…	!#!PRINTFORM 　にげ、にゃいとぉ…
PRINTFORM 「にげ、にゃいと、わらひっ、もっ…	!#!PRINTFORM 「にげ、にゃいと、わらひっ、もっ…
PRINTFORM 「に、にげ、ないと、わらひぃ…	!#!PRINTFORM 「に、にげ、ないと、わらひぃ…
PRINTL	!#!PRINTL
PRINTFORMW 「一度退いて体勢を立て直さないと……！」	!#!PRINTFORMW 「一度退いて体勢を立て直さないと……！」
PRINTFORM 「ら、め、にゃの、にぃ…	!#!PRINTFORM 「ら、め、にゃの、にぃ…
PRINTFORM 　もっ、わらひっ、にげにゃいと、いけにゃいのにぃ…	!#!PRINTFORM 　もっ、わらひっ、にげにゃいと、いけにゃいのにぃ…
PRINTFORM 「や、やはり、逃がしてはくれませんよね…	!#!PRINTFORM 「や、やはり、逃がしてはくれませんよね…
PRINTFORM （そして、私は……	!#!PRINTFORM （そして、私は……
PRINTFORMW ）	!#!PRINTFORMW ）
PRINTFORMW 「くっ、やはりそう簡単に逃がしてはくれませんか！」	!#!PRINTFORMW 「くっ、やはりそう簡単に逃がしてはくれませんか！」
PRINTFORMW 	!#!PRINTFORMW 
PRINTFORM 「ち、超人『聖白蓮』っ、はあぁぁぁっ	!#!PRINTFORM 「ち、超人『聖白蓮』っ、はあぁぁぁっ
PRINTFORMDL 外部からの刺激にすっかり弱くなった%CALLNAME:(TARGET)%の身体は超高速機動によって起こる身体へと当たる風にすら快楽を感じ、	!#!PRINTFORMDL 外部からの刺激にすっかり弱くなった%CALLNAME:(TARGET)%の身体は超高速機動によって起こる身体へと当たる風にすら快楽を感じ、
PRINTFORMDW %CALLNAME:(TARGET)%嬌声を上げながらも何とか触手達を蹴散らしている。	!#!PRINTFORMDW %CALLNAME:(TARGET)%嬌声を上げながらも何とか触手達を蹴散らしている。
PRINTFORMW 「	!#!PRINTFORMW 「
PRINTFORMW 「ま、まだ、負けられないんです！」	!#!PRINTFORMW 「ま、まだ、負けられないんです！」
PRINTFORMW 「超人『聖白蓮』！」	!#!PRINTFORMW 「超人『聖白蓮』！」
PRINTFORMDW %CALLNAME:(TARGET)%は自由に動かない身体を叱咤しながら超高速機動へ入った。	!#!PRINTFORMDW %CALLNAME:(TARGET)%は自由に動かない身体を叱咤しながら超高速機動へ入った。
PRINTFORMW 「はあぁぁぁぁぁぁ……！」	!#!PRINTFORMW 「はあぁぁぁぁぁぁ……！」
PRINTFORMDW 白蓮の身体を中心に、知覚出来る程強力な法力が渦巻いて行く…！	!#!PRINTFORMDW 白蓮の身体を中心に、知覚出来る程強力な法力が渦巻いて行く…！
PRINTFORMW 「……参ります……！」	!#!PRINTFORMW 「……参ります……！」
PRINTFORMW 「超人『聖白蓮』！ まとめて、砕けなさい！」	!#!PRINTFORMW 「超人『聖白蓮』！ まとめて、砕けなさい！」
PRINTFORMW 残像が残る程に急加速した白蓮の拳が、蹴撃が触手達を蹴散らして行く！	!#!PRINTFORMW 残像が残る程に急加速した白蓮の拳が、蹴撃が触手達を蹴散らして行く！
PRINTFORM 「はふっ	!#!PRINTFORM 「はふっ
PRINTFORM 　ひゃぁっ	!#!PRINTFORM 　ひゃぁっ
PRINTFORM 　も、もう、らめれすからぁぁっ	!#!PRINTFORM 　も、もう、らめれすからぁぁっ
PRINTFORM 「も、もぅ、これいじょう、はぁ…	!#!PRINTFORM 「も、もぅ、これいじょう、はぁ…
PRINTFORM 「ふあぁ…	!#!PRINTFORM 「ふあぁ…
PRINTFORMW 　早く…抜け出さないとぉ…」	!#!PRINTFORMW 　早く…抜け出さないとぉ…」
PRINTFORM 「ひっ、ひっひゃっれ…	!#!PRINTFORM 「ひっ、ひっひゃっれ…
PRINTFORM 　も、らめなのにぃっ	!#!PRINTFORM 　も、らめなのにぃっ
PRINTFORM 「ひああぁぁぁぁっ	!#!PRINTFORM 「ひああぁぁぁぁっ
PRINTFORM 　ああぁぁぁん	!#!PRINTFORM 　ああぁぁぁん
PRINTFORMDW %CALLNAME:(TARGET)%は襲い来る絶頂感に身体をびくびく跳ねさせるだけで、抵抗も何も出来ていない…。	!#!PRINTFORMDW %CALLNAME:(TARGET)%は襲い来る絶頂感に身体をびくびく跳ねさせるだけで、抵抗も何も出来ていない…。
PRINTFORM 「はひぃぃぃっ	!#!PRINTFORM 「はひぃぃぃっ
PRINTFORM 「やらぁ、やらあぁぁっ	!#!PRINTFORM 「やらぁ、やらあぁぁっ
PRINTFORMDL %CALLNAME:(TARGET)%は身体をびくんびくんと跳ねさせる。	!#!PRINTFORMDL %CALLNAME:(TARGET)%は身体をびくんびくんと跳ねさせる。
PRINTFORMW それが触手から逃れようとする動きなのか、ただの絶頂の動きなのかは%CALLNAME:(TARGET)%にも分からなかった。	!#!PRINTFORMW それが触手から逃れようとする動きなのか、ただの絶頂の動きなのかは%CALLNAME:(TARGET)%にも分からなかった。
PRINTFORM 「ち、ちから、はいらな…	!#!PRINTFORM 「ち、ちから、はいらな…
PRINTFORM 　は、はなひて、はなひてくださぁいっ	!#!PRINTFORM 　は、はなひて、はなひてくださぁいっ
PRINTFORM 「うあぁっ	!#!PRINTFORM 「うあぁっ
PRINTFORM 　うあぁぁぁっ	!#!PRINTFORM 　うあぁぁぁっ
PRINTFORM （に、逃げなきゃ……でも、このままだと、とろとろに…	!#!PRINTFORM （に、逃げなきゃ……でも、このままだと、とろとろに…
PRINTFORMW （に、逃げなきゃ、いけないのに…）	!#!PRINTFORMW （に、逃げなきゃ、いけないのに…）
PRINTFORMW 「このっ……、放しなさいっ！」	!#!PRINTFORMW 「このっ……、放しなさいっ！」
PRINTFORMW 「くっ…やはり、そう簡単には行きませんか…」	!#!PRINTFORMW 「くっ…やはり、そう簡単には行きませんか…」
PRINTFORM 「が、がまん、ひてぇ	!#!PRINTFORM 「が、がまん、ひてぇ
PRINTFORM 　に、げ	!#!PRINTFORM 　に、げ
PRINTFORM （でも……、このままだと、もっときもひよくひてもらえるかもぉ	!#!PRINTFORM （でも……、このままだと、もっときもひよくひてもらえるかもぉ
PRINTFORM 「が、がまん、しない、とぉ	!#!PRINTFORM 「が、がまん、しない、とぉ
PRINTFORM 　にげ、なきゃぁ	!#!PRINTFORM 　にげ、なきゃぁ
PRINTFORM 「ち、ちから、ためないとぉ	!#!PRINTFORM 「ち、ちから、ためないとぉ
PRINTFORM 　このままひゃ、わたしぃ…	!#!PRINTFORM 　このままひゃ、わたしぃ…
PRINTFORM 「し、集中、しないと…ふぁ	!#!PRINTFORM 「し、集中、しないと…ふぁ
PRINTFORM 　そ、そこらめですぅっ	!#!PRINTFORM 　そ、そこらめですぅっ
PRINTFORM 「いみゃらめぇぇぇっ	!#!PRINTFORM 「いみゃらめぇぇぇっ
PRINTFORM 　しょこらめれしゅぅぅぅっ	!#!PRINTFORM 　しょこらめれしゅぅぅぅっ
PRINTFORMDL %CALLNAME:(TARGET)%は何とか力を貯めようとしているが、	!#!PRINTFORMDL %CALLNAME:(TARGET)%は何とか力を貯めようとしているが、
PRINTFORMDW 絶頂に身体を無茶苦茶に跳ねさせながらでは出来る訳も無かった…。	!#!PRINTFORMDW 絶頂に身体を無茶苦茶に跳ねさせながらでは出来る訳も無かった…。
PRINTFORM 「っひっ	!#!PRINTFORM 「っひっ
PRINTFORM 　あ゛～～～～	!#!PRINTFORM 　あ゛～～～～
PRINTFORMDW 力を貯めようと試みる度に激しい快楽に襲われ、%CALLNAME:(TARGET)%は蕩けた表情でイき狂っている…。	!#!PRINTFORMDW 力を貯めようと試みる度に激しい快楽に襲われ、%CALLNAME:(TARGET)%は蕩けた表情でイき狂っている…。
PRINTFORM 「ひにゅうぅぅ	!#!PRINTFORM 「ひにゅうぅぅ
PRINTFORM 　ひにゃあぁぁぁ	!#!PRINTFORM 　ひにゃあぁぁぁ
PRINTFORMDW どろどろに蕩けた表情を浮かべ、%CALLNAME:(TARGET)%はぐったりと快楽に震えている…。	!#!PRINTFORMDW どろどろに蕩けた表情を浮かべ、%CALLNAME:(TARGET)%はぐったりと快楽に震えている…。
PRINTFORM 「ちから、ためなきゃいけないのに…	!#!PRINTFORM 「ちから、ためなきゃいけないのに…
PRINTFORM 　あたま、まっしろで…	!#!PRINTFORM 　あたま、まっしろで…
PRINTFORM 「ちっ	!#!PRINTFORM 「ちっ
PRINTFORM 　ちからっ	!#!PRINTFORM 　ちからっ
PRINTFORM 　ためてぇっ	!#!PRINTFORM 　ためてぇっ
PRINTFORMW 「し、集中しなきゃ…」	!#!PRINTFORMW 「し、集中しなきゃ…」
PRINTFORM 「んんっ	!#!PRINTFORM 「んんっ
PRINTFORM 　な、なんとか力を集中しないと…ふぁ	!#!PRINTFORM 　な、なんとか力を集中しないと…ふぁ
PRINTFORM 「っは、はひ…	!#!PRINTFORM 「っは、はひ…
PRINTFORM 「も……、もう、だめ…	!#!PRINTFORM 「も……、もう、だめ…
PRINTFORM 　すきにして、いいですからぁ	!#!PRINTFORM 　すきにして、いいですからぁ
PRINTFORM 「えっひなひじりを、どれいにひてぇぇぇっ	!#!PRINTFORM 「えっひなひじりを、どれいにひてぇぇぇっ
PRINTFORMDW %CALLNAME:(TARGET)%は格下の相手の幻影に屈服し、おねだりを始めた。	!#!PRINTFORMDW %CALLNAME:(TARGET)%は格下の相手の幻影に屈服し、おねだりを始めた。
PRINTFORM 「も、もうがまんできないんですぅ…	!#!PRINTFORM 「も、もうがまんできないんですぅ…
PRINTFORM 「えっひなわらひを、『私』でいっぱいきもひよくひてくださぁいっ	!#!PRINTFORM 「えっひなわらひを、『私』でいっぱいきもひよくひてくださぁいっ
PRINTFORMDW %CALLNAME:(TARGET)%は蕩けた表情を浮かべて、自分におねだりをした。	!#!PRINTFORMDW %CALLNAME:(TARGET)%は蕩けた表情を浮かべて、自分におねだりをした。
PRINTFORMW 「も、もうだめです…」	!#!PRINTFORMW 「も、もうだめです…」
PRINTFORMW 「どれいでいいですから、いっぱいひてください…」	!#!PRINTFORMW 「どれいでいいですから、いっぱいひてください…」
PRINTFORM 「っひ	!#!PRINTFORM 「っひ
PRINTFORM 　ひぅぅっ	!#!PRINTFORM 　ひぅぅっ
PRINTFORM 「も、もう、むりれしゅぅっ	!#!PRINTFORM 「も、もう、むりれしゅぅっ
PRINTFORM 　ろれいれいいれすからっ	!#!PRINTFORM 　ろれいれいいれすからっ
PRINTFORM 　いっぱいわらひをイかしぇてくらさぁいっ	!#!PRINTFORM 　いっぱいわらひをイかしぇてくらさぁいっ
PRINTFORM 「も、もう、らめぇ…	!#!PRINTFORM 「も、もう、らめぇ…
PRINTFORM 　きもひよすぎれ、もっとひてほしいんれしゅぅっ	!#!PRINTFORM 　きもひよすぎれ、もっとひてほしいんれしゅぅっ
PRINTFORMW 「うぅ、ぁ……」	!#!PRINTFORMW 「うぅ、ぁ……」
PRINTFORMW 「も、もう逃げられない…」	!#!PRINTFORMW 「も、もう逃げられない…」
PRINTFORM 「%CALLNAME_96_0(CFLAG:900, 1, ARGS:1)%	!#!PRINTFORM 「%CALLNAME_96_0(CFLAG:900, 1, ARGS:1)%
PRINTFORM 　もっとぎゅぅってしてくださぁいっ	!#!PRINTFORM 　もっとぎゅぅってしてくださぁいっ
PRINTFORM 「%CALLNAME_96_0(CFLAG:900, 1, ARGS:1)%…	!#!PRINTFORM 「%CALLNAME_96_0(CFLAG:900, 1, ARGS:1)%…
PRINTFORM 　%CALLNAME_96_0(CFLAG:900, 1, ARGS:1)%っっ	!#!PRINTFORM 　%CALLNAME_96_0(CFLAG:900, 1, ARGS:1)%っっ
PRINTFORM 「はぅ…	!#!PRINTFORM 「はぅ…
PRINTFORM 　%CALLNAME_96_0(CFLAG:900, 0, ARGS:1)%にぎゅっとされたら…	!#!PRINTFORM 　%CALLNAME_96_0(CFLAG:900, 0, ARGS:1)%にぎゅっとされたら…
PRINTFORM 　何も考えられなく…	!#!PRINTFORM 　何も考えられなく…
PRINTFORM 「ま、またひてくらさいっ	!#!PRINTFORM 「ま、またひてくらさいっ
PRINTFORM 「わらひっ、%CALLNAME_96_0(CFLAG:900, 0, ARGS:1)%にっ、されたくてしかたないんれすぅっ	!#!PRINTFORM 「わらひっ、%CALLNAME_96_0(CFLAG:900, 0, ARGS:1)%にっ、されたくてしかたないんれすぅっ
PRINTFORM 「ぅん……	!#!PRINTFORM 「ぅん……
PRINTFORM 　そうです…もっとしてください…%CALLNAME_96_0(CFLAG:900, 1, ARGS:1)%……	!#!PRINTFORM 　そうです…もっとしてください…%CALLNAME_96_0(CFLAG:900, 1, ARGS:1)%……
PRINTFORM 　はひいぃぃっ	!#!PRINTFORM 　はひいぃぃっ
PRINTFORM 「か、からだっ	!#!PRINTFORM 「か、からだっ
PRINTFORM 　うずいてっ	!#!PRINTFORM 　うずいてっ
PRINTFORM 　むりっ	!#!PRINTFORM 　むりっ
PRINTFORM 　がまんなんかむりれすぅぅぅっ	!#!PRINTFORM 　がまんなんかむりれすぅぅぅっ
PRINTFORM 「はー	!#!PRINTFORM 「はー
PRINTFORM 　はー…	!#!PRINTFORM 　はー…
PRINTFORM 「む、むりですよぉ……	!#!PRINTFORM 「む、むりですよぉ……
PRINTFORM 　こんな、あついのに、がまんなんてぇ…	!#!PRINTFORM 　こんな、あついのに、がまんなんてぇ…
PRINTFORMW 「て、手が、勝手に…」	!#!PRINTFORMW 「て、手が、勝手に…」
PRINTFORM 「お、おひりよりももっときもひいいところあるんれすぅっ	!#!PRINTFORM 「お、おひりよりももっときもひいいところあるんれすぅっ
PRINTFORM 「こっちよりもっ	!#!PRINTFORM 「こっちよりもっ
PRINTFORM 　そっちをっ、いっぱいいじめてくらさぁいっ	!#!PRINTFORM 　そっちをっ、いっぱいいじめてくらさぁいっ
PRINTFORM 「だ、だめですぅ…	!#!PRINTFORM 「だ、だめですぅ…
PRINTFORM 「こっちより、もっと気持ちいいところにくださぁい…	!#!PRINTFORM 「こっちより、もっと気持ちいいところにくださぁい…
PRINTFORMW 「お、お尻はやめてください！」	!#!PRINTFORMW 「お、お尻はやめてください！」
PRINTFORM 「ら、らめれすよぉ	!#!PRINTFORM 「ら、らめれすよぉ
PRINTFORM 　わらひっ、特大おっぱいいじめられたら、すぐイっちゃうんれすっ	!#!PRINTFORM 　わらひっ、特大おっぱいいじめられたら、すぐイっちゃうんれすっ
PRINTFORM 「それよりもっ、もっと他の場所でいっぱいイきたいんれすよぉっ	!#!PRINTFORM 「それよりもっ、もっと他の場所でいっぱいイきたいんれすよぉっ
PRINTFORM 「お、おっぱいらめれすよぉ	!#!PRINTFORM 「お、おっぱいらめれすよぉ
PRINTFORM 　こっちよりも、他のところできもちよくなりたいんですぅっ	!#!PRINTFORM 　こっちよりも、他のところできもちよくなりたいんですぅっ
PRINTFORM 「おっぱいはだめですぅ	!#!PRINTFORM 「おっぱいはだめですぅ
PRINTFORM 　おっぱい敏感すぎて、すぐにイっちゃうんですからぁ	!#!PRINTFORM 　おっぱい敏感すぎて、すぐにイっちゃうんですからぁ
PRINTFORMW 「こ、こんな大きくなったの、隠し切れない…」	!#!PRINTFORMW 「こ、こんな大きくなったの、隠し切れない…」
PRINTFORMW 「やっぱり、私のおっぱいって魅力的なのかしら…？」	!#!PRINTFORMW 「やっぱり、私のおっぱいって魅力的なのかしら…？」
PRINTFORM 「こ、こっちじゃだめです…	!#!PRINTFORM 「こ、こっちじゃだめです…
PRINTFORM 　もっと、してほしいところ、あるんですからぁ	!#!PRINTFORM 　もっと、してほしいところ、あるんですからぁ
PRINTFORM 「そ、そこよりも、ずぼずぼっていっぱい入れてください	!#!PRINTFORM 「そ、そこよりも、ずぼずぼっていっぱい入れてください
PRINTFORMW 「だ、だめです！」	!#!PRINTFORMW 「だ、だめです！」
PRINTFORM 「にゅ、にゅぽにゅぽされるよりも、ほかのところで、イきたいんれすぅっ	!#!PRINTFORM 「にゅ、にゅぽにゅぽされるよりも、ほかのところで、イきたいんれすぅっ
PRINTFORM 「そこらったら、わらひいっぱいイかしぇていいれすからぁっ	!#!PRINTFORM 「そこらったら、わらひいっぱいイかしぇていいれすからぁっ
PRINTFORMW 「い、今はおまんこよりも他でイきたいんです…」	!#!PRINTFORMW 「い、今はおまんこよりも他でイきたいんです…」
PRINTFORM 「他の場所でならいくらでもイかせてくれていいですからぁ	!#!PRINTFORM 「他の場所でならいくらでもイかせてくれていいですからぁ
PRINTFORM 「じゅ、じゅぽじゅぽはだめですぅ	!#!PRINTFORM 「じゅ、じゅぽじゅぽはだめですぅ
PRINTFORM 「それ、されたら私すぐにイっちゃいますからぁ	!#!PRINTFORM 「それ、されたら私すぐにイっちゃいますからぁ
PRINTFORMW 「く、ここだけはだめです！」	!#!PRINTFORMW 「く、ここだけはだめです！」
PRINTFORM 「わ、私のおひり…	!#!PRINTFORM 「わ、私のおひり…
PRINTFORM 　いっぱい、開発してください…	!#!PRINTFORM 　いっぱい、開発してください…
PRINTFORM 「お、お尻が、うずいてるんですぅっ	!#!PRINTFORM 「お、お尻が、うずいてるんですぅっ
PRINTFORM いっぱいずぼずぼしてぇっ	!#!PRINTFORM いっぱいずぼずぼしてぇっ
PRINTFORMW 「あんまり好きじゃないですけど、他の所をされるよりは…」	!#!PRINTFORMW 「あんまり好きじゃないですけど、他の所をされるよりは…」
PRINTFORM 「私のおっきなおっぱい、おいしそうでしょう	!#!PRINTFORM 「私のおっきなおっぱい、おいしそうでしょう
PRINTFORM 　はやく、まきついて、いじめてぇぇっ	!#!PRINTFORM 　はやく、まきついて、いじめてぇぇっ
PRINTFORM 「おっぱいが、たぷたぷって張ってるんです……	!#!PRINTFORM 「おっぱいが、たぷたぷって張ってるんです……
PRINTFORM 「いっぱい、巻き付いて、びゅるびゅる搾ってぇっ	!#!PRINTFORM 「いっぱい、巻き付いて、びゅるびゅる搾ってぇっ
PRINTFORM 「わらひのおっぱいっ、もっ、ミルクでたぷたぷなんれすぅっ	!#!PRINTFORM 「わらひのおっぱいっ、もっ、ミルクでたぷたぷなんれすぅっ
PRINTFORM 「いっぱい搾って、ごくごく飲んでいいれすよぉ…	!#!PRINTFORM 「いっぱい搾って、ごくごく飲んでいいれすよぉ…
PRINTFORM 「わらひ、おっぱいがきもちよしゅぎてぇっ	!#!PRINTFORM 「わらひ、おっぱいがきもちよしゅぎてぇっ
PRINTFORM 　ちくびくにくにひてくださいっ、いっぱいきもひよくひてくださぁいっ	!#!PRINTFORM 　ちくびくにくにひてくださいっ、いっぱいきもひよくひてくださぁいっ
PRINTFORM 「わらひっ、すぐにおっぱいでイけましゅからぁっ	!#!PRINTFORM 「わらひっ、すぐにおっぱいでイけましゅからぁっ
PRINTFORM 「おっぱいいじめてくださいっ、えっちなわらひを、おっぱいでいっぱいイかせてくらさぁいっ	!#!PRINTFORM 「おっぱいいじめてくださいっ、えっちなわらひを、おっぱいでいっぱいイかせてくらさぁいっ
PRINTFORM 「おっぱいっ、もっとむにむにしてぇっ	!#!PRINTFORM 「おっぱいっ、もっとむにむにしてぇっ
PRINTFORM 　ちくびもっ、いじめていいですからぁっ	!#!PRINTFORM 　ちくびもっ、いじめていいですからぁっ
PRINTFORM 「わらひのえっちなおっぱい、もっと気持ちよくさせてぇっ	!#!PRINTFORM 「わらひのえっちなおっぱい、もっと気持ちよくさせてぇっ
PRINTFORM 「ほら…、いっぱいミルク、出したいんです	!#!PRINTFORM 「ほら…、いっぱいミルク、出したいんです
PRINTFORM 「いくらでも飲んでいいですから…どうぞ	!#!PRINTFORM 「いくらでも飲んでいいですから…どうぞ
PRINTFORM 「ほ、ほら、大きいでしょう？ 触手でぐりぐりってしたいでしょう	!#!PRINTFORM 「ほ、ほら、大きいでしょう？ 触手でぐりぐりってしたいでしょう
PRINTFORM 「私も、して欲しいんですっ	!#!PRINTFORM 「私も、して欲しいんですっ
PRINTFORM 　触手さんでおっぱいいじめてくださぁいっ	!#!PRINTFORM 　触手さんでおっぱいいじめてくださぁいっ
PRINTFORM 「胸がっ、敏感すぎて痛いぐらいなんですぅっ	!#!PRINTFORM 「胸がっ、敏感すぎて痛いぐらいなんですぅっ
PRINTFORM 「その触手さんでっ、いっぱいいじめてくださぁいっ	!#!PRINTFORM 「その触手さんでっ、いっぱいいじめてくださぁいっ
PRINTFORMW 「やっぱり、ここまで大きくなっちゃったら、気になりますよね…」	!#!PRINTFORMW 「やっぱり、ここまで大きくなっちゃったら、気になりますよね…」
PRINTFORM 「私も張って痛いんです、いっぱいさすってください…	!#!PRINTFORM 「私も張って痛いんです、いっぱいさすってください…
PRINTFORMW 「あ、胸が、いいんですか……？」	!#!PRINTFORMW 「あ、胸が、いいんですか……？」
PRINTFORM 「いいですよ、私のおっぱい、いじめてください…	!#!PRINTFORM 「いいですよ、私のおっぱい、いじめてください…
PRINTFORMW 「ち、乳首が、立っちゃって…」	!#!PRINTFORMW 「ち、乳首が、立っちゃって…」
PRINTFORMW 「鎮めて、もらえませんか…？」	!#!PRINTFORMW 「鎮めて、もらえませんか…？」
PRINTFORM 「お、おちんちんが、ぴくぴくって…	!#!PRINTFORM 「お、おちんちんが、ぴくぴくって…
PRINTFORM 　びゅるびゅる出したいんですぅっ	!#!PRINTFORM 　びゅるびゅる出したいんですぅっ
PRINTFORM いっぱいしごいてくださぁいっ	!#!PRINTFORM いっぱいしごいてくださぁいっ
PRINTFORM 「もぉっ、クリをこすこすしてほしくてしかたないんれすぅっ	!#!PRINTFORM 「もぉっ、クリをこすこすしてほしくてしかたないんれすぅっ
PRINTFORM 「もっといじって、わらひをこわひてぇぇぇっ	!#!PRINTFORM 「もっといじって、わらひをこわひてぇぇぇっ
PRINTFORM 「もっ、クリちゃんかちかちなんれすぅっ	!#!PRINTFORM 「もっ、クリちゃんかちかちなんれすぅっ
PRINTFORM 　しこしこして、いっぱいイかせてくらさぁいっ	!#!PRINTFORM 　しこしこして、いっぱいイかせてくらさぁいっ
PRINTFORM 「おちんちん、がまんできないんですぅっ	!#!PRINTFORM 「おちんちん、がまんできないんですぅっ
PRINTFORM ぐりぐり、してくださぁいっ	!#!PRINTFORM ぐりぐり、してくださぁいっ
PRINTFORM 「クリがっ、ぴくぴくしてぇっ	!#!PRINTFORM 「クリがっ、ぴくぴくしてぇっ
PRINTFORM 　がまんできないんですぅっ	!#!PRINTFORM 　がまんできないんですぅっ
PRINTFORM 「いっぱいいじめてくださぁいっ	!#!PRINTFORM 「いっぱいいじめてくださぁいっ
PRINTFORMW 「こ、このおちんちん、取ってください…」	!#!PRINTFORMW 「こ、このおちんちん、取ってください…」
PRINTFORMW 「クリトリスがっ、じんじんしてるんです…」	!#!PRINTFORMW 「クリトリスがっ、じんじんしてるんです…」
PRINTFORM 「ずぷってひれくらさぁいっ	!#!PRINTFORM 「ずぷってひれくらさぁいっ
PRINTFORM 　わらひのおまんこ、はつじょうしちゃってるんれすぅっ	!#!PRINTFORM 　わらひのおまんこ、はつじょうしちゃってるんれすぅっ
PRINTFORM 「えっひなびゃくれんを、もっろえっひにひてぇぇぇっ	!#!PRINTFORM 「えっひなびゃくれんを、もっろえっひにひてぇぇぇっ
PRINTFORM 「いっぱひっ、いっぱいひてほしいんれすぅっ	!#!PRINTFORM 「いっぱひっ、いっぱいひてほしいんれすぅっ
PRINTFORM 　じゅぷじゅぷひれくらさぁいっ	!#!PRINTFORM 　じゅぷじゅぷひれくらさぁいっ
PRINTFORM 「あかひゃんっ、れきてもいいれすからぁっ	!#!PRINTFORM 「あかひゃんっ、れきてもいいれすからぁっ
PRINTFORM 「いっぱいちゅいてぇっ	!#!PRINTFORM 「いっぱいちゅいてぇっ
PRINTFORM 　いっぱいそそいでくださぁいっ	!#!PRINTFORM 　いっぱいそそいでくださぁいっ
PRINTFORM 「おまんこに、じゅぽじゅぽってされていっぱいイきたいんです	!#!PRINTFORM 「おまんこに、じゅぽじゅぽってされていっぱいイきたいんです
PRINTFORM 「わらひがこわれちゃうぐらいにっ、いっぱいにゅこにゅこしてくらさぁいっ	!#!PRINTFORM 「わらひがこわれちゃうぐらいにっ、いっぱいにゅこにゅこしてくらさぁいっ
PRINTFORM 「たねつけひれくらさいっ	!#!PRINTFORM 「たねつけひれくらさいっ
PRINTFORM 　びゃくれんのっ、えっちなおまんこ、満たしてくらさぁいっ	!#!PRINTFORM 　びゃくれんのっ、えっちなおまんこ、満たしてくらさぁいっ
PRINTFORM 「ぬぷぬぷひてくらさぁいっ	!#!PRINTFORM 「ぬぷぬぷひてくらさぁいっ
PRINTFORM 　いっぱい、おまんこにぃぃっ	!#!PRINTFORM 　いっぱい、おまんこにぃぃっ
PRINTFORM 「はぁ	!#!PRINTFORM 「はぁ
PRINTFORM 　はぁ	!#!PRINTFORM 　はぁ
PRINTFORM 「が、がまんできないんです、子宮にどぷどぷって欲しいんですぅ	!#!PRINTFORM 「が、がまんできないんです、子宮にどぷどぷって欲しいんですぅ
PRINTFORMW 「わ、私の中に、注いでもいいですから…」	!#!PRINTFORMW 「わ、私の中に、注いでもいいですから…」
PRINTFORMW 「乱暴にはしないでください、ね…？」	!#!PRINTFORMW 「乱暴にはしないでください、ね…？」
PRINTFORMW 「欲しい、です……満たされたいんですぅ…」	!#!PRINTFORMW 「欲しい、です……満たされたいんですぅ…」
PRINTFORM 「ひじりのえっちなからだぁっ	!#!PRINTFORM 「ひじりのえっちなからだぁっ
PRINTFORM 　いっぱいめちゃくちゃにひてくらさぁいっ	!#!PRINTFORM 　いっぱいめちゃくちゃにひてくらさぁいっ
PRINTFORM 「もっ、全身が欲しくてたまらないんですぅっ	!#!PRINTFORM 「もっ、全身が欲しくてたまらないんですぅっ
PRINTFORM 　どこれもいいれすからぁっ	!#!PRINTFORM 　どこれもいいれすからぁっ
PRINTFORM 　いっぱいいじめていっぱいイかせてくらさぁいっ	!#!PRINTFORM 　いっぱいいじめていっぱいイかせてくらさぁいっ
PRINTFORM 「どこれも、かまいませんからぁっ…	!#!PRINTFORM 「どこれも、かまいませんからぁっ…
PRINTFORM 　触手さんで、いじってほしいんですぅ…	!#!PRINTFORM 　触手さんで、いじってほしいんですぅ…
PRINTFORMW 「どこでも、いいですよ……」	!#!PRINTFORMW 「どこでも、いいですよ……」
PRINTFORMW 「私、逃げませんから…、気持ちよくしてください…」	!#!PRINTFORMW 「私、逃げませんから…、気持ちよくしてください…」
PRINTFORM 「んむっ	!#!PRINTFORM 「んむっ
PRINTFORM 　ちゅぅっ	!#!PRINTFORM 　ちゅぅっ
PRINTFORM 　ろう、れすか…	!#!PRINTFORM 　ろう、れすか…
PRINTFORM 「んちゅ…	!#!PRINTFORM 「んちゅ…
PRINTFORM 　…んっ	!#!PRINTFORM 　…んっ
PRINTFORM 　どう、ですか	!#!PRINTFORM 　どう、ですか
PRINTFORM 　わたしの、ちゅぅ…っ	!#!PRINTFORM 　わたしの、ちゅぅ…っ
PRINTFORM 「んむぅっ	!#!PRINTFORM 「んむぅっ
PRINTFORM 　はぷっ	!#!PRINTFORM 　はぷっ
PRINTFORMW 　ちゅくっ♪」	!#!PRINTFORMW 　ちゅくっ♪」
PRINTFORM 「はむ	!#!PRINTFORM 「はむ
PRINTFORM 　きもひ、いいれすか…？	!#!PRINTFORM 　きもひ、いいれすか…？
PRINTFORM 　わらひの、きす、いいれすか？	!#!PRINTFORM 　わらひの、きす、いいれすか？
PRINTFORM 　おっきい、れす…	!#!PRINTFORM 　おっきい、れす…
PRINTFORM 「ん	!#!PRINTFORM 「ん
PRINTFORM 　しゅっ、しゅっ	!#!PRINTFORM 　しゅっ、しゅっ
PRINTFORM 　気持ちいい、ですか？	!#!PRINTFORM 　気持ちいい、ですか？
PRINTFORM 「あ	!#!PRINTFORM 「あ
PRINTFORM 　こんなに、おおきく…	!#!PRINTFORM 　こんなに、おおきく…
PRINTFORM 「すごっ、かたい、れすよぉ…	!#!PRINTFORM 「すごっ、かたい、れすよぉ…
PRINTFORM 「こんなに、びくびくって…	!#!PRINTFORM 「こんなに、びくびくって…
PRINTFORM 　あぅ、身体が、だんだん、ほしくなって…	!#!PRINTFORM 　あぅ、身体が、だんだん、ほしくなって…
PRINTFORM 「んぅ…	!#!PRINTFORM 「んぅ…
PRINTFORM 　ふぁ、こんなにかちかち…	!#!PRINTFORM 　ふぁ、こんなにかちかち…
PRINTFORM 　はむっ	!#!PRINTFORM 　はむっ
PRINTFORM 　ちゅぷっ	!#!PRINTFORM 　ちゅぷっ
PRINTFORM 　くちゅっ	!#!PRINTFORM 　くちゅっ
PRINTFORM 「ふぁ…	!#!PRINTFORM 「ふぁ…
PRINTFORMDW %CALLNAME:(TARGET)%は、蕩けた表情で性器に舌を這わせている…。	!#!PRINTFORMDW %CALLNAME:(TARGET)%は、蕩けた表情で性器に舌を這わせている…。
PRINTFORM 　んんっ	!#!PRINTFORM 　んんっ
PRINTFORM 　おっきくて、素敵ですぅ…	!#!PRINTFORM 　おっきくて、素敵ですぅ…
PRINTFORM 　くち、入りきれませんよぉ…	!#!PRINTFORM 　くち、入りきれませんよぉ…
PRINTFORMDW %CALLNAME:(TARGET)%はちろちろと性器の先端を舐め始めた…。	!#!PRINTFORMDW %CALLNAME:(TARGET)%はちろちろと性器の先端を舐め始めた…。
PRINTFORM 　はむぅぅっ	!#!PRINTFORM 　はむぅぅっ
PRINTFORM 　んっ	!#!PRINTFORM 　んっ
PRINTFORM 　んっんっ	!#!PRINTFORM 　んっんっ
PRINTFORM 「んふぅ…	!#!PRINTFORM 「んふぅ…
PRINTFORM 　くひ、いっぱひ、れすぅ…	!#!PRINTFORM 　くひ、いっぱひ、れすぅ…
PRINTFORMDW %CALLNAME:(TARGET)%は口をすぼめ、少しでも性器に刺激を与えようとしている…。	!#!PRINTFORMDW %CALLNAME:(TARGET)%は口をすぼめ、少しでも性器に刺激を与えようとしている…。
PRINTFORM 「んちゅっ	!#!PRINTFORM 「んちゅっ
PRINTFORM 　ちろっ、ちろっ	!#!PRINTFORM 　ちろっ、ちろっ
PRINTFORM 「んふっ	!#!PRINTFORM 「んふっ
PRINTFORM 　きもひ、いいれすかぁ？	!#!PRINTFORM 　きもひ、いいれすかぁ？
PRINTFORM 「んっ	!#!PRINTFORM 「んっ
PRINTFORM 　ほらほら、むにゅ～	!#!PRINTFORM 　ほらほら、むにゅ～
PRINTFORM 「ふふっ、おっぱいに埋もれちゃいましたね	!#!PRINTFORM 「ふふっ、おっぱいに埋もれちゃいましたね
PRINTFORMDW %CALLNAME:(TARGET)%は胸の中に性器を埋めさせ、刺激を与え続けている…。	!#!PRINTFORMDW %CALLNAME:(TARGET)%は胸の中に性器を埋めさせ、刺激を与え続けている…。
PRINTFORM 「んあっ	!#!PRINTFORM 「んあっ
PRINTFORM 　はうぅっ	!#!PRINTFORM 　はうぅっ
PRINTFORM 　おっぱいっ	!#!PRINTFORM 　おっぱいっ
PRINTFORM 　こすれちゃいまふぅぅっ	!#!PRINTFORM 　こすれちゃいまふぅぅっ
PRINTFORMDW %CALLNAME:(TARGET)%は胸の隙間に出し入れされる性器の刺激に、自らも嬌声を上げている…。	!#!PRINTFORMDW %CALLNAME:(TARGET)%は胸の隙間に出し入れされる性器の刺激に、自らも嬌声を上げている…。
PRINTFORM 「どうですか	!#!PRINTFORM 「どうですか
PRINTFORM 　こんなに、おっきくなっちゃったから…	!#!PRINTFORM 　こんなに、おっきくなっちゃったから…
PRINTFORM 　やりやすい、ですよね	!#!PRINTFORM 　やりやすい、ですよね
PRINTFORM 「わっ	!#!PRINTFORM 「わっ
PRINTFORM 　わらひもっ	!#!PRINTFORM 　わらひもっ
PRINTFORM 　みるくっ	!#!PRINTFORM 　みるくっ
PRINTFORM 　れちゃいまふっ	!#!PRINTFORM 　れちゃいまふっ
PRINTFORM 「わらひのみるくとっ	!#!PRINTFORM 「わらひのみるくとっ
PRINTFORM 　あなたのみるくれっ	!#!PRINTFORM 　あなたのみるくれっ
PRINTFORM 　おっぱいまっしろにしてくらさぁいっ	!#!PRINTFORM 　おっぱいまっしろにしてくらさぁいっ
PRINTFORM 「ふふっ	!#!PRINTFORM 「ふふっ
PRINTFORM 　こんなにおっきいと、埋まっちゃいますよね	!#!PRINTFORM 　こんなにおっきいと、埋まっちゃいますよね
PRINTFORM 　でも、きもちいいでしょう	!#!PRINTFORM 　でも、きもちいいでしょう
PRINTFORM 　ほら、おっぱいの中で、いっぱい出してくださいね	!#!PRINTFORM 　ほら、おっぱいの中で、いっぱい出してくださいね
PRINTFORM 「どうですか？ わたしの特大おっぱい…	!#!PRINTFORM 「どうですか？ わたしの特大おっぱい…
PRINTFORM 　ふふっ	!#!PRINTFORM 　ふふっ
PRINTFORM 　もっとむにむに、してあげますからね	!#!PRINTFORM 　もっとむにむに、してあげますからね
PRINTFORMDW %CALLNAME:(TARGET)%は一抱えもありそうな程肥大化した胸で性器を挟み、擦り上げている…。	!#!PRINTFORMDW %CALLNAME:(TARGET)%は一抱えもありそうな程肥大化した胸で性器を挟み、擦り上げている…。
PRINTFORM 　わたしのおっぱい、気持ちいいですか？	!#!PRINTFORM 　わたしのおっぱい、気持ちいいですか？
PRINTFORM 「きゃっ	!#!PRINTFORM 「きゃっ
PRINTFORM 　そんなにびくびくして…	!#!PRINTFORM 　そんなにびくびくして…
PRINTFORM 　やっぱり、私のおっぱい、気持ちいいんですね	!#!PRINTFORM 　やっぱり、私のおっぱい、気持ちいいんですね
PRINTFORM 「んちゅ	!#!PRINTFORM 「んちゅ
PRINTFORM 「んしょ…	!#!PRINTFORM 「んしょ…
PRINTFORM 　やっぱり、気持ちいいんですね	!#!PRINTFORM 　やっぱり、気持ちいいんですね
PRINTFORM 　わたしの、えっちなおっぱい…	!#!PRINTFORM 　わたしの、えっちなおっぱい…
PRINTFORM 「んぅっ	!#!PRINTFORM 「んぅっ
PRINTFORM 　こっ	!#!PRINTFORM 　こっ
PRINTFORM 　こしゅれひゃっれっ	!#!PRINTFORM 　こしゅれひゃっれっ
PRINTFORM 　おっぱひっ	!#!PRINTFORM 　おっぱひっ
PRINTFORM 　きもひいぃれすぅぅぅっ	!#!PRINTFORM 　きもひいぃれすぅぅぅっ
PRINTFORMDW %CALLNAME:(TARGET)%は胸に刺激が来る度に甲高い嬌声を上げている…。	!#!PRINTFORMDW %CALLNAME:(TARGET)%は胸に刺激が来る度に甲高い嬌声を上げている…。
PRINTFORM 「うふふっ	!#!PRINTFORM 「うふふっ
PRINTFORM 　おっぱい	!#!PRINTFORM 　おっぱい
PRINTFORMW 　どうですか？」	!#!PRINTFORMW 　どうですか？」
PRINTFORM 「わたし、結構自信あるんですよ	!#!PRINTFORM 「わたし、結構自信あるんですよ
PRINTFORM 「……ふふっ	!#!PRINTFORM 「……ふふっ
PRINTFORM 　気持ちいいんですね	!#!PRINTFORM 　気持ちいいんですね
PRINTFORM 　びくびくしてますよ	!#!PRINTFORM 　びくびくしてますよ
PRINTFORMW 「よい、しょ…。……ん、少し、やりにくいですね…」	!#!PRINTFORMW 「よい、しょ…。……ん、少し、やりにくいですね…」
PRINTFORM 　ちゃんと、気持ちよくなってくれてるんですね	!#!PRINTFORM 　ちゃんと、気持ちよくなってくれてるんですね
PRINTFORM 　良かった	!#!PRINTFORM 　良かった
PRINTFORM 「んしょ	!#!PRINTFORM 「んしょ
PRINTFORM 　どうですか？ ちょっと小さくなっちゃいましたけど……十分挟めるんですよ	!#!PRINTFORM 　どうですか？ ちょっと小さくなっちゃいましたけど……十分挟めるんですよ
PRINTFORMDW %CALLNAME:(TARGET)%は少しやりにくそうにしながらも、性器を胸で挟んで擦っている…。	!#!PRINTFORMDW %CALLNAME:(TARGET)%は少しやりにくそうにしながらも、性器を胸で挟んで擦っている…。
PRINTFORMW 「う…身体が、勝手に…！？」	!#!PRINTFORMW 「う…身体が、勝手に…！？」
PRINTFORMW 「何だか周りが騒がしいですね…？」	!#!PRINTFORMW 「何だか周りが騒がしいですね…？」
PRINTFORMW 「ひょっとするとうちの子達が騒いでいるのかしら…？」	!#!PRINTFORMW 「ひょっとするとうちの子達が騒いでいるのかしら…？」
PRINTFORMDW %CALLNAME:(TARGET)%は敵に擦り寄りながらちょっと怪訝そうな表情を浮かべている…	!#!PRINTFORMDW %CALLNAME:(TARGET)%は敵に擦り寄りながらちょっと怪訝そうな表情を浮かべている…
PRINTFORM 「ん…何だかおかしいですね	!#!PRINTFORM 「ん…何だかおかしいですね
PRINTFORMW 　ずっといっしょにいるような、最近出会ったような…。」	!#!PRINTFORMW 　ずっといっしょにいるような、最近出会ったような…。」
PRINTFORM 「どちらにしても、あなたと一緒にいる事が心地良いのは変わらないんですけれども	!#!PRINTFORM 「どちらにしても、あなたと一緒にいる事が心地良いのは変わらないんですけれども
PRINTFORMDW 敵に身体を預け、%CALLNAME:(TARGET)%は心地よさそうな表情を浮かべている…。	!#!PRINTFORMDW 敵に身体を預け、%CALLNAME:(TARGET)%は心地よさそうな表情を浮かべている…。
PRINTFORMW 「一輪。申し訳ありませんが、お茶を淹れていただけませんか？ 少し手が離せなくて…」	!#!PRINTFORMW 「一輪。申し訳ありませんが、お茶を淹れていただけませんか？ 少し手が離せなくて…」
PRINTFORMDW %CALLNAME:(TARGET)%は敵に対して、さも当然の様にお願いをしている。	!#!PRINTFORMDW %CALLNAME:(TARGET)%は敵に対して、さも当然の様にお願いをしている。
PRINTFORMW 「だ、だめっ、ここで脱いだらだめなのにぃっ！」	!#!PRINTFORMW 「だ、だめっ、ここで脱いだらだめなのにぃっ！」
PRINTFORM 「そ、そんなに食い入るように見ないでくださいよぉ	!#!PRINTFORM 「そ、そんなに食い入るように見ないでくださいよぉ
PRINTFORM 「あなたでも、恥ずかしいんですからね	!#!PRINTFORM 「あなたでも、恥ずかしいんですからね
PRINTFORM 　私の身体、見たいんですか？	!#!PRINTFORM 　私の身体、見たいんですか？
PRINTFORM 「いいですよ	!#!PRINTFORM 「いいですよ
PRINTFORM 　わたしのえっちな身体…いっぱい見てくださいね	!#!PRINTFORM 　わたしのえっちな身体…いっぱい見てくださいね
PRINTFORMW 「何だか、服がべたべたしてますね……」	!#!PRINTFORMW 「何だか、服がべたべたしてますね……」
PRINTFORMW 「少し、行水しますか……」	!#!PRINTFORMW 「少し、行水しますか……」
PRINTFORMW 「な、何で…、あっちは、敵なのに、逃げなきゃいけないのに！」	!#!PRINTFORMW 「な、何で…、あっちは、敵なのに、逃げなきゃいけないのに！」
PRINTFORM 「すきですよぉっ	!#!PRINTFORM 「すきですよぉっ
PRINTFORM 　もっともっと、いっしょにいましょうね	!#!PRINTFORM 　もっともっと、いっしょにいましょうね
PRINTFORMDW %CALLNAME:(TARGET)%は無邪気な笑顔で触手に抱き付いている…。	!#!PRINTFORMDW %CALLNAME:(TARGET)%は無邪気な笑顔で触手に抱き付いている…。
PRINTFORM 「ふふっ♪ もっとぎゅーってしてくださいよぉ	!#!PRINTFORM 「ふふっ♪ もっとぎゅーってしてくださいよぉ
PRINTFORMDW %CALLNAME:(TARGET)%は満面の笑みを浮かべて敵へと歩み寄っている…。	!#!PRINTFORMDW %CALLNAME:(TARGET)%は満面の笑みを浮かべて敵へと歩み寄っている…。
PRINTFORMW 「もう少し、運動しないといけませんね」	!#!PRINTFORMW 「もう少し、運動しないといけませんね」
PRINTFORMDW %CALLNAME:(TARGET)%はその場で体操を始めた…。	!#!PRINTFORMDW %CALLNAME:(TARGET)%はその場で体操を始めた…。
PRINTFORMW 「だ、だめ……、ここで、寝ちゃったらぁ…」	!#!PRINTFORMW 「だ、だめ……、ここで、寝ちゃったらぁ…」
PRINTFORMW 「ん……何だか眠く…」	!#!PRINTFORMW 「ん……何だか眠く…」
PRINTFORM 「ごめんなさい、少し、腕を貸していただけますか？ ……ありがとうございます	!#!PRINTFORM 「ごめんなさい、少し、腕を貸していただけますか？ ……ありがとうございます
PRINTFORM 「ん～～…	!#!PRINTFORM 「ん～～…
PRINTFORM 「ふふっ、腕枕してくれるんですか？ ありがとうございます	!#!PRINTFORM 「ふふっ、腕枕してくれるんですか？ ありがとうございます
PRINTFORM 「……も、もしも寝てる私にいたずらしたいんなら……、あなたなら、構いませんから	!#!PRINTFORM 「……も、もしも寝てる私にいたずらしたいんなら……、あなたなら、構いませんから
PRINTFORMW 「ふぁ……急に、眠気が…」	!#!PRINTFORMW 「ふぁ……急に、眠気が…」
PRINTFORMW （ぜ、全力で踏み潰してやりたい…！）	!#!PRINTFORMW （ぜ、全力で踏み潰してやりたい…！）
PRINTFORMW 「えいえい！」	!#!PRINTFORMW 「えいえい！」
PRINTFORM 「……ふふっ、何だか楽しいかも知れませんね	!#!PRINTFORM 「……ふふっ、何だか楽しいかも知れませんね
PRINTFORMW 「ええと、踏めばいいんですか？」	!#!PRINTFORMW 「ええと、踏めばいいんですか？」
PRINTFORM 「分かりました、あなたが望むのなら……	!#!PRINTFORM 「分かりました、あなたが望むのなら……
PRINTFORMW 「何だかこの床、変な感触ですね…」	!#!PRINTFORMW 「何だかこの床、変な感触ですね…」
PRINTFORMDW %CALLNAME:(TARGET)%は、触手の存在が目に入っていないかのように、首を傾げながら触手の上で足踏みを繰り返している…。	!#!PRINTFORMDW %CALLNAME:(TARGET)%は、触手の存在が目に入っていないかのように、首を傾げながら触手の上で足踏みを繰り返している…。
PRINTFORMW 「……はたいて欲しいのならば、これを解きなさい」	!#!PRINTFORMW 「……はたいて欲しいのならば、これを解きなさい」
PRINTFORMW 「法力を全力で込めて、やってあげますから……！」	!#!PRINTFORMW 「法力を全力で込めて、やってあげますから……！」
PRINTFORMW 「え、えいっ！」	!#!PRINTFORMW 「え、えいっ！」
PRINTFORMW 「え、ええと、本当に大丈夫なんですか？ 痛くないですか？」	!#!PRINTFORMW 「え、ええと、本当に大丈夫なんですか？ 痛くないですか？」
PRINTFORMW 「ええと、叩けばいいんですか？」	!#!PRINTFORMW 「ええと、叩けばいいんですか？」
PRINTFORMW 「はっ！」	!#!PRINTFORMW 「はっ！」
PRINTFORMW 「……これでいいんですか？」	!#!PRINTFORMW 「……これでいいんですか？」
PRINTFORMW 「っく……！」	!#!PRINTFORMW 「っく……！」
PRINTFORMW 「っこ、この！ えいえい！ ……あ」	!#!PRINTFORMW 「っこ、この！ えいえい！ ……あ」
PRINTFORM 「踏んで欲しいんですか？ いいですよ	!#!PRINTFORM 「踏んで欲しいんですか？ いいですよ
PRINTFORM 「えい、えい	!#!PRINTFORM 「えい、えい
PRINTFORMW 　……きゃっ！？ お、折れちゃいました…」	!#!PRINTFORMW 　……きゃっ！？ お、折れちゃいました…」
PRINTFORMW 「……あっ！？」	!#!PRINTFORMW 「……あっ！？」
PRINTFORMW 「だ、大丈夫ですか！？ 痛くないですか！？」	!#!PRINTFORMW 「だ、大丈夫ですか！？ 痛くないですか！？」
PRINTFORMW 「こうされるのが好きなんですか？」	!#!PRINTFORMW 「こうされるのが好きなんですか？」
PRINTFORM 「えいえい	!#!PRINTFORM 「えいえい
PRINTFORMW 　……きゃっ！？ だ、大丈夫ですか！？」	!#!PRINTFORMW 　……きゃっ！？ だ、大丈夫ですか！？」
PRINTFORMW 「こ、こんな……」	!#!PRINTFORMW 「こ、こんな……」
PRINTFORMW 「い、嫌……ん！ ん～～～～っ！！！」	!#!PRINTFORMW 「い、嫌……ん！ ん～～～～っ！！！」
PRINTFORM 　ちゅむっ	!#!PRINTFORM 　ちゅむっ
PRINTFORM 「…ふふっ	!#!PRINTFORM 「…ふふっ
PRINTFORM 　どうですか	!#!PRINTFORM 　どうですか
PRINTFORM 　ちゅっ	!#!PRINTFORM 　ちゅっ
PRINTFORM 「ん～～～～～……	!#!PRINTFORM 「ん～～～～～……
PRINTFORM 「っぷは	!#!PRINTFORM 「っぷは
PRINTFORM 　もっとしていいですか？ あなたとのキス、好きなんです……	!#!PRINTFORM 　もっとしていいですか？ あなたとのキス、好きなんです……
PRINTFORMW 「キス、ですか？ ……もう、しょうがないですねぇ……」	!#!PRINTFORMW 「キス、ですか？ ……もう、しょうがないですねぇ……」
PRINTFORM 「ちゅっ	!#!PRINTFORM 「ちゅっ
PRINTFORMW 　……これで、よろしいですか？」	!#!PRINTFORMW 　……これで、よろしいですか？」
PRINTFORMW 「う、うぅ、気持ち悪い……」	!#!PRINTFORMW 「う、うぅ、気持ち悪い……」
PRINTFORM 「しゅっ、しゅっ	!#!PRINTFORM 「しゅっ、しゅっ
PRINTFORMW 　ふふっ、どうですか？ 気持ちいいですか？」	!#!PRINTFORMW 　ふふっ、どうですか？ 気持ちいいですか？」
PRINTFORM 「ふふふっ	!#!PRINTFORM 「ふふふっ
PRINTFORM 　私の手、凄く気持ちいいみたいですね	!#!PRINTFORM 　私の手、凄く気持ちいいみたいですね
PRINTFORM 「こんなに、びくびくしてますよ	!#!PRINTFORM 「こんなに、びくびくしてますよ
PRINTFORMW 「手でして、白い液体を出せば、調伏が？」	!#!PRINTFORMW 「手でして、白い液体を出せば、調伏が？」
PRINTFORMW 「分かりました、試してみますね」	!#!PRINTFORMW 「分かりました、試してみますね」
PRINTFORMW 「う、うぅ……っ！」	!#!PRINTFORMW 「う、うぅ……っ！」
PRINTFORMW 「こ、こんな物、口に入れたくないのにぃ…！」	!#!PRINTFORMW 「こ、こんな物、口に入れたくないのにぃ…！」
PRINTFORMW 「おくちで……ですか？」	!#!PRINTFORMW 「おくちで……ですか？」
PRINTFORM 「構いませんよ♪ でも、その代わり…、後で私のおまんこも、い～っぱい愛してくださいね	!#!PRINTFORM 「構いませんよ♪ でも、その代わり…、後で私のおまんこも、い～っぱい愛してくださいね
PRINTFORM 　んくっ、ちゅるるっ	!#!PRINTFORM 　んくっ、ちゅるるっ
PRINTFORM 「どうですか？ 気持ちいいですか？ ちゅっ	!#!PRINTFORM 「どうですか？ 気持ちいいですか？ ちゅっ
PRINTFORMW 「これを口ですれば、いいんですね？」	!#!PRINTFORMW 「これを口ですれば、いいんですね？」
PRINTFORMW 「ん…、何だか、変な味がします…」	!#!PRINTFORMW 「ん…、何だか、変な味がします…」
PRINTFORMW 「く、うぅぅっ…！」	!#!PRINTFORMW 「く、うぅぅっ…！」
PRINTFORMW 「か、身体が、勝手に…！」	!#!PRINTFORMW 「か、身体が、勝手に…！」
PRINTFORMW 「おっぱいがいいんですか？」	!#!PRINTFORMW 「おっぱいがいいんですか？」
PRINTFORM 　わたしのえっちなおっぱいで、いっぱい気持ちよくなってくださいね	!#!PRINTFORM 　わたしのえっちなおっぱいで、いっぱい気持ちよくなってくださいね
PRINTFORM 「んっ…	!#!PRINTFORM 「んっ…
PRINTFORM 「ふふっ、私のおっぱい、気持ちいいですか？ 遠慮せずにびゅーって一杯おっぱいに出していいんですからね	!#!PRINTFORM 「ふふっ、私のおっぱい、気持ちいいですか？ 遠慮せずにびゅーって一杯おっぱいに出していいんですからね
PRINTFORM 「わたしのおっぱいまんこ…好きに使っていいんですからね	!#!PRINTFORM 「わたしのおっぱいまんこ…好きに使っていいんですからね
PRINTFORMW 「ふふっ、どうですか？ 私のおっぱい」	!#!PRINTFORMW 「ふふっ、どうですか？ 私のおっぱい」
PRINTFORMW 「寺の仲間達の中では一番大きい、自慢なんですよ♪」	!#!PRINTFORMW 「寺の仲間達の中では一番大きい、自慢なんですよ♪」
PRINTFORMW 「それっ、ぎゅ～♪」	!#!PRINTFORMW 「それっ、ぎゅ～♪」
PRINTFORMW 「ふふっ、ぴくぴくして……可愛い♪」	!#!PRINTFORMW 「ふふっ、ぴくぴくして……可愛い♪」
PRINTFORM 「はひっ、はふっ	!#!PRINTFORM 「はひっ、はふっ
PRINTFORM 　い、いまたたかってるんれすからぁっ	!#!PRINTFORM 　い、いまたたかってるんれすからぁっ
PRINTFORM 　こんにゃの、らめれすよぉっ	!#!PRINTFORM 　こんにゃの、らめれすよぉっ
PRINTFORM 「はふっ、ぁ…	!#!PRINTFORM 「はふっ、ぁ…
PRINTFORM 　わ、わらひが、たたかわないと…	!#!PRINTFORM 　わ、わらひが、たたかわないと…
PRINTFORM 「ひあぁ！？ だ、だめれすっ、いまは、ふぁ	!#!PRINTFORM 「ひあぁ！？ だ、だめれすっ、いまは、ふぁ
PRINTFORM 「ご、ごめんなさい…、おちんちんがっ、がまんれきないんれすぅっ	!#!PRINTFORM 「ご、ごめんなさい…、おちんちんがっ、がまんれきないんれすぅっ
PRINTFORM 　%CALLNAME_96_0(CFLAG:900, 1, ARGS:1)%って……	!#!PRINTFORM 　%CALLNAME_96_0(CFLAG:900, 1, ARGS:1)%って……
PRINTFORM 　らめ、がまん、できなっ	!#!PRINTFORM 　らめ、がまん、できなっ
PRINTFORM 「ふふっ、おまんこぬぷぬぷされて、気持ちいいんですか？	!#!PRINTFORM 「ふふっ、おまんこぬぷぬぷされて、気持ちいいんですか？
PRINTFORM 「もっとしてあげますからね…	!#!PRINTFORM 「もっとしてあげますからね…
PRINTFORM 　触手さんよりも、気持ちよくしてあげますから	!#!PRINTFORM 　触手さんよりも、気持ちよくしてあげますから
PRINTFORM 「ふふふ…	!#!PRINTFORM 「ふふふ…
PRINTFORM 　あんあんって、そんなに気持ちいいんですか？	!#!PRINTFORM 　あんあんって、そんなに気持ちいいんですか？
PRINTFORM 「いいですよ…	!#!PRINTFORM 「いいですよ…
PRINTFORM 　もっといっぱい、感じさせてあげますからね	!#!PRINTFORM 　もっといっぱい、感じさせてあげますからね
PRINTFORMW 「だ、だめ、だめです！」	!#!PRINTFORMW 「だ、だめ、だめです！」
PRINTFORMW 「わ、私、まだ誰ともっ、だめぇぇぇっ！」	!#!PRINTFORMW 「わ、私、まだ誰ともっ、だめぇぇぇっ！」
PRINTFORMW 「あなた、はじめてなんですよね……」	!#!PRINTFORMW 「あなた、はじめてなんですよね……」
PRINTFORMW 「でも、ごめんなさい……。我慢、できないんですっ…」	!#!PRINTFORMW 「でも、ごめんなさい……。我慢、できないんですっ…」
PRINTFORML 「ま、まだ、するんですか！？」	!#!PRINTFORML 「ま、まだ、するんですか！？」
PRINTFORMW 「さっき、私の始めてを、奪ったばかりなのにっ…！」	!#!PRINTFORMW 「さっき、私の始めてを、奪ったばかりなのにっ…！」
PRINTFORMW 「だ、だめっ！」	!#!PRINTFORMW 「だ、だめっ！」
PRINTFORMW 「お、落ち着いてください！」	!#!PRINTFORMW 「お、落ち着いてください！」
PRINTFORML 「ふふっ、もうはじめては私が奪ったじゃないですか」	!#!PRINTFORML 「ふふっ、もうはじめては私が奪ったじゃないですか」
PRINTFORM 「抵抗しても無駄ですよ？ またしてあげますからね	!#!PRINTFORM 「抵抗しても無駄ですよ？ またしてあげますからね
PRINTFORML 「ごめんなさい、がまんできなくて…」	!#!PRINTFORML 「ごめんなさい、がまんできなくて…」
PRINTFORMW 「ずぶずぶって、させてください…」	!#!PRINTFORMW 「ずぶずぶって、させてください…」
PRINTFORMW 「も、もうこれ以上はやめてください……」	!#!PRINTFORMW 「も、もうこれ以上はやめてください……」
PRINTFORML 	!#!PRINTFORML 
PRINTFORML 「だ、だめですからっ！」	!#!PRINTFORML 「だ、だめですからっ！」
PRINTFORMW 「落ち着いてください！」	!#!PRINTFORMW 「落ち着いてください！」
PRINTFORML 「……だめ、ですか？」	!#!PRINTFORML 「……だめ、ですか？」
PRINTFORMW 「気持ちいいのに…」	!#!PRINTFORMW 「気持ちいいのに…」
PRINTFORMW 「あ、危なかった…」	!#!PRINTFORMW 「あ、危なかった…」
PRINTFORML 「ふふっ、安心してください」	!#!PRINTFORML 「ふふっ、安心してください」
PRINTFORM 「今度はいっぱい気持ちよくしてあげますから…	!#!PRINTFORM 「今度はいっぱい気持ちよくしてあげますから…
PRINTFORMW 「だ、駄目ですよ、こんな…」	!#!PRINTFORMW 「だ、駄目ですよ、こんな…」
PRINTFORML 「っぐ……ぁ……！」	!#!PRINTFORML 「っぐ……ぁ……！」
PRINTFORMW 「そ、そんな……」	!#!PRINTFORMW 「そ、そんな……」
PRINTFORM 「ふふっ、ずぶずぶって、入っちゃいましたよ	!#!PRINTFORM 「ふふっ、ずぶずぶって、入っちゃいましたよ
PRINTFORM 　さ、動いちゃいますね	!#!PRINTFORM 　さ、動いちゃいますね
PRINTFORM 　大丈夫、すぐに気持ちよくなれますから…	!#!PRINTFORM 　大丈夫、すぐに気持ちよくなれますから…
PRINTFORML 「わ、分かりました…」	!#!PRINTFORML 「わ、分かりました…」
PRINTFORMW 「もう、暴れませんから、痛くしないでくださいね…？」	!#!PRINTFORMW 「もう、暴れませんから、痛くしないでくださいね…？」
PRINTFORM 「ほら、ぬるーって	!#!PRINTFORM 「ほら、ぬるーって
PRINTFORM 　ふふっ、気持ちいいんですね？ 腰、動いちゃってますよ	!#!PRINTFORM 　ふふっ、気持ちいいんですね？ 腰、動いちゃってますよ
PRINTFORM 「そんなにおねだりしなくても…	!#!PRINTFORM 「そんなにおねだりしなくても…
PRINTFORM 　すぐに、い～っぱいにゅぽにゅぽしてあげますね	!#!PRINTFORM 　すぐに、い～っぱいにゅぽにゅぽしてあげますね
PRINTFORM 　とまっへっ	!#!PRINTFORM 　とまっへっ
PRINTFORM 　らめらめらめぇぇぇっ	!#!PRINTFORM 　らめらめらめぇぇぇっ
PRINTFORM 「そんな悪い子は、おしおきですね	!#!PRINTFORM 「そんな悪い子は、おしおきですね
PRINTFORM 　そんなに気持ち良さそうに鳴いちゃって	!#!PRINTFORM 　そんなに気持ち良さそうに鳴いちゃって
PRINTFORM 「ひっ！？　そ、それは、はあぁっ	!#!PRINTFORM 「ひっ！？　そ、それは、はあぁっ
PRINTFORM 「らめぇ	!#!PRINTFORM 「らめぇ
PRINTFORM 　うねうね、らめれしゅぅぅっ	!#!PRINTFORM 　うねうね、らめれしゅぅぅっ
PRINTFORM 「ふふっ、抵抗しても無駄ですよ	!#!PRINTFORM 「ふふっ、抵抗しても無駄ですよ
PRINTFORM 「ほら、こうしたら……ふふっ、ほら、こんなすぐにとろとろ	!#!PRINTFORM 「ほら、こうしたら……ふふっ、ほら、こんなすぐにとろとろ
PRINTFORM 「ひぅっ	!#!PRINTFORM 「ひぅっ
PRINTFORM 　ひぅぅぅ	!#!PRINTFORM 　ひぅぅぅ
PRINTFORM 「ら、め。なの、にぃ…	!#!PRINTFORM 「ら、め。なの、にぃ…
PRINTFORM 「ふふっ、もうとろとろですね	!#!PRINTFORM 「ふふっ、もうとろとろですね
PRINTFORM 「ほら、また入っちゃいますよ	!#!PRINTFORM 「ほら、また入っちゃいますよ
PRINTFORM 　…ふふっ	!#!PRINTFORM 　…ふふっ
PRINTFORM 　そんなに気持ち良さそうな顔、しちゃって	!#!PRINTFORM 　そんなに気持ち良さそうな顔、しちゃって
PRINTFORM 「はーっ	!#!PRINTFORM 「はーっ
PRINTFORM 　はーっ	!#!PRINTFORM 　はーっ
PRINTFORM 　ぁ…ぅ…ぁ…	!#!PRINTFORM 　ぁ…ぅ…ぁ…
PRINTFORMDW 触手服に何度もイかされ、息も絶え絶えになって抵抗すら出来なくなった%CALLNAME:(TARGET)%を改めて襲い始めた。	!#!PRINTFORMDW 触手服に何度もイかされ、息も絶え絶えになって抵抗すら出来なくなった%CALLNAME:(TARGET)%を改めて襲い始めた。
PRINTFORM 「ふふっ、何回もイっちゃいましたね	!#!PRINTFORM 「ふふっ、何回もイっちゃいましたね
PRINTFORM 　こんなにとろとろ…これならぬるって入っちゃいますね	!#!PRINTFORM 　こんなにとろとろ…これならぬるって入っちゃいますね
PRINTFORM 「ほら、ずぶずぶ入っちゃいますよ…	!#!PRINTFORM 「ほら、ずぶずぶ入っちゃいますよ…
PRINTFORM 　いっぱい感じて、いっぱいイってくださいね	!#!PRINTFORM 　いっぱい感じて、いっぱいイってくださいね
PRINTFORMW 「だ、だめ、脱がさないでぇっ！」	!#!PRINTFORMW 「だ、だめ、脱がさないでぇっ！」
PRINTFORM 　ほら、ぬぎぬぎしましょうね	!#!PRINTFORM 　ほら、ぬぎぬぎしましょうね
PRINTFORM 「だ、だめ…脱がしちゃ、だめぇ…	!#!PRINTFORM 「だ、だめ…脱がしちゃ、だめぇ…
PRINTFORM 「ほら、脱ぎましょうね	!#!PRINTFORM 「ほら、脱ぎましょうね
PRINTFORM 　いっぱい気持ちよく、してあげますから	!#!PRINTFORM 　いっぱい気持ちよく、してあげますから
PRINTFORMW 「や、やめて…、もう嫌なんです…」	!#!PRINTFORMW 「や、やめて…、もう嫌なんです…」
PRINTFORM 「ほら、入れちゃいますよ…	!#!PRINTFORM 「ほら、入れちゃいますよ…
PRINTFORM 　いっぱいきもちよく、してあげますからね	!#!PRINTFORM 　いっぱいきもちよく、してあげますからね
PRINTFORM 「も、もう、逃げられ…	!#!PRINTFORM 「も、もう、逃げられ…
PRINTFORM 「ほらほら	!#!PRINTFORM 「ほらほら
PRINTFORM 　もう逃げられませんからね	!#!PRINTFORM 　もう逃げられませんからね
PRINTFORM 「ま、また、され、ちゃ…	!#!PRINTFORM 「ま、また、され、ちゃ…
PRINTFORM 「ほら、またしてあげますからね	!#!PRINTFORM 「ほら、またしてあげますからね
PRINTFORMW 　あなたも期待してるんでしょう？」	!#!PRINTFORMW 　あなたも期待してるんでしょう？」
PRINTFORM 「も、もぅ、私…	!#!PRINTFORM 「も、もぅ、私…
PRINTFORM 「ふふっ、形だけの抵抗しなくてもいいんですよ	!#!PRINTFORM 「ふふっ、形だけの抵抗しなくてもいいんですよ
PRINTFORM 「もう裸で……期待してるんじゃないですか？	!#!PRINTFORM 「もう裸で……期待してるんじゃないですか？
PRINTFORMW 「も、もう私、どうでも…」	!#!PRINTFORMW 「も、もう私、どうでも…」
PRINTFORM 「ふふっ…、観念しちゃったんですね	!#!PRINTFORM 「ふふっ…、観念しちゃったんですね
PRINTFORM 「ほらほら、ずぶずぶ入っちゃいますよ	!#!PRINTFORM 「ほらほら、ずぶずぶ入っちゃいますよ
PRINTFORMW 「わ、分かりました…、好きにしてください…」	!#!PRINTFORMW 「わ、分かりました…、好きにしてください…」
PRINTFORM 　また気持ちよくしてあげますからね	!#!PRINTFORM 　また気持ちよくしてあげますからね
PRINTFORM 「はひめれっ、はひめれなのにぃっ	!#!PRINTFORM 「はひめれっ、はひめれなのにぃっ
PRINTFORM 　わ、ら	!#!PRINTFORM 　わ、ら
PRINTFORM 　わら、ひっ	!#!PRINTFORM 　わら、ひっ
PRINTFORM 「ひあああぁあぁぁぁんっ	!#!PRINTFORM 「ひあああぁあぁぁぁんっ
PRINTFORM 「ふふふっ、はじめてなのにイっちゃいましたね	!#!PRINTFORM 「ふふふっ、はじめてなのにイっちゃいましたね
PRINTFORM 　んっ、すご…、私も、びゅーってしちゃいますよ	!#!PRINTFORM 　んっ、すご…、私も、びゅーってしちゃいますよ
PRINTFORM 「イくっ、イくぅぅっ	!#!PRINTFORM 「イくっ、イくぅぅっ
PRINTFORM 　イっちゃいまひゅぅぅぅっ	!#!PRINTFORM 　イっちゃいまひゅぅぅぅっ
PRINTFORM 　ろくろくって、きひゃうよぉぉっ	!#!PRINTFORM 　ろくろくって、きひゃうよぉぉっ
PRINTFORM 「んんっ…きゅうきゅう来てぇ…	!#!PRINTFORM 「んんっ…きゅうきゅう来てぇ…
PRINTFORM 　出しちゃいますよ	!#!PRINTFORM 　出しちゃいますよ
PRINTFORM 　私も、びゅーってぇ	!#!PRINTFORM 　私も、びゅーってぇ
PRINTFORM 「ひあ	!#!PRINTFORM 「ひあ
PRINTFORM 　～～～～っ	!#!PRINTFORM 　～～～～っ
PRINTFORM 「んあぁぁぁっ	!#!PRINTFORM 「んあぁぁぁっ
PRINTFORM 　しゅごいっ、しゅごいぃぃっ	!#!PRINTFORM 　しゅごいっ、しゅごいぃぃっ
PRINTFORM 　びゅーって、きひゃいまひゅぅぅぅっ	!#!PRINTFORM 　びゅーって、きひゃいまひゅぅぅぅっ
PRINTFORM 「あ゛～～～～っ	!#!PRINTFORM 「あ゛～～～～っ
PRINTFORM 　あ゛～～～～～っ	!#!PRINTFORM 　あ゛～～～～～っ
PRINTFORM 「ひっ、すごっ	!#!PRINTFORM 「ひっ、すごっ
PRINTFORM 　だひてほしいんですね	!#!PRINTFORM 　だひてほしいんですね
PRINTFORM 　いいですよ、びゅーってだしまひゅからぁっ	!#!PRINTFORM 　いいですよ、びゅーってだしまひゅからぁっ
PRINTFORM 「ぁ…	!#!PRINTFORM 「ぁ…
PRINTFORM ぁ…	!#!PRINTFORM ぁ…
PRINTFORM 「なか、びゅーって…	!#!PRINTFORM 「なか、びゅーって…
PRINTFORM 　はじめてのおまんこの中…	!#!PRINTFORM 　はじめてのおまんこの中…
PRINTFORM 　いっぱい、出しちゃいました…	!#!PRINTFORM 　いっぱい、出しちゃいました…
PRINTFORM 「っ	!#!PRINTFORM 「っ
PRINTFORM 　ぁ……	!#!PRINTFORM 　ぁ……
PRINTFORM 「ほら、びゅ～って…	!#!PRINTFORM 「ほら、びゅ～って…
PRINTFORM 　あなたも、気持ちよかったんですね	!#!PRINTFORM 　あなたも、気持ちよかったんですね
PRINTFORM 　ほら、びくびくって…	!#!PRINTFORM 　ほら、びくびくって…
PRINTFORM 「イきゅぅっ	!#!PRINTFORM 「イきゅぅっ
PRINTFORM 　はひめれにゃのにぃっ	!#!PRINTFORM 　はひめれにゃのにぃっ
PRINTFORM 　イっひゃいまひゅぅぅっ	!#!PRINTFORM 　イっひゃいまひゅぅぅっ
PRINTFORM 「らめれしゅぅっ	!#!PRINTFORM 「らめれしゅぅっ
PRINTFORM 　なからめぇぇぇっ	!#!PRINTFORM 　なからめぇぇぇっ
PRINTFORMW 　はじめてなのに、イっちゃうんですか？」	!#!PRINTFORMW 　はじめてなのに、イっちゃうんですか？」
PRINTFORM 　あつ～いせーえき、いっぱいかけてあげますからね	!#!PRINTFORM 　あつ～いせーえき、いっぱいかけてあげますからね
PRINTFORM 「ひゃぁぁぁっ	!#!PRINTFORM 「ひゃぁぁぁっ
PRINTFORM 　ひゅごっ、ひゅごいぃぃっ	!#!PRINTFORM 　ひゅごっ、ひゅごいぃぃっ
PRINTFORM 　ひくっ	!#!PRINTFORM 　ひくっ
PRINTFORM 　ひきまひゅぅぅぅっ	!#!PRINTFORM 　ひきまひゅぅぅぅっ
PRINTFORM 　きゅんきゅんって…	!#!PRINTFORM 　きゅんきゅんって…
PRINTFORM 　だひますよぉ	!#!PRINTFORM 　だひますよぉ
PRINTFORM 　いっぱひっ	!#!PRINTFORM 　いっぱひっ
PRINTFORM 　どろどろにひまふからぁっ	!#!PRINTFORM 　どろどろにひまふからぁっ
PRINTFORM 「～～～～っ	!#!PRINTFORM 「～～～～っ
PRINTFORM 「～～～っ	!#!PRINTFORM 「～～～っ
PRINTFORM 「ふあぁぁぁっ	!#!PRINTFORM 「ふあぁぁぁっ
PRINTFORM 　きゅぅぅぅっってっ	!#!PRINTFORM 　きゅぅぅぅっってっ
PRINTFORM 　くるっ	!#!PRINTFORM 　くるっ
PRINTFORM 　きひゃうぅぅっ	!#!PRINTFORM 　きひゃうぅぅっ
PRINTFORM 「っっっぁっ	!#!PRINTFORM 「っっっぁっ
PRINTFORM 　ひああぁぁあぁぁぁぁっ	!#!PRINTFORM 　ひああぁぁあぁぁぁぁっ
PRINTFORM 　くりゅっ	!#!PRINTFORM 　くりゅっ
PRINTFORM 　のぼってぇぇっ	!#!PRINTFORM 　のぼってぇぇっ
PRINTFORMW 「ぅ…ぁ…。いっぱい、どろって…」	!#!PRINTFORMW 「ぅ…ぁ…。いっぱい、どろって…」
PRINTFORM 「ふふっ、真っ白…	!#!PRINTFORM 「ふふっ、真っ白…
PRINTFORM 　気持ち良かったですか？ そんなにぴくぴくしちゃって…	!#!PRINTFORM 　気持ち良かったですか？ そんなにぴくぴくしちゃって…
PRINTFORM 「っはひ	!#!PRINTFORM 「っはひ
PRINTFORM 　はひっ	!#!PRINTFORM 　はひっ
PRINTFORM 「ふふふっ、気持ち良かったですか？	!#!PRINTFORM 「ふふふっ、気持ち良かったですか？
PRINTFORM 「良くなかったなんて、言えませんよね	!#!PRINTFORM 「良くなかったなんて、言えませんよね
PRINTFORM 　あんなに気持ちよさそうにイってましたもんね	!#!PRINTFORM 　あんなに気持ちよさそうにイってましたもんね
PRINTFORM 「ひぃっ	!#!PRINTFORM 「ひぃっ
PRINTFORM 　もっ	!#!PRINTFORM 　もっ
PRINTFORM 　ら、はひ	!#!PRINTFORM 　ら、はひ
PRINTFORM 　～～～～～っ	!#!PRINTFORM 　～～～～～っ
PRINTFORM 「ふふっ、びくんびくんって…	!#!PRINTFORM 「ふふっ、びくんびくんって…
PRINTFORM 　イっちゃったんですね	!#!PRINTFORM 　イっちゃったんですね
PRINTFORM 「らめぇぇぇ	!#!PRINTFORM 「らめぇぇぇ
PRINTFORM 　イっ、イきまひゅぅぅぅっ	!#!PRINTFORM 　イっ、イきまひゅぅぅぅっ
PRINTFORM 「ふふっ、イっちゃいましたね	!#!PRINTFORM 「ふふっ、イっちゃいましたね
PRINTFORM 　そんなに気持ち良さそうに震えちゃって…	!#!PRINTFORM 　そんなに気持ち良さそうに震えちゃって…
PRINTFORM 「あ゛～～～	!#!PRINTFORM 「あ゛～～～
PRINTFORM 「ふあぁっ	!#!PRINTFORM 「ふあぁっ
PRINTFORM 　きゅーって…	!#!PRINTFORM 　きゅーって…
PRINTFORM 　いいれすよ、なか、いっぱいびゅーびゅーしちゃいますからねぇ	!#!PRINTFORM 　いいれすよ、なか、いっぱいびゅーびゅーしちゃいますからねぇ
PRINTFORM 「イっへっ、イっへまひゅからぁっ	!#!PRINTFORM 「イっへっ、イっへまひゅからぁっ
PRINTFORM 　も、うごかにゃいれぇぇっ	!#!PRINTFORM 　も、うごかにゃいれぇぇっ
PRINTFORM 「んあぁっ	!#!PRINTFORM 「んあぁっ
PRINTFORM 　また、きひゃぁぁぁっ	!#!PRINTFORM 　また、きひゃぁぁぁっ
PRINTFORM 　いっぱいっ	!#!PRINTFORM 　いっぱいっ
PRINTFORM 　びゅ～ってしますよぉっ	!#!PRINTFORM 　びゅ～ってしますよぉっ
PRINTFORM 「っぁ	!#!PRINTFORM 「っぁ
PRINTFORM 　びゅ～って、出されて…	!#!PRINTFORM 　びゅ～って、出されて…
PRINTFORM 　良かったですよ…、あなたは、どうですか…？	!#!PRINTFORM 　良かったですよ…、あなたは、どうですか…？
PRINTFORM 「……ふふっ、聞くまでもなかったかも知れませんね	!#!PRINTFORM 「……ふふっ、聞くまでもなかったかも知れませんね
PRINTFORM 「はじめてなのにイっちゃって、中に熱いのびゅーびゅーされて、こんなに悦んでるんですから	!#!PRINTFORM 「はじめてなのにイっちゃって、中に熱いのびゅーびゅーされて、こんなに悦んでるんですから
PRINTFORM 「はうっ	!#!PRINTFORM 「はうっ
PRINTFORM 　はうぅぅぅっ	!#!PRINTFORM 　はうぅぅぅっ
PRINTFORM 　あっ	!#!PRINTFORM 　あっ
PRINTFORM 　あちゅいのっ	!#!PRINTFORM 　あちゅいのっ
PRINTFORM 　だされ、てぇ	!#!PRINTFORM 　だされ、てぇ
PRINTFORM 「ふふっ、そんなにびくびく悶えちゃって…	!#!PRINTFORM 「ふふっ、そんなにびくびく悶えちゃって…
PRINTFORMW 　むりやりなのに、そんなに良かったんですか？」	!#!PRINTFORMW 　むりやりなのに、そんなに良かったんですか？」
PRINTFORM 「それなら、またしてあげましょうか	!#!PRINTFORM 「それなら、またしてあげましょうか
PRINTFORM 「しょっ	!#!PRINTFORM 「しょっ
PRINTFORM 　しょんにゃっ	!#!PRINTFORM 　しょんにゃっ
PRINTFORM 　はじめて、	!#!PRINTFORM 　はじめて、
PRINTFORM 　にゃのっ、～～～～～～っ	!#!PRINTFORM 　にゃのっ、～～～～～～っ
PRINTFORM 「くすくす、今、イっちゃいましたね？ はじめてなのに…	!#!PRINTFORM 「くすくす、今、イっちゃいましたね？ はじめてなのに…
PRINTFORM 「はじめてで、無理矢理なのに、こんなに感じちゃうなんて…	!#!PRINTFORM 「はじめてで、無理矢理なのに、こんなに感じちゃうなんて…
PRINTFORM 　いやらしいんですね	!#!PRINTFORM 　いやらしいんですね
PRINTFORM 「くすっ、どうしたんですか？	!#!PRINTFORM 「くすっ、どうしたんですか？
PRINTFORM 　そんなに震えて…、イっちゃったんですか？	!#!PRINTFORM 　そんなに震えて…、イっちゃったんですか？
PRINTFORM 　にゃかっ、らめ、らめぇぇぇ	!#!PRINTFORM 　にゃかっ、らめ、らめぇぇぇ
PRINTFORM 「ふぁっ、きゅ～って…	!#!PRINTFORM 「ふぁっ、きゅ～って…
PRINTFORM 　いっぱい、かけちゃいますよ	!#!PRINTFORM 　いっぱい、かけちゃいますよ
PRINTFORM 「どろどろに、してあげますねぇ…	!#!PRINTFORM 「どろどろに、してあげますねぇ…
PRINTFORM 「ひっ……～～～っ	!#!PRINTFORM 「ひっ……～～～っ
PRINTFORM 　どろどろにしてあげますからぁっ	!#!PRINTFORM 　どろどろにしてあげますからぁっ
PRINTFORM 「ぁ……ぅ……	!#!PRINTFORM 「ぁ……ぅ……
PRINTFORM 　どろどろに、されひゃいまひたぁ…	!#!PRINTFORM 　どろどろに、されひゃいまひたぁ…
PRINTFORM 「ん……	!#!PRINTFORM 「ん……
PRINTFORM 　ほら、ちゃんと外に出してあげましたからねぇ…	!#!PRINTFORM 　ほら、ちゃんと外に出してあげましたからねぇ…
PRINTFORM 　まっしろで、きれいですよ	!#!PRINTFORM 　まっしろで、きれいですよ
PRINTFORM 「ふあぁぁぁぁ	!#!PRINTFORM 「ふあぁぁぁぁ
PRINTFORM 　こんにゃ、いっぱい…	!#!PRINTFORM 　こんにゃ、いっぱい…
PRINTFORM 　どろどろにぃ…	!#!PRINTFORM 　どろどろにぃ…
PRINTFORM 「っは	!#!PRINTFORM 「っは
PRINTFORM 　ひっ…	!#!PRINTFORM 　ひっ…
PRINTFORM 　いっぱひ	!#!PRINTFORM 　いっぱひ
PRINTFORM 　れひゃったぁぁ…	!#!PRINTFORM 　れひゃったぁぁ…
PRINTFORM 「ひっ	!#!PRINTFORM 「ひっ
PRINTFORM 　ひうんっ	!#!PRINTFORM 　ひうんっ
PRINTFORM 　らめっ	!#!PRINTFORM 　らめっ
PRINTFORMW 　だしちゃらめぇぇぇっ！」	!#!PRINTFORMW 　だしちゃらめぇぇぇっ！」
PRINTFORM 「ひあぁぁぁっ	!#!PRINTFORM 「ひあぁぁぁっ
PRINTFORM 　きゅぅぅっへぇっ	!#!PRINTFORM 　きゅぅぅっへぇっ
PRINTFORM 　れひゃっ、れひゃうぅぅっ	!#!PRINTFORM 　れひゃっ、れひゃうぅぅっ
PRINTFORM 　にゃかっ	!#!PRINTFORM 　にゃかっ
PRINTFORMW 　やめてくださぁいっ！」	!#!PRINTFORMW 　やめてくださぁいっ！」
PRINTFORM 「ひゃぁぁっ	!#!PRINTFORM 「ひゃぁぁっ
PRINTFORM 　しゅごいぃぃ	!#!PRINTFORM 　しゅごいぃぃ
PRINTFORM 　しゅぐっ	!#!PRINTFORM 　しゅぐっ
PRINTFORM 　れひゃいましゅよぉぉっ	!#!PRINTFORM 　れひゃいましゅよぉぉっ
PRINTFORMW 「な、中、いっぱい、出されて…」	!#!PRINTFORMW 「な、中、いっぱい、出されて…」
PRINTFORM 「ごめんなさい…いっぱい、れちゃって…	!#!PRINTFORM 「ごめんなさい…いっぱい、れちゃって…
PRINTFORMW 「な、中、いっぱい…」	!#!PRINTFORMW 「な、中、いっぱい…」
PRINTFORM 　ご、ごめんなさい…	!#!PRINTFORM 　ご、ごめんなさい…
PRINTFORM 　まだ、イってませんよね…	!#!PRINTFORM 　まだ、イってませんよね…
PRINTFORM 「ふあぁぁっ	!#!PRINTFORM 「ふあぁぁっ
PRINTFORMW 　なかっ、だめ、だめぇぇぇっ！！」	!#!PRINTFORMW 　なかっ、だめ、だめぇぇぇっ！！」
PRINTFORM 「ひぁ、れちゃ…	!#!PRINTFORM 「ひぁ、れちゃ…
PRINTFORM 　いっぱいかけて、あげますからねっ	!#!PRINTFORM 　いっぱいかけて、あげますからねっ
PRINTFORM 　イくん、れす、かっ	!#!PRINTFORM 　イくん、れす、かっ
PRINTFORM 　なかっ、やめっ…ひゃう	!#!PRINTFORM 　なかっ、やめっ…ひゃう
PRINTFORM 　ごめ、なさっ	!#!PRINTFORM 　ごめ、なさっ
PRINTFORM 　すぐ、でちゃ…	!#!PRINTFORM 　すぐ、でちゃ…
PRINTFORM 　かけますねぇっ	!#!PRINTFORM 　かけますねぇっ
PRINTFORMW 「うぁ……、どろって……」	!#!PRINTFORMW 「うぁ……、どろって……」
PRINTFORMW 　もう、真っ白ですね♪」	!#!PRINTFORMW 　もう、真っ白ですね♪」
PRINTFORM 「う、あ……。いっぱい、かけられちゃって…」	!#!PRINTFORM 「う、あ……。いっぱい、かけられちゃって…」
PRINTFORM 「ひにゃぁぁぁっ	!#!PRINTFORM 「ひにゃぁぁぁっ
PRINTFORM 　が、がまんできなくて、ごめんなさぁいっ…	!#!PRINTFORM 　が、がまんできなくて、ごめんなさぁいっ…
PRINTFORMW 「う、うぅ……」	!#!PRINTFORMW 「う、うぅ……」
PRINTFORMW 「お、終わり、ましたか…？」	!#!PRINTFORMW 「お、終わり、ましたか…？」
PRINTFORM 「はふぅ	!#!PRINTFORM 「はふぅ
PRINTFORM 　良かったですよ…、ありがとうございます	!#!PRINTFORM 　良かったですよ…、ありがとうございます
PRINTFORM 　はー	!#!PRINTFORM 　はー
PRINTFORMW 　お、終わった、んですか…？」	!#!PRINTFORMW 　お、終わった、んですか…？」
PRINTFORM 「んん……	!#!PRINTFORM 「んん……
PRINTFORM 　ご、ごめんなさい、がまん、できなくて…	!#!PRINTFORM 　ご、ごめんなさい、がまん、できなくて…
PRINTFORMW 「や、やめ、もうやめてぇぇっ！」	!#!PRINTFORMW 「や、やめ、もうやめてぇぇっ！」
PRINTFORM 「ふふっ……まだまだ満足出来ないでしょう	!#!PRINTFORM 「ふふっ……まだまだ満足出来ないでしょう
PRINTFORM 　いやらしい子、ですからね	!#!PRINTFORM 　いやらしい子、ですからね
PRINTFORM 「さぁ、まだまだい～っぱいしましょうね	!#!PRINTFORM 「さぁ、まだまだい～っぱいしましょうね
PRINTFORMW 「も、やめ、やめてくらさぁいっ！」	!#!PRINTFORMW 「も、やめ、やめてくらさぁいっ！」
PRINTFORM 「ほらほら…	!#!PRINTFORM 「ほらほら…
PRINTFORM 　こんなに欲しがってますよ	!#!PRINTFORM 　こんなに欲しがってますよ
PRINTFORM 　まだまだしましょうね	!#!PRINTFORM 　まだまだしましょうね
PRINTFORMW 「あ、ぅ……また、されて……」	!#!PRINTFORMW 「あ、ぅ……また、されて……」
PRINTFORM 「ふふっ、こんなに、大きくなりましたよ	!#!PRINTFORM 「ふふっ、こんなに、大きくなりましたよ
PRINTFORM 「また、これでずぶずぶしてあげますからね	!#!PRINTFORM 「また、これでずぶずぶしてあげますからね
PRINTFORM 「こ、こんな、大きくなっちゃって…	!#!PRINTFORM 「こ、こんな、大きくなっちゃって…
PRINTFORM これで、わらひ、また…	!#!PRINTFORM これで、わらひ、また…
PRINTFORM 「ふふっ、こんなに大きくなっちゃいましたよ	!#!PRINTFORM 「ふふっ、こんなに大きくなっちゃいましたよ
PRINTFORM 　そんなに物欲しそうな目しちゃって…	!#!PRINTFORM 　そんなに物欲しそうな目しちゃって…
PRINTFORM 　ひゃめへっ、にゅるにゅるひゃめへぇぇぇっ	!#!PRINTFORM 　ひゃめへっ、にゅるにゅるひゃめへぇぇぇっ
PRINTFORM 「ちゅかにゃいれっ、にゅるにゅるしにゃがららめぇぇぇっ	!#!PRINTFORM 「ちゅかにゃいれっ、にゅるにゅるしにゃがららめぇぇぇっ
PRINTFORM 「ふふっ、そんなにあんあん言っちゃって……	!#!PRINTFORM 「ふふっ、そんなにあんあん言っちゃって……
PRINTFORM 「まだ、そんなにしてないのに、こんなに気持ちよくなっちゃったんですか？ いやらしいんですね	!#!PRINTFORM 「まだ、そんなにしてないのに、こんなに気持ちよくなっちゃったんですか？ いやらしいんですね
PRINTFORM 「ほらほら、も～っとしてあげますからね	!#!PRINTFORM 「ほらほら、も～っとしてあげますからね
PRINTFORM 　りゃめ、りゃめぇぇぇっ	!#!PRINTFORM 　りゃめ、りゃめぇぇぇっ
PRINTFORM 「も、ゆるひ、これとめりぇくらひゃぁぁぁいっ	!#!PRINTFORM 「も、ゆるひ、これとめりぇくらひゃぁぁぁいっ
PRINTFORM 　そんなに腰振っちゃって……そんなに気持ちいいんですか？	!#!PRINTFORM 　そんなに腰振っちゃって……そんなに気持ちいいんですか？
PRINTFORM 「それなら、もっと気持ちよく、してあげますからね	!#!PRINTFORM 「それなら、もっと気持ちよく、してあげますからね
PRINTFORM 「やめへぇぇ	!#!PRINTFORM 「やめへぇぇ
PRINTFORM 　にゅるにゅるっ、やめへくらさぁぁいっ	!#!PRINTFORM 　にゅるにゅるっ、やめへくらさぁぁいっ
PRINTFORM 「らされひゃいまひゅっ	!#!PRINTFORM 「らされひゃいまひゅっ
PRINTFORM 　まらびゅーびゅーっれぇぇっ	!#!PRINTFORM 　まらびゅーびゅーっれぇぇっ
PRINTFORM 「だ・め・で・す・よ	!#!PRINTFORM 「だ・め・で・す・よ
PRINTFORM 「わらひ、いっぱいびゅーびゅーしたいんれすからぁ	!#!PRINTFORM 「わらひ、いっぱいびゅーびゅーしたいんれすからぁ
PRINTFORM 　ほら、うねうねさんでいっぱい気持ちよくなってくらさいね	!#!PRINTFORM 　ほら、うねうねさんでいっぱい気持ちよくなってくらさいね
PRINTFORM 「あぁぁぁぁんっ	!#!PRINTFORM 「あぁぁぁぁんっ
PRINTFORM 　あぁぁあぁぁっ	!#!PRINTFORM 　あぁぁあぁぁっ
PRINTFORM 　まら、らひゃれ、らひゃれぇぇぇっ	!#!PRINTFORM 　まら、らひゃれ、らひゃれぇぇぇっ
PRINTFORM 「嫌なんですか？　嘘ですよね	!#!PRINTFORM 「嫌なんですか？　嘘ですよね
PRINTFORM 　だって、こんなにうねうねさんで感じちゃってるじゃないですか	!#!PRINTFORM 　だって、こんなにうねうねさんで感じちゃってるじゃないですか
PRINTFORM 「ほら、うそつきさんには、い～っぱい出してあげないといけませんね	!#!PRINTFORM 「ほら、うそつきさんには、い～っぱい出してあげないといけませんね
PRINTFORM 「こ、こんな……	!#!PRINTFORM 「こ、こんな……
PRINTFORM 　はじめてなのに、わらひ、こどもが、できちゃ…	!#!PRINTFORM 　はじめてなのに、わらひ、こどもが、できちゃ…
PRINTFORM 「んっ……ふふっ	!#!PRINTFORM 「んっ……ふふっ
PRINTFORM 　こんなにぽっこりしちゃって	!#!PRINTFORM 　こんなにぽっこりしちゃって
PRINTFORM 「はじめてなのにあんなに感じて…	!#!PRINTFORM 「はじめてなのにあんなに感じて…
PRINTFORM 　わたしのこども、できちゃいましたね	!#!PRINTFORM 　わたしのこども、できちゃいましたね
PRINTFORM 　は～～	!#!PRINTFORM 　は～～
PRINTFORM 「こ、こんにゃ、そそぐにゃんて……	!#!PRINTFORM 「こ、こんにゃ、そそぐにゃんて……
PRINTFORM 　れ、れきひゃい、まひゅよぉ…	!#!PRINTFORM 　れ、れきひゃい、まひゅよぉ…
PRINTFORM 　いっぱい気持ちよくなっちゃいましたね	!#!PRINTFORM 　いっぱい気持ちよくなっちゃいましたね
PRINTFORM 「わたしも、良かったですよ	!#!PRINTFORM 「わたしも、良かったですよ
PRINTFORM 　こんなに注いだら……わたしのあかちゃん、できたかもしれませんね	!#!PRINTFORM 　こんなに注いだら……わたしのあかちゃん、できたかもしれませんね
PRINTFORMW 「……ぁ……ぁ……」	!#!PRINTFORMW 「……ぁ……ぁ……」
PRINTFORMW 　気絶しちゃったんですか？」	!#!PRINTFORMW 　気絶しちゃったんですか？」
PRINTFORM 「はじめてなのに、気絶するまであんあん感じちゃって…	!#!PRINTFORM 「はじめてなのに、気絶するまであんあん感じちゃって…
PRINTFORM 　本当に可愛いんですから	!#!PRINTFORM 　本当に可愛いんですから
PRINTFORM 　っ……ぁ……	!#!PRINTFORM 　っ……ぁ……
PRINTFORM 　気絶しちゃいましたね	!#!PRINTFORM 　気絶しちゃいましたね
PRINTFORM 「まだ満足は出来てませんけど……、こんなに感じてくれて、嬉しいですよ	!#!PRINTFORM 「まだ満足は出来てませんけど……、こんなに感じてくれて、嬉しいですよ
PRINTFORMW 「も、もう嫌、いやぁぁ！」	!#!PRINTFORMW 「も、もう嫌、いやぁぁ！」
PRINTFORMW 「ぁ……」	!#!PRINTFORMW 「ぁ……」
PRINTFORM 「いいじゃないですか、もっと気持ちよくなりましょうよぉ…	!#!PRINTFORM 「いいじゃないですか、もっと気持ちよくなりましょうよぉ…
PRINTFORMW 「な、何とか抜け出せ……」	!#!PRINTFORMW 「な、何とか抜け出せ……」
PRINTFORMW 「落ち着いてください、ね？」	!#!PRINTFORMW 「落ち着いてください、ね？」
PRINTFORM 「……ぁぅ……	!#!PRINTFORM 「……ぁぅ……
PRINTFORM 「逃げられちゃいました…	!#!PRINTFORM 「逃げられちゃいました…
PRINTFORM 「ま、また……するんです、か……？	!#!PRINTFORM 「ま、また……するんです、か……？
PRINTFORM 　わ、わたし、はじめてだったのに、受け入れちゃだめなのに…	!#!PRINTFORM 　わ、わたし、はじめてだったのに、受け入れちゃだめなのに…
PRINTFORM 「っはふ…	!#!PRINTFORM 「っはふ…
PRINTFORM 　まだ、ですよ……、まだ私、満足してないんです…	!#!PRINTFORM 　まだ、ですよ……、まだ私、満足してないんです…
PRINTFORM 「はじめてを奪われたばかりで辛いでしょうけど、もう少し付き合ってくださいね…	!#!PRINTFORM 「はじめてを奪われたばかりで辛いでしょうけど、もう少し付き合ってくださいね…
PRINTFORMW 「ま、まだ、するんですか…？」	!#!PRINTFORMW 「ま、まだ、するんですか…？」
PRINTFORM 「わ、わたし、壊れちゃいますよぉ…	!#!PRINTFORM 「わ、わたし、壊れちゃいますよぉ…
PRINTFORM 「ごめんなさい、まだ私、満足出来てないんです	!#!PRINTFORM 「ごめんなさい、まだ私、満足出来てないんです
PRINTFORM 　……また、しちゃいますね	!#!PRINTFORM 　……また、しちゃいますね
PRINTFORM 「ひあぁっ！！？	!#!PRINTFORM 「ひあぁっ！！？
PRINTFORM 　い、いひゃく、にゃくにゃっれぇぇぇっ	!#!PRINTFORM 　い、いひゃく、にゃくにゃっれぇぇぇっ
PRINTFORM 「動きますね	!#!PRINTFORM 「動きますね
PRINTFORM 　ほら、もう痛くないでしょう？ 気持ちいいですよね	!#!PRINTFORM 　ほら、もう痛くないでしょう？ 気持ちいいですよね
PRINTFORM 「あんっ	!#!PRINTFORM 「あんっ
PRINTFORM 　ああぁぁぁんっ	!#!PRINTFORM 　ああぁぁぁんっ
PRINTFORM 「ゆるひれっ	!#!PRINTFORM 「ゆるひれっ
PRINTFORM 　もっ、ゆるひれくらひゃぁぁいっ	!#!PRINTFORM 　もっ、ゆるひれくらひゃぁぁいっ
PRINTFORM 「ふふっ、こんなにびくびくしちゃって	!#!PRINTFORM 「ふふっ、こんなにびくびくしちゃって
PRINTFORM 　大丈夫ですよ、もっといっぱい気持ちよくしてあげますからねっ	!#!PRINTFORM 　大丈夫ですよ、もっといっぱい気持ちよくしてあげますからねっ
PRINTFORM 「わ、分かりました、あなたなら…	!#!PRINTFORM 「わ、分かりました、あなたなら…
PRINTFORMDW %CALLNAME:(TARGET)%は嬉しそうに頬を染めてその要求を受け入れた…。	!#!PRINTFORMDW %CALLNAME:(TARGET)%は嬉しそうに頬を染めてその要求を受け入れた…。
PRINTFORMW 「わ、分かりました…」	!#!PRINTFORMW 「わ、分かりました…」
PRINTFORMDW %CALLNAME:(TARGET)%はそれほど抵抗する様子も無く要求を受け入れた…。	!#!PRINTFORMDW %CALLNAME:(TARGET)%はそれほど抵抗する様子も無く要求を受け入れた…。
PRINTFORMW 「っ……！ わかり、ました…！」	!#!PRINTFORMW 「っ……！ わかり、ました…！」
PRINTFORMDW %CALLNAME:(TARGET)%は苦渋の決断、と言った表情で要求を受け入れた…。	!#!PRINTFORMDW %CALLNAME:(TARGET)%は苦渋の決断、と言った表情で要求を受け入れた…。
PRINTFORM 「ひあぁぁぁん	!#!PRINTFORM 「ひあぁぁぁん
PRINTFORM 　にゅるんっれぇ	!#!PRINTFORM 　にゅるんっれぇ
PRINTFORM 　にゅるんっへきまひたぁっ	!#!PRINTFORM 　にゅるんっへきまひたぁっ
PRINTFORM 「んくぅぅっ…	!#!PRINTFORM 「んくぅぅっ…
PRINTFORM 　き、きまひ、たぁ…	!#!PRINTFORM 　き、きまひ、たぁ…
PRINTFORMW 「っ……！」	!#!PRINTFORMW 「っ……！」
PRINTFORMW 「これで、満足ですか…？」	!#!PRINTFORMW 「これで、満足ですか…？」
PRINTFORM 「はあぁぁんっ	!#!PRINTFORM 「はあぁぁんっ
PRINTFORM 　はじめてなのにぃっ	!#!PRINTFORM 　はじめてなのにぃっ
PRINTFORM 　イっひゃぁぁっ	!#!PRINTFORM 　イっひゃぁぁっ
PRINTFORM 「うそっ、うそれすぅっ	!#!PRINTFORM 「うそっ、うそれすぅっ
PRINTFORM 　わらひっ、はじめてなのにぃっ	!#!PRINTFORM 　わらひっ、はじめてなのにぃっ
PRINTFORM 「いっ	!#!PRINTFORM 「いっ
PRINTFORM 　いたい、はずなのにぃっ	!#!PRINTFORM 　いたい、はずなのにぃっ
PRINTFORM 　らめっ、らめぇぇっ	!#!PRINTFORM 　らめっ、らめぇぇっ
PRINTFORM 「ひゅごいっ	!#!PRINTFORM 「ひゅごいっ
PRINTFORM 　じゅこじゅこしゅごいれしゅぅっ	!#!PRINTFORM 　じゅこじゅこしゅごいれしゅぅっ
PRINTFORM 「わらひっ	!#!PRINTFORM 「わらひっ
PRINTFORM 　わらひぃぃっ	!#!PRINTFORM 　わらひぃぃっ
PRINTFORM 「イ、きゅっ	!#!PRINTFORM 「イ、きゅっ
PRINTFORM 　イきまひゅぅぅぅぅっ	!#!PRINTFORM 　イきまひゅぅぅぅぅっ
PRINTFORM 「ひあぁぁっ	!#!PRINTFORM 「ひあぁぁっ
PRINTFORM 　ら、め	!#!PRINTFORM 　ら、め
PRINTFORM 　もうらめぇぇぇっ	!#!PRINTFORM 　もうらめぇぇぇっ
PRINTFORM 「ゆ、ゆるひ、てぇ	!#!PRINTFORM 「ゆ、ゆるひ、てぇ
PRINTFORM 　らめれすっ	!#!PRINTFORM 　らめれすっ
PRINTFORM 　ほんとらめぇぇっ	!#!PRINTFORM 　ほんとらめぇぇっ
PRINTFORM 「あ、ぷるぷるして…	!#!PRINTFORM 「あ、ぷるぷるして…
PRINTFORM 　はじめてなのに、イっちゃいそうなんですね？	!#!PRINTFORM 　はじめてなのに、イっちゃいそうなんですね？
PRINTFORM 「いいですよ、いっぱいイっちゃって…、わらひ、もっ	!#!PRINTFORM 「いいですよ、いっぱいイっちゃって…、わらひ、もっ
PRINTFORMW 「ふふっ、はじめてなのに、イきそうなんですか？」	!#!PRINTFORMW 「ふふっ、はじめてなのに、イきそうなんですか？」
PRINTFORM 「いいですよ、私も…	!#!PRINTFORM 「いいですよ、私も…
PRINTFORM 「ふふっ、どうしたんですか？	!#!PRINTFORM 「ふふっ、どうしたんですか？
PRINTFORM 「嫌だって言ってらしたのに、はじめてなのに、そんなに気持ち良さそうにしちゃって…	!#!PRINTFORM 「嫌だって言ってらしたのに、はじめてなのに、そんなに気持ち良さそうにしちゃって…
PRINTFORM 「イきたいんですか？ いいですよ、私も中にびゅーってしちゃいますからね	!#!PRINTFORM 「イきたいんですか？ いいですよ、私も中にびゅーってしちゃいますからね
PRINTFORM 　イっちゃうんですか？ いいですよ	!#!PRINTFORM 　イっちゃうんですか？ いいですよ
PRINTFORM 　いっしょに、ね	!#!PRINTFORM 　いっしょに、ね
PRINTFORM 「ふふふっ、気持ちいいですか？　私も…	!#!PRINTFORM 「ふふふっ、気持ちいいですか？　私も…
PRINTFORMW 「ふふっ、そんなに鳴いちゃって…」	!#!PRINTFORMW 「ふふっ、そんなに鳴いちゃって…」
PRINTFORM 「イきたいんならどうぞ？ 私も、好きにさせて貰いますけどね	!#!PRINTFORM 「イきたいんならどうぞ？ 私も、好きにさせて貰いますけどね
PRINTFORM 　にゃあぁぁぁん	!#!PRINTFORM 　にゃあぁぁぁん
PRINTFORM 「はじめてっ	!#!PRINTFORM 「はじめてっ
PRINTFORM 　なのにぃっ	!#!PRINTFORM 　なのにぃっ
PRINTFORM 「もっ、らめぇっ	!#!PRINTFORM 「もっ、らめぇっ
PRINTFORM 　びゅーってっ	!#!PRINTFORM 　びゅーってっ
PRINTFORM 　かけてくらさぁいっ	!#!PRINTFORM 　かけてくらさぁいっ
PRINTFORM 「ひくっ	!#!PRINTFORM 「ひくっ
PRINTFORM 　ひっひゃいまひゅぅっ	!#!PRINTFORM 　ひっひゃいまひゅぅっ
PRINTFORM 「ご、ごめんにゃさいっ	!#!PRINTFORM 「ご、ごめんにゃさいっ
PRINTFORM 　にゃかはっ	!#!PRINTFORM 　にゃかはっ
PRINTFORM 　にゃかはぁっ	!#!PRINTFORM 　にゃかはぁっ
PRINTFORM 「んあぁぁぁっっ	!#!PRINTFORM 「んあぁぁぁっっ
PRINTFORM 「イっ、くぅぅぅぅっ	!#!PRINTFORM 「イっ、くぅぅぅぅっ
PRINTFORM 　かけてっ	!#!PRINTFORM 　かけてっ
PRINTFORM 　いっぱいどろどろにひてくらさぁいっ	!#!PRINTFORM 　いっぱいどろどろにひてくらさぁいっ
PRINTFORM 「ひあぁぁぁぁっ	!#!PRINTFORM 「ひあぁぁぁぁっ
PRINTFORM 　そとにっ、そとにおねがいしましゅぅっ	!#!PRINTFORM 　そとにっ、そとにおねがいしましゅぅっ
PRINTFORM 「ひっ……～～～～っ	!#!PRINTFORM 「ひっ……～～～～っ
PRINTFORM 　らめ、らめぇぇ！　なからめぇぇぇ	!#!PRINTFORM 　らめ、らめぇぇ！　なからめぇぇぇ
PRINTFORM 　はじめてなのに、そんなにきゅうきゅうって…	!#!PRINTFORM 　はじめてなのに、そんなにきゅうきゅうって…
PRINTFORM 「大丈夫ですよ	!#!PRINTFORM 「大丈夫ですよ
PRINTFORM 　ちゃんとそとに、出してあげますから…	!#!PRINTFORM 　ちゃんとそとに、出してあげますから…
PRINTFORM 　びくびくって、イっちゃったんですね？　はじめてなのに	!#!PRINTFORM 　びくびくって、イっちゃったんですね？　はじめてなのに
PRINTFORM 「いっぱい、私も、かけてあげますから…	!#!PRINTFORM 「いっぱい、私も、かけてあげますから…
PRINTFORMW 「ふふっ、はじめてなのにイっちゃうなんて…、いやらしいんですね♪」	!#!PRINTFORMW 「ふふっ、はじめてなのにイっちゃうなんて…、いやらしいんですね♪」
PRINTFORM 「そとに、いっぱい出してあげますからね	!#!PRINTFORM 「そとに、いっぱい出してあげますからね
PRINTFORM 「ふふっ、感じてるんですね	!#!PRINTFORM 「ふふっ、感じてるんですね
PRINTFORM 　そんなにあんあんって何回もイっちゃって	!#!PRINTFORM 　そんなにあんあんって何回もイっちゃって
PRINTFORM 「いっぱいどろどろにっ、かけてあげますからねっ	!#!PRINTFORM 「いっぱいどろどろにっ、かけてあげますからねっ
PRINTFORM 　それじゃあ、そろそろ私もっ…	!#!PRINTFORM 　それじゃあ、そろそろ私もっ…
PRINTFORM 「大丈夫ですよっ、いっぱい、かけてあげますからぁっ…	!#!PRINTFORM 「大丈夫ですよっ、いっぱい、かけてあげますからぁっ…
PRINTFORM 「あらあら、こんなに浅ましく、すぐにイってしまうだなんて	!#!PRINTFORM 「あらあら、こんなに浅ましく、すぐにイってしまうだなんて
PRINTFORM 「ほら、いっぱいかけてあげますからね	!#!PRINTFORM 「ほら、いっぱいかけてあげますからね
PRINTFORM 　真っ白に、なってくださいねぇっ	!#!PRINTFORM 　真っ白に、なってくださいねぇっ
PRINTFORM 「ああぁぁあぁあっぁっ	!#!PRINTFORM 「ああぁぁあぁあっぁっ
PRINTFORM 　なかにっ、なかにくらさぁいっ	!#!PRINTFORM 　なかにっ、なかにくらさぁいっ
PRINTFORM 「あにゃたなら、かまいましぇんからぁぁぁっ	!#!PRINTFORM 「あにゃたなら、かまいましぇんからぁぁぁっ
PRINTFORM 「ひっ、～～～～～っ	!#!PRINTFORM 「ひっ、～～～～～っ
PRINTFORM 　は、はひめれ、にゃの、にぃ…	!#!PRINTFORM 　は、はひめれ、にゃの、にぃ…
PRINTFORM 「あ、ぁ～～～～～っ	!#!PRINTFORM 「あ、ぁ～～～～～っ
PRINTFORM 　にゃ、にゃからしちゃ、らめ、らめれすぅぅっ	!#!PRINTFORM 　にゃ、にゃからしちゃ、らめ、らめれすぅぅっ
PRINTFORM 「～～～～～っ	!#!PRINTFORM 「～～～～～っ
PRINTFORM 「らしてぇっ	!#!PRINTFORM 「らしてぇっ
PRINTFORM 　にゃかっ、びゅーってくらさぁいっ	!#!PRINTFORM 　にゃかっ、びゅーってくらさぁいっ
PRINTFORM 　あにゃたなら、いいれすからぁぁぁっ	!#!PRINTFORM 　あにゃたなら、いいれすからぁぁぁっ
PRINTFORM 「っっっぁ	!#!PRINTFORM 「っっっぁ
PRINTFORM 　ひっ……～～～～っ	!#!PRINTFORM 　ひっ……～～～～っ
PRINTFORM 「にゃ、にゃか、らされ、ひゃ……	!#!PRINTFORM 「にゃ、にゃか、らされ、ひゃ……
PRINTFORM 　ひっ	!#!PRINTFORM 　ひっ
PRINTFORM 「にゃからめ！ らめぇぇぇぇっ	!#!PRINTFORM 「にゃからめ！ らめぇぇぇぇっ
PRINTFORM 　きゅぅぅぅっってきまひたぁぁっ	!#!PRINTFORM 　きゅぅぅぅっってきまひたぁぁっ
PRINTFORM 「らしますからねっ	!#!PRINTFORM 「らしますからねっ
PRINTFORM 　わらひのあかちゃん、うんれくらさぁいっ	!#!PRINTFORM 　わらひのあかちゃん、うんれくらさぁいっ
PRINTFORM 「んんんっ	!#!PRINTFORM 「んんんっ
PRINTFORM 　はひめれなのに、イっちゃったんれすかぁ…	!#!PRINTFORM 　はひめれなのに、イっちゃったんれすかぁ…
PRINTFORM 「わらひも、らひちゃいます、よぉ…	!#!PRINTFORM 「わらひも、らひちゃいます、よぉ…
PRINTFORM 「あらあら、はじめてでイってしまうような、淫乱な方だったんですか	!#!PRINTFORM 「あらあら、はじめてでイってしまうような、淫乱な方だったんですか
PRINTFORM 「そんなあなたには、いっぱい注いであげますからね	!#!PRINTFORM 「そんなあなたには、いっぱい注いであげますからね
PRINTFORM 　いっぱい、イっちゃってくださいねっ	!#!PRINTFORM 　いっぱい、イっちゃってくださいねっ
PRINTFORM 「ぁ、ふふ♪ そんなに声上げちゃって…	!#!PRINTFORM 「ぁ、ふふ♪ そんなに声上げちゃって…
PRINTFORM 「わらひも、らしますから…	!#!PRINTFORM 「わらひも、らしますから…
PRINTFORM 　いっぱい、なかにぃっ	!#!PRINTFORM 　いっぱい、なかにぃっ
PRINTFORM 　こんなにきゅぅぅぅっれされたらぁっ	!#!PRINTFORM 　こんなにきゅぅぅぅっれされたらぁっ
PRINTFORM 「れちゃいましゅっ	!#!PRINTFORM 「れちゃいましゅっ
PRINTFORM 　れちゃいまひゅぅぅぅっ	!#!PRINTFORM 　れちゃいまひゅぅぅぅっ
PRINTFORM 「あらあら、もうイってしまわれたんですか？ いやらしいんですね	!#!PRINTFORM 「あらあら、もうイってしまわれたんですか？ いやらしいんですね
PRINTFORM 　それじゃあ、私もイきますからね	!#!PRINTFORM 　それじゃあ、私もイきますからね
PRINTFORM 　ほら、中に、いっぱい注ぎますからっ、イきまくってくらさいねっ	!#!PRINTFORM 　ほら、中に、いっぱい注ぎますからっ、イきまくってくらさいねっ
PRINTFORMW 「ら、らめって……いっひゃ……の、にぃ……」	!#!PRINTFORMW 「ら、らめって……いっひゃ……の、にぃ……」
PRINTFORMW 「ごめんなさい、星、我慢できないの…」	!#!PRINTFORMW 「ごめんなさい、星、我慢できないの…」
PRINTFORM 「あなたの中で、いっぱいびゅくびゅくさせてね	!#!PRINTFORM 「あなたの中で、いっぱいびゅくびゅくさせてね
PRINTFORMW 「ご、ごめんね、我慢できないの…」	!#!PRINTFORMW 「ご、ごめんね、我慢できないの…」
PRINTFORM 「あなたのおっぱい、使わせてちょうだいね	!#!PRINTFORM 「あなたのおっぱい、使わせてちょうだいね
PRINTFORM 　こんなに大きくなっちゃって	!#!PRINTFORM 　こんなに大きくなっちゃって
PRINTFORM 　そのおっぱい、使わせてくださいね	!#!PRINTFORM 　そのおっぱい、使わせてくださいね
PRINTFORM 「星のお尻……こんなに、引き締まってて……	!#!PRINTFORM 「星のお尻……こんなに、引き締まってて……
PRINTFORM 　ごめんなさい、我慢、できないんですっ	!#!PRINTFORM 　ごめんなさい、我慢、できないんですっ
PRINTFORM 「う、うぅ……がまん、できなくて……	!#!PRINTFORM 「う、うぅ……がまん、できなくて……
PRINTFORM 　星のお口、使わせてください…	!#!PRINTFORM 　星のお口、使わせてください…
PRINTFORM 「星、私の中で、こんなに…	!#!PRINTFORM 「星、私の中で、こんなに…
PRINTFORMW は「;」を左につけるか消すかしたほうがよいでしょう	!#!PRINTFORMW は「;」を左につけるか消すかしたほうがよいでしょう
PRINTFORMW はその行の左にある「;」を消しましょう	!#!PRINTFORMW はその行の左にある「;」を消しましょう
PRINTFORML 【悲報】淫魔モードこぁより淫乱っぽくなった	!#!PRINTFORML 【悲報】淫魔モードこぁより淫乱っぽくなった
PRINTFORML あとハートマーク使いすぎ警報。	!#!PRINTFORML あとハートマーク使いすぎ警報。
PRINTFORMW そんな代物でよければどうぞ。	!#!PRINTFORMW そんな代物でよければどうぞ。
PRINTFORM 　ひきまひゅっ	!#!PRINTFORM 　ひきまひゅっ
PRINTFORM 　びゃくれんっ	!#!PRINTFORM 　びゃくれんっ
PRINTFORM 　まらイきまひゅぅぅぅっ	!#!PRINTFORM 　まらイきまひゅぅぅぅっ
PRINTFORM 「っっっっっぁ	!#!PRINTFORM 「っっっっっぁ
PRINTFORM 　～～～～～	!#!PRINTFORM 　～～～～～
PRINTFORM 「ふ…ぁ…	!#!PRINTFORM 「ふ…ぁ…
PRINTFORM あ～～～～～	!#!PRINTFORM あ～～～～～
PRINTFORM 「ら、め、なのにぃっ	!#!PRINTFORM 「ら、め、なのにぃっ
PRINTFORM 　からだがっ、ほひくれぇぇっ	!#!PRINTFORM 　からだがっ、ほひくれぇぇっ
PRINTFORM 「イっひゃうっ	!#!PRINTFORM 「イっひゃうっ
PRINTFORM 　らめ	!#!PRINTFORM 　らめ
PRINTFORM 　らめなのにっ	!#!PRINTFORM 　らめなのにっ
PRINTFORM 　手が	!#!PRINTFORM 　手が
PRINTFORM 　とまらにゃっ	!#!PRINTFORM 　とまらにゃっ
PRINTFORM 「からだぁ	!#!PRINTFORM 「からだぁ
PRINTFORM 　あちゅいんれしゅぅ	!#!PRINTFORM 　あちゅいんれしゅぅ
PRINTFORM 「がまん	!#!PRINTFORM 「がまん
PRINTFORM 　れきませんよぉ	!#!PRINTFORM 　れきませんよぉ
PRINTFORM 「ゆっ	!#!PRINTFORM 「ゆっ
PRINTFORM 　ゆびがっ	!#!PRINTFORM 　ゆびがっ
PRINTFORM 　とまらにゃ	!#!PRINTFORM 　とまらにゃ
PRINTFORM 　んん～～～っ	!#!PRINTFORM 　んん～～～っ
PRINTFORM 　きもひっ	!#!PRINTFORM 　きもひっ
PRINTFORM 　よくれぇぇっ	!#!PRINTFORM 　よくれぇぇっ
PRINTFORM 「ら	!#!PRINTFORM 「ら
PRINTFORM 　らめぇ	!#!PRINTFORM 　らめぇ
PRINTFORM 　からだっ	!#!PRINTFORM 　からだっ
PRINTFORM 　あつくれぇっ	!#!PRINTFORM 　あつくれぇっ
PRINTFORM 「ゆ、指が、止まらな……	!#!PRINTFORM 「ゆ、指が、止まらな……
PRINTFORMW 「うぁ……ぐ…」	!#!PRINTFORMW 「うぁ……ぐ…」
PRINTFORMW 「た、たたく、よりもぉ……」	!#!PRINTFORMW 「た、たたく、よりもぉ……」
PRINTFORMW 「っかふ、ぁ……」	!#!PRINTFORMW 「っかふ、ぁ……」
PRINTFORMW 「こふっ、ぐぅぅっ！」	!#!PRINTFORMW 「こふっ、ぐぅぅっ！」
PRINTFORMW 「ま、まだです！」	!#!PRINTFORMW 「ま、まだです！」
PRINTFORMW 「ぐっ！」	!#!PRINTFORMW 「ぐっ！」
PRINTFORM 「ひゅごいぃぃ	!#!PRINTFORM 「ひゅごいぃぃ
PRINTFORM 　もっろっ	!#!PRINTFORM 　もっろっ
PRINTFORM 　もっろぉぉっ	!#!PRINTFORM 　もっろぉぉっ
PRINTFORM 「くらさいっ	!#!PRINTFORM 「くらさいっ
PRINTFORM 　もっとにゅこにゅこひてくらさぁいっ	!#!PRINTFORM 　もっとにゅこにゅこひてくらさぁいっ
PRINTFORM 「もっろぉっ	!#!PRINTFORM 「もっろぉっ
PRINTFORM 　もっろきもひよくひてくらさぁいっ	!#!PRINTFORM 　もっろきもひよくひてくらさぁいっ
PRINTFORM 「っっっあ～～～～～	!#!PRINTFORM 「っっっあ～～～～～
PRINTFORM 　あ゛～～～～～	!#!PRINTFORM 　あ゛～～～～～
PRINTFORM 「らめれすっ	!#!PRINTFORM 「らめれすっ
PRINTFORM 　しゅぐえっひになっひゃいまひゅぅぅぅっ	!#!PRINTFORM 　しゅぐえっひになっひゃいまひゅぅぅぅっ
PRINTFORM 　ひあぁっ	!#!PRINTFORM 　ひあぁっ
PRINTFORM 　らめぇぇぇっ	!#!PRINTFORM 　らめぇぇぇっ
PRINTFORM 「ひぃんっ	!#!PRINTFORM 「ひぃんっ
PRINTFORM 　ひぃぃぃぃんっ	!#!PRINTFORM 　ひぃぃぃぃんっ
PRINTFORM 「イっひゃふっ	!#!PRINTFORM 「イっひゃふっ
PRINTFORM 　まひゃぁぁぁぁ	!#!PRINTFORM 　まひゃぁぁぁぁ
PRINTFORM 「だ、だめですよぉ	!#!PRINTFORM 「だ、だめですよぉ
PRINTFORM 　そんな、激しくしたらぁ	!#!PRINTFORM 　そんな、激しくしたらぁ
PRINTFORM 「わ、わらひ、またぁっ	!#!PRINTFORM 「わ、わらひ、またぁっ
PRINTFORM 「そ、そんなにしなくても、わらひはちゃんと受け入れまひゅからぁっ	!#!PRINTFORM 「そ、そんなにしなくても、わらひはちゃんと受け入れまひゅからぁっ
PRINTFORM 「ひぐぅぅぅっ	!#!PRINTFORM 「ひぐぅぅぅっ
PRINTFORM 　まひゃぁぁぁっ	!#!PRINTFORM 　まひゃぁぁぁっ
PRINTFORM 　きひゃいまひゅぅぅぅっ	!#!PRINTFORM 　きひゃいまひゅぅぅぅっ
PRINTFORM 「くりゅぅぅぅっ	!#!PRINTFORM 「くりゅぅぅぅっ
PRINTFORM 　ひゅごいのまひゃきひゃいましゅぅぅっ	!#!PRINTFORM 　ひゅごいのまひゃきひゃいましゅぅぅっ
PRINTFORM 「イきゅっ	!#!PRINTFORM 「イきゅっ
PRINTFORM 　ひくぅぅぅぅぅっ	!#!PRINTFORM 　ひくぅぅぅぅぅっ
PRINTFORM 「きひゃあぁぁ	!#!PRINTFORM 「きひゃあぁぁ
PRINTFORM 　なえどこひじりにぃっ	!#!PRINTFORM 　なえどこひじりにぃっ
PRINTFORM 　ごほうびえっひがぁぁっ	!#!PRINTFORM 　ごほうびえっひがぁぁっ
PRINTFORM 「イきゅぅ	!#!PRINTFORM 「イきゅぅ
PRINTFORM 　わらひぃ	!#!PRINTFORM 　わらひぃ
PRINTFORM 　イきまきゅっひゃいまひゅぅぅぅぅっ	!#!PRINTFORM 　イきまきゅっひゃいまひゅぅぅぅぅっ
PRINTFORM 「ひゅごいぃぃいぃ	!#!PRINTFORM 「ひゅごいぃぃいぃ
PRINTFORM 　イっへるのにぃぃっ	!#!PRINTFORM 　イっへるのにぃぃっ
PRINTFORM 「にゅるにゅるっ	!#!PRINTFORM 「にゅるにゅるっ
PRINTFORM 　しゅごいっ	!#!PRINTFORM 　しゅごいっ
PRINTFORM 　しゅごいれひゅぅぅぅぅっ	!#!PRINTFORM 　しゅごいれひゅぅぅぅぅっ
PRINTFORM 「っひぅぅぅっ	!#!PRINTFORM 「っひぅぅぅっ
PRINTFORM 　しゅごいれしゅぅぅっ	!#!PRINTFORM 　しゅごいれしゅぅぅっ
PRINTFORM 「こりぇっ	!#!PRINTFORM 「こりぇっ
PRINTFORM 　はやく、にぃぃっ	!#!PRINTFORM 　はやく、にぃぃっ
PRINTFORM 「イきゅぅぅぅっ	!#!PRINTFORM 「イきゅぅぅぅっ
PRINTFORM 　イきまひゅぅぅっ	!#!PRINTFORM 　イきまひゅぅぅっ
PRINTFORM 「えっひなわらひっ	!#!PRINTFORM 「えっひなわらひっ
PRINTFORM 　もっろきもひよくひてくらさぁぁいっ	!#!PRINTFORM 　もっろきもひよくひてくらさぁぁいっ
PRINTFORM 「ゆっ、ゆるひっ	!#!PRINTFORM 「ゆっ、ゆるひっ
PRINTFORM 　ゆるひれぇぇぇっ	!#!PRINTFORM 　ゆるひれぇぇぇっ
PRINTFORM 「びゃくれんっ	!#!PRINTFORM 「びゃくれんっ
PRINTFORM 　イきまふっ	!#!PRINTFORM 　イきまふっ
PRINTFORM 「まらぁぁぁっ	!#!PRINTFORM 「まらぁぁぁっ
PRINTFORM 　まらきひゃいまひゅぅぅっ	!#!PRINTFORM 　まらきひゃいまひゅぅぅっ
PRINTFORM 　イきまひゅっ	!#!PRINTFORM 　イきまひゅっ
PRINTFORM 　びゃくれんっ、イっひゃいまひゅぅぅぅっ	!#!PRINTFORM 　びゃくれんっ、イっひゃいまひゅぅぅぅっ
PRINTFORM 「ひあぁぁぁぁ	!#!PRINTFORM 「ひあぁぁぁぁ
PRINTFORM 　はひぃぃぃぃぃっ！	!#!PRINTFORM 　はひぃぃぃぃぃっ！
PRINTFORM 　ゆるひれくらひゃああぁぁっぁっ	!#!PRINTFORM 　ゆるひれくらひゃああぁぁっぁっ
PRINTFORM 　ひあぁぁぁっ	!#!PRINTFORM 　ひあぁぁぁっ
PRINTFORM 「イっへるっ	!#!PRINTFORM 「イっへるっ
PRINTFORM 　イっへまひゅぅぅぅっ	!#!PRINTFORM 　イっへまひゅぅぅぅっ
PRINTFORM 　ゆるひれっ	!#!PRINTFORM 　ゆるひれっ
PRINTFORM 　イくぅぅぅっ	!#!PRINTFORM 　イくぅぅぅっ
PRINTFORM 　いまっ	!#!PRINTFORM 　いまっ
PRINTFORM 　イっひゃっ	!#!PRINTFORM 　イっひゃっ
PRINTFORM 　らめなのにぃっ	!#!PRINTFORM 　らめなのにぃっ
PRINTFORM 「らっ	!#!PRINTFORM 「らっ
PRINTFORM 　めぇぇっ	!#!PRINTFORM 　めぇぇっ
PRINTFORM 「イくっ	!#!PRINTFORM 「イくっ
PRINTFORM 　きもひよしゅぎれぇぇっ	!#!PRINTFORM 　きもひよしゅぎれぇぇっ
PRINTFORM 　んあぁぁぁんっ	!#!PRINTFORM 　んあぁぁぁんっ
PRINTFORM 「ゆるひれぇぇっ	!#!PRINTFORM 「ゆるひれぇぇっ
PRINTFORM ゆるひれくらさぁぁいっ	!#!PRINTFORM ゆるひれくらさぁぁいっ
PRINTFORM 「あ、あ～～～～～	!#!PRINTFORM 「あ、あ～～～～～
PRINTFORM 「ひくぅぅぅっ	!#!PRINTFORM 「ひくぅぅぅっ
PRINTFORM 「イきにゃがらぁぁぁっ	!#!PRINTFORM 「イきにゃがらぁぁぁっ
PRINTFORM 　まひゃひくぅぅぅぅぅっ	!#!PRINTFORM 　まひゃひくぅぅぅぅぅっ
PRINTFORM 　もうやらぁぁぁっ	!#!PRINTFORM 　もうやらぁぁぁっ
PRINTFORM 「イっへっ	!#!PRINTFORM 「イっへっ
PRINTFORM 　まひゃイきまひゅぅぅぅっ	!#!PRINTFORM 　まひゃイきまひゅぅぅぅっ
PRINTFORM 「ふにゃああぁぁっ	!#!PRINTFORM 「ふにゃああぁぁっ
PRINTFORM 　らめぇぇぇぇぇっ	!#!PRINTFORM 　らめぇぇぇぇぇっ
PRINTFORM 「あ゛～～～～～っ	!#!PRINTFORM 「あ゛～～～～～っ
PRINTFORM 　あ゛～～～～～～～っ	!#!PRINTFORM 　あ゛～～～～～～～っ
PRINTFORM 「イくぅ	!#!PRINTFORM 「イくぅ
PRINTFORM 　イっへるっ	!#!PRINTFORM 　イっへるっ
PRINTFORM 　イっへましゅぅぅっ	!#!PRINTFORM 　イっへましゅぅぅっ
PRINTFORM 「イっへる、の、にぃぃっ	!#!PRINTFORM 「イっへる、の、にぃぃっ
PRINTFORM 　イきながらっ	!#!PRINTFORM 　イきながらっ
PRINTFORM 　イきながらイっひゃいまひゅぅぅぅ～～～っ	!#!PRINTFORM 　イきながらイっひゃいまひゅぅぅぅ～～～っ
PRINTFORM 「イっ、きゅぅっ	!#!PRINTFORM 「イっ、きゅぅっ
PRINTFORM 　こんにゃのっ	!#!PRINTFORM 　こんにゃのっ
PRINTFORM 　こんにゃのらめぇぇええぇぇぇぇ～～～～っ	!#!PRINTFORM 　こんにゃのらめぇぇええぇぇぇぇ～～～～っ
PRINTFORM 　りゃ、め	!#!PRINTFORM 　りゃ、め
PRINTFORM 　これりゃめぇぇぇっ	!#!PRINTFORM 　これりゃめぇぇぇっ
PRINTFORM 　んうぅぅぅっ	!#!PRINTFORM 　んうぅぅぅっ
PRINTFORM 「あはあぁぁぁぁんっ	!#!PRINTFORM 「あはあぁぁぁぁんっ
PRINTFORM 　きもひっ、よしゅぎれぇぇっ	!#!PRINTFORM 　きもひっ、よしゅぎれぇぇっ
PRINTFORM 「ふあぁ……	!#!PRINTFORM 「ふあぁ……
PRINTFORM 「こ、これすごくてぇ…	!#!PRINTFORM 「こ、これすごくてぇ…
PRINTFORM 　からだ、がぁ	!#!PRINTFORM 　からだ、がぁ
PRINTFORM 「ゆるひれっ、ゆるひれぇぇぇっ	!#!PRINTFORM 「ゆるひれっ、ゆるひれぇぇぇっ
PRINTFORM 　ひきた、～～～～～～っ	!#!PRINTFORM 　ひきた、～～～～～～っ
PRINTFORM 「ひきたくなっ、ひきたくないよぉぉっ	!#!PRINTFORM 「ひきたくなっ、ひきたくないよぉぉっ
PRINTFORM 　っひ、ひ～～～～っ	!#!PRINTFORM 　っひ、ひ～～～～っ
PRINTFORM 「は、はげ、ひっ	!#!PRINTFORM 「は、はげ、ひっ
PRINTFORM わらひ、またぁっ	!#!PRINTFORM わらひ、またぁっ
PRINTFORM 「らめぇぇ	!#!PRINTFORM 「らめぇぇ
PRINTFORM 　それらめれしゅぅぅっ	!#!PRINTFORM 　それらめれしゅぅぅっ
PRINTFORM 　きもひいいですっ、もっとぉっ	!#!PRINTFORM 　きもひいいですっ、もっとぉっ
PRINTFORM 「ふあぁ	!#!PRINTFORM 「ふあぁ
PRINTFORM 　ふあぁぁあ	!#!PRINTFORM 　ふあぁぁあ
PRINTFORM 「ど、どうして……子宮の奥まで、満たされたくてぇ…	!#!PRINTFORM 「ど、どうして……子宮の奥まで、満たされたくてぇ…
PRINTFORM 「ぁ	!#!PRINTFORM 「ぁ
PRINTFORM 　うぁ	!#!PRINTFORM 　うぁ
PRINTFORM 　すご	!#!PRINTFORM 　すご
PRINTFORM 　おっき…	!#!PRINTFORM 　おっき…
PRINTFORM 「だ、だめ、なのに、だめなのにぃっ	!#!PRINTFORM 「だ、だめ、なのに、だめなのにぃっ
PRINTFORM 「ほ、ほひくなっちゃってますぅっ	!#!PRINTFORM 「ほ、ほひくなっちゃってますぅっ
PRINTFORM 　おなか、たぷたぷになるまでそそがれてっ	!#!PRINTFORM 　おなか、たぷたぷになるまでそそがれてっ
PRINTFORM 　あかひゃんほひくなっちゃってますぅぅっ	!#!PRINTFORM 　あかひゃんほひくなっちゃってますぅぅっ
PRINTFORM 「おねがいひますぅっ	!#!PRINTFORM 「おねがいひますぅっ
PRINTFORM 　おひんひんっ	!#!PRINTFORM 　おひんひんっ
PRINTFORM 　じゅぶじゅぶさせてくらはぁいっ	!#!PRINTFORM 　じゅぶじゅぶさせてくらはぁいっ
PRINTFORM 　そっそう…んんああぁぁぁっっ	!#!PRINTFORM 　そっそう…んんああぁぁぁっっ
PRINTFORM 「おちんちん、すきれすよね	!#!PRINTFORM 「おちんちん、すきれすよね
PRINTFORM 　いっぱいずぶずぶして、びゅーってそそいであげまふねぇ…	!#!PRINTFORM 　いっぱいずぶずぶして、びゅーってそそいであげまふねぇ…
PRINTFORM 「ら、め	!#!PRINTFORM 「ら、め
PRINTFORM 　ま…まだ…だひちゃらめなのぉ…	!#!PRINTFORM 　ま…まだ…だひちゃらめなのぉ…
PRINTFORM 　もっろっ、もっろきもひよくひてくらさぁいっ	!#!PRINTFORM 　もっろっ、もっろきもひよくひてくらさぁいっ
PRINTFORM 「れ、れひゃ	!#!PRINTFORM 「れ、れひゃ
PRINTFORM 　れひゃうぅ	!#!PRINTFORM 　れひゃうぅ
PRINTFORM 　ら、らめ	!#!PRINTFORM 　ら、らめ
PRINTFORM 　がまんひれっ	!#!PRINTFORM 　がまんひれっ
PRINTFORM 　びゅーびゅーひたいんれふぅっ	!#!PRINTFORM 　びゅーびゅーひたいんれふぅっ
PRINTFORMDW %CALLNAME:(TARGET)%は激しく腰を突き上げながらも快感に耐え、熱いマグマを練り上げている…	!#!PRINTFORMDW %CALLNAME:(TARGET)%は激しく腰を突き上げながらも快感に耐え、熱いマグマを練り上げている…
PRINTFORM 「おちんちんもっと！　ずぷずぷさせてくらさぁいっ	!#!PRINTFORM 「おちんちんもっと！　ずぷずぷさせてくらさぁいっ
PRINTFORM 　ひんっ	!#!PRINTFORM 　ひんっ
PRINTFORM 　あうっ	!#!PRINTFORM 　あうっ
PRINTFORM 　もっとひたいんれすぅっ	!#!PRINTFORM 　もっとひたいんれすぅっ
PRINTFORM 「ふふ…	!#!PRINTFORM 「ふふ…
PRINTFORM 　わたしのせーえき、いっぱいびゅくびゅくして欲しいんですよね	!#!PRINTFORM 　わたしのせーえき、いっぱいびゅくびゅくして欲しいんですよね
PRINTFORM 「それなら…この程度じゃぜんぜん足りませんよぉ	!#!PRINTFORM 「それなら…この程度じゃぜんぜん足りませんよぉ
PRINTFORM 「あっ	!#!PRINTFORM 「あっ
PRINTFORM 　しゅっ	!#!PRINTFORM 　しゅっ
PRINTFORM 　しゅごいれすぅっ	!#!PRINTFORM 　しゅごいれすぅっ
PRINTFORM 　しょんなっ	!#!PRINTFORM 　しょんなっ
PRINTFORM 　やさしくぅぅぅ～～～っ	!#!PRINTFORM 　やさしくぅぅぅ～～～っ
PRINTFORM 「んぁっ	!#!PRINTFORM 「んぁっ
PRINTFORM 　きゅんきゅんらめぇっ	!#!PRINTFORM 　きゅんきゅんらめぇっ
PRINTFORM 　そんな締め付けられたらぁ	!#!PRINTFORM 　そんな締め付けられたらぁ
PRINTFORM 　むりれふっ	!#!PRINTFORM 　むりれふっ
PRINTFORM 　がまんれきまへんよぉぉっ	!#!PRINTFORM 　がまんれきまへんよぉぉっ
PRINTFORM 「あ、いれさせて、くれるんですね…	!#!PRINTFORM 「あ、いれさせて、くれるんですね…
PRINTFORM 　ふあぁぁぁ	!#!PRINTFORM 　ふあぁぁぁ
PRINTFORM 「う、うねうねらめれすぅっ	!#!PRINTFORM 「う、うねうねらめれすぅっ
PRINTFORM 　しゅぐれちゃいまひゅよぉっ	!#!PRINTFORM 　しゅぐれちゃいまひゅよぉっ
PRINTFORM 「そっ	!#!PRINTFORM 「そっ
PRINTFORM 　そうれふぅ…	!#!PRINTFORM 　そうれふぅ…
PRINTFORM 　おひんひんれ、いっぱいずぼずぼひてあげまふからねぇ…	!#!PRINTFORM 　おひんひんれ、いっぱいずぼずぼひてあげまふからねぇ…
PRINTFORM 「くぅんッ	!#!PRINTFORM 「くぅんッ
PRINTFORM 　だ…駄目れすよぉ…	!#!PRINTFORM 　だ…駄目れすよぉ…
PRINTFORM 　強引に挿入れさせられたって…我慢できるんれすからぁ…	!#!PRINTFORM 　強引に挿入れさせられたって…我慢できるんれすからぁ…
PRINTFORM 「ひ、うぅぅぅぅ～～～っ	!#!PRINTFORM 「ひ、うぅぅぅぅ～～～っ
PRINTFORM 　っひ、っっっひっ	!#!PRINTFORM 　っひ、っっっひっ
PRINTFORMDW 己の肉棒を深く咥え込まれた%CALLNAME:(TARGET)%は、こみ上げてくる快感から必死に耐えている…	!#!PRINTFORMDW 己の肉棒を深く咥え込まれた%CALLNAME:(TARGET)%は、こみ上げてくる快感から必死に耐えている…
PRINTFORM 　れめれすよぉ…	!#!PRINTFORM 　れめれすよぉ…
PRINTFORM 　おんなのひと、どうひなのにぃ…	!#!PRINTFORM 　おんなのひと、どうひなのにぃ…
PRINTFORM 「やめ…てぇ	!#!PRINTFORM 「やめ…てぇ
PRINTFORM 　やっ	!#!PRINTFORM 　やっ
PRINTFORM あっ	!#!PRINTFORM あっ
PRINTFORM 　そんなに…腰っ	!#!PRINTFORM 　そんなに…腰っ
PRINTFORM 動かさないでくらふぁぁぁいっ	!#!PRINTFORM 動かさないでくらふぁぁぁいっ
PRINTFORM 　もう…	!#!PRINTFORM 　もう…
PRINTFORM 　そんなに、私にずぼずぼして欲しいんですか？ 仕方ないですね…	!#!PRINTFORM 　そんなに、私にずぼずぼして欲しいんですか？ 仕方ないですね…
PRINTFORM 　いいれすよ…	!#!PRINTFORM 　いいれすよ…
PRINTFORM 　もっと…一緒に気持ちよくなりましょうね…	!#!PRINTFORM 　もっと…一緒に気持ちよくなりましょうね…
PRINTFORMW 「や、やだ…おしりで、なんてぇ…」	!#!PRINTFORMW 「や、やだ…おしりで、なんてぇ…」
PRINTFORM 「お、おしりっ、だめなのに…	!#!PRINTFORM 「お、おしりっ、だめなのに…
PRINTFORM 　きもひよく、なっれきてぇっ…	!#!PRINTFORM 　きもひよく、なっれきてぇっ…
PRINTFORM 「ふふっ…、私から、入れちゃいますね…	!#!PRINTFORM 「ふふっ…、私から、入れちゃいますね…
PRINTFORML 」	!#!PRINTFORML 」
PRINTFORM 「んっ、んんっ	!#!PRINTFORM 「んっ、んんっ
PRINTFORM 　おひりっ、しゅきじゃにゃいのにっ	!#!PRINTFORM 　おひりっ、しゅきじゃにゃいのにっ
PRINTFORM 　あにゃたらからっ、こんにゃにきもひいいんれすぅっ	!#!PRINTFORM 　あにゃたらからっ、こんにゃにきもひいいんれすぅっ
PRINTFORM 「はうぅぅぅ……	!#!PRINTFORM 「はうぅぅぅ……
PRINTFORM 　おひりがっ、あなたの、ずっぽりって……	!#!PRINTFORM 　おひりがっ、あなたの、ずっぽりって……
PRINTFORM 「へあぁぁっっ	!#!PRINTFORM 「へあぁぁっっ
PRINTFORM 　ま、まらっ	!#!PRINTFORM 　ま、まらっ
PRINTFORM 　うごいひゃ	!#!PRINTFORM 　うごいひゃ
PRINTFORM らめぇぇぇぇぇ～～～っ	!#!PRINTFORM らめぇぇぇぇぇ～～～っ
PRINTFORM 「おしりですね、分かりました…んあっ	!#!PRINTFORM 「おしりですね、分かりました…んあっ
PRINTFORM 　しゅきじゃにゃいのにぃっ	!#!PRINTFORM 　しゅきじゃにゃいのにぃっ
PRINTFORM 　こんにゃっ、きもひぃ、ふあぁぁぁっ	!#!PRINTFORM 　こんにゃっ、きもひぃ、ふあぁぁぁっ
PRINTFORM 「んあぁ…	!#!PRINTFORM 「んあぁ…
PRINTFORM 　お、おひりに、ずっぽりはいっひゃいまひたぁ…	!#!PRINTFORM 　お、おひりに、ずっぽりはいっひゃいまひたぁ…
PRINTFORM 「お、おひりにっ、じゅぼじゅぼされひゃ	!#!PRINTFORM 「お、おひりにっ、じゅぼじゅぼされひゃ
PRINTFORM 　あ	!#!PRINTFORM 　あ
PRINTFORM 　あああっ	!#!PRINTFORM 　あああっ
PRINTFORM 　しゅごっ、にゃんれっ、きもひっ	!#!PRINTFORM 　しゅごっ、にゃんれっ、きもひっ
PRINTFORML 「お、おっぱいいやですっ…」	!#!PRINTFORML 「お、おっぱいいやですっ…」
PRINTFORMW 「なのにっ、身体が勝手にぃ…」	!#!PRINTFORMW 「なのにっ、身体が勝手にぃ…」
PRINTFORM 「ひゃっ	!#!PRINTFORM 「ひゃっ
PRINTFORM 　ひゃめっ	!#!PRINTFORM 　ひゃめっ
PRINTFORM 　ふああぁぁんっ	!#!PRINTFORM 　ふああぁぁんっ
PRINTFORM 「触手で好き勝手にされてるのにぃっ	!#!PRINTFORM 「触手で好き勝手にされてるのにぃっ
PRINTFORM 　わらひっ、かんじてぇぇっ	!#!PRINTFORM 　わらひっ、かんじてぇぇっ
PRINTFORM 「ふふっ、そんなにいいんですかぁ	!#!PRINTFORM 「ふふっ、そんなにいいんですかぁ
PRINTFORM 　いいですよ、いっぱい…	!#!PRINTFORM 　いいですよ、いっぱい…
PRINTFORM 「わらひのえっひなおっぱい	!#!PRINTFORM 「わらひのえっひなおっぱい
PRINTFORM 　いっぱいむにゅむにゅしてくださいね	!#!PRINTFORM 　いっぱいむにゅむにゅしてくださいね
PRINTFORM 「あ～～～～	!#!PRINTFORM 「あ～～～～
PRINTFORM 「おっぱいしゅごいぃぃっ	!#!PRINTFORM 「おっぱいしゅごいぃぃっ
PRINTFORM 「ああぁぁぁんっ	!#!PRINTFORM 「ああぁぁぁんっ
PRINTFORM 　ああぁあああああんっ	!#!PRINTFORM 　ああぁあああああんっ
PRINTFORM 　えっひなおっぱいれイきまくりまひゅぅぅぅっ	!#!PRINTFORM 　えっひなおっぱいれイきまくりまひゅぅぅぅっ
PRINTFORM 　おっぱい、いいですよね	!#!PRINTFORM 　おっぱい、いいですよね
PRINTFORM 　はうぅ…	!#!PRINTFORM 　はうぅ…
PRINTFORM 　わたひも、いいですよぉ…	!#!PRINTFORM 　わたひも、いいですよぉ…
PRINTFORM 「おっぱいでむにむにですか？ いいですよ	!#!PRINTFORM 「おっぱいでむにむにですか？ いいですよ
PRINTFORM 「おっぱひっ	!#!PRINTFORM 「おっぱひっ
PRINTFORM 　むにむにされたらけれぇっ	!#!PRINTFORM 　むにむにされたらけれぇっ
PRINTFORM 　しゅぐにぃぃっ	!#!PRINTFORM 　しゅぐにぃぃっ
PRINTFORM 「私の胸で、ですか？ いいですよ	!#!PRINTFORM 「私の胸で、ですか？ いいですよ
PRINTFORM 　わたひも、きもひよくしてくださいね	!#!PRINTFORM 　わたひも、きもひよくしてくださいね
PRINTFORM 　ふあっ	!#!PRINTFORM 　ふあっ
PRINTFORM 　いやなのにっ、かってにうごいてぇぇっ	!#!PRINTFORM 　いやなのにっ、かってにうごいてぇぇっ
PRINTFORM 「これ、やめっ、ひんっ	!#!PRINTFORM 「これ、やめっ、ひんっ
PRINTFORM 　やなのにぃっ	!#!PRINTFORM 　やなのにぃっ
PRINTFORM 　わらひ、かってにぃっ	!#!PRINTFORM 　わらひ、かってにぃっ
PRINTFORM 「…はうぅ	!#!PRINTFORM 「…はうぅ
PRINTFORM 　ふあぁっ	!#!PRINTFORM 　ふあぁっ
PRINTFORM 　い、いじわるれすよぉ	!#!PRINTFORM 　い、いじわるれすよぉ
PRINTFORM 　わらひっ、もういれたいのにぃっ	!#!PRINTFORM 　わらひっ、もういれたいのにぃっ
PRINTFORM 　まららめなんれすかぁっ	!#!PRINTFORM 　まららめなんれすかぁっ
PRINTFORM 　ひゃうぅぅぅんっ	!#!PRINTFORM 　ひゃうぅぅぅんっ
PRINTFORM 「ひゅごい、ひゅごいれしゅぅぅっ	!#!PRINTFORM 「ひゅごい、ひゅごいれしゅぅぅっ
PRINTFORM 　おまんこっ、こすこすしゃれてぇぇっ	!#!PRINTFORM 　おまんこっ、こすこすしゃれてぇぇっ
PRINTFORM 　びゃくれんっ、えっひにぃぃっ	!#!PRINTFORM 　びゃくれんっ、えっひにぃぃっ
PRINTFORM 　も、ぬるぬるれすねぇ	!#!PRINTFORM 　も、ぬるぬるれすねぇ
PRINTFORMDW %CALLNAME:(TARGET)%は触手の上にまたがり、ゆっくりと割れ目を擦り付けている…	!#!PRINTFORMDW %CALLNAME:(TARGET)%は触手の上にまたがり、ゆっくりと割れ目を擦り付けている…
PRINTFORM 「…じゅぶじゅぶひて、ほしいんれすぅっ	!#!PRINTFORM 「…じゅぶじゅぶひて、ほしいんれすぅっ
PRINTFORM 　おねがいひまふっ、いれてくらさぁいっ	!#!PRINTFORM 　おねがいひまふっ、いれてくらさぁいっ
PRINTFORM 　こすれて、きもひいいれすぅっ	!#!PRINTFORM 　こすれて、きもひいいれすぅっ
PRINTFORM 「ふふっ、まら、いれちゃらめれすよぉ	!#!PRINTFORM 「ふふっ、まら、いれちゃらめれすよぉ
PRINTFORM 　クリちゃんこすこすひて、きもひよくなりたいんれすぅっ	!#!PRINTFORM 　クリちゃんこすこすひて、きもひよくなりたいんれすぅっ
PRINTFORM 　わ、わらひがっ	!#!PRINTFORM 　わ、わらひがっ
PRINTFORM 　うごいてるわけじゃないのにぃっ	!#!PRINTFORM 　うごいてるわけじゃないのにぃっ
PRINTFORM 「わら、ひのっ	!#!PRINTFORM 「わら、ひのっ
PRINTFORM 　よわいとこっ	!#!PRINTFORM 　よわいとこっ
PRINTFORM 　ぜんぶぅっ	!#!PRINTFORM 　ぜんぶぅっ
PRINTFORM 「らめっ	!#!PRINTFORM 「らめっ
PRINTFORM 　そこっ	!#!PRINTFORM 　そこっ
PRINTFORM 　らめれしゅぅっ	!#!PRINTFORM 　らめれしゅぅっ
PRINTFORM 「おくっ	!#!PRINTFORM 「おくっ
PRINTFORM 　こつこつされてっ	!#!PRINTFORM 　こつこつされてっ
PRINTFORM 　きもひよくぅっ	!#!PRINTFORM 　きもひよくぅっ
PRINTFORM 　じぇ、じぇんぶはいっちゃいまひたぁっ	!#!PRINTFORM 　じぇ、じぇんぶはいっちゃいまひたぁっ
PRINTFORM 「わ、わらひがうごきまふからぁっ	!#!PRINTFORM 「わ、わらひがうごきまふからぁっ
PRINTFORM 　いっぱいきもひよく、ふあぁぁ	!#!PRINTFORM 　いっぱいきもひよく、ふあぁぁ
PRINTFORMDW %CALLNAME:(TARGET)%は腰をくねらせながら、なまめかしい嬌声を上げ続けている…。	!#!PRINTFORMDW %CALLNAME:(TARGET)%は腰をくねらせながら、なまめかしい嬌声を上げ続けている…。
PRINTFORM 　じゅぼじゅぼっ	!#!PRINTFORM 　じゅぼじゅぼっ
PRINTFORM 　しゅごくてぇぇっ	!#!PRINTFORM 　しゅごくてぇぇっ
PRINTFORM 「しゅぐにっ	!#!PRINTFORM 「しゅぐにっ
PRINTFORM 　にゃんかいもっ	!#!PRINTFORM 　にゃんかいもっ
PRINTFORM 　イっひゃいまひゅぅぅぅっ	!#!PRINTFORM 　イっひゃいまひゅぅぅぅっ
PRINTFORM 「きゃあああんっ	!#!PRINTFORM 「きゃあああんっ
PRINTFORM 　しょっ	!#!PRINTFORM 　しょっ
PRINTFORM 　しょんなぁっ	!#!PRINTFORM 　しょんなぁっ
PRINTFORM 　ずぼずぼっ	!#!PRINTFORM 　ずぼずぼっ
PRINTFORM 　らめ、らめぇぇぇぇっ	!#!PRINTFORM 　らめ、らめぇぇぇぇっ
PRINTFORM 　しゅぐにぃぃぃぃっ	!#!PRINTFORM 　しゅぐにぃぃぃぃっ
PRINTFORM 「…ふあぁぁ…	!#!PRINTFORM 「…ふあぁぁ…
PRINTFORM 　ふといの、わらひのおまんこのなかにぃ	!#!PRINTFORM 　ふといの、わらひのおまんこのなかにぃ
PRINTFORM 　いいれすよ、いっぱいうごいて、きもひよくなってくらさいね	!#!PRINTFORM 　いいれすよ、いっぱいうごいて、きもひよくなってくらさいね
PRINTFORM 　ふああぁぁぁっ	!#!PRINTFORM 　ふああぁぁぁっ
PRINTFORM 「しゅごいぃぃっ	!#!PRINTFORM 「しゅごいぃぃっ
PRINTFORM 　おまんこしゅごいぃぃぃぃ	!#!PRINTFORM 　おまんこしゅごいぃぃぃぃ
PRINTFORM 「んぅ	!#!PRINTFORM 「んぅ
PRINTFORM 　う、うごき、ますねぇ	!#!PRINTFORM 　う、うごき、ますねぇ
PRINTFORM 「ひあぁっ	!#!PRINTFORM 「ひあぁっ
PRINTFORM 　いいれすっ、きもひいいれすぅっ	!#!PRINTFORM 　いいれすっ、きもひいいれすぅっ
PRINTFORM 「が、がまんれきないんれすぅっ	!#!PRINTFORM 「が、がまんれきないんれすぅっ
PRINTFORM 　ひじりのからだ、おすきにおつかいくださぁいっ	!#!PRINTFORM 　ひじりのからだ、おすきにおつかいくださぁいっ
PRINTFORM 「ご主人様、お腹、すいてませんか…	!#!PRINTFORM 「ご主人様、お腹、すいてませんか…
PRINTFORM 「わ、わらひ、もぅ、食べられたくてしかたないんれふぅっ…	!#!PRINTFORM 「わ、わらひ、もぅ、食べられたくてしかたないんれふぅっ…
PRINTFORM 「わ…私…もう…待ち切れないんです……お願いします…ご主人様	!#!PRINTFORM 「わ…私…もう…待ち切れないんです……お願いします…ご主人様
PRINTFORM 　きれっ	!#!PRINTFORM 　きれっ
PRINTFORM 　いっぱいいじめてくらさぁいっ	!#!PRINTFORM 　いっぱいいじめてくらさぁいっ
PRINTFORM 「ご、ご主人様、お情けをください…	!#!PRINTFORM 「ご、ご主人様、お情けをください…
PRINTFORMW 　」	!#!PRINTFORMW 　」
PRINTFORM 「も、もぅわらひ、おかひくなっちゃいそうなんれすぅっ……	!#!PRINTFORM 「も、もぅわらひ、おかひくなっちゃいそうなんれすぅっ……
PRINTFORM 「も、もぉ…	!#!PRINTFORM 「も、もぉ…
PRINTFORM 　あなたなしでは、いられなくなってきてますぅ…	!#!PRINTFORM 　あなたなしでは、いられなくなってきてますぅ…
PRINTFORM 「あ、あなたも頑張っていただけていますから…	!#!PRINTFORM 「あ、あなたも頑張っていただけていますから…
PRINTFORM 「ごほうびに、私の身体、好きにしていいですよ…	!#!PRINTFORM 「ごほうびに、私の身体、好きにしていいですよ…
PRINTFORM 　もう、我慢できませんよぉ…	!#!PRINTFORM 　もう、我慢できませんよぉ…
PRINTFORM 「えっちなひじりの身体、いっぱいいじめてくれませんか…？	!#!PRINTFORM 「えっちなひじりの身体、いっぱいいじめてくれませんか…？
PRINTFORMW 「あ、あの……、して、いただけませんか？」	!#!PRINTFORMW 「あ、あの……、して、いただけませんか？」
PRINTFORM 「あなたとするの、とても気持ち良くて…	!#!PRINTFORM 「あなたとするの、とても気持ち良くて…
PRINTFORMW 「ほ、他の方を生贄に捧げてしまうよりは、私がした方が…」	!#!PRINTFORMW 「ほ、他の方を生贄に捧げてしまうよりは、私がした方が…」
PRINTFORMW 「いいですよ、それが、あなたが共存する為の条件なのならば、私の身体ぐらい…」	!#!PRINTFORMW 「いいですよ、それが、あなたが共存する為の条件なのならば、私の身体ぐらい…」
PRINTFORM 　あなたは、私達と共存したい、そう考えていただいているのですから…	!#!PRINTFORM 　あなたは、私達と共存したい、そう考えていただいているのですから…
PRINTFORM 「いいですよ、遠慮しないで、来てください	!#!PRINTFORM 「いいですよ、遠慮しないで、来てください
PRINTFORM 「ど、どこでも、いいですからぁっ	!#!PRINTFORM 「ど、どこでも、いいですからぁっ
PRINTFORM 　えっちなわたしを、気持ちよくしてくださぁいっ	!#!PRINTFORM 　えっちなわたしを、気持ちよくしてくださぁいっ
PRINTFORM 「ろこれもっ、ろこれもいいれすからぁっ	!#!PRINTFORM 「ろこれもっ、ろこれもいいれすからぁっ
PRINTFORM 　いじめれっ	!#!PRINTFORM 　いじめれっ
PRINTFORM 　きもひよくひてぇぇっ	!#!PRINTFORM 　きもひよくひてぇぇっ
PRINTFORM 　いいですっ、すごいですぅっ	!#!PRINTFORM 　いいですっ、すごいですぅっ
PRINTFORM 「もっといっぱいしてくらさぁいっ	!#!PRINTFORM 「もっといっぱいしてくらさぁいっ
PRINTFORM 「おしりにっ	!#!PRINTFORM 「おしりにっ
PRINTFORM 　ぐぽぐぽ	!#!PRINTFORM 　ぐぽぐぽ
PRINTFORM 　ぐぽぐぽしゅごいぃぃっ	!#!PRINTFORM 　ぐぽぐぽしゅごいぃぃっ
PRINTFORM 「おひりっ、しゅきじゃにゃいのにぃっ	!#!PRINTFORM 「おひりっ、しゅきじゃにゃいのにぃっ
PRINTFORM れも、きもひ、はぁあぁぁんっ	!#!PRINTFORM れも、きもひ、はぁあぁぁんっ
PRINTFORM 　おひりっ	!#!PRINTFORM 　おひりっ
PRINTFORM 　にゅぽにゅぽきひゃいまひたぁぁぁっ	!#!PRINTFORM 　にゅぽにゅぽきひゃいまひたぁぁぁっ
PRINTFORM 　ひっひゃいまひゅぅぅぅっ	!#!PRINTFORM 　ひっひゃいまひゅぅぅぅっ
PRINTFORM 「ぬるんってっ	!#!PRINTFORM 「ぬるんってっ
PRINTFORM 　ぬるんってぇっ	!#!PRINTFORM 　ぬるんってぇっ
PRINTFORM 「おひりにっ	!#!PRINTFORM 「おひりにっ
PRINTFORM 　いっぱいじゅぼじゅぼってぇ	!#!PRINTFORM 　いっぱいじゅぼじゅぼってぇ
PRINTFORM 　じゅぼじゅぼってきてまひゅぅ	!#!PRINTFORM 　じゅぼじゅぼってきてまひゅぅ
PRINTFORM 　しゅぐイきまひゅ、しゅぐにイっひゃいまひゅうぅっ	!#!PRINTFORM 　しゅぐイきまひゅ、しゅぐにイっひゃいまひゅうぅっ
PRINTFORM 「いいれすぅ	!#!PRINTFORM 「いいれすぅ
PRINTFORM 　ちくびこりこりしゅごいれしゅぅ	!#!PRINTFORM 　ちくびこりこりしゅごいれしゅぅ
PRINTFORM 「もっろくにくにひれくらさぁいっ	!#!PRINTFORM 「もっろくにくにひれくらさぁいっ
PRINTFORM 「ふあぁぁぁんっ	!#!PRINTFORM 「ふあぁぁぁんっ
PRINTFORM 　ちくびぃ	!#!PRINTFORM 　ちくびぃ
PRINTFORM ちくびしゅごいれしゅぅ	!#!PRINTFORM ちくびしゅごいれしゅぅ
PRINTFORM 「こしゅこしゅされたりゃ	!#!PRINTFORM 「こしゅこしゅされたりゃ
PRINTFORM 　わらししゅぐにぃ	!#!PRINTFORM 　わらししゅぐにぃ
PRINTFORM 「いいれしゅぅっ	!#!PRINTFORM 「いいれしゅぅっ
PRINTFORM 　おっぱいみるく、いっぱいれひゃいましゅぅぅっ	!#!PRINTFORM 　おっぱいみるく、いっぱいれひゃいましゅぅぅっ
PRINTFORM 「きもひぃぃっ	!#!PRINTFORM 「きもひぃぃっ
PRINTFORM 　おっぱいれなんかいもイっひゃいまひゅよぉぉっ	!#!PRINTFORM 　おっぱいれなんかいもイっひゃいまひゅよぉぉっ
PRINTFORM 「もっろひてくらさぁいっ	!#!PRINTFORM 「もっろひてくらさぁいっ
PRINTFORM 　ミルクいっぱいのわらひのびんかんおっぱい	!#!PRINTFORM 　ミルクいっぱいのわらひのびんかんおっぱい
PRINTFORM 「んあぁぁぁんっ	!#!PRINTFORM 「んあぁぁぁんっ
PRINTFORM 　そうれすっ、すごいれすぅっ	!#!PRINTFORM 　そうれすっ、すごいれすぅっ
PRINTFORM 「あぁあぁぁんっ	!#!PRINTFORM 「あぁあぁぁんっ
PRINTFORM 　わらしの特大おっぱい、もっといっぱいぐにぐにしてくらさぁいっ	!#!PRINTFORM 　わらしの特大おっぱい、もっといっぱいぐにぐにしてくらさぁいっ
PRINTFORM 「ひにゃあぁぁぁっ	!#!PRINTFORM 「ひにゃあぁぁぁっ
PRINTFORM 　きひゃっ、きまひらぁっ	!#!PRINTFORM 　きひゃっ、きまひらぁっ
PRINTFORM 「おっぱいむにむにってしゃれ、～～～～っ	!#!PRINTFORM 「おっぱいむにむにってしゃれ、～～～～っ
PRINTFORM 　いいれすっ、しゅごいれしゅぅっ	!#!PRINTFORM 　いいれすっ、しゅごいれしゅぅっ
PRINTFORM 「んあぁぁんっ	!#!PRINTFORM 「んあぁぁんっ
PRINTFORM 　わらひのえっひなおっぱい、もっろいっぱいひてくださぁいっ	!#!PRINTFORM 　わらひのえっひなおっぱい、もっろいっぱいひてくださぁいっ
PRINTFORM 「ひゃぁっ	!#!PRINTFORM 「ひゃぁっ
PRINTFORM 　私のおっぱいそんなにいいんですか	!#!PRINTFORM 　私のおっぱいそんなにいいんですか
PRINTFORM 「いいですよ、もっといっぱい私のおっぱい無茶苦茶にしてください…	!#!PRINTFORM 「いいですよ、もっといっぱい私のおっぱい無茶苦茶にしてください…
PRINTFORM 「いいれすっ	!#!PRINTFORM 「いいれすっ
PRINTFORM 　おっぱいいいれすぅっ	!#!PRINTFORM 　おっぱいいいれすぅっ
PRINTFORM 「はぁんっ	!#!PRINTFORM 「はぁんっ
PRINTFORM 　おっぱい、きもひいぃれすぅ	!#!PRINTFORM 　おっぱい、きもひいぃれすぅ
PRINTFORM 　おっぱいがすごいんですぅ	!#!PRINTFORM 　おっぱいがすごいんですぅ
PRINTFORM 　もっとしてくらさぁいっ	!#!PRINTFORM 　もっとしてくらさぁいっ
PRINTFORM 「おちんちんっ	!#!PRINTFORM 「おちんちんっ
PRINTFORM 　きらっ	!#!PRINTFORM 　きらっ
PRINTFORM 　きまひたぁっ	!#!PRINTFORM 　きまひたぁっ
PRINTFORM 「れもっ	!#!PRINTFORM 「れもっ
PRINTFORM 　はげひしゅぎましゅよぉぉっ	!#!PRINTFORM 　はげひしゅぎましゅよぉぉっ
PRINTFORM 　おちんちんっ	!#!PRINTFORM 　おちんちんっ
PRINTFORM 　きらぁっ	!#!PRINTFORM 　きらぁっ
PRINTFORM 「れ、れもっ、こんなにちゅよくしたりゃぁぁっ	!#!PRINTFORM 「れ、れもっ、こんなにちゅよくしたりゃぁぁっ
PRINTFORM 　しゅぐに、しゅぐにイっひゃいまひゅぅぅっ	!#!PRINTFORM 　しゅぐに、しゅぐにイっひゃいまひゅぅぅっ
PRINTFORM 　クリひゃんっ	!#!PRINTFORM 　クリひゃんっ
PRINTFORM 　しゅごくれぇぇっ	!#!PRINTFORM 　しゅごくれぇぇっ
PRINTFORM 「しゅごしゅぎれっ	!#!PRINTFORM 「しゅごしゅぎれっ
PRINTFORM 　しゅぐにっ	!#!PRINTFORM 　しゅぐにっ
PRINTFORM 「クリこりこりすごいれしゅぅぅっ	!#!PRINTFORM 「クリこりこりすごいれしゅぅぅっ
PRINTFORM 「ひぃぃぃぃん	!#!PRINTFORM 「ひぃぃぃぃん
PRINTFORM 　たべひゃらめれすよぉっ	!#!PRINTFORM 　たべひゃらめれすよぉっ
PRINTFORM 　わらひ、すぐにイっひゃいましゅからぁぁっ	!#!PRINTFORM 　わらひ、すぐにイっひゃいましゅからぁぁっ
PRINTFORM 「あはあぁぁぁんっ	!#!PRINTFORM 「あはあぁぁぁんっ
PRINTFORM 　クリこすこすしゅごしゅぎましゅぅぅぅっ	!#!PRINTFORM 　クリこすこすしゅごしゅぎましゅぅぅぅっ
PRINTFORM 「こんにゃっ	!#!PRINTFORM 「こんにゃっ
PRINTFORM 　こんにゃしゅごいのっ	!#!PRINTFORM 　こんにゃしゅごいのっ
PRINTFORM 　しゅぐにイっひゃいましゅよぉぉっ	!#!PRINTFORM 　しゅぐにイっひゃいましゅよぉぉっ
PRINTFORM 「あんっ、ああんっ	!#!PRINTFORM 「あんっ、ああんっ
PRINTFORM 　じらさないでくださぁい	!#!PRINTFORM 　じらさないでくださぁい
PRINTFORM 　もっとおくまでずぼずぼしてくれないと、わらひ、おかひくぅ	!#!PRINTFORM 　もっとおくまでずぼずぼしてくれないと、わらひ、おかひくぅ
PRINTFORM 　もっと、もっとおくまでくださぁいっ	!#!PRINTFORM 　もっと、もっとおくまでくださぁいっ
PRINTFORM 　じゅこじゅこ突かれてっ、わらひイきたいんれしゅぅっ	!#!PRINTFORM 　じゅこじゅこ突かれてっ、わらひイきたいんれしゅぅっ
PRINTFORM 「きっ	!#!PRINTFORM 「きっ
PRINTFORM 　きまひたぁぁっ	!#!PRINTFORM 　きまひたぁぁっ
PRINTFORM 　もっろっ、奥まれちゅいて、ひあぁぁっ	!#!PRINTFORM 　もっろっ、奥まれちゅいて、ひあぁぁっ
PRINTFORM 凄いっ	!#!PRINTFORM 凄いっ
PRINTFORM れすぅっ	!#!PRINTFORM れすぅっ
PRINTFORM 　じゅこじゅこちゅかれてっ	!#!PRINTFORM 　じゅこじゅこちゅかれてっ
PRINTFORM 　わらひっ、しゅぐにぃっ	!#!PRINTFORM 　わらひっ、しゅぐにぃっ
PRINTFORM 　わらひのえっちなおまんこ、ぜんびゅうまっちゃいまひたぁっ	!#!PRINTFORM 　わらひのえっちなおまんこ、ぜんびゅうまっちゃいまひたぁっ
PRINTFORM 　あああんっ	!#!PRINTFORM 　あああんっ
PRINTFORM 「もっ	!#!PRINTFORM 「もっ
PRINTFORM 　ちいひゃくっ	!#!PRINTFORM 　ちいひゃくっ
PRINTFORM 　イっへま、～～～～～っ	!#!PRINTFORM 　イっへま、～～～～～っ
PRINTFORM 「んぅ…欲しかったのは…そこじゃ…ないれすよぉ…んんっ	!#!PRINTFORM 「んぅ…欲しかったのは…そこじゃ…ないれすよぉ…んんっ
PRINTFORM 「そこじゃなくて…ん	!#!PRINTFORM 「そこじゃなくて…ん
PRINTFORM 　ひゃぁんっ	!#!PRINTFORM 　ひゃぁんっ
PRINTFORM 　…いいれすよ…、こっちがいいなら、好きにして…	!#!PRINTFORM 　…いいれすよ…、こっちがいいなら、好きにして…
PRINTFORMW 「ひゃんっ、おしりに欲しいって言いましたよねぇ…？」	!#!PRINTFORMW 「ひゃんっ、おしりに欲しいって言いましたよねぇ…？」
PRINTFORMW 「ふあ、おっぱいに、欲しいんれすよぉ…？」	!#!PRINTFORMW 「ふあ、おっぱいに、欲しいんれすよぉ…？」
PRINTFORMW 「んんぅ…おちんちんしこしこして欲しかったのにぃ…」	!#!PRINTFORMW 「んんぅ…おちんちんしこしこして欲しかったのにぃ…」
PRINTFORMW 「んんぅ…クリトリスこりこりして欲しかったんですよぉ…？」	!#!PRINTFORMW 「んんぅ…クリトリスこりこりして欲しかったんですよぉ…？」
PRINTFORMW 「んあぁ…おまんこずぼずぼして欲しかったんですよ…？」	!#!PRINTFORMW 「んあぁ…おまんこずぼずぼして欲しかったんですよ…？」
PRINTFORMW 「んぅぅ…いろいろいじっていいとは言いましたけどぉ…」	!#!PRINTFORMW 「んぅぅ…いろいろいじっていいとは言いましたけどぉ…」
PRINTFORM 「んあああっ	!#!PRINTFORM 「んあああっ
PRINTFORM 　やっぱり…おしりっ	!#!PRINTFORM 　やっぱり…おしりっ
PRINTFORM 　お尻の穴にくださぁいっ	!#!PRINTFORM 　お尻の穴にくださぁいっ
PRINTFORM 「あひぃぃぃんっ	!#!PRINTFORM 「あひぃぃぃんっ
PRINTFORM 　もっろっ、もっろぉっ	!#!PRINTFORM 　もっろっ、もっろぉっ
PRINTFORM 　もっろひてくらさぁいっ	!#!PRINTFORM 　もっろひてくらさぁいっ
PRINTFORM 「おっぱいれいいれすぅっ	!#!PRINTFORM 「おっぱいれいいれすぅっ
PRINTFORM 　もっろいっぱい、ひてくださぁいっ	!#!PRINTFORM 　もっろいっぱい、ひてくださぁいっ
PRINTFORM 「ひああぁあぁっ	!#!PRINTFORM 「ひああぁあぁっ
PRINTFORM 　れ、れもっ	!#!PRINTFORM 　れ、れもっ
PRINTFORM 　おっぱいしゅきれしゅぅっ	!#!PRINTFORM 　おっぱいしゅきれしゅぅっ
PRINTFORM 「おっぱいれいいれすからぁっ	!#!PRINTFORM 「おっぱいれいいれすからぁっ
PRINTFORM 「ひゃああんっ	!#!PRINTFORM 「ひゃああんっ
PRINTFORM 　やっぱり…おっぱいっ	!#!PRINTFORM 　やっぱり…おっぱいっ
PRINTFORM 　おっぱいでいいれすからぁっ	!#!PRINTFORM 　おっぱいでいいれすからぁっ
PRINTFORM 「ふぁぁぁあっっ	!#!PRINTFORM 「ふぁぁぁあっっ
PRINTFORM 　やっぱり…おちんちんっ	!#!PRINTFORM 　やっぱり…おちんちんっ
PRINTFORM 　おちんちんいじられるのすごいれすぅぅっ	!#!PRINTFORM 　おちんちんいじられるのすごいれすぅぅっ
PRINTFORM 「ひゃあぁぁぁんっ	!#!PRINTFORM 「ひゃあぁぁぁんっ
PRINTFORM 　クリっ、クリがすごいれすぅぅっ	!#!PRINTFORM 　クリっ、クリがすごいれすぅぅっ
PRINTFORM 　こっちれ、いいれすからぁっ	!#!PRINTFORM 　こっちれ、いいれすからぁっ
PRINTFORM 　もっろいじめてくらさぁいっ	!#!PRINTFORM 　もっろいじめてくらさぁいっ
PRINTFORM 「ああぁぁんっ	!#!PRINTFORM 「ああぁぁんっ
PRINTFORM 　やっぱり…おまんこっ	!#!PRINTFORM 　やっぱり…おまんこっ
PRINTFORM 　おまんこもっと弄ってくださぁいっ	!#!PRINTFORM 　おまんこもっと弄ってくださぁいっ
PRINTFORM 「そ、そこは、ひああぁぁぁっ	!#!PRINTFORM 「そ、そこは、ひああぁぁぁっ
PRINTFORM 　らっ	!#!PRINTFORM 　らっ
PRINTFORM 　なのにっ	!#!PRINTFORM 　なのにっ
PRINTFORM 「ずぼずぼ	!#!PRINTFORM 「ずぼずぼ
PRINTFORM 　しゅごいれしゅぅぅぅっ	!#!PRINTFORM 　しゅごいれしゅぅぅぅっ
PRINTFORM 「ふあああぁぁぁっ	!#!PRINTFORM 「ふあああぁぁぁっ
PRINTFORM 　おまんこっ	!#!PRINTFORM 　おまんこっ
PRINTFORM 　おまんこじゅぼじゅぼしゅごいれしゅうぅっ	!#!PRINTFORM 　おまんこじゅぼじゅぼしゅごいれしゅうぅっ
PRINTFORM 「お、お尻はやめてくださぁいっ	!#!PRINTFORM 「お、お尻はやめてくださぁいっ
PRINTFORM 　な、なんで、いやな、はずなのにぃっ	!#!PRINTFORM 　な、なんで、いやな、はずなのにぃっ
PRINTFORM 「お尻じゃなく…て……んあぁ…	!#!PRINTFORM 「お尻じゃなく…て……んあぁ…
PRINTFORM 　そっそこ…	!#!PRINTFORM 　そっそこ…
PRINTFORM 　そこはらめれすぅぅっ	!#!PRINTFORM 　そこはらめれすぅぅっ
PRINTFORM 「おっぱいらめぇっ	!#!PRINTFORM 「おっぱいらめぇっ
PRINTFORM 　しゅぐにイっひゃうんれしゅぅっ	!#!PRINTFORM 　しゅぐにイっひゃうんれしゅぅっ
PRINTFORM 「お、おっぱい、はぁっ	!#!PRINTFORM 「お、おっぱい、はぁっ
PRINTFORM 　もみもみされたらっ	!#!PRINTFORM 　もみもみされたらっ
PRINTFORM 　わらひ、しゅぐにぃぃっ	!#!PRINTFORM 　わらひ、しゅぐにぃぃっ
PRINTFORM 「おちんちんはっ	!#!PRINTFORM 「おちんちんはっ
PRINTFORM 　らめなんれすぅっ	!#!PRINTFORM 　らめなんれすぅっ
PRINTFORM 　わらひっ、おとこのひとじゃないれすよぉぉっ	!#!PRINTFORM 　わらひっ、おとこのひとじゃないれすよぉぉっ
PRINTFORM 「違う…そっちじゃ…おちんちん…っ	!#!PRINTFORM 「違う…そっちじゃ…おちんちん…っ
PRINTFORM 　しごいひゃ、あああんっ	!#!PRINTFORM 　しごいひゃ、あああんっ
PRINTFORM 「こすこすらめれすぅぅっ	!#!PRINTFORM 「こすこすらめれすぅぅっ
PRINTFORM 　はぁんっ	!#!PRINTFORM 　はぁんっ
PRINTFORM 　くりくりもっとらめぇっ	!#!PRINTFORM 　くりくりもっとらめぇっ
PRINTFORM 　すぐにっ、すぐにぃぃっ	!#!PRINTFORM 　すぐにっ、すぐにぃぃっ
PRINTFORM 「ク、クリじゃ、なひゃあぁぁん	!#!PRINTFORM 「ク、クリじゃ、なひゃあぁぁん
PRINTFORM 　い、いまっ	!#!PRINTFORM 　い、いまっ
PRINTFORM びんかんしゅぎるの、にぃっ	!#!PRINTFORM びんかんしゅぎるの、にぃっ
PRINTFORM 「…ひゃああん	!#!PRINTFORM 「…ひゃああん
PRINTFORM 　そこじゃ、にゃいれすよぉ…	!#!PRINTFORM 　そこじゃ、にゃいれすよぉ…
PRINTFORM 「それにっ	!#!PRINTFORM 「それにっ
PRINTFORM 　そんにゃに、じらしゃないれくらひゃあいっ	!#!PRINTFORM 　そんにゃに、じらしゃないれくらひゃあいっ
PRINTFORM 「んうぅぅぅっ	!#!PRINTFORM 「んうぅぅぅっ
PRINTFORM 　い、いりぐちれぇっ	!#!PRINTFORM 　い、いりぐちれぇっ
PRINTFORM 「お願いしまひゅっ	!#!PRINTFORM 「お願いしまひゅっ
PRINTFORM 　もっろおくまれずぼずぼひてくらさぁいっ	!#!PRINTFORM 　もっろおくまれずぼずぼひてくらさぁいっ
PRINTFORM 「はああああんっ	!#!PRINTFORM 「はああああんっ
PRINTFORM 「きもひっ	!#!PRINTFORM 「きもひっ
PRINTFORM 　いいれしゅぅっ	!#!PRINTFORM 　いいれしゅぅっ
PRINTFORM 　太いのずぼずぼされてっ	!#!PRINTFORM 　太いのずぼずぼされてっ
PRINTFORM 　わらひっ、しゅぐにぃぃっ	!#!PRINTFORM 　わらひっ、しゅぐにぃぃっ
PRINTFORM 　ら、らめらって言ったにょ、に…	!#!PRINTFORM 　ら、らめらって言ったにょ、に…
PRINTFORM 　れ、れも、しゅごいれしゅぅっ	!#!PRINTFORM 　れ、れも、しゅごいれしゅぅっ
PRINTFORM 「はあんっ	!#!PRINTFORM 「はあんっ
PRINTFORM おくっ	!#!PRINTFORM おくっ
PRINTFORM 　しゅごいんれしゅぅっ	!#!PRINTFORM 　しゅごいんれしゅぅっ
PRINTFORM 「このままっ	!#!PRINTFORM 「このままっ
PRINTFORM 　ちゅいてくらひゃぁいっ	!#!PRINTFORM 　ちゅいてくらひゃぁいっ
PRINTFORM 　いっぱいそそいれ、いいれしゅからぁぁっ	!#!PRINTFORM 　いっぱいそそいれ、いいれしゅからぁぁっ
PRINTFORMW 「ど、どこを触って！？」	!#!PRINTFORMW 「ど、どこを触って！？」
PRINTFORMW 「ひゃんっ！？」	!#!PRINTFORMW 「ひゃんっ！？」
PRINTFORMW 「そ、そんなに焦らなくていいですから…」	!#!PRINTFORMW 「そ、そんなに焦らなくていいですから…」
PRINTFORMW 「ふあっ！？」	!#!PRINTFORMW 「ふあっ！？」
PRINTFORMW 「っくぅ……」	!#!PRINTFORMW 「っくぅ……」
PRINTFORM 「ぁ…ぎゅぅって…	!#!PRINTFORM 「ぁ…ぎゅぅって…
PRINTFORM 　いいれすよぉ	!#!PRINTFORM 　いいれすよぉ
PRINTFORM 　わらひをいっぱいきもひよくひてくらさぁいっ	!#!PRINTFORM 　わらひをいっぱいきもひよくひてくらさぁいっ
PRINTFORM 　こ、このままわたし、何回も…	!#!PRINTFORM 　こ、このままわたし、何回も…
PRINTFORMW 「は、離してください！」	!#!PRINTFORMW 「は、離してください！」
PRINTFORM 「おくにっ、ろくろくってきてまひゅぅぅっ	!#!PRINTFORM 「おくにっ、ろくろくってきてまひゅぅぅっ
PRINTFORM 「あああぁぁんっ	!#!PRINTFORM 「あああぁぁんっ
PRINTFORM ふにゃぁぁぁぁ	!#!PRINTFORM ふにゃぁぁぁぁ
PRINTFORM 「子宮ににゅるにゅるきもひいいれしゅうううぅぅぅっ	!#!PRINTFORM 「子宮ににゅるにゅるきもひいいれしゅうううぅぅぅっ
PRINTFORMW 「な、何か、入って……！」	!#!PRINTFORMW 「な、何か、入って……！」
PRINTFORMW 「うああぁぁぁっ！」	!#!PRINTFORMW 「うああぁぁぁっ！」
PRINTFORM はぁっ	!#!PRINTFORM はぁっ
PRINTFORMW 「当たりませんよ！」	!#!PRINTFORMW 「当たりませんよ！」
PRINTFORM 「い、今脱がされるのは……	!#!PRINTFORM 「い、今脱がされるのは……
PRINTFORMW 「だ、駄目ですよ！」	!#!PRINTFORMW 「だ、駄目ですよ！」
PRINTFORM 「い、今はだめですからぁっ	!#!PRINTFORM 「い、今はだめですからぁっ
PRINTFORMW 「きゃっ！？」	!#!PRINTFORMW 「きゃっ！？」
PRINTFORM 「そ、それは、だめぇ…	!#!PRINTFORM 「そ、それは、だめぇ…
PRINTFORMW 「させません！」	!#!PRINTFORMW 「させません！」
PRINTFORMW 「か、身体が…」	!#!PRINTFORMW 「か、身体が…」
PRINTFORM 「もう服なんていりませんからぁっ	!#!PRINTFORM 「もう服なんていりませんからぁっ
PRINTFORM 「いっぱい、ひじりのえっちな身体で満足してくださぁいっ	!#!PRINTFORM 「いっぱい、ひじりのえっちな身体で満足してくださぁいっ
PRINTFORM 「あ……服が……	!#!PRINTFORM 「あ……服が……
PRINTFORM 「これで、いっぱい、にゅるにゅるって…	!#!PRINTFORM 「これで、いっぱい、にゅるにゅるって…
PRINTFORM 「服が、全部…	!#!PRINTFORM 「服が、全部…
PRINTFORM もう、邪魔な物がないから、このままだと…	!#!PRINTFORM もう、邪魔な物がないから、このままだと…
PRINTFORMW 「う、うぅ…」	!#!PRINTFORMW 「う、うぅ…」
PRINTFORMW 「ぜ、全部脱げて……」	!#!PRINTFORMW 「ぜ、全部脱げて……」
PRINTFORM 「ふ、服が…	!#!PRINTFORM 「ふ、服が…
PRINTFORM 　このままだと、私…	!#!PRINTFORM 　このままだと、私…
PRINTFORM 「きゃぁっ	!#!PRINTFORM 「きゃぁっ
PRINTFORM 「だ、だめですっ！ 服やぶっちゃぁ	!#!PRINTFORM 「だ、だめですっ！ 服やぶっちゃぁ
PRINTFORMW 「くっ、このまま、だと…！」	!#!PRINTFORMW 「くっ、このまま、だと…！」
PRINTFORMW 「こ、こら、乱暴にするのは駄目ですよ！」	!#!PRINTFORMW 「こ、こら、乱暴にするのは駄目ですよ！」
PRINTFORMW 「ふ、服を破らないでください！」	!#!PRINTFORMW 「ふ、服を破らないでください！」
PRINTFORMW 「ふあぅっ！？」	!#!PRINTFORMW 「ふあぅっ！？」
PRINTFORMW 「い、いつの間に！？」	!#!PRINTFORMW 「い、いつの間に！？」
PRINTFORMW 「ん……くぅ……、すぅ……」	!#!PRINTFORMW 「ん……くぅ……、すぅ……」
PRINTFORM 「…ぁ	!#!PRINTFORM 「…ぁ
PRINTFORM 「い、今、こんな触手さんのお相手したら…	!#!PRINTFORM 「い、今、こんな触手さんのお相手したら…
PRINTFORMW 「い、今は駄目……！」	!#!PRINTFORMW 「い、今は駄目……！」
PRINTFORMW 「しま……！」	!#!PRINTFORMW 「しま……！」
PRINTFORMW 「い、今じゃあこんな相手は…！」	!#!PRINTFORMW 「い、今じゃあこんな相手は…！」
PRINTFORMW 「あなたを倒せば全ては終わるのですね……」	!#!PRINTFORMW 「あなたを倒せば全ては終わるのですね……」
PRINTFORMW 「そう、あなたは色欲の権化にして悪徳鬼畜である！」	!#!PRINTFORMW 「そう、あなたは色欲の権化にして悪徳鬼畜である！」
PRINTFORMW 「いざ、南無三―――！」	!#!PRINTFORMW 「いざ、南無三―――！」
PRINTFORMW 「参ります！」	!#!PRINTFORMW 「参ります！」
PRINTFORMW 「さぁ、一気に参りましょう！」	!#!PRINTFORMW 「さぁ、一気に参りましょう！」
PRINTFORMW 「……うそ……、わた、し……？」	!#!PRINTFORMW 「……うそ……、わた、し……？」
PRINTFORMW 「まさか……私の！？」	!#!PRINTFORMW 「まさか……私の！？」
PRINTFORMW 「くっ！ 正気に戻ってください！」	!#!PRINTFORMW 「くっ！ 正気に戻ってください！」
PRINTFORMW 「な、何とか倒せましたが、今は……」	!#!PRINTFORMW 「な、何とか倒せましたが、今は……」
PRINTFORMW 「次っ！」	!#!PRINTFORMW 「次っ！」
PRINTFORMW 「ふぅ……、何とかなるものですね」	!#!PRINTFORMW 「ふぅ……、何とかなるものですね」
PRINTFORMW 「に、逃げ切れ、ましたか……」	!#!PRINTFORMW 「に、逃げ切れ、ましたか……」
PRINTFORM （でも、少しもったいなかったかも…	!#!PRINTFORM （でも、少しもったいなかったかも…
PRINTFORMW 「な、何とか逃げ切れたようですね……」	!#!PRINTFORMW 「な、何とか逃げ切れたようですね……」
PRINTFORMW 「とにかく今は、体勢を立て直さないと……」	!#!PRINTFORMW 「とにかく今は、体勢を立て直さないと……」
PRINTFORMW 「逃げ切れましたか…」	!#!PRINTFORMW 「逃げ切れましたか…」
PRINTFORM 「ほ、他の方がいらっしゃるのにぃっ	!#!PRINTFORM 「ほ、他の方がいらっしゃるのにぃっ
PRINTFORM 「で、でも、指が止められなっ……	!#!PRINTFORM 「で、でも、指が止められなっ……
PRINTFORM 「み、見られてしまう…、でも、でもぉ…	!#!PRINTFORM 「み、見られてしまう…、でも、でもぉ…
PRINTFORM 　ゆるひれぇぇぇぇっ	!#!PRINTFORM 　ゆるひれぇぇぇぇっ
PRINTFORM 「わら	!#!PRINTFORM 「わら
PRINTFORM 　こ、わ	!#!PRINTFORM 　こ、わ
PRINTFORM 「あ゛～～っ	!#!PRINTFORM 「あ゛～～っ
PRINTFORM 　あ゛～～～～っ	!#!PRINTFORM 　あ゛～～～～っ
PRINTFORM 「イっれっ	!#!PRINTFORM 「イっれっ
PRINTFORM 　イっれるのにぃっ	!#!PRINTFORM 　イっれるのにぃっ
PRINTFORM 　まらっ、イきまひゅぅぅぅっ	!#!PRINTFORM 　まらっ、イきまひゅぅぅぅっ
PRINTFORM 「はへぇぇっ	!#!PRINTFORM 「はへぇぇっ
PRINTFORM 　ひにゃあぁぁぁっ	!#!PRINTFORM 　ひにゃあぁぁぁっ
PRINTFORM 　イっへる	!#!PRINTFORM 　イっへる
PRINTFORM 　イっへるからぁぁぁぁっ	!#!PRINTFORM 　イっへるからぁぁぁぁっ
PRINTFORM 　まひゃっ	!#!PRINTFORM 　まひゃっ
PRINTFORM 　ひきまひゅぅぅっ	!#!PRINTFORM 　ひきまひゅぅぅっ
PRINTFORM 「イっへまひゅからぁぁっ	!#!PRINTFORM 「イっへまひゅからぁぁっ
PRINTFORM 　いまぁっ	!#!PRINTFORM 　いまぁっ
PRINTFORM 　うごかにゃいれぇぇっ	!#!PRINTFORM 　うごかにゃいれぇぇっ
PRINTFORM 「イきまひゅぅっ	!#!PRINTFORM 「イきまひゅぅっ
PRINTFORM 　まらっ	!#!PRINTFORM 　まらっ
PRINTFORM 　まらぁぁぁっ	!#!PRINTFORM 　まらぁぁぁっ
PRINTFORM 「きゃひぃぃぃっ	!#!PRINTFORM 「きゃひぃぃぃっ
PRINTFORM 　も	!#!PRINTFORM 　も
PRINTFORM 　イって	!#!PRINTFORM 　イって
PRINTFORM 　まひゅからぁっ	!#!PRINTFORM 　まひゅからぁっ
PRINTFORM 　くぅ	!#!PRINTFORM 　くぅ
PRINTFORM 「わらひぃっ	!#!PRINTFORM 「わらひぃっ
PRINTFORM 　イっへっ	!#!PRINTFORM 　イっへっ
PRINTFORM 　これいじょう、やめへくらさぁいっ	!#!PRINTFORM 　これいじょう、やめへくらさぁいっ
PRINTFORM 「ひ、うぅぅぅぅっ	!#!PRINTFORM 「ひ、うぅぅぅぅっ
PRINTFORM 「あへあぁあぁぁぁ	!#!PRINTFORM 「あへあぁあぁぁぁ
PRINTFORM 「へあぁぁぁっ	!#!PRINTFORM 「へあぁぁぁっ
PRINTFORM 　ふああぁぁぁぁ	!#!PRINTFORM 　ふああぁぁぁぁ
PRINTFORM 「んんんんっ	!#!PRINTFORM 「んんんんっ
PRINTFORM 　っっっぁ	!#!PRINTFORM 　っっっぁ
PRINTFORM 「ああああぁあぁぁぁっ	!#!PRINTFORM 「ああああぁあぁぁぁっ
PRINTFORM 「あ―――……	!#!PRINTFORM 「あ―――……
PRINTFORM 　ふああぁぁあぁぁ	!#!PRINTFORM 　ふああぁぁあぁぁ
PRINTFORM 「は、ひ……	!#!PRINTFORM 「は、ひ……
PRINTFORM 　ひっ、ひぃっ	!#!PRINTFORM 　ひっ、ひぃっ
PRINTFORM 「ぅ……ぁ……	!#!PRINTFORM 「ぅ……ぁ……
PRINTFORM 　～～～～～～～っ	!#!PRINTFORM 　～～～～～～～っ
PRINTFORM 「イっらぁっ	!#!PRINTFORM 「イっらぁっ
PRINTFORM 　イきまひたぁぁっ	!#!PRINTFORM 　イきまひたぁぁっ
PRINTFORM 　ああぁあぁぁぁっ	!#!PRINTFORM 　ああぁあぁぁぁっ
PRINTFORM 「イきまひゅっ	!#!PRINTFORM 「イきまひゅっ
PRINTFORM 「ひああぁぁぁん	!#!PRINTFORM 「ひああぁぁぁん
PRINTFORM 「ふあぁぁぁぁ！ ひあぁあぁぁぁあん	!#!PRINTFORM 「ふあぁぁぁぁ！ ひあぁあぁぁぁあん
PRINTFORM 「ひゅご、ひゅごいの、ひゅごいのきひぇましゅぅぅぅっ	!#!PRINTFORM 「ひゅご、ひゅごいの、ひゅごいのきひぇましゅぅぅぅっ
PRINTFORM 　あんっ	!#!PRINTFORM 　あんっ
PRINTFORM 　あああああんっ	!#!PRINTFORM 　あああああんっ
PRINTFORM 「ま、まひゃっ	!#!PRINTFORM 「ま、まひゃっ
PRINTFORM 　イきますっ	!#!PRINTFORM 　イきますっ
PRINTFORM 　イきましゅぅぅっ	!#!PRINTFORM 　イきましゅぅぅっ
PRINTFORM 　こりぇっ	!#!PRINTFORM 　こりぇっ
PRINTFORM 　これしゅごいぃぃっ	!#!PRINTFORM 　これしゅごいぃぃっ
PRINTFORM 「ま、まらっ	!#!PRINTFORM 「ま、まらっ
PRINTFORM 　イかひゃれぇっ	!#!PRINTFORM 　イかひゃれぇっ
PRINTFORM 「ま、ひゃっ	!#!PRINTFORM 「ま、ひゃっ
PRINTFORM 　も、もうわらひイってまひゅぅぅぅっ	!#!PRINTFORM 　も、もうわらひイってまひゅぅぅぅっ
PRINTFORM 「しゅごいの、しゅごいのきひぇまひゅぅぅぅっ	!#!PRINTFORM 「しゅごいの、しゅごいのきひぇまひゅぅぅぅっ
PRINTFORM 　イきゅぅっ	!#!PRINTFORM 　イきゅぅっ
PRINTFORM 　あ～～～っ	!#!PRINTFORM 　あ～～～っ
PRINTFORM 「これいじょうっ	!#!PRINTFORM 「これいじょうっ
PRINTFORM 　しゃれたらっ	!#!PRINTFORM 　しゃれたらっ
PRINTFORM 　こわれぇぇっ	!#!PRINTFORM 　こわれぇぇっ
PRINTFORM 「れ、れもおぉぉっ	!#!PRINTFORM 「れ、れもおぉぉっ
PRINTFORM イっちゃいまひゅぅぅっ	!#!PRINTFORM イっちゃいまひゅぅぅっ
PRINTFORM 「まらっ	!#!PRINTFORM 「まらっ
PRINTFORM 「きもひいいの	!#!PRINTFORM 「きもひいいの
PRINTFORM 　きひゃいましゅぅぅぅっ	!#!PRINTFORM 　きひゃいましゅぅぅぅっ
PRINTFORM 「あひっ	!#!PRINTFORM 「あひっ
PRINTFORM 　はひゃんっ	!#!PRINTFORM 　はひゃんっ
PRINTFORM 「ふあぁあぁぁっ	!#!PRINTFORM 「ふあぁあぁぁっ
PRINTFORM 　やあぁぁあぁぁんっ	!#!PRINTFORM 　やあぁぁあぁぁんっ
PRINTFORM 「まひゃっ	!#!PRINTFORM 「まひゃっ
PRINTFORM 　らめぇっ	!#!PRINTFORM 　らめぇっ
PRINTFORM 　イきまひゅうぅぅっ	!#!PRINTFORM 　イきまひゅうぅぅっ
PRINTFORM 　ひあっ	!#!PRINTFORM 　ひあっ
PRINTFORM ふにゃああぁぁぁぁん	!#!PRINTFORM ふにゃああぁぁぁぁん
PRINTFORM 「イっひゃっ	!#!PRINTFORM 「イっひゃっ
PRINTFORM 　イきまひゅうっ	!#!PRINTFORM 　イきまひゅうっ
PRINTFORM 　しゅごいのきまひゅぅぅっ	!#!PRINTFORM 　しゅごいのきまひゅぅぅっ
PRINTFORM 「あはぁぁぁっ	!#!PRINTFORM 「あはぁぁぁっ
PRINTFORM 　すごっ	!#!PRINTFORM 　すごっ
PRINTFORM 　イっちゃうぅぅっ	!#!PRINTFORM 　イっちゃうぅぅっ
PRINTFORMW 「ああぁあぁぁぁんっ！！！」	!#!PRINTFORMW 「ああぁあぁぁぁんっ！！！」
PRINTFORM 「イっ、くっ	!#!PRINTFORM 「イっ、くっ
PRINTFORM 　イっちゃい、まひゅうぅぅぅっ	!#!PRINTFORM 　イっちゃい、まひゅうぅぅぅっ
PRINTFORM 「ひあああぁぁぁん	!#!PRINTFORM 「ひあああぁぁぁん
PRINTFORM 　ま、まひゃっ	!#!PRINTFORM 　ま、まひゃっ
PRINTFORM 　まひゃイきまひゅぅぅっ	!#!PRINTFORM 　まひゃイきまひゅぅぅっ
PRINTFORMW 「ん、んん～～～っ！」	!#!PRINTFORMW 「ん、んん～～～っ！」
PRINTFORM 「っぁ…	!#!PRINTFORM 「っぁ…
PRINTFORM 　は…	!#!PRINTFORM 　は…
PRINTFORM 「イっ……イっ、くぅぅぅぅっ	!#!PRINTFORM 「イっ……イっ、くぅぅぅぅっ
PRINTFORM 「ぁ―――	!#!PRINTFORM 「ぁ―――
PRINTFORM 　あぁぁ～～～っ	!#!PRINTFORM 　あぁぁ～～～っ
PRINTFORM 「うあぁぁぁ	!#!PRINTFORM 「うあぁぁぁ
PRINTFORM ……ぇぁぁ	!#!PRINTFORM ……ぇぁぁ
PRINTFORM 「……ひ……	!#!PRINTFORM 「……ひ……
PRINTFORM 　うぅぅ～～～～っ	!#!PRINTFORM 　うぅぅ～～～～っ
PRINTFORM 　くぅっ	!#!PRINTFORM 　くぅっ
PRINTFORM 　―――――っ	!#!PRINTFORM 　―――――っ
PRINTFORM 　っっっっぁ	!#!PRINTFORM 　っっっっぁ
PRINTFORM 「ひああぁあぁぁぁぁっ	!#!PRINTFORM 「ひああぁあぁぁぁぁっ
PRINTFORM 「っあぁあぁぁぁーっ…	!#!PRINTFORM 「っあぁあぁぁぁーっ…
PRINTFORM 「みる、くっ、れっ……	!#!PRINTFORM 「みる、くっ、れっ……
PRINTFORM 「こ、こぼひてまひゅよぉ	!#!PRINTFORM 「こ、こぼひてまひゅよぉ
PRINTFORM 　もっろゆっくりぃ	!#!PRINTFORM 　もっろゆっくりぃ
PRINTFORM 「じゃないと、わらひ、しゅぐにぃぃっ	!#!PRINTFORM 「じゃないと、わらひ、しゅぐにぃぃっ
PRINTFORM 　そ、そんなあせらなくていいですからぁっ	!#!PRINTFORM 　そ、そんなあせらなくていいですからぁっ
PRINTFORM 「そんなはげしくちゅうちゅうすわないれくらさぁいっ	!#!PRINTFORM 「そんなはげしくちゅうちゅうすわないれくらさぁいっ
PRINTFORM 「ま、またっ	!#!PRINTFORM 「ま、またっ
PRINTFORM 　こどもにっ、おっぱいすわれてっ	!#!PRINTFORM 　こどもにっ、おっぱいすわれてっ
PRINTFORM 　わらひっ、イっちゃあぁぁぁっ	!#!PRINTFORM 　わらひっ、イっちゃあぁぁぁっ
PRINTFORM 「あひぃっ	!#!PRINTFORM 「あひぃっ
PRINTFORM 　はひぃっ	!#!PRINTFORM 　はひぃっ
PRINTFORM 「母乳っ、まらっ、でちゃいますぅぅっ	!#!PRINTFORM 「母乳っ、まらっ、でちゃいますぅぅっ
PRINTFORM 「らめれすぅっ	!#!PRINTFORM 「らめれすぅっ
PRINTFORM 　おっぱいみるくびゅーびゅーしちゃいますぅぅっ	!#!PRINTFORM 　おっぱいみるくびゅーびゅーしちゃいますぅぅっ
PRINTFORM 「で、でちゃ……	!#!PRINTFORM 「で、でちゃ……
PRINTFORM 　らめっ、ら―――っ	!#!PRINTFORM 　らめっ、ら―――っ
PRINTFORM 　おっぱいしぼられちゃいますぅっ	!#!PRINTFORM 　おっぱいしぼられちゃいますぅっ
PRINTFORMW 「っ……！ ま、魔理沙さん……！」	!#!PRINTFORMW 「っ……！ ま、魔理沙さん……！」
PRINTFORMW 「くっ…しっかりしてください！」	!#!PRINTFORMW 「くっ…しっかりしてください！」
PRINTFORMW 「こ、こいしさん！？」	!#!PRINTFORMW 「こ、こいしさん！？」
PRINTFORMW 「あなたまで、こんな……」	!#!PRINTFORMW 「あなたまで、こんな……」
PRINTFORMW 「一輪っ！？」	!#!PRINTFORMW 「一輪っ！？」
PRINTFORMW 「そんな……そんな……！」	!#!PRINTFORMW 「そんな……そんな……！」
PRINTFORMW 「っ……ムラサ！？」	!#!PRINTFORMW 「っ……ムラサ！？」
PRINTFORMW 「しっかりして！ 答えてください！」	!#!PRINTFORMW 「しっかりして！ 答えてください！」
PRINTFORMW 「星！？」	!#!PRINTFORMW 「星！？」
PRINTFORMW 「……そ、そんな……あなたまで……」	!#!PRINTFORMW 「……そ、そんな……あなたまで……」
PRINTFORMW 「ぬえっ！？」	!#!PRINTFORMW 「ぬえっ！？」
PRINTFORMW 「しっかりしてください！ そんな…っ！」	!#!PRINTFORMW 「しっかりしてください！ そんな…っ！」
PRINTFORMW 「なっ…響子！？」	!#!PRINTFORMW 「なっ…響子！？」
PRINTFORMW 「しっかりしてください！ またあの元気な声を……！」	!#!PRINTFORMW 「しっかりしてください！ またあの元気な声を……！」
PRINTFORMW 「う……、こ、こんな……」	!#!PRINTFORMW 「う……、こ、こんな……」
PRINTFORMW 「あら、魔理沙さんではありませんか」	!#!PRINTFORMW 「あら、魔理沙さんではありませんか」
PRINTFORMW 「大丈夫ですか？ お怪我は？」	!#!PRINTFORMW 「大丈夫ですか？ お怪我は？」
PRINTFORMW 「あら……こいしさん？」	!#!PRINTFORMW 「あら……こいしさん？」
PRINTFORMW 「ここは無意識で迷い込んでいいような所では…」	!#!PRINTFORMW 「ここは無意識で迷い込んでいいような所では…」
PRINTFORMW 「一輪、あなたも？」	!#!PRINTFORMW 「一輪、あなたも？」
PRINTFORMW 「大丈夫ですか？ 良かった……」	!#!PRINTFORMW 「大丈夫ですか？ 良かった……」
PRINTFORMW 「ムラサ、あなたもここに！？」	!#!PRINTFORMW 「ムラサ、あなたもここに！？」
PRINTFORMW 「大丈夫でしたか？」	!#!PRINTFORMW 「大丈夫でしたか？」
PRINTFORMW 「星！？ あなたまで！？」	!#!PRINTFORMW 「星！？ あなたまで！？」
PRINTFORMW 「でも、良かった、無事で…」	!#!PRINTFORMW 「でも、良かった、無事で…」
PRINTFORMW 「ぬえ！？ あなたも、ここに？」	!#!PRINTFORMW 「ぬえ！？ あなたも、ここに？」
PRINTFORMW 「大丈夫、ですか？」	!#!PRINTFORMW 「大丈夫、ですか？」
PRINTFORMW 「響子……あなたまで……」	!#!PRINTFORMW 「響子……あなたまで……」
PRINTFORMW 「あら…、あなたも、ですか？」	!#!PRINTFORMW 「あら…、あなたも、ですか？」
PRINTFORMW 「……分かりました。魔理沙さんはあちらへ向かうのですね？」	!#!PRINTFORMW 「……分かりました。魔理沙さんはあちらへ向かうのですね？」
PRINTFORMW 「ご無事で…」	!#!PRINTFORMW 「ご無事で…」
PRINTFORMW 「こいしさん、いくらあなたでも、ここは無意識で徘徊出来るような場所ではありませんよ？」	!#!PRINTFORMW 「こいしさん、いくらあなたでも、ここは無意識で徘徊出来るような場所ではありませんよ？」
PRINTFORMW 「お気をつけて…」	!#!PRINTFORMW 「お気をつけて…」
PRINTFORMW 「一輪、出来るだけ気をつけてね？」	!#!PRINTFORMW 「一輪、出来るだけ気をつけてね？」
PRINTFORMW 「ムラサ……。分かりました、ここは確かに別れて探した方がいいようね」	!#!PRINTFORMW 「ムラサ……。分かりました、ここは確かに別れて探した方がいいようね」
PRINTFORMW 「でも、気をつけて…」	!#!PRINTFORMW 「でも、気をつけて…」
PRINTFORMW 「では星、あなたも気をつけて」	!#!PRINTFORMW 「では星、あなたも気をつけて」
PRINTFORMW 「別れて？ ……ぬえ、気をつけてくださいね？」	!#!PRINTFORMW 「別れて？ ……ぬえ、気をつけてくださいね？」
PRINTFORMW 「響子、気をつけて…」	!#!PRINTFORMW 「響子、気をつけて…」
PRINTFORMW 「……では、あなたもご十分にお気をつけて」	!#!PRINTFORMW 「……では、あなたもご十分にお気をつけて」
PRINTFORMW 「う、あ…」	!#!PRINTFORMW 「う、あ…」
PRINTFORMW 「こ、これ、また…」	!#!PRINTFORMW 「こ、これ、また…」
PRINTFORMW 「あ、また、子供が…」	!#!PRINTFORMW 「あ、また、子供が…」
PRINTFORMW 「うぅ…、また、出来てしまうなんて…」	!#!PRINTFORMW 「うぅ…、また、出来てしまうなんて…」
PRINTFORMW 「お、大きくなって…」	!#!PRINTFORMW 「お、大きくなって…」
PRINTFORMW 「うぅ、動きにくく…」	!#!PRINTFORMW 「うぅ、動きにくく…」
PRINTFORMW 「お、大きく、こんなにぃ…」	!#!PRINTFORMW 「お、大きく、こんなにぃ…」
PRINTFORMW 「ま、また赤ちゃん、生まれちゃう…！」	!#!PRINTFORMW 「ま、また赤ちゃん、生まれちゃう…！」
PRINTFORMW 「ま、また、生まれちゃ…」	!#!PRINTFORMW 「ま、また、生まれちゃ…」
PRINTFORMW 「う…、気持ち悪い…」	!#!PRINTFORMW 「う…、気持ち悪い…」
PRINTFORMW 「こ、これ、また…っ！」	!#!PRINTFORMW 「こ、これ、また…っ！」
PRINTFORMW 「これ、まさか…！」	!#!PRINTFORMW 「これ、まさか…！」
PRINTFORMW 「う…」	!#!PRINTFORMW 「う…」
PRINTFORMW 「やっぱり…、また、出来てしまったんですか…」	!#!PRINTFORMW 「やっぱり…、また、出来てしまったんですか…」
PRINTFORMW 「うそ…これって…！」	!#!PRINTFORMW 「うそ…これって…！」
PRINTFORMW 「う…、この感じ、まさか、また…」	!#!PRINTFORMW 「う…、この感じ、まさか、また…」
PRINTFORMW 「……大丈夫です。少し気分が悪いだけですので…」	!#!PRINTFORMW 「……大丈夫です。少し気分が悪いだけですので…」
PRINTFORMW 「……何だか、身体が重い…？」	!#!PRINTFORMW 「……何だか、身体が重い…？」
PRINTFORMW 「こ、これ……。また、私に……。	!#!PRINTFORMW 「こ、これ……。また、私に……。
PRINTFORM 　れひゃうぅぅっ	!#!PRINTFORM 　れひゃうぅぅっ
PRINTFORM 　またっ	!#!PRINTFORM 　またっ
PRINTFORM 　れちゃうぅぅぅっ	!#!PRINTFORM 　れちゃうぅぅぅっ
PRINTFORM 「ま、またぁぁぁっ	!#!PRINTFORM 「ま、またぁぁぁっ
PRINTFORM 「らめぇぇぇっ	!#!PRINTFORM 「らめぇぇぇっ
PRINTFORM 　またぁっ	!#!PRINTFORM 　またぁっ
PRINTFORM 　うみにゃがらっ	!#!PRINTFORM 　うみにゃがらっ
PRINTFORM 　イきまひゅぅぅぅっ	!#!PRINTFORM 　イきまひゅぅぅぅっ
PRINTFORM 「やめへぇぇぇぇぇっ	!#!PRINTFORM 「やめへぇぇぇぇぇっ
PRINTFORM 　おっぱいちゅーちゅーらめれしゅぅぅぅっ	!#!PRINTFORM 　おっぱいちゅーちゅーらめれしゅぅぅぅっ
PRINTFORM 「おっぱひっ、すわれてっ、のまれてぇっ	!#!PRINTFORM 「おっぱひっ、すわれてっ、のまれてぇっ
PRINTFORM 　もぅっ……～～～～～	!#!PRINTFORM 　もぅっ……～～～～～
PRINTFORM 「もっ、ひゃめぇぇぇっ	!#!PRINTFORM 「もっ、ひゃめぇぇぇっ
PRINTFORM 　しゅわにゃいれくらひゃぁいっ	!#!PRINTFORM 　しゅわにゃいれくらひゃぁいっ
PRINTFORM 「わ、ら	!#!PRINTFORM 「わ、ら
PRINTFORM 　イくっ、イきまふぅぅぅっ	!#!PRINTFORM 　イくっ、イきまふぅぅぅっ
PRINTFORM 「……ぁ	!#!PRINTFORM 「……ぁ
PRINTFORM 「わ、わらひ……	!#!PRINTFORM 「わ、わらひ……
PRINTFORM 　まら、あかちゃんうんれ、イっひゃいまひたぁ……	!#!PRINTFORM 　まら、あかちゃんうんれ、イっひゃいまひたぁ……
PRINTFORMW 「っぎ……！ な、なにか、で……！」	!#!PRINTFORMW 「っぎ……！ な、なにか、で……！」
PRINTFORM 「ひぎっ！？ ひあっ	!#!PRINTFORM 「ひぎっ！？ ひあっ
PRINTFORM 　にゃん、れっ	!#!PRINTFORM 　にゃん、れっ
PRINTFORM 　いたひのぉ、にぃぃっ	!#!PRINTFORM 　いたひのぉ、にぃぃっ
PRINTFORM 「こ、こんな、吸っちゃ…ひっ！？ にゃっ	!#!PRINTFORM 「こ、こんな、吸っちゃ…ひっ！？ にゃっ
PRINTFORM 　にゃにっ	!#!PRINTFORM 　にゃにっ
PRINTFORM 　にゃにかれてぇぇっ	!#!PRINTFORM 　にゃにかれてぇぇっ
PRINTFORM 　いますっちゃ	!#!PRINTFORM 　いますっちゃ
PRINTFORM 　おっぱ……っ	!#!PRINTFORM 　おっぱ……っ
PRINTFORM 　～～～～～～っ	!#!PRINTFORM 　～～～～～～っ
PRINTFORM 「っぁ……	!#!PRINTFORM 「っぁ……
PRINTFORM 　は……	!#!PRINTFORM 　は……
PRINTFORM 　こ、こんにゃ	!#!PRINTFORM 　こ、こんにゃ
PRINTFORM 　ころも、うんれ……わらひぃ……	!#!PRINTFORM 　ころも、うんれ……わらひぃ……
PRINTFORM 「う、うまれまひゅぅぅっ	!#!PRINTFORM 「う、うまれまひゅぅぅっ
PRINTFORM 　とろとろおまんこがっ	!#!PRINTFORM 　とろとろおまんこがっ
PRINTFORM 　こどもうんでイっちゃいまひゅぅぅっ	!#!PRINTFORM 　こどもうんでイっちゃいまひゅぅぅっ
PRINTFORM 　うまれっ	!#!PRINTFORM 　うまれっ
PRINTFORM 　まらっ、れひゃいましゅぅぅっ	!#!PRINTFORM 　まらっ、れひゃいましゅぅぅっ
PRINTFORM 　れ、ひゃ	!#!PRINTFORM 　れ、ひゃ
PRINTFORM 　こどもうんれっ	!#!PRINTFORM 　こどもうんれっ
PRINTFORM 「おっぱひぃっ	!#!PRINTFORM 「おっぱひぃっ
PRINTFORM 　おっぱいちゅうちゅうしゅごいれひゅぅっ	!#!PRINTFORM 　おっぱいちゅうちゅうしゅごいれひゅぅっ
PRINTFORM 　ころもにおっぱい吸われてっ	!#!PRINTFORM 　ころもにおっぱい吸われてっ
PRINTFORM 　イきゅっ	!#!PRINTFORM 　イきゅっ
PRINTFORM 「そ、そんなに慌てなくても逃げませんからぁっ	!#!PRINTFORM 「そ、そんなに慌てなくても逃げませんからぁっ
PRINTFORM 「らから、ゆっくりぃ	!#!PRINTFORM 「らから、ゆっくりぃ
PRINTFORM 　まらっ、イっひゃいまひゅぅっ	!#!PRINTFORM 　まらっ、イっひゃいまひゅぅっ
PRINTFORM 　ちゅーちゅーはっ	!#!PRINTFORM 　ちゅーちゅーはっ
PRINTFORM 　ちゅーちゅーしちゃらめれしゅよぉぉっ	!#!PRINTFORM 　ちゅーちゅーしちゃらめれしゅよぉぉっ
PRINTFORM 「っは……ひ……	!#!PRINTFORM 「っは……ひ……
PRINTFORMW 　もう、行っひゃうんれすかぁ…？」	!#!PRINTFORMW 　もう、行っひゃうんれすかぁ…？」
PRINTFORMW 「い…ぎっ……！」	!#!PRINTFORMW 「い…ぎっ……！」
PRINTFORMW 「で、でちゃい、生まれちゃう……！」	!#!PRINTFORMW 「で、でちゃい、生まれちゃう……！」
PRINTFORM 「ひっ！？	!#!PRINTFORM 「ひっ！？
PRINTFORM 　ど、どうしれっ	!#!PRINTFORM 　ど、どうしれっ
PRINTFORM 　ころも、うみながらっ、わら、ひぃぃっ	!#!PRINTFORM 　ころも、うみながらっ、わら、ひぃぃっ
PRINTFORM 　おっぱいごくごくのまないれくらさぁぁいっ	!#!PRINTFORM 　おっぱいごくごくのまないれくらさぁぁいっ
PRINTFORM 「っはーっ	!#!PRINTFORM 「っはーっ
PRINTFORMDW %CALLNAME:(TARGET)%が度重なる絶頂に忘我の境地にある間に、子は去って行った…。	!#!PRINTFORMDW %CALLNAME:(TARGET)%が度重なる絶頂に忘我の境地にある間に、子は去って行った…。
PRINTFORMW 「も、もう、限界……」	!#!PRINTFORMW 「も、もう、限界……」
PRINTFORMW 「……っふわ……」	!#!PRINTFORMW 「……っふわ……」
PRINTFORMW 「そろそろ、休まないと、持たないわね……」	!#!PRINTFORMW 「そろそろ、休まないと、持たないわね……」
PRINTFORMW 「休むときは、しっかりと寝ておかないと…ふわ…」	!#!PRINTFORMW 「休むときは、しっかりと寝ておかないと…ふわ…」
PRINTFORMW 「そろそろ、眠っておかないと……」	!#!PRINTFORMW 「そろそろ、眠っておかないと……」
PRINTFORMW 「休める時に休んでおかないと、いけませんよね…」	!#!PRINTFORMW 「休める時に休んでおかないと、いけませんよね…」
PRINTFORM 「い、いま、来られたら、だめぇ…	!#!PRINTFORM 「い、いま、来られたら、だめぇ…
PRINTFORM 「あ、安全なばしょが、ないとぉ…	!#!PRINTFORM 「あ、安全なばしょが、ないとぉ…
PRINTFORMW 「は、早く眠れる場所を、ふあ……」	!#!PRINTFORMW 「は、早く眠れる場所を、ふあ……」
PRINTFORMW 「く……、身体を、休める場所を…」	!#!PRINTFORMW 「く……、身体を、休める場所を…」
PRINTFORMW 「ここは、少しでも安全な場所を作らないと、いけませんね…」	!#!PRINTFORMW 「ここは、少しでも安全な場所を作らないと、いけませんね…」
PRINTFORMW 「去りなさい、邪な気よ！」	!#!PRINTFORMW 「去りなさい、邪な気よ！」
PRINTFORMW 「ふぅ……。法力が効いてくれて、助かりました…」	!#!PRINTFORMW 「ふぅ……。法力が効いてくれて、助かりました…」
PRINTFORMW 「……うん、こんなもの、ですね」	!#!PRINTFORMW 「……うん、こんなもの、ですね」
PRINTFORMW 「や、休める場所を、はやく…」	!#!PRINTFORMW 「や、休める場所を、はやく…」
PRINTFORMW 「休まないと、早くみつけなきゃ…」	!#!PRINTFORMW 「休まないと、早くみつけなきゃ…」
PRINTFORMW 「魔理沙さん、もう少し負担をかけさせてしまうかも知れません…」	!#!PRINTFORMW 「魔理沙さん、もう少し負担をかけさせてしまうかも知れません…」
PRINTFORMW 「こいしさん、ごめんなさい……」	!#!PRINTFORMW 「こいしさん、ごめんなさい……」
PRINTFORMW 「信者さんに、負担をかけてしまいますね…」	!#!PRINTFORMW 「信者さんに、負担をかけてしまいますね…」
PRINTFORMW 「一輪、もう少し頑張ってもらえる？ ごめんなさいね…」	!#!PRINTFORMW 「一輪、もう少し頑張ってもらえる？ ごめんなさいね…」
PRINTFORMW 「村紗、ごめんなさい。少し無理をさせちゃうわね…」	!#!PRINTFORMW 「村紗、ごめんなさい。少し無理をさせちゃうわね…」
PRINTFORMW 「ごめんなさい、星……」	!#!PRINTFORMW 「ごめんなさい、星……」
PRINTFORMW 「早く、休まないといけないの。少し無理をさせちゃうわね…」	!#!PRINTFORMW 「早く、休まないといけないの。少し無理をさせちゃうわね…」
PRINTFORMW 「ごめんなさいね、ぬえ」	!#!PRINTFORMW 「ごめんなさいね、ぬえ」
PRINTFORMW 「少し、あなたに無理をさせるかも……」	!#!PRINTFORMW 「少し、あなたに無理をさせるかも……」
PRINTFORMW 「ごめんなさい、響子……」	!#!PRINTFORMW 「ごめんなさい、響子……」
PRINTFORMW 「本当は、私が守らなきゃいけないのに…」	!#!PRINTFORMW 「本当は、私が守らなきゃいけないのに…」
PRINTFORMW 「申し訳ありません、ご負担をおかけするかと思います……」	!#!PRINTFORMW 「申し訳ありません、ご負担をおかけするかと思います……」
PRINTFORMW 「急いで、休める場所を…！」	!#!PRINTFORMW 「急いで、休める場所を…！」
PRINTFORMW 「眠い、ですけど……、ここで眠ったら危ないわよね…」	!#!PRINTFORMW 「眠い、ですけど……、ここで眠ったら危ないわよね…」
PRINTFORMW 「早く安全な場所を見つけないと…！」	!#!PRINTFORMW 「早く安全な場所を見つけないと…！」
PRINTFORMW 「急いで、この異変の首謀者の居場所を突き止めないと…！」	!#!PRINTFORMW 「急いで、この異変の首謀者の居場所を突き止めないと…！」
PRINTFORMW 「ふぁ……はぁ……」	!#!PRINTFORMW 「ふぁ……はぁ……」
PRINTFORMW 「い、今敵に会ったら、いけない…」	!#!PRINTFORMW 「い、今敵に会ったら、いけない…」
PRINTFORM 「いま、みつかちゃったら…	!#!PRINTFORM 「いま、みつかちゃったら…
PRINTFORMW 「い、今の状況じゃ、戦えない…」	!#!PRINTFORMW 「い、今の状況じゃ、戦えない…」
PRINTFORMW 「今は、敵に見付かっては…」	!#!PRINTFORMW 「今は、敵に見付かっては…」
PRINTFORMW 「休める場所を見つけないと…、慎重に…」	!#!PRINTFORMW 「休める場所を見つけないと…、慎重に…」
PRINTFORMW 「落ち着いて、奇襲があるかも…」	!#!PRINTFORMW 「落ち着いて、奇襲があるかも…」
PRINTFORMW 「こう言う時こそ落ち着いて行動しないといけませんね」	!#!PRINTFORMW 「こう言う時こそ落ち着いて行動しないといけませんね」
PRINTFORM 「い、今来られたら、でも…	!#!PRINTFORM 「い、今来られたら、でも…
PRINTFORMW 「ま、待ち伏せすれば、何とか…？」	!#!PRINTFORMW 「ま、待ち伏せすれば、何とか…？」
PRINTFORMW 「今は動けませんね…」	!#!PRINTFORMW 「今は動けませんね…」
PRINTFORMW 「奇襲で、一撃で決めないと…」	!#!PRINTFORMW 「奇襲で、一撃で決めないと…」
PRINTFORMW 「く…、今は、動けない…」	!#!PRINTFORMW 「く…、今は、動けない…」
PRINTFORMW 「う、眠気が…」	!#!PRINTFORMW 「う、眠気が…」
PRINTFORMW 「さぁ、いつでも来なさい」	!#!PRINTFORMW 「さぁ、いつでも来なさい」
PRINTFORMW 「他にいるかも知れない被害者の方の為にも、少しでも効率的に多く倒さないと…！」	!#!PRINTFORMW 「他にいるかも知れない被害者の方の為にも、少しでも効率的に多く倒さないと…！」
PRINTFORMW 「な、なにか、有用なアイテムを、見つけないと…」	!#!PRINTFORMW 「な、なにか、有用なアイテムを、見つけないと…」
PRINTFORMW 「何とか、この状況を打開しないと…」	!#!PRINTFORMW 「何とか、この状況を打開しないと…」
PRINTFORMW 「く、疲れてはいますが、今は何か見つけなければ…」	!#!PRINTFORMW 「く、疲れてはいますが、今は何か見つけなければ…」
PRINTFORMW 「っく、はぁ、はぁ…」	!#!PRINTFORMW 「っく、はぁ、はぁ…」
PRINTFORMDW 体力をかなり消耗しているのか、%CALLNAME:(TARGET)%は肩で息をしながら探索をしている…。	!#!PRINTFORMDW 体力をかなり消耗しているのか、%CALLNAME:(TARGET)%は肩で息をしながら探索をしている…。
PRINTFORMW 「な、何とか安全な休息場所を…」	!#!PRINTFORMW 「な、何とか安全な休息場所を…」
PRINTFORMW 「何か見付かればいいのですけど…」	!#!PRINTFORMW 「何か見付かればいいのですけど…」
PRINTFORMW 「他に、被害者の方が見付かれば…」	!#!PRINTFORMW 「他に、被害者の方が見付かれば…」
PRINTFORM 「っは、はふ	!#!PRINTFORM 「っは、はふ
PRINTFORMW 　す、少しでも身体休めないと…」	!#!PRINTFORMW 　す、少しでも身体休めないと…」
PRINTFORMW 「くすっ……一緒に入りますか？」	!#!PRINTFORMW 「くすっ……一緒に入りますか？」
PRINTFORMW 「大丈夫ですか？ みなさん…」	!#!PRINTFORMW 「大丈夫ですか？ みなさん…」
PRINTFORMW 「今は、少しでも身体を休めて…」	!#!PRINTFORMW 「今は、少しでも身体を休めて…」
PRINTFORMW 「今は、休みましょう」	!#!PRINTFORMW 「今は、休みましょう」
PRINTFORMW 「お風呂も入りませんとね」	!#!PRINTFORMW 「お風呂も入りませんとね」
PRINTFORMW 　	!#!PRINTFORMW 　
PRINTFORMW 「……はふ」	!#!PRINTFORMW 「……はふ」
PRINTFORMW 「何だか、気分が楽に……」	!#!PRINTFORMW 「何だか、気分が楽に……」
PRINTFORMW 「……ふぅ」	!#!PRINTFORMW 「……ふぅ」
PRINTFORMW 「何だか、すっきりしたわね」	!#!PRINTFORMW 「何だか、すっきりしたわね」
PRINTFORM 「……い、今何かの罠にかかったら…	!#!PRINTFORM 「……い、今何かの罠にかかったら…
PRINTFORMW 「……ん、ふぅ……」	!#!PRINTFORMW 「……ん、ふぅ……」
PRINTFORMW 「なんだか急に、身体が凄く楽になりましたね…」	!#!PRINTFORMW 「なんだか急に、身体が凄く楽になりましたね…」
PRINTFORMW 「……ぁ、ふぁ……」	!#!PRINTFORMW 「……ぁ、ふぁ……」
PRINTFORMW 「い、今眠っちゃったら、だめなの、に…」	!#!PRINTFORMW 「い、今眠っちゃったら、だめなの、に…」
PRINTFORM 「ひふっ	!#!PRINTFORM 「ひふっ
PRINTFORM 　いっ	!#!PRINTFORM 　いっ
PRINTFORM 　ずぼずぼされたらっ	!#!PRINTFORM 　ずぼずぼされたらっ
PRINTFORM 「でっ	!#!PRINTFORM 「でっ
PRINTFORM 　でもっ	!#!PRINTFORM 　でもっ
PRINTFORM 　わらひっ、ほしくなってぇっ	!#!PRINTFORM 　わらひっ、ほしくなってぇっ
PRINTFORMW 「あ…、身体が、軽く……」	!#!PRINTFORMW 「あ…、身体が、軽く……」
PRINTFORMW 「これなら、もう少し…」	!#!PRINTFORMW 「これなら、もう少し…」
PRINTFORM 　にゃかにぃっ	!#!PRINTFORM 　にゃかにぃっ
PRINTFORM 　にゅるにゅる、はいっれぇっ	!#!PRINTFORM 　にゅるにゅる、はいっれぇっ
PRINTFORMW 「い、いま、罠だったら…」	!#!PRINTFORMW 「い、いま、罠だったら…」
PRINTFORMW 「こ、これ、凄い…！」	!#!PRINTFORMW 「こ、これ、凄い…！」
PRINTFORMW 「どれほど霊験がある、霊泉だったのでしょうか…？」	!#!PRINTFORMW 「どれほど霊験がある、霊泉だったのでしょうか…？」
PRINTFORMW 「ふぅ……身体が、楽になりましたね…」	!#!PRINTFORMW 「ふぅ……身体が、楽になりましたね…」
PRINTFORMW 「今、罠だったら…」	!#!PRINTFORMW 「今、罠だったら…」
PRINTFORM 「ふ、服だけじゃなくて…	!#!PRINTFORM 「ふ、服だけじゃなくて…
PRINTFORM 　身体、ぬるぬるってして、気持ち良くして欲しかったの、に…	!#!PRINTFORM 　身体、ぬるぬるってして、気持ち良くして欲しかったの、に…
PRINTFORM 「ぁ……ぅ…	!#!PRINTFORM 「ぁ……ぅ…
PRINTFORM 「こ、このままじゃ、また……	!#!PRINTFORM 「こ、このままじゃ、また……
PRINTFORM 　わらひっ、きもひよくぅ…	!#!PRINTFORM 　わらひっ、きもひよくぅ…
PRINTFORMW 「あ、危なかった……」	!#!PRINTFORMW 「あ、危なかった……」
PRINTFORMW 「今、脱がされちゃったら…」	!#!PRINTFORMW 「今、脱がされちゃったら…」
PRINTFORMW 「きゃあぁっ！？ あ、これ…」	!#!PRINTFORMW 「きゃあぁっ！？ あ、これ…」
PRINTFORM 「ひあっ	!#!PRINTFORM 「ひあっ
PRINTFORM 　じぇんしんっ	!#!PRINTFORM 　じぇんしんっ
PRINTFORMW 「きゃぁぁぁっ！？」	!#!PRINTFORMW 「きゃぁぁぁっ！？」
PRINTFORM 　くちゅくちゅ	!#!PRINTFORM 　くちゅくちゅ
PRINTFORM 「い、いま、つかまっちゃったら…	!#!PRINTFORM 「い、いま、つかまっちゃったら…
PRINTFORM （で、でも、つかまって、ぜんしんくちゅくちゅされても…	!#!PRINTFORM （で、でも、つかまって、ぜんしんくちゅくちゅされても…
PRINTFORMW 「ご、ごめんなさい……今、捕まっちゃったら…！」	!#!PRINTFORMW 「ご、ごめんなさい……今、捕まっちゃったら…！」
PRINTFORMW 「きゃんっ！！？」	!#!PRINTFORMW 「きゃんっ！！？」
PRINTFORM 「ま、また、すごいの、きちゃ…	!#!PRINTFORM 「ま、また、すごいの、きちゃ…
PRINTFORM 　あへあぁぁぁっ	!#!PRINTFORM 　あへあぁぁぁっ
PRINTFORM 　しゅごいよぉぉっ	!#!PRINTFORM 　しゅごいよぉぉっ
PRINTFORM 　もっろしゅごいのっ	!#!PRINTFORM 　もっろしゅごいのっ
PRINTFORM 　してくらひゃぁいっ	!#!PRINTFORM 　してくらひゃぁいっ
PRINTFORM 　こ、これ、わたし、また…	!#!PRINTFORM 　こ、これ、わたし、また…
PRINTFORM 　きひゃぁっ	!#!PRINTFORM 　きひゃぁっ
PRINTFORM 　きもひいいのっ	!#!PRINTFORM 　きもひいいのっ
PRINTFORM 　いっぱいイかひぇれくらさぁいっ	!#!PRINTFORM 　いっぱいイかひぇれくらさぁいっ
PRINTFORM 「ふえっ	!#!PRINTFORM 「ふえっ
PRINTFORM 　かっ	!#!PRINTFORM 　かっ
PRINTFORM 　にゅるにゅるっへぇ	!#!PRINTFORM 　にゅるにゅるっへぇ
PRINTFORM 　れっ	!#!PRINTFORM 　れっ
PRINTFORM 　らめれしゅぅぅぅっ	!#!PRINTFORM 　らめれしゅぅぅぅっ
PRINTFORMW 「あ、危なかった……！」	!#!PRINTFORMW 「あ、危なかった……！」
PRINTFORM 「い、今、捕まっちゃったら、ぐちゃぐちゃに…	!#!PRINTFORM 「い、今、捕まっちゃったら、ぐちゃぐちゃに…
PRINTFORM 「かっ	!#!PRINTFORM 「かっ
PRINTFORM 　身体、がぁっ	!#!PRINTFORM 　身体、がぁっ
PRINTFORM 　あちゅく、てぇっ	!#!PRINTFORM 　あちゅく、てぇっ
PRINTFORM 　れきないよぉぉっ	!#!PRINTFORM 　れきないよぉぉっ
PRINTFORM 　ふあぁ	!#!PRINTFORM 　ふあぁ
PRINTFORM 　ほてってぇ	!#!PRINTFORM 　ほてってぇ
PRINTFORMW 「い、今吸ったら駄目！」 	!#!PRINTFORMW 「い、今吸ったら駄目！」 
PRINTFORMW 「ごめんなさい、使わせてもらいますね…」	!#!PRINTFORMW 「ごめんなさい、使わせてもらいますね…」
PRINTFORMW 「でないと、私、もう…」	!#!PRINTFORMW 「でないと、私、もう…」
PRINTFORMW 「罠だったら、私もう、逃げられ…」	!#!PRINTFORMW 「罠だったら、私もう、逃げられ…」
PRINTFORMW 「も、もしも罠だったら……」	!#!PRINTFORMW 「も、もしも罠だったら……」
PRINTFORM 　はふぅぅぅっ	!#!PRINTFORM 　はふぅぅぅっ
PRINTFORM 　おしり…きもひよく、れぇ…	!#!PRINTFORM 　おしり…きもひよく、れぇ…
PRINTFORM 「あ、ぁ…	!#!PRINTFORM 「あ、ぁ…
PRINTFORM 　わらひの、えっひなおっぱいがぁぁっ	!#!PRINTFORM 　わらひの、えっひなおっぱいがぁぁっ
PRINTFORM 　もっろえっひに、されちゃいまひたぁぁっ	!#!PRINTFORM 　もっろえっひに、されちゃいまひたぁぁっ
PRINTFORM 「ぅぅ……	!#!PRINTFORM 「ぅぅ……
PRINTFORM 　おちんちんが……これ…下着、履けなくなっちゃいそうです…	!#!PRINTFORM 　おちんちんが……これ…下着、履けなくなっちゃいそうです…
PRINTFORM 　クリトリスが……これ…下着、履けなくなっちゃいそうです…	!#!PRINTFORM 　クリトリスが……これ…下着、履けなくなっちゃいそうです…
PRINTFORM 「ぁぁ…	!#!PRINTFORM 「ぁぁ…
PRINTFORM 　こ、こんなの…	!#!PRINTFORM 　こ、こんなの…
PRINTFORM 　ずっとハメられっぱなしにして欲しくなっちゃいますよぉ…	!#!PRINTFORM 　ずっとハメられっぱなしにして欲しくなっちゃいますよぉ…
PRINTFORM 「ご、ごめんなさい	!#!PRINTFORM 「ご、ごめんなさい
PRINTFORM 　い、今は……壊れちゃいそうです、から…	!#!PRINTFORM 　い、今は……壊れちゃいそうです、から…
PRINTFORM 「おひりっ、らめれしゅぅぅっ	!#!PRINTFORM 「おひりっ、らめれしゅぅぅっ
PRINTFORM 「らめなのにっ、らめなのにぃっ	!#!PRINTFORM 「らめなのにっ、らめなのにぃっ
PRINTFORM 　おひりがっ、ろんろんえっひになっひゃうよぉぉっ	!#!PRINTFORM 　おひりがっ、ろんろんえっひになっひゃうよぉぉっ
PRINTFORM 「ひっ……	!#!PRINTFORM 「ひっ……
PRINTFORM 　イきまひたっ	!#!PRINTFORM 　イきまひたっ
PRINTFORM 　イきまひたからぁっ	!#!PRINTFORM 　イきまひたからぁっ
PRINTFORM 「もうみるくしゅわにゃいれっ	!#!PRINTFORM 「もうみるくしゅわにゃいれっ
PRINTFORM 　イきっぱにゃひにゃんれすぅぅぅっ	!#!PRINTFORM 　イきっぱにゃひにゃんれすぅぅぅっ
PRINTFORM 　らめれすよぉぉっ	!#!PRINTFORM 　らめれすよぉぉっ
PRINTFORM 「えっひなおっぱいみるく、ちゅるちゅるらめぇぇぇ	!#!PRINTFORM 「えっひなおっぱいみるく、ちゅるちゅるらめぇぇぇ
PRINTFORM 「むにむにいやぁ	!#!PRINTFORM 「むにむにいやぁ
PRINTFORM 　わらひのおっぱいが、えっひにとろけさせられへぇぇっ	!#!PRINTFORM 　わらひのおっぱいが、えっひにとろけさせられへぇぇっ
PRINTFORM 「あひんっ	!#!PRINTFORM 「あひんっ
PRINTFORM 　ひぅぅぅぅっ	!#!PRINTFORM 　ひぅぅぅぅっ
PRINTFORM 　もぅっ	!#!PRINTFORM 　もぅっ
PRINTFORM 　たっへっ	!#!PRINTFORM 　たっへっ
PRINTFORM 　られ、な…	!#!PRINTFORM 　られ、な…
PRINTFORMDW クリトリスを刺激する触手達に屈し、%CALLNAME:(TARGET)%はその場に膝を付く。	!#!PRINTFORMDW クリトリスを刺激する触手達に屈し、%CALLNAME:(TARGET)%はその場に膝を付く。
PRINTFORMDW すると、さらにクリトリスを責める触手が増え、%CALLNAME:(TARGET)%は腰をかくかく振って抵抗するのが精一杯になっている…。	!#!PRINTFORMDW すると、さらにクリトリスを責める触手が増え、%CALLNAME:(TARGET)%は腰をかくかく振って抵抗するのが精一杯になっている…。
PRINTFORM 「はひーっ	!#!PRINTFORM 「はひーっ
PRINTFORM 　ひーっ	!#!PRINTFORM 　ひーっ
PRINTFORM 　イきっぱなひっ	!#!PRINTFORM 　イきっぱなひっ
PRINTFORM 　ほひくぅぅっ	!#!PRINTFORM 　ほひくぅぅっ
PRINTFORM 　ふーっ	!#!PRINTFORM 　ふーっ
PRINTFORM 　おひんひん	!#!PRINTFORM 　おひんひん
PRINTFORM 　はえひゃいまひたぁ	!#!PRINTFORM 　はえひゃいまひたぁ
PRINTFORM 「びゅるびゅる	!#!PRINTFORM 「びゅるびゅる
PRINTFORM 　らしたくなっちゃいまひゅよぉ	!#!PRINTFORM 　らしたくなっちゃいまひゅよぉ
PRINTFORM 「にゅこにゅこっ	!#!PRINTFORM 「にゅこにゅこっ
PRINTFORM 　おまんこにゅこにゅこらめぇぇぇっ	!#!PRINTFORM 　おまんこにゅこにゅこらめぇぇぇっ
PRINTFORM 「…はー…	!#!PRINTFORM 「…はー…
PRINTFORM 「おまんこの奥、くぽくぽ入られて…	!#!PRINTFORM 「おまんこの奥、くぽくぽ入られて…
PRINTFORM わらひ、悦んじゃいまひたぁ…	!#!PRINTFORM わらひ、悦んじゃいまひたぁ…
PRINTFORMW 「う、ぐっ……！」	!#!PRINTFORMW 「う、ぐっ……！」
PRINTFORMW 「な、何とか…」	!#!PRINTFORMW 「な、何とか…」
PRINTFORM 「らめっ、らめぇぇぇっ	!#!PRINTFORM 「らめっ、らめぇぇぇっ
PRINTFORM 　クリちゃんしょんなにおっきくしにゃいれくらさぁぁぁいっ	!#!PRINTFORM 　クリちゃんしょんなにおっきくしにゃいれくらさぁぁぁいっ
PRINTFORM 「おひっ	!#!PRINTFORM 「おひっ
PRINTFORM 　おちんちんらめぇぇ	!#!PRINTFORM 　おちんちんらめぇぇ
PRINTFORM 「びゅーびゅーっれ、れちゃいまひゅぅぅっ	!#!PRINTFORM 「びゅーびゅーっれ、れちゃいまひゅぅぅっ
PRINTFORMW 「あ、危なかった…、いま、されたら…」	!#!PRINTFORMW 「あ、危なかった…、いま、されたら…」
PRINTFORMW 「んっ…」	!#!PRINTFORMW 「んっ…」
PRINTFORMW 「凄い…急に、気分が良くなったわ」	!#!PRINTFORMW 「凄い…急に、気分が良くなったわ」
PRINTFORMW 「ふぅ……」	!#!PRINTFORMW 「ふぅ……」
PRINTFORMW 「大分、楽になりましたね♪」	!#!PRINTFORMW 「大分、楽になりましたね♪」
PRINTFORMW 「こんな所に泉なんて……怪しい、わよね？」	!#!PRINTFORMW 「こんな所に泉なんて……怪しい、わよね？」
PRINTFORMW 「んっ、んっ……」	!#!PRINTFORMW 「んっ、んっ……」
PRINTFORMW 「何だか、気分が良くなったわね…」	!#!PRINTFORMW 「何だか、気分が良くなったわね…」
PRINTFORMW 「こく……ん……」	!#!PRINTFORMW 「こく……ん……」
PRINTFORMW 「ふわ……、何だか……急に……」	!#!PRINTFORMW 「ふわ……、何だか……急に……」
PRINTFORM 「っはっ	!#!PRINTFORM 「っはっ
PRINTFORM 　はふっ	!#!PRINTFORM 　はふっ
PRINTFORM 「からだ	!#!PRINTFORM 「からだ
PRINTFORM 　あつ、くなってぇ	!#!PRINTFORM 　あつ、くなってぇ
PRINTFORMW 「……身体が、軽く？」	!#!PRINTFORMW 「……身体が、軽く？」
PRINTFORMW 「一体どうしたんでしょう…」	!#!PRINTFORMW 「一体どうしたんでしょう…」
PRINTFORMW 「な、何かがいる！？」	!#!PRINTFORMW 「な、何かがいる！？」
PRINTFORM 「ひっ！？ やっ	!#!PRINTFORM 「ひっ！？ やっ
PRINTFORMW 　入っちゃだめぇ！」	!#!PRINTFORMW 　入っちゃだめぇ！」
PRINTFORMW 「……あからさまに、怪しいです、よねぇ？」	!#!PRINTFORMW 「……あからさまに、怪しいです、よねぇ？」
PRINTFORMW 「こ、この泉、凄い……」	!#!PRINTFORMW 「こ、この泉、凄い……」
PRINTFORMW 「この泉…、どれ程の、法力を持っていると言うの…？」	!#!PRINTFORMW 「この泉…、どれ程の、法力を持っていると言うの…？」
PRINTFORMW 「……あからさまに、怪しいですよねぇ？」	!#!PRINTFORMW 「……あからさまに、怪しいですよねぇ？」
PRINTFORMW 「ひゃふっ、冷たい！」	!#!PRINTFORMW 「ひゃふっ、冷たい！」
PRINTFORMW 「ふ、服が……！」	!#!PRINTFORMW 「ふ、服が……！」
PRINTFORMW 「だ、だめ！ 溶かしちゃだめぇぇ！」	!#!PRINTFORMW 「だ、だめ！ 溶かしちゃだめぇぇ！」
PRINTFORMW 「このくらいなら、避けられます！」	!#!PRINTFORMW 「このくらいなら、避けられます！」
PRINTFORMW 「か、壁からっ！？」	!#!PRINTFORMW 「か、壁からっ！？」
PRINTFORM 「ひあっ！？ ひあぁっ	!#!PRINTFORM 「ひあっ！？ ひあぁっ
PRINTFORM 　そこらめれすよぉっ	!#!PRINTFORM 　そこらめれすよぉっ
PRINTFORMW 「きゃうぅっ！？」	!#!PRINTFORMW 「きゃうぅっ！？」
PRINTFORM 「な、何か身体に…ひあぁっ	!#!PRINTFORM 「な、何か身体に…ひあぁっ
PRINTFORM 「ら、らめっ、そこらめぇぇっ	!#!PRINTFORM 「ら、らめっ、そこらめぇぇっ
PRINTFORMW 「き、きゃぁっ！？」	!#!PRINTFORMW 「き、きゃぁっ！？」
PRINTFORMW 「お、落とし穴ですか！？」	!#!PRINTFORMW 「お、落とし穴ですか！？」
PRINTFORM 「ふあぁぁぁ	!#!PRINTFORM 「ふあぁぁぁ
PRINTFORM 　これっ	!#!PRINTFORM 　これっ
PRINTFORMW 「ひゃふぅっ！？」	!#!PRINTFORMW 「ひゃふぅっ！？」
PRINTFORM 「こ、これすった	!#!PRINTFORM 「こ、これすった
PRINTFORM 　らぁ	!#!PRINTFORM 　らぁ
PRINTFORMW 「す、吸ったらだめ！」	!#!PRINTFORMW 「す、吸ったらだめ！」
PRINTFORMW 「あら、これは……」	!#!PRINTFORMW 「あら、これは……」
PRINTFORMW 「誰かが、残して行ったのかしら…？」	!#!PRINTFORMW 「誰かが、残して行ったのかしら…？」
PRINTFORMW 「こんな所に荷物、ですか？」	!#!PRINTFORMW 「こんな所に荷物、ですか？」
PRINTFORMW 「怪しいですね…、そのままにしておきましょうか」	!#!PRINTFORMW 「怪しいですね…、そのままにしておきましょうか」
PRINTFORMW 「きゃあっ！？」	!#!PRINTFORMW 「きゃあっ！？」
PRINTFORM 　ひぃん…	!#!PRINTFORM 　ひぃん…
PRINTFORM 　おしり…きらいだったのにぃ…	!#!PRINTFORM 　おしり…きらいだったのにぃ…
PRINTFORM 「ひゃあん…	!#!PRINTFORM 「ひゃあん…
PRINTFORM 　私のおっぱい…	!#!PRINTFORM 　私のおっぱい…
PRINTFORM 　物凄く、敏感、にぃ…	!#!PRINTFORM 　物凄く、敏感、にぃ…
PRINTFORMW 「も、申し訳ありませんが、それは……」	!#!PRINTFORMW 「も、申し訳ありませんが、それは……」
PRINTFORM 「ひあ…	!#!PRINTFORM 「ひあ…
PRINTFORM 　ふあぁ…	!#!PRINTFORM 　ふあぁ…
PRINTFORM 　こ、これで…全部、ですよね…	!#!PRINTFORM 　こ、これで…全部、ですよね…
PRINTFORMW 」」	!#!PRINTFORMW 」」
PRINTFORMW 「お、おしりはだめぇぇっ！」	!#!PRINTFORMW 「お、おしりはだめぇぇっ！」
PRINTFORM 　ひあ	!#!PRINTFORM 　ひあ
PRINTFORM 　だめっ	!#!PRINTFORM 　だめっ
PRINTFORM 　だめぇぇぇっ	!#!PRINTFORM 　だめぇぇぇっ
PRINTFORM 「あっ、だ、だめですぅぅっ	!#!PRINTFORM 「あっ、だ、だめですぅぅっ
PRINTFORM 　おっぱいっ、そんなにちゅうちゅうしちゃあぁっ	!#!PRINTFORM 　おっぱいっ、そんなにちゅうちゅうしちゃあぁっ
PRINTFORM 「イきますっ、すぐにイっちゃいましゅうぅっ	!#!PRINTFORM 「イきますっ、すぐにイっちゃいましゅうぅっ
PRINTFORM 「こ、この蟲さん、おっぱいばっかりぃっ	!#!PRINTFORM 「こ、この蟲さん、おっぱいばっかりぃっ
PRINTFORM 「だ	!#!PRINTFORM 「だ
PRINTFORM 　だめですっ	!#!PRINTFORM 　だめですっ
PRINTFORM 　びんかん	!#!PRINTFORM 　びんかん
PRINTFORM 　しゅぎてぇぇっ	!#!PRINTFORM 　しゅぎてぇぇっ
PRINTFORM 「はひぃぃっ	!#!PRINTFORM 「はひぃぃっ
PRINTFORM 　ひゃああぁぁぁんっ	!#!PRINTFORM 　ひゃああぁぁぁんっ
PRINTFORMDW 下半身からの蟲達の刺激に、%CALLNAME:(TARGET)%は思わずその場に膝を突いた。	!#!PRINTFORMDW 下半身からの蟲達の刺激に、%CALLNAME:(TARGET)%は思わずその場に膝を突いた。
PRINTFORM 「ひゃひぃぃぃっ	!#!PRINTFORM 「ひゃひぃぃぃっ
PRINTFORM 　いっぱい、くりくりってぇ	!#!PRINTFORM 　いっぱい、くりくりってぇ
PRINTFORMDW しかし、その体勢がさらなる蟲達の責めを呼ぶ事になってしまい、%CALLNAME:(TARGET)%は悶え狂った。	!#!PRINTFORMDW しかし、その体勢がさらなる蟲達の責めを呼ぶ事になってしまい、%CALLNAME:(TARGET)%は悶え狂った。
PRINTFORM 「っは…	!#!PRINTFORM 「っは…
PRINTFORM 　な、なんれ…いっぱい、イっちゃったのにぃ…	!#!PRINTFORM 　な、なんれ…いっぱい、イっちゃったのにぃ…
PRINTFORM 　わらひ、もっと欲しく…	!#!PRINTFORM 　わらひ、もっと欲しく…
PRINTFORM 　おちんちん、付いちゃいましたぁ…	!#!PRINTFORM 　おちんちん、付いちゃいましたぁ…
PRINTFORM 「ら、めぇぇぇぇっ	!#!PRINTFORM 「ら、めぇぇぇぇっ
PRINTFORM 　そんなっ、いっぱい入ってきちゃらめれしゅぅぅぅっ	!#!PRINTFORM 　そんなっ、いっぱい入ってきちゃらめれしゅぅぅぅっ
PRINTFORM 「なかれいっぱいしゅきかってにうごかにゃいれぇぇっ	!#!PRINTFORM 「なかれいっぱいしゅきかってにうごかにゃいれぇぇっ
PRINTFORM 　はひ	!#!PRINTFORM 　はひ
PRINTFORMW 　な、中に、まだ残って…？」	!#!PRINTFORMW 　な、中に、まだ残って…？」
PRINTFORMW 「ぐっ……！ や、やってしまいましたね……」	!#!PRINTFORMW 「ぐっ……！ や、やってしまいましたね……」
PRINTFORMW 「あ、危ないっ！」	!#!PRINTFORMW 「あ、危ないっ！」
PRINTFORMW 「……ふぅ、びっくりしました…」	!#!PRINTFORMW 「……ふぅ、びっくりしました…」
PRINTFORMW 「う、そ…」	!#!PRINTFORMW 「う、そ…」
PRINTFORMW 「おちんちん、生やされて…」	!#!PRINTFORMW 「おちんちん、生やされて…」
PRINTFORM 「ま、まっれ、ひあぁ	!#!PRINTFORM 「ま、まっれ、ひあぁ
PRINTFORM 「そこっ、らめ、らめれすぅぅぅっ	!#!PRINTFORM 「そこっ、らめ、らめれすぅぅぅっ
PRINTFORMW 「あ、危ない！」	!#!PRINTFORMW 「あ、危ない！」
PRINTFORMW 「…な、何でしょうか、これ……」	!#!PRINTFORMW 「…な、何でしょうか、これ……」
PRINTFORMW 「何かの、装置なんでしょうか……？」	!#!PRINTFORMW 「何かの、装置なんでしょうか……？」
PRINTFORM 「また、触手さんが私の身体を…	!#!PRINTFORM 「また、触手さんが私の身体を…
PRINTFORM 　はやくっ、ひじりのえっちなからだ、覆ってくださぁいっ	!#!PRINTFORM 　はやくっ、ひじりのえっちなからだ、覆ってくださぁいっ
PRINTFORMW 「ま、また私、こんな服を……」	!#!PRINTFORMW 「ま、また私、こんな服を……」
PRINTFORM （で、でも……また覆ってくれると、考えると…	!#!PRINTFORM （で、でも……また覆ってくれると、考えると…
PRINTFORMW 「……は、裸のままよりは、ましですよね！」	!#!PRINTFORMW 「……は、裸のままよりは、ましですよね！」
PRINTFORMW 「う、うん！ きっとそうです！」	!#!PRINTFORMW 「う、うん！ きっとそうです！」
PRINTFORMW 「えっ、ちょっ！？」	!#!PRINTFORMW 「えっ、ちょっ！？」
PRINTFORMW 「ふ、服ってそう言う、きゃあぁぁぁっ！！？」	!#!PRINTFORMW 「ふ、服ってそう言う、きゃあぁぁぁっ！！？」
PRINTFORM 　この気持ちいい服、知っちゃったら…	!#!PRINTFORM 　この気持ちいい服、知っちゃったら…
PRINTFORM 　もう、戻れませんよぉ…	!#!PRINTFORM 　もう、戻れませんよぉ…
PRINTFORM 　全身、気持ちよすぎてぇ…	!#!PRINTFORM 　全身、気持ちよすぎてぇ…
PRINTFORM 　わらひ、くせになっちゃいそうですぅ……	!#!PRINTFORM 　わらひ、くせになっちゃいそうですぅ……
PRINTFORM 　はふぅっ	!#!PRINTFORM 　はふぅっ
PRINTFORM 　も、もう…暴れすぎですよ…	!#!PRINTFORM 　も、もう…暴れすぎですよ…
PRINTFORM 　おくまで、とどいただけで、わたしぃ	!#!PRINTFORM 　おくまで、とどいただけで、わたしぃ
PRINTFORM 　いっぱい、ろくろくひてくださぁいっ	!#!PRINTFORM 　いっぱい、ろくろくひてくださぁいっ
PRINTFORM 「ひあうっ！？ そ、そこ、だめぇ	!#!PRINTFORM 「ひあうっ！？ そ、そこ、だめぇ
PRINTFORM 　ふにゃぁっ	!#!PRINTFORM 　ふにゃぁっ
PRINTFORM 　どくどく注いじゃ、らめぇぇ	!#!PRINTFORM 　どくどく注いじゃ、らめぇぇ
PRINTFORM 　はひぃぃっ	!#!PRINTFORM 　はひぃぃっ
PRINTFORM 「お、おなかいっぱいになるまで、そそがれちゃいまひたぁっ…	!#!PRINTFORM 「お、おなかいっぱいになるまで、そそがれちゃいまひたぁっ…
PRINTFORMW 「も、もう入らない…」	!#!PRINTFORMW 「も、もう入らない…」
PRINTFORMW 「こんなに、注ぐ、なんてぇ…」	!#!PRINTFORMW 「こんなに、注ぐ、なんてぇ…」
PRINTFORM 「んん～～～っ！！？ ん～っ！ んんっ、んっ…	!#!PRINTFORM 「んん～～～っ！！？ ん～っ！ んんっ、んっ…
PRINTFORM 　…んんっ	!#!PRINTFORM 　…んんっ
PRINTFORM 　こ	!#!PRINTFORM 　こ
PRINTFORM 　からだがっ	!#!PRINTFORM 　からだがっ
PRINTFORMW 「わ、私、ですか？」	!#!PRINTFORMW 「わ、私、ですか？」
PRINTFORMW 「わ、分かりました。私が、みなさんを守らないと…」	!#!PRINTFORMW 「わ、分かりました。私が、みなさんを守らないと…」
PRINTFORMW 「申し訳ありませんが、お願いできますか？」	!#!PRINTFORMW 「申し訳ありませんが、お願いできますか？」
PRINTFORMW 「あなたに強くなっていただいた方が、いいと思いますから」	!#!PRINTFORMW 「あなたに強くなっていただいた方が、いいと思いますから」
PRINTFORMW 「それでは…、私が」	!#!PRINTFORMW 「それでは…、私が」
PRINTFORMW 「少しでも、脱出の可能性を高めないと…」	!#!PRINTFORMW 「少しでも、脱出の可能性を高めないと…」
PRINTFORM 「ひぃっ！？ お、おしりはっ	!#!PRINTFORM 「ひぃっ！？ お、おしりはっ
PRINTFORM 　らめ、なのにぃぃっ	!#!PRINTFORM 　らめ、なのにぃぃっ
PRINTFORM 「こ、こんにゃっ	!#!PRINTFORM 「こ、こんにゃっ
PRINTFORM 　いぃぃっ	!#!PRINTFORM 　いぃぃっ
PRINTFORM 「おっ	!#!PRINTFORM 「おっ
PRINTFORM 　びんかんなんれすぅっ	!#!PRINTFORM 　びんかんなんれすぅっ
PRINTFORM 「そんにゃっ	!#!PRINTFORM 「そんにゃっ
PRINTFORM 　しぼったらぁぁっ	!#!PRINTFORM 　しぼったらぁぁっ
PRINTFORM 　感じちゃいますぅぅっ	!#!PRINTFORM 　感じちゃいますぅぅっ
PRINTFORM 「ふあっ	!#!PRINTFORM 「ふあっ
PRINTFORM 　ひゃんっ	!#!PRINTFORM 　ひゃんっ
PRINTFORM 　すごすぎますぅっ	!#!PRINTFORM 　すごすぎますぅっ
PRINTFORM 　クリっ	!#!PRINTFORM 　クリっ
PRINTFORM 　らめれすぅっ	!#!PRINTFORM 　らめれすぅっ
PRINTFORM 　すぐ、にぃ	!#!PRINTFORM 　すぐ、にぃ
PRINTFORM 「ひあぁあんっ	!#!PRINTFORM 「ひあぁあんっ
PRINTFORM 　そ、そこ	!#!PRINTFORM 　そ、そこ
PRINTFORM 　しょこっ	!#!PRINTFORM 　しょこっ
PRINTFORM 　らめぇぇぇぇっ	!#!PRINTFORM 　らめぇぇぇぇっ
PRINTFORM 　おっ、おっぱいぃぃ	!#!PRINTFORM 　おっ、おっぱいぃぃ
PRINTFORM 「しょんにゃにっ	!#!PRINTFORM 「しょんにゃにっ
PRINTFORM 　びゅるびゅるしゅっちゃっ	!#!PRINTFORM 　びゅるびゅるしゅっちゃっ
PRINTFORM 「んふぅぅぅっ！！？　んんーっ	!#!PRINTFORM 「んふぅぅぅっ！！？　んんーっ
PRINTFORMW 　んひぃぃぃ―――――っ…」	!#!PRINTFORMW 　んひぃぃぃ―――――っ…」
PRINTFORMW 「はぁ…はぁ……え…身体が…？」	!#!PRINTFORMW 「はぁ…はぁ……え…身体が…？」
PRINTFORMDW %CALLNAME:(TARGET)%は小さくなった手のひらで全身をペタペタ確認しながら呟いた	!#!PRINTFORMDW %CALLNAME:(TARGET)%は小さくなった手のひらで全身をペタペタ確認しながら呟いた
PRINTFORMW 「どう考えても…怪しすぎます、よね…」	!#!PRINTFORMW 「どう考えても…怪しすぎます、よね…」
PRINTFORM 「ひあぁっ！？ そ、そこっ	!#!PRINTFORM 「ひあぁっ！？ そ、そこっ
PRINTFORM 　そこはっ、違う穴でっ	!#!PRINTFORM 　そこはっ、違う穴でっ
PRINTFORM 「ひんっ	!#!PRINTFORM 「ひんっ
PRINTFORM 　どくどくってぇっ	!#!PRINTFORM 　どくどくってぇっ
PRINTFORM 　流し込んじゃだめぇぇぇ	!#!PRINTFORM 　流し込んじゃだめぇぇぇ
PRINTFORM 「ふぁ、あ…	!#!PRINTFORM 「ふぁ、あ…
PRINTFORM 　また…	!#!PRINTFORM 　また…
PRINTFORM 　げんきに、なっちゃいましたぁ…	!#!PRINTFORM 　げんきに、なっちゃいましたぁ…
PRINTFORM 「ひあぁあああぁぁっ	!#!PRINTFORM 「ひあぁあああぁぁっ
PRINTFORM 　おっぱいっ、弱いんれすぅぅぅっ	!#!PRINTFORM 　おっぱいっ、弱いんれすぅぅぅっ
PRINTFORM 　そんにゃっ	!#!PRINTFORM 　そんにゃっ
PRINTFORM 　ちゅーちゅーしたらぁぁっ	!#!PRINTFORM 　ちゅーちゅーしたらぁぁっ
PRINTFORM 　ぼ、ぼにゅうはとまりまひたけど、くせになっちゃいそうですよぉ…	!#!PRINTFORM 　ぼ、ぼにゅうはとまりまひたけど、くせになっちゃいそうですよぉ…
PRINTFORMW 「こっ、これって……！」	!#!PRINTFORMW 「こっ、これって……！」
PRINTFORMW 「だ、駄目です！ こんなお風呂…！」	!#!PRINTFORMW 「だ、駄目です！ こんなお風呂…！」
PRINTFORM 　だっ	!#!PRINTFORM 　だっ
PRINTFORM 　だめですぅっ	!#!PRINTFORM 　だめですぅっ
PRINTFORM 　にゅるにゅるらめぇ	!#!PRINTFORM 　にゅるにゅるらめぇ
PRINTFORM 　ぬりこまないれくださぁいっ	!#!PRINTFORM 　ぬりこまないれくださぁいっ
PRINTFORM 「こ、この匂い…	!#!PRINTFORM 「こ、この匂い…
PRINTFORM 　お、おまんこ、がぁ	!#!PRINTFORM 　お、おまんこ、がぁ
PRINTFORM 　欲しがっちゃって、るぅ	!#!PRINTFORM 　欲しがっちゃって、るぅ
PRINTFORM 「こ、こんなの、覚えちゃったら…	!#!PRINTFORM 「こ、こんなの、覚えちゃったら…
PRINTFORM 　まいにちだって、欲しくなっちゃいますよぉ…	!#!PRINTFORM 　まいにちだって、欲しくなっちゃいますよぉ…
PRINTFORMW 「この帽子、まさか…」	!#!PRINTFORMW 「この帽子、まさか…」
PRINTFORMW 「そ、そんな、魔理沙さん…！」	!#!PRINTFORMW 「そ、そんな、魔理沙さん…！」
PRINTFORMW 「これは、こいしさんの…！？」	!#!PRINTFORMW 「これは、こいしさんの…！？」
PRINTFORMW 「そんな、どうして…」	!#!PRINTFORMW 「そんな、どうして…」
PRINTFORMW 「こ、これ、一輪、の…？」	!#!PRINTFORMW 「こ、これ、一輪、の…？」
PRINTFORMW 「そ、そんな、こんな事って…」	!#!PRINTFORMW 「そ、そんな、こんな事って…」
PRINTFORMW 「これは、まさか…！」	!#!PRINTFORMW 「これは、まさか…！」
PRINTFORMW 「ムラサ、そんな……っ！」	!#!PRINTFORMW 「ムラサ、そんな……っ！」
PRINTFORMW 「こ、これ……、星、の……」	!#!PRINTFORMW 「こ、これ……、星、の……」
PRINTFORMW 「そ、そんな…」	!#!PRINTFORMW 「そ、そんな…」
PRINTFORMW 「これは……ぬえ、の……？」	!#!PRINTFORMW 「これは……ぬえ、の……？」
PRINTFORMW 「そ、そんな、あの子が…？」	!#!PRINTFORMW 「そ、そんな、あの子が…？」
PRINTFORMW 「そんな、こんなに犠牲者が……」	!#!PRINTFORMW 「そんな、こんなに犠牲者が……」
PRINTFORMW 「くぅ…っ！」	!#!PRINTFORMW 「くぅ…っ！」
PRINTFORML ―――甘かった。	!#!PRINTFORML ―――甘かった。
PRINTFORML 近頃幻想郷を襲う神隠し。	!#!PRINTFORML 近頃幻想郷を襲う神隠し。
PRINTFORML それが新たな異変であり、首謀者は妖怪であると直感し、白蓮は迷宮の入り口を探し始めた。	!#!PRINTFORML それが新たな異変であり、首謀者は妖怪であると直感し、白蓮は迷宮の入り口を探し始めた。
PRINTFORMW その神隠しを止める為に、可能ならば首謀者を説得し、共存する為に。	!#!PRINTFORMW その神隠しを止める為に、可能ならば首謀者を説得し、共存する為に。
PRINTFORML そして白蓮は首尾良く迷宮の入り口を見つけ出し、中へと潜り込む。	!#!PRINTFORML そして白蓮は首尾良く迷宮の入り口を見つけ出し、中へと潜り込む。
PRINTFORMW ―――しかし。	!#!PRINTFORMW ―――しかし。
PRINTFORML 迷宮にいたのは人の言葉を解さない触手の化け物達、	!#!PRINTFORML 迷宮にいたのは人の言葉を解さない触手の化け物達、
PRINTFORML そして被害者となり、苗床となり、加害者となりつつある女性達。	!#!PRINTFORML そして被害者となり、苗床となり、加害者となりつつある女性達。
PRINTFORML 説得の余地など介在しない、首謀者の位置も分からない、と気付いた時には、	!#!PRINTFORML 説得の余地など介在しない、首謀者の位置も分からない、と気付いた時には、
PRINTFORMW 触手達は白蓮にもその魔の手を伸ばそうとして来ていて。	!#!PRINTFORMW 触手達は白蓮にもその魔の手を伸ばそうとして来ていて。
PRINTFORML なんとかその攻撃自体は振り払い、逃亡に成功こそしたものの、	!#!PRINTFORML なんとかその攻撃自体は振り払い、逃亡に成功こそしたものの、
PRINTFORML 入ってきた入り口は忽然と消え失せ、逃げ回った結果現在地すら分からない有様。	!#!PRINTFORML 入ってきた入り口は忽然と消え失せ、逃げ回った結果現在地すら分からない有様。
PRINTFORML そして、説得に来た為に法具等も必要最低限の物以外は所持しておらず。	!#!PRINTFORML そして、説得に来た為に法具等も必要最低限の物以外は所持しておらず。
PRINTFORMW 説得に来たはず白蓮は、図らずも自ら食われに来たおいしい餌となってしまっていた…。	!#!PRINTFORMW 説得に来たはず白蓮は、図らずも自ら食われに来たおいしい餌となってしまっていた…。
